PartitionKey,RowKey,Timestamp,AcademicYear,All,Disabilities,EconomicallyDisadvantaged,Female,FosterCare,HispanicNOTPuertoRican,Homeless,Male,Migrants,MilitaryParent,NOTDisabilities,NOTEconomicallyDisadvantaged,OtherOrigin,PuertoRican,Section504,SpanishLearners,WhiteNOTHispanic
35295,31796,2021-06-24T05:35:16.8709135Z,2021,184,33,136,93,0,9,0,91,0,0,151,48,0,175,0,1,0
35295,4320,2020-11-18T16:16:12.1590916Z,2012,341,30,270,172,0,3,0,169,0,0,311,71,1,336,0,0,1
35295,4321,2020-11-18T16:16:12.160092Z,2013,311,44,261,153,0,5,0,158,0,0,267,50,0,305,0,4,1
35295,4322,2020-11-18T16:16:12.160092Z,2014,300,59,229,145,0,4,0,155,0,0,241,71,0,294,0,3,2
35295,4323,2020-11-18T16:16:12.160092Z,2015,271,41,218,129,0,4,0,142,0,0,230,53,0,266,0,2,1
35295,4324,2020-11-18T16:16:12.1610929Z,2016,210,40,164,114,0,7,1,96,0,0,170,46,0,203,0,4,0
35295,4325,2020-11-18T16:16:12.1610929Z,2017,218,50,188,109,0,9,0,109,0,0,168,30,0,209,0,2,0
35295,4326,2020-11-18T16:16:12.1610929Z,2018,231,51,195,118,0,5,0,113,0,0,180,36,0,225,1,2,1
35295,4327,2020-11-18T16:16:12.1620938Z,2019,210,50,175,120,0,4,0,90,0,0,160,35,0,205,1,1,1
35295,4328,2020-11-18T16:16:12.1620938Z,2020,200,43,164,111,0,12,0,89,0,0,157,36,0,187,0,1,1
74864,10739,2020-11-18T16:16:56.8889183Z,2012,505,100,389,228,0,10,0,277,0,0,405,116,0,495,0,0,0
74864,10740,2020-11-18T16:16:56.8889183Z,2013,504,156,398,236,0,14,0,268,0,0,348,106,0,490,0,1,0
74864,10741,2020-11-18T16:16:56.8889183Z,2014,472,159,368,204,0,14,0,268,0,0,313,104,0,458,0,0,0
74864,10742,2020-11-18T16:16:56.8889183Z,2015,435,147,334,198,0,13,0,237,0,0,288,101,0,422,0,0,0
74864,10743,2020-11-18T16:16:56.8899192Z,2016,583,236,318,264,0,10,1,319,0,0,347,265,0,572,0,1,1
74864,10744,2020-11-18T16:16:56.8899192Z,2017,498,201,395,233,0,11,0,265,0,0,297,103,0,486,0,2,1
74864,10745,2020-11-18T16:16:56.8899192Z,2018,549,190,407,269,0,5,0,280,0,0,359,142,0,543,1,0,1
74864,10746,2020-11-18T16:16:56.8899192Z,2019,484,178,378,225,0,6,7,259,0,0,306,106,0,478,1,2,0
74864,10747,2020-11-18T16:16:56.8899192Z,2020,443,156,361,195,0,6,3,248,0,0,287,82,1,436,0,3,0
74864,31681,2021-06-24T05:35:15.2847773Z,2021,395,146,317,170,0,7,2,225,0,0,249,78,1,387,0,3,0
20578,1823,2020-11-18T16:15:57.841544Z,2012,298,79,213,144,0,7,0,154,0,0,219,85,0,290,0,0,1
20578,1824,2020-11-18T16:15:57.841544Z,2013,303,94,203,150,0,6,0,153,0,0,209,100,0,297,0,1,0
20578,1825,2020-11-18T16:15:57.841544Z,2014,563,163,288,291,0,18,0,272,0,0,400,275,0,541,0,6,4
20578,1826,2020-11-18T16:15:57.8425449Z,2015,736,216,476,362,0,20,0,374,0,0,520,260,0,715,0,7,1
20578,1827,2020-11-18T16:15:57.8425449Z,2016,623,199,302,311,0,15,12,312,0,0,424,321,0,607,0,0,1
20578,1828,2020-11-18T16:15:57.8425449Z,2017,656,207,454,332,0,19,1,324,0,0,449,202,0,636,0,2,1
20578,1829,2020-11-18T16:15:57.8425449Z,2018,578,164,394,279,0,22,12,299,0,0,414,184,0,554,0,1,2
20578,1830,2020-11-18T16:15:57.8435453Z,2019,425,163,302,208,0,9,4,217,0,0,262,123,0,413,0,1,3
20578,1831,2020-11-18T16:15:57.8435453Z,2020,432,142,331,219,0,7,0,213,0,0,290,101,0,425,0,1,0
20578,25695,2021-06-24T05:35:08.6410127Z,2021,437,134,345,232,0,6,0,205,0,0,303,92,0,431,1,0,0
15784,1260,2020-11-18T16:15:53.6107231Z,2012,423,0,273,283,0,6,0,140,0,0,423,150,0,417,0,0,0
15784,1261,2020-11-18T16:15:53.611724Z,2013,437,0,289,290,0,9,0,147,0,0,437,148,0,428,0,1,0
15784,1262,2020-11-18T16:15:53.611724Z,2014,418,22,276,283,0,10,0,135,0,0,396,142,0,408,0,2,0
15784,1263,2020-11-18T16:15:53.611724Z,2015,381,19,262,253,0,9,0,128,0,0,362,119,0,371,0,2,1
15784,1264,2020-11-18T16:15:53.611724Z,2016,373,51,46,249,0,7,0,124,0,0,322,327,0,365,0,0,1
15784,1265,2020-11-18T16:15:53.611724Z,2017,465,68,304,293,0,5,2,172,0,0,397,161,1,458,0,0,1
15784,1266,2020-11-18T16:15:53.6127249Z,2018,464,61,280,299,0,2,15,165,0,0,403,184,0,462,6,0,0
15784,1267,2020-11-18T16:15:53.6127249Z,2019,432,61,267,260,0,3,3,172,0,0,371,165,0,429,6,0,0
15784,1268,2020-11-18T16:15:53.6127249Z,2020,407,78,260,238,0,5,0,169,0,0,329,147,0,402,7,0,0
15784,31606,2021-06-24T05:35:14.5812713Z,2021,384,74,274,215,0,3,2,169,0,0,310,110,0,380,3,0,1
52357,31895,2021-06-24T05:35:18.4690597Z,2021,165,69,151,79,0,4,0,86,0,0,96,14,0,159,0,0,2
52357,6807,2020-11-18T16:16:30.1470868Z,2012,303,105,265,134,0,2,0,169,0,0,198,38,0,279,0,0,22
52357,6808,2020-11-18T16:16:30.1470868Z,2013,264,105,205,122,0,4,0,142,0,0,159,59,0,239,0,0,21
52357,6809,2020-11-18T16:16:30.1480881Z,2014,270,99,216,128,0,8,0,142,0,0,171,54,0,241,0,1,21
52357,6810,2020-11-18T16:16:30.1480881Z,2015,267,82,251,136,0,9,0,131,0,0,185,16,0,241,0,2,17
52357,6811,2020-11-18T16:16:30.1480881Z,2016,166,63,83,80,0,4,0,86,0,0,103,83,0,150,0,0,12
52357,6812,2020-11-18T16:16:30.1480881Z,2017,211,75,197,95,0,7,1,116,0,0,136,14,0,194,0,1,10
52357,6813,2020-11-18T16:16:30.1480881Z,2018,248,79,236,110,1,4,3,138,0,0,169,12,0,240,0,0,4
52357,6814,2020-11-18T16:16:30.1490881Z,2019,266,94,251,124,5,16,6,142,0,0,172,15,0,249,0,0,1
52357,6815,2020-11-18T16:16:30.1490881Z,2020,223,86,210,109,0,14,7,114,0,0,137,13,0,207,0,0,2
61598,31953,2021-06-24T05:35:18.5671314Z,2021,133,35,108,64,0,3,0,69,0,0,98,25,0,129,0,0,1
61598,8313,2020-11-18T16:16:39.7785074Z,2012,168,88,138,71,0,1,0,97,0,0,80,30,0,166,0,0,1
61598,8314,2020-11-18T16:16:39.7785074Z,2013,134,70,113,65,0,2,0,69,0,0,64,21,0,132,0,0,0
61598,8315,2020-11-18T16:16:39.7785074Z,2014,143,76,109,67,0,5,0,76,0,0,67,34,0,137,0,0,1
61598,8316,2020-11-18T16:16:39.7795079Z,2015,158,72,129,70,0,11,0,88,0,0,86,29,0,147,0,0,0
61598,8317,2020-11-18T16:16:39.7795079Z,2016,139,64,116,63,0,5,1,76,0,0,75,23,0,134,0,0,0
61598,8318,2020-11-18T16:16:39.7795079Z,2017,150,52,126,63,0,6,7,87,0,0,98,24,0,144,0,0,0
61598,8319,2020-11-18T16:16:39.7805097Z,2018,141,40,122,66,0,5,2,75,0,0,101,19,0,136,1,0,0
61598,8320,2020-11-18T16:16:39.7805097Z,2019,134,37,115,71,0,3,1,63,0,0,97,19,0,131,0,0,0
61598,8321,2020-11-18T16:16:39.7805097Z,2020,130,35,109,69,0,5,1,61,0,0,95,21,0,124,0,0,1
27714,3080,2020-11-18T16:16:04.7691648Z,2012,380,58,297,202,0,10,0,178,0,0,322,83,0,369,0,0,1
27714,3081,2020-11-18T16:16:04.7701652Z,2013,410,66,319,209,0,15,0,201,0,0,344,91,0,394,0,5,1
27714,3082,2020-11-18T16:16:04.7701652Z,2014,370,65,286,176,0,4,0,194,0,0,305,84,0,365,0,4,1
27714,3083,2020-11-18T16:16:04.7701652Z,2015,371,78,276,169,0,7,0,202,0,0,293,95,1,362,0,4,1
27714,3084,2020-11-18T16:16:04.7701652Z,2016,252,75,200,130,0,4,6,122,0,0,177,52,1,246,0,3,1
27714,3085,2020-11-18T16:16:04.7701652Z,2017,314,95,246,152,0,6,8,162,0,0,219,68,1,304,0,3,3
27714,3086,2020-11-18T16:16:04.7701652Z,2018,414,104,339,191,0,6,17,223,0,0,310,75,0,406,2,3,2
27714,3087,2020-11-18T16:16:04.7711661Z,2019,341,104,273,166,0,4,2,175,0,0,237,68,0,335,2,3,2
27714,3088,2020-11-18T16:16:04.7711661Z,2020,330,92,272,163,0,4,5,167,0,0,238,58,0,323,1,2,3
27714,31737,2021-06-24T05:35:15.4078658Z,2021,282,79,248,143,0,4,0,139,0,0,203,34,0,277,0,2,1
26336,2963,2020-11-18T16:16:04.2938475Z,2012,527,27,389,260,0,8,0,267,0,0,500,138,1,518,0,0,0
26336,2964,2020-11-18T16:16:04.2938475Z,2013,542,53,422,249,0,7,0,293,0,0,489,120,1,534,0,2,0
26336,2965,2020-11-18T16:16:04.2938475Z,2014,546,66,450,251,0,8,0,295,0,0,480,96,0,538,0,7,0
26336,2966,2020-11-18T16:16:04.2948493Z,2015,465,62,393,222,0,7,0,243,0,0,403,72,0,458,0,20,0
26336,2967,2020-11-18T16:16:04.2948493Z,2016,419,76,351,191,0,7,0,228,0,0,343,68,0,412,0,8,0
26336,2968,2020-11-18T16:16:04.2948493Z,2017,340,76,297,162,0,2,3,178,0,0,264,43,0,338,0,1,0
26336,2969,2020-11-18T16:16:04.2958493Z,2018,363,88,319,172,0,4,17,191,0,0,275,44,0,359,0,0,0
26336,2970,2020-11-18T16:16:04.2958493Z,2019,349,92,306,163,0,3,6,186,0,0,257,43,1,345,3,2,0
26336,2971,2020-11-18T16:16:04.2958493Z,2020,346,100,318,162,0,4,14,184,0,0,246,28,2,340,2,0,0
26336,31731,2021-06-24T05:35:15.4028611Z,2021,299,88,246,142,0,4,2,157,0,0,211,53,0,295,2,0,0
78931,11047,2020-11-18T16:16:58.5460256Z,2012,904,1,595,471,0,10,0,433,0,0,903,309,11,883,0,0,0
78931,11048,2020-11-18T16:16:58.5460256Z,2013,899,10,606,471,0,9,0,428,0,0,889,293,11,879,0,0,0
78931,11049,2020-11-18T16:16:58.5470274Z,2014,875,73,610,467,0,9,0,408,0,0,802,265,3,863,0,0,0
78931,11050,2020-11-18T16:16:58.5470274Z,2015,848,74,590,418,0,11,0,430,0,0,774,258,3,833,0,0,1
78931,11051,2020-11-18T16:16:58.5470274Z,2016,840,112,321,429,0,12,3,411,0,0,728,519,2,826,0,0,0
78931,11052,2020-11-18T16:16:58.5480274Z,2017,703,117,420,363,0,14,0,340,0,0,586,283,3,686,0,1,0
78931,11053,2020-11-18T16:16:58.5480274Z,2018,518,87,359,274,0,9,4,244,0,0,431,159,1,508,0,1,0
78931,11054,2020-11-18T16:16:58.5480274Z,2019,510,132,342,263,0,8,1,247,0,0,378,168,1,500,0,0,1
78931,11055,2020-11-18T16:16:58.5480274Z,2020,582,190,430,301,0,9,7,281,0,0,392,152,0,572,0,0,1
78931,25685,2021-06-24T05:35:08.6290036Z,2021,631,208,483,338,0,9,10,293,0,0,423,148,0,620,1,1,2
71514,10294,2020-11-18T16:16:53.7398216Z,2012,482,3,318,253,0,8,0,229,0,0,479,164,2,471,0,0,1
71514,10295,2020-11-18T16:16:53.7398216Z,2013,452,7,385,242,0,12,0,210,0,0,445,67,2,438,0,1,0
71514,10296,2020-11-18T16:16:53.7398216Z,2014,477,24,400,243,0,14,0,234,0,0,453,77,2,459,0,1,2
71514,10297,2020-11-18T16:16:53.7408212Z,2015,532,36,451,279,0,15,0,253,0,0,496,81,1,514,0,2,2
71514,10298,2020-11-18T16:16:53.7408212Z,2016,746,122,156,395,0,14,0,351,0,0,624,590,0,729,0,1,3
71514,10299,2020-11-18T16:16:53.7408212Z,2017,628,121,516,319,0,3,4,309,0,0,507,112,0,624,0,1,1
71514,10300,2020-11-18T16:16:53.7408212Z,2018,574,110,477,283,0,4,1,291,0,0,464,97,0,569,3,1,1
71514,10301,2020-11-18T16:16:54.3001911Z,2019,430,61,366,222,0,6,3,208,0,0,369,64,0,423,3,0,1
71514,10302,2020-11-18T16:16:54.3011916Z,2020,397,92,352,205,0,9,36,192,0,0,305,45,0,387,5,1,1
71514,25671,2021-06-24T05:35:04.7392146Z,2021,398,128,336,203,0,10,12,195,0,0,270,62,0,386,2,0,2
42473,25832,2021-06-24T05:35:10.9416617Z,2021,351,135,286,177,0,1,0,174,0,0,216,65,1,349,0,1,0
42473,5271,2020-11-18T16:16:18.4482846Z,2012,487,170,432,218,0,2,0,269,0,0,317,55,0,485,0,0,0
42473,5272,2020-11-18T16:16:18.4482846Z,2013,446,169,389,196,0,2,0,250,0,0,277,57,0,444,0,0,0
42473,5273,2020-11-18T16:16:18.4482846Z,2014,382,151,309,159,0,2,0,223,0,0,231,73,0,380,0,0,0
42473,5274,2020-11-18T16:16:18.4492851Z,2015,368,152,324,144,0,1,0,224,0,0,216,44,0,367,0,2,0
42473,5275,2020-11-18T16:16:18.4492851Z,2016,440,169,360,183,0,7,7,257,0,0,271,80,1,432,0,5,0
42473,5276,2020-11-18T16:16:18.4492851Z,2017,322,134,286,127,0,3,1,195,0,0,188,36,0,319,0,1,0
42473,5277,2020-11-18T16:16:18.4502869Z,2018,325,132,286,131,0,4,7,194,0,0,193,39,0,321,1,1,0
42473,5278,2020-11-18T16:16:18.4502869Z,2019,435,172,389,193,1,3,4,242,0,0,263,46,0,432,0,3,0
42473,5279,2020-11-18T16:16:18.4502869Z,2020,407,149,364,200,0,4,4,207,0,0,258,43,1,402,0,2,0
58594,31936,2021-06-24T05:35:18.5341066Z,2021,368,100,253,171,0,7,2,197,0,0,268,115,0,361,1,0,0
58594,7915,2020-11-18T16:16:37.0847151Z,2012,448,46,311,219,0,0,0,229,0,0,402,137,1,447,0,0,0
58594,7916,2020-11-18T16:16:37.0847151Z,2013,423,76,317,206,0,0,0,217,0,0,347,106,2,421,0,0,0
58594,7917,2020-11-18T16:16:37.0847151Z,2014,401,78,289,195,0,0,0,206,0,0,323,112,1,400,0,3,0
58594,7918,2020-11-18T16:16:37.0847151Z,2015,367,74,258,185,0,0,0,182,0,0,293,109,6,361,0,0,0
58594,7919,2020-11-18T16:16:37.0857169Z,2016,342,67,13,176,0,0,1,166,0,0,275,329,5,337,0,1,0
58594,7920,2020-11-18T16:16:37.0857169Z,2017,387,68,273,219,0,0,0,168,0,0,319,114,6,381,0,0,0
58594,7921,2020-11-18T16:16:37.0857169Z,2018,382,73,252,222,0,2,4,160,0,0,309,130,6,374,4,1,0
58594,7922,2020-11-18T16:16:37.0857169Z,2019,386,91,257,196,0,6,6,190,0,0,295,129,2,378,3,0,0
58594,7923,2020-11-18T16:16:37.0867164Z,2020,399,100,266,203,0,6,0,196,0,0,299,133,2,391,1,0,0
32375,31775,2021-06-24T05:35:16.8539015Z,2021,86,28,70,39,0,4,0,47,0,0,58,16,0,78,0,0,4
32375,3855,2020-11-18T16:16:09.1811055Z,2012,49,10,45,23,0,3,0,26,0,0,39,4,0,46,0,0,0
32375,3856,2020-11-18T16:16:09.1811055Z,2013,49,17,47,29,0,1,0,20,0,0,32,2,0,48,0,2,0
32375,3857,2020-11-18T16:16:09.1821064Z,2016,27,6,18,14,0,2,0,13,0,0,21,9,0,24,0,1,1
32375,3858,2020-11-18T16:16:09.1821064Z,2017,111,30,88,40,0,5,0,71,0,0,81,23,0,106,0,0,0
32375,3859,2020-11-18T16:16:09.1821064Z,2018,108,26,85,41,0,3,0,67,0,0,82,23,0,104,0,0,1
32375,3860,2020-11-18T16:16:09.1821064Z,2019,116,35,95,43,0,3,2,73,0,0,81,21,0,110,0,0,3
32375,3861,2020-11-18T16:16:09.1821064Z,2020,92,29,80,33,0,2,0,59,0,0,63,12,0,88,0,0,2
74807,10730,2020-11-18T16:16:56.8889183Z,2012,671,156,504,330,0,3,0,341,0,0,515,167,0,666,0,0,2
74807,10731,2020-11-18T16:16:56.8889183Z,2013,550,137,411,267,0,2,0,283,0,0,413,139,0,548,0,6,0
74807,10732,2020-11-18T16:16:56.8889183Z,2014,611,158,443,296,0,7,0,315,0,0,453,168,0,604,0,4,0
74807,10733,2020-11-18T16:16:56.8889183Z,2015,605,150,466,295,0,13,0,310,0,0,455,139,0,592,0,3,0
74807,10734,2020-11-18T16:16:56.8889183Z,2016,585,153,316,268,0,17,0,317,0,0,432,269,0,568,0,4,0
74807,10735,2020-11-18T16:16:56.8899192Z,2017,531,140,414,237,0,18,0,294,0,0,391,117,0,513,0,4,0
74807,10736,2020-11-18T16:16:56.8899192Z,2018,473,140,383,203,0,8,0,270,0,0,333,90,0,465,0,0,0
74807,10737,2020-11-18T16:16:56.8899192Z,2019,565,209,479,246,0,5,1,319,0,0,356,86,0,560,0,1,0
74807,10738,2020-11-18T16:16:56.8899192Z,2020,505,177,432,238,0,9,0,267,0,0,328,73,2,494,0,0,0
74807,31628,2021-06-24T05:35:14.6263038Z,2021,449,147,418,214,0,6,0,235,0,0,302,31,0,443,0,0,0
50740,25877,2021-06-24T05:35:11.056744Z,2021,153,51,135,70,0,1,7,83,0,0,102,18,0,152,1,0,0
50740,6317,2020-11-18T16:16:26.2685016Z,2012,364,55,327,186,0,6,0,178,0,0,309,37,0,358,0,0,0
50740,6318,2020-11-18T16:16:26.2685016Z,2013,382,78,334,190,0,8,0,192,0,0,304,48,0,374,0,5,0
50740,6319,2020-11-18T16:16:26.2685016Z,2014,353,87,311,171,0,11,0,182,0,0,266,42,0,342,0,5,0
50740,6320,2020-11-18T16:16:26.2695025Z,2015,272,53,235,118,0,2,0,154,0,0,219,37,0,270,0,3,0
50740,6321,2020-11-18T16:16:26.2695025Z,2016,264,64,210,103,0,2,1,161,0,0,200,54,0,262,0,1,0
50740,6322,2020-11-18T16:16:26.2695025Z,2017,274,79,227,117,0,0,1,157,0,0,195,47,0,274,0,2,0
50740,6323,2020-11-18T16:16:26.2695025Z,2018,255,78,211,121,0,0,7,134,0,0,177,44,0,255,4,3,0
50740,6324,2020-11-18T16:16:26.2695025Z,2019,226,76,194,107,0,2,0,119,0,0,150,32,0,224,2,3,0
50740,6325,2020-11-18T16:16:26.270503Z,2020,185,60,163,92,0,3,17,93,0,0,125,22,0,182,1,1,0
66019,25982,2021-06-24T05:35:14.5052185Z,2021,344,134,295,169,0,5,3,175,0,0,210,49,0,339,1,0,0
66019,9141,2020-11-18T16:16:45.4993229Z,2012,400,46,280,180,0,6,0,220,0,0,354,120,0,394,0,0,0
66019,9142,2020-11-18T16:16:45.4993229Z,2013,419,85,305,200,0,7,0,219,0,0,334,114,1,410,0,3,1
66019,9143,2020-11-18T16:16:45.4993229Z,2014,335,75,250,167,0,10,0,168,0,0,260,85,0,325,0,0,0
66019,9144,2020-11-18T16:16:45.5003238Z,2015,312,66,237,149,0,12,0,163,0,0,246,75,0,299,0,1,1
66019,9145,2020-11-18T16:16:45.5003238Z,2016,270,60,172,125,0,8,2,145,0,0,210,98,0,261,0,1,1
66019,9146,2020-11-18T16:16:45.5003238Z,2017,253,59,197,120,0,5,1,133,0,0,194,56,0,247,0,1,1
66019,9147,2020-11-18T16:16:45.5013247Z,2018,417,145,351,207,0,4,0,210,0,0,272,66,0,413,0,4,0
66019,9148,2020-11-18T16:16:45.5013247Z,2019,340,104,288,178,0,8,8,162,0,0,236,52,0,331,0,0,1
66019,9149,2020-11-18T16:16:45.5013247Z,2020,338,134,299,165,0,5,9,173,0,0,204,39,0,333,2,0,0
62984,25969,2021-06-24T05:35:12.9080728Z,2021,340,143,288,164,0,32,0,176,0,0,197,52,0,308,0,0,0
62984,8791,2020-11-18T16:16:42.8515584Z,2012,291,2,228,168,0,29,0,123,0,0,289,63,0,258,0,0,4
62984,8792,2020-11-18T16:16:42.8525593Z,2013,334,4,235,193,0,27,0,141,0,0,330,99,0,304,0,0,3
62984,8793,2020-11-18T16:16:42.8525593Z,2014,346,34,270,203,0,38,0,143,0,0,312,76,0,308,0,0,0
62984,8794,2020-11-18T16:16:42.8525593Z,2015,371,48,300,221,0,47,0,150,0,0,323,71,0,323,0,0,1
62984,8795,2020-11-18T16:16:42.8525593Z,2016,380,80,231,232,0,58,0,148,0,0,300,149,0,320,0,0,2
62984,8796,2020-11-18T16:16:42.8535597Z,2017,425,79,377,250,0,52,0,175,0,0,346,48,0,370,0,0,3
62984,8797,2020-11-18T16:16:42.8535597Z,2018,363,64,325,214,0,56,0,149,0,0,299,38,0,307,0,0,0
62984,8798,2020-11-18T16:16:42.8535597Z,2019,448,131,409,214,0,53,2,234,0,0,317,39,0,395,0,0,0
62984,8799,2020-11-18T16:16:42.8545606Z,2020,370,144,341,169,0,31,1,201,0,0,226,29,0,339,0,0,0
14340,1044,2020-11-18T16:15:52.4979803Z,2012,458,0,351,215,0,13,0,243,0,0,458,107,0,445,0,0,0
14340,1045,2020-11-18T16:15:52.4979803Z,2013,437,0,326,215,0,17,0,222,0,0,437,111,0,420,0,2,0
14340,1046,2020-11-18T16:15:52.4979803Z,2014,423,28,302,197,0,23,0,226,0,0,395,121,0,400,0,1,0
14340,1047,2020-11-18T16:15:52.4989816Z,2015,415,31,328,197,0,15,0,218,0,0,384,87,0,400,0,0,0
14340,1048,2020-11-18T16:15:52.4989816Z,2016,541,104,442,258,0,11,1,283,0,0,437,99,0,530,0,0,0
14340,1049,2020-11-18T16:15:52.4989816Z,2017,511,98,418,248,0,7,2,263,0,0,413,93,0,504,0,0,0
14340,1050,2020-11-18T16:15:52.4989816Z,2018,415,97,337,205,0,7,0,210,0,0,318,78,0,407,11,0,1
14340,1051,2020-11-18T16:15:52.4989816Z,2019,383,91,320,194,0,7,0,189,0,0,292,63,0,376,10,0,0
14340,1052,2020-11-18T16:15:52.4999821Z,2020,338,121,284,170,0,5,1,168,0,0,217,54,0,333,7,0,0
14340,31639,2021-06-24T05:35:14.6413148Z,2021,321,123,292,150,0,0,0,171,0,0,198,29,0,321,4,1,0
71449,10245,2020-11-18T16:16:53.7248097Z,2012,206,77,178,86,0,2,0,120,0,0,129,28,0,204,0,0,0
71449,10246,2020-11-18T16:16:53.7248097Z,2013,181,63,162,87,0,2,0,94,0,0,118,19,0,179,0,3,0
71449,10247,2020-11-18T16:16:53.7248097Z,2014,150,61,124,68,0,1,0,82,0,0,89,26,0,149,0,1,0
71449,10248,2020-11-18T16:16:53.7258115Z,2015,150,60,117,70,0,0,0,80,0,0,90,33,0,150,0,0,0
71449,10249,2020-11-18T16:16:53.7258115Z,2016,139,52,85,70,0,2,27,69,0,0,87,54,0,136,0,0,1
71449,10250,2020-11-18T16:16:53.7258115Z,2017,93,38,86,46,0,1,1,47,0,0,55,7,0,91,0,0,1
71449,10251,2020-11-18T16:16:53.7258115Z,2018,119,46,107,50,0,1,15,69,0,0,73,12,0,117,0,0,1
71449,10252,2020-11-18T16:16:53.7268119Z,2019,157,75,142,72,0,2,24,85,0,0,82,15,0,155,0,0,0
71449,10253,2020-11-18T16:16:53.7268119Z,2020,154,75,143,70,0,2,28,84,0,0,79,11,0,152,0,0,0
71449,31671,2021-06-24T05:35:15.2587582Z,2021,155,78,151,64,0,2,28,91,0,0,77,4,0,152,0,0,1
63172,25974,2021-06-24T05:35:12.9100743Z,2021,254,79,215,120,0,16,0,134,0,0,175,39,0,238,0,0,0
63172,8922,2020-11-18T16:16:44.443617Z,2012,279,93,242,119,0,1,0,160,0,0,186,37,0,276,0,0,2
63172,8923,2020-11-18T16:16:44.443617Z,2013,303,103,238,145,0,1,0,158,0,0,200,65,0,297,0,1,5
63172,8924,2020-11-18T16:16:44.443617Z,2014,289,96,223,144,0,0,0,145,0,0,193,66,0,284,0,0,5
63172,8925,2020-11-18T16:16:44.4446184Z,2015,276,100,250,137,0,2,0,139,0,0,176,26,0,268,0,3,6
63172,8926,2020-11-18T16:16:44.4446184Z,2016,225,75,163,114,0,1,0,111,0,0,150,62,0,219,0,1,5
63172,8927,2020-11-18T16:16:44.4446184Z,2017,262,91,249,138,0,4,0,124,0,0,171,13,0,253,0,1,5
63172,8928,2020-11-18T16:16:44.4446184Z,2018,256,88,236,116,0,9,2,140,0,0,168,20,1,243,0,2,3
63172,8929,2020-11-18T16:16:44.4446184Z,2019,300,114,284,153,0,11,0,147,0,0,186,16,1,287,0,1,1
63172,8930,2020-11-18T16:16:44.4456188Z,2020,272,99,257,128,0,12,0,144,0,0,173,15,1,258,0,1,1
31542,31770,2021-06-24T05:35:16.8438939Z,2021,274,68,235,128,0,4,17,146,0,0,206,39,0,270,3,0,0
31542,3707,2020-11-18T16:16:08.7087895Z,2012,355,0,270,186,0,0,0,169,0,0,355,85,0,355,0,0,0
31542,3708,2020-11-18T16:16:08.7087895Z,2013,307,1,236,174,0,0,0,133,0,0,306,71,0,307,0,1,0
31542,3709,2020-11-18T16:16:08.7097909Z,2014,260,9,199,152,0,0,0,108,0,0,251,61,0,260,0,2,0
31542,3710,2020-11-18T16:16:08.7097909Z,2015,268,13,204,154,0,0,0,114,0,0,255,64,0,268,0,1,0
31542,3711,2020-11-18T16:16:08.7097909Z,2016,384,54,292,194,0,1,24,190,0,0,330,92,0,383,0,2,0
31542,3712,2020-11-18T16:16:08.7097909Z,2017,369,53,285,195,0,3,9,174,0,0,316,84,0,366,0,0,0
31542,3713,2020-11-18T16:16:08.7097909Z,2018,335,45,253,180,0,4,26,155,0,0,290,82,0,331,5,0,0
31542,3714,2020-11-18T16:16:08.7107913Z,2019,320,52,251,157,0,3,24,163,0,0,268,69,0,317,5,0,0
31542,3715,2020-11-18T16:16:08.7107913Z,2020,311,69,250,149,0,6,0,162,0,0,242,61,0,305,7,1,0
32979,31781,2021-06-24T05:35:16.8599054Z,2021,300,83,250,148,0,6,0,152,0,0,217,50,0,294,1,0,0
32979,4006,2020-11-18T16:16:10.2858443Z,2012,328,27,239,165,0,4,0,163,0,0,301,89,0,324,0,0,0
32979,4007,2020-11-18T16:16:10.2858443Z,2013,318,49,219,170,0,8,0,148,0,0,269,99,0,310,0,3,0
32979,4008,2020-11-18T16:16:10.2868452Z,2014,360,72,237,192,0,10,0,168,0,0,288,123,0,349,0,1,1
32979,4009,2020-11-18T16:16:10.2868452Z,2015,417,92,321,211,0,18,0,206,0,0,325,96,1,398,0,0,0
32979,4010,2020-11-18T16:16:10.2868452Z,2016,286,79,191,141,0,5,0,145,0,0,207,95,1,280,0,0,0
32979,4011,2020-11-18T16:16:10.2868452Z,2017,207,51,160,105,0,2,0,102,0,0,156,47,1,204,0,0,0
32979,4012,2020-11-18T16:16:10.2878457Z,2018,219,47,175,124,0,7,1,95,0,0,172,44,0,212,1,0,0
32979,4013,2020-11-18T16:16:10.2878457Z,2019,374,110,313,198,0,4,1,176,0,0,264,61,0,370,1,1,0
32979,4014,2020-11-18T16:16:10.2878457Z,2020,344,97,301,181,0,5,0,163,0,0,247,43,0,339,2,0,0
20065,1583,2020-11-18T16:15:55.3839081Z,2012,147,56,113,71,0,3,0,76,0,0,91,34,0,144,0,0,0
20065,1584,2020-11-18T16:15:55.3849085Z,2013,141,60,111,67,0,3,0,74,0,0,81,30,0,138,0,1,0
20065,1585,2020-11-18T16:15:55.3849085Z,2014,129,52,98,63,0,1,0,66,0,0,77,31,0,128,0,0,0
20065,1586,2020-11-18T16:15:55.3849085Z,2015,158,69,115,72,0,0,0,86,0,0,89,43,0,158,0,0,0
20065,1587,2020-11-18T16:15:55.3849085Z,2016,145,55,82,69,0,0,0,76,0,0,90,63,0,145,0,0,0
20065,1588,2020-11-18T16:15:55.385909Z,2017,137,51,102,68,0,0,0,69,0,0,86,35,0,137,0,0,0
20065,1589,2020-11-18T16:15:55.385909Z,2018,148,61,105,74,0,0,45,74,0,0,87,43,0,148,1,0,0
20065,1590,2020-11-18T16:15:55.385909Z,2019,153,68,119,72,0,0,4,81,0,0,85,34,0,153,1,0,0
20065,1591,2020-11-18T16:15:55.3869103Z,2020,126,49,104,61,0,0,0,65,0,0,77,22,0,126,1,0,0
20065,31688,2021-06-24T05:35:15.2987864Z,2021,115,37,100,56,0,0,1,59,0,0,78,15,0,115,1,0,0
53330,31903,2021-06-24T05:35:18.4790669Z,2021,108,33,91,47,0,0,2,61,0,0,75,17,0,108,0,0,0
53330,7217,2020-11-18T16:16:32.4996576Z,2012,144,39,114,63,0,1,0,81,0,0,105,30,0,143,0,0,0
53330,7218,2020-11-18T16:16:32.4996576Z,2013,147,38,119,67,0,1,0,80,0,0,109,28,0,146,0,3,0
53330,7219,2020-11-18T16:16:32.500659Z,2014,121,30,96,57,0,3,0,64,0,0,91,25,0,118,0,0,0
53330,7220,2020-11-18T16:16:32.500659Z,2015,145,43,112,63,0,2,0,82,0,0,102,33,0,141,0,2,2
53330,7221,2020-11-18T16:16:32.500659Z,2016,162,46,72,68,0,2,0,94,0,0,116,90,0,160,0,0,0
53330,7222,2020-11-18T16:16:32.5016585Z,2017,135,43,127,62,0,2,1,73,0,0,92,8,0,133,0,0,0
53330,7223,2020-11-18T16:16:32.5016585Z,2018,112,44,103,45,0,2,7,67,0,0,68,9,0,110,0,0,0
53330,7224,2020-11-18T16:16:32.5016585Z,2019,101,36,84,46,0,0,6,55,0,0,65,17,0,101,0,0,0
53330,7225,2020-11-18T16:16:32.5016585Z,2020,99,35,79,45,0,0,4,54,0,0,64,20,0,99,0,0,0
71530,10312,2020-11-18T16:16:54.3101973Z,2012,628,215,569,285,0,20,0,343,0,0,413,59,0,608,0,0,0
71530,10313,2020-11-18T16:16:54.3101973Z,2013,613,219,553,277,0,14,0,336,0,0,394,60,0,599,0,1,0
71530,10314,2020-11-18T16:16:54.3111986Z,2014,565,211,502,258,0,15,0,307,0,0,354,63,0,550,0,0,0
71530,10315,2020-11-18T16:16:54.3111986Z,2015,523,190,466,229,0,15,0,294,0,0,333,57,0,508,0,0,0
71530,10316,2020-11-18T16:16:54.3111986Z,2016,463,172,394,215,0,11,0,248,0,0,291,69,1,451,0,1,0
71530,10317,2020-11-18T16:16:54.3111986Z,2017,595,203,517,281,0,11,0,314,0,0,392,78,1,583,0,1,0
71530,10318,2020-11-18T16:16:54.3121986Z,2018,625,196,535,305,0,11,15,320,0,0,429,90,1,612,0,1,1
71530,10319,2020-11-18T16:16:54.3121986Z,2019,616,219,531,292,0,13,1,324,0,0,397,85,0,603,0,1,0
71530,10320,2020-11-18T16:16:54.3121986Z,2020,606,209,524,282,0,14,38,324,0,0,397,82,0,592,0,1,0
71530,25672,2021-06-24T05:35:04.7392146Z,2021,590,207,519,278,0,14,0,312,0,0,383,71,0,576,0,1,0
17467,1387,2020-11-18T16:15:54.3252013Z,2012,259,90,218,105,0,7,0,154,0,0,169,41,0,252,0,0,0
17467,1388,2020-11-18T16:15:54.3252013Z,2013,239,87,165,103,0,6,0,136,0,0,152,74,0,233,0,2,0
17467,1389,2020-11-18T16:15:54.3252013Z,2014,189,77,143,74,0,7,0,115,0,0,112,46,0,182,0,2,0
17467,1390,2020-11-18T16:15:54.3262013Z,2015,165,66,136,66,0,3,0,99,0,0,99,29,0,162,0,2,0
17467,1391,2020-11-18T16:15:54.3262013Z,2016,158,68,116,70,0,0,0,88,0,0,90,42,0,158,0,0,0
17467,1392,2020-11-18T16:15:54.3262013Z,2017,148,67,121,63,0,0,0,85,0,0,81,27,0,148,0,0,0
17467,1393,2020-11-18T16:15:54.3262013Z,2018,332,113,271,153,0,1,0,179,0,0,219,61,0,331,2,0,0
17467,1394,2020-11-18T16:15:54.3262013Z,2019,348,136,292,155,0,6,3,193,0,1,212,56,0,342,2,0,0
17467,1395,2020-11-18T16:15:54.3262013Z,2020,337,129,282,151,0,6,0,186,0,0,208,55,0,331,2,0,0
17467,31611,2021-06-24T05:35:14.6032875Z,2021,298,117,270,132,0,8,0,166,0,0,181,28,0,290,2,1,0
62661,25964,2021-06-24T05:35:12.9030686Z,2021,258,110,230,124,0,5,0,134,0,0,148,28,0,252,0,0,1
62661,8634,2020-11-18T16:16:42.1701046Z,2012,568,38,434,306,0,16,0,262,0,0,530,134,3,547,0,0,2
62661,8635,2020-11-18T16:16:42.1701046Z,2013,453,61,355,235,0,13,0,218,0,0,392,98,1,437,0,1,2
62661,8636,2020-11-18T16:16:42.1701046Z,2014,430,67,343,214,0,14,0,216,0,0,363,87,0,414,0,0,2
62661,8637,2020-11-18T16:16:42.1711059Z,2015,367,46,298,180,0,14,0,187,0,0,321,69,0,351,0,0,2
62661,8638,2020-11-18T16:16:42.1711059Z,2016,377,74,205,174,0,16,1,203,0,0,303,172,0,360,0,0,1
62661,8639,2020-11-18T16:16:42.1711059Z,2017,380,77,291,180,0,18,0,200,0,0,303,89,0,361,0,0,1
62661,8640,2020-11-18T16:16:42.1711059Z,2018,371,97,308,177,0,22,1,194,0,0,274,63,1,348,1,2,0
62661,8641,2020-11-18T16:16:42.1711059Z,2019,340,124,295,169,0,15,1,171,0,0,216,45,1,324,0,2,0
62661,8642,2020-11-18T16:16:42.1711059Z,2020,230,92,205,107,0,9,1,123,0,0,138,25,0,220,0,2,1
62679,31966,2021-06-24T05:35:20.2713527Z,2021,88,40,79,47,0,4,0,41,0,0,48,9,0,84,0,0,0
62679,8643,2020-11-18T16:16:42.1721064Z,2012,189,47,134,97,0,8,0,92,0,0,142,55,0,181,0,0,0
62679,8644,2020-11-18T16:16:42.1721064Z,2013,165,47,119,77,0,13,0,88,0,0,118,46,0,151,0,0,1
62679,8645,2020-11-18T16:16:42.1721064Z,2014,150,40,116,81,0,8,0,69,0,0,110,34,0,142,0,0,0
62679,8646,2020-11-18T16:16:42.1721064Z,2015,143,37,138,72,0,9,0,71,0,0,106,5,0,132,0,0,2
62679,8647,2020-11-18T16:16:42.1721064Z,2016,96,28,90,55,0,1,0,41,0,0,68,6,0,95,0,0,0
62679,8648,2020-11-18T16:16:42.1731073Z,2017,134,54,120,65,0,3,1,69,0,0,80,14,0,131,0,0,0
62679,8649,2020-11-18T16:16:42.1731073Z,2018,133,48,120,59,0,6,5,74,0,0,85,13,0,127,0,0,0
62679,8650,2020-11-18T16:16:42.1731073Z,2019,106,46,96,51,0,8,8,55,0,0,60,10,0,98,0,0,0
62679,8651,2020-11-18T16:16:42.1731073Z,2020,88,37,83,53,0,5,0,35,0,0,51,5,0,83,0,0,0
26013,25728,2021-06-24T05:35:08.6820423Z,2021,273,90,198,122,0,1,2,151,0,0,183,75,0,272,0,0,0
26013,2936,2020-11-18T16:16:04.2878443Z,2012,718,0,440,377,0,0,0,341,0,0,718,278,0,716,0,0,2
26013,2937,2020-11-18T16:16:04.2878443Z,2013,713,9,448,373,0,1,0,340,0,0,704,265,1,710,0,0,1
26013,2938,2020-11-18T16:16:04.2888443Z,2014,617,48,438,322,0,0,0,295,0,0,569,179,0,616,0,0,1
26013,2939,2020-11-18T16:16:04.2888443Z,2015,599,54,467,286,0,3,0,313,0,0,545,132,0,596,0,1,0
26013,2940,2020-11-18T16:16:04.2888443Z,2016,524,94,387,261,0,2,0,263,0,0,430,137,0,522,0,1,0
26013,2941,2020-11-18T16:16:04.2898452Z,2017,490,92,368,247,0,1,0,243,0,0,398,122,0,489,0,2,0
26013,2942,2020-11-18T16:16:04.2898452Z,2018,473,104,340,234,0,6,0,239,0,0,369,133,0,467,0,2,0
26013,2943,2020-11-18T16:16:04.2898452Z,2019,382,75,277,183,0,7,3,199,0,0,307,105,0,375,0,1,0
26013,2944,2020-11-18T16:16:04.2898452Z,2020,322,105,243,151,0,4,1,171,0,0,217,79,0,318,0,0,0
40493,31820,2021-06-24T05:35:16.9229508Z,2021,271,85,250,129,0,3,1,142,0,0,186,21,1,267,0,0,0
40493,4798,2020-11-18T16:16:15.3362111Z,2012,280,96,232,134,0,0,0,146,0,0,184,48,0,280,0,0,0
40493,4799,2020-11-18T16:16:15.3362111Z,2013,275,97,185,126,0,0,0,149,0,0,178,90,0,274,0,7,1
40493,4800,2020-11-18T16:16:15.3372115Z,2014,285,105,269,128,0,2,0,157,0,0,180,16,0,283,0,5,0
40493,4801,2020-11-18T16:16:15.7705012Z,2015,255,97,244,121,0,2,0,134,0,0,158,11,0,253,0,5,0
40493,4802,2020-11-18T16:16:15.7705012Z,2016,260,99,251,119,0,4,7,141,0,0,161,9,0,256,0,5,0
40493,4803,2020-11-18T16:16:15.7705012Z,2017,243,89,233,117,0,3,7,126,0,0,154,10,0,240,0,3,0
40493,4804,2020-11-18T16:16:15.7715021Z,2018,215,69,205,105,0,1,3,110,0,0,146,10,1,212,0,1,1
40493,4805,2020-11-18T16:16:15.7715021Z,2019,311,102,294,142,1,2,4,169,0,0,209,17,1,308,0,2,0
40493,4806,2020-11-18T16:16:15.7715021Z,2020,285,90,272,128,0,2,1,157,0,0,195,13,1,282,0,1,0
30270,31758,2021-06-24T05:35:16.8298843Z,2021,504,107,400,275,0,4,0,229,0,0,397,104,2,498,20,1,0
30270,3298,2020-11-18T16:16:05.7298055Z,2012,336,0,225,193,0,9,0,143,0,0,336,111,0,327,0,0,0
30270,3299,2020-11-18T16:16:05.7298055Z,2013,352,3,235,191,0,7,0,161,0,0,349,117,0,343,0,3,2
30270,3300,2020-11-18T16:16:05.7308073Z,2014,477,16,324,250,0,11,0,227,0,0,461,153,1,459,0,3,6
30270,3301,2020-11-18T16:16:06.3442125Z,2015,519,19,329,276,0,7,0,243,0,0,500,190,4,501,0,1,7
30270,3302,2020-11-18T16:16:06.3442125Z,2016,484,36,162,248,0,5,0,236,0,0,448,322,3,474,0,0,2
30270,3303,2020-11-18T16:16:06.3442125Z,2017,581,64,374,290,0,5,0,291,0,0,517,207,5,571,0,0,0
30270,3304,2020-11-18T16:16:06.345213Z,2018,592,62,410,316,0,8,1,276,0,0,530,182,3,581,18,0,0
30270,3305,2020-11-18T16:16:06.345213Z,2019,526,72,371,293,0,5,0,233,0,0,454,155,2,519,23,0,0
30270,3306,2020-11-18T16:16:06.345213Z,2020,492,98,346,277,0,4,1,215,0,0,394,146,3,485,30,0,0
52985,25899,2021-06-24T05:35:12.7959925Z,2021,158,54,135,86,0,1,16,72,0,0,104,23,0,155,2,0,2
52985,7088,2020-11-18T16:16:31.3268737Z,2012,200,57,169,103,0,4,0,97,0,0,143,31,0,196,0,0,0
52985,7089,2020-11-18T16:16:31.3278746Z,2013,180,46,146,95,0,1,0,85,0,0,134,34,1,178,0,2,0
52985,7090,2020-11-18T16:16:31.3278746Z,2014,177,53,133,86,0,2,0,91,0,0,124,44,1,174,0,1,0
52985,7091,2020-11-18T16:16:31.3278746Z,2015,194,53,148,85,0,2,0,109,0,0,141,46,0,191,0,0,1
52985,7092,2020-11-18T16:16:31.3278746Z,2016,151,43,116,62,0,2,14,89,0,0,108,35,0,146,0,0,3
52985,7093,2020-11-18T16:16:31.3278746Z,2017,149,38,120,66,0,2,17,83,0,0,111,29,0,144,0,1,3
52985,7094,2020-11-18T16:16:31.3288755Z,2018,226,61,160,106,0,6,0,120,0,0,165,66,0,217,1,3,3
52985,7095,2020-11-18T16:16:31.3288755Z,2019,179,71,157,94,0,5,14,85,0,0,108,22,0,173,2,2,1
52985,7096,2020-11-18T16:16:31.3288755Z,2020,180,66,136,96,0,1,1,84,0,0,114,44,0,177,2,1,2
70672,31659,2021-06-24T05:35:15.2397439Z,2021,132,51,111,50,0,1,3,82,0,0,81,21,0,131,0,0,0
70672,9840,2020-11-18T16:16:50.875908Z,2012,329,101,260,151,0,3,0,178,0,0,228,69,0,326,0,0,0
70672,9841,2020-11-18T16:16:50.8769098Z,2013,317,113,258,143,0,3,0,174,0,0,204,59,0,314,0,0,0
70672,9842,2020-11-18T16:16:50.8769098Z,2014,323,114,237,142,0,4,0,181,0,0,209,86,0,319,0,0,0
70672,9843,2020-11-18T16:16:50.8769098Z,2015,299,98,233,148,0,4,0,151,0,0,201,66,0,295,0,1,0
70672,9844,2020-11-18T16:16:50.8769098Z,2016,234,82,193,111,0,1,3,123,0,0,152,41,0,233,0,0,0
70672,9845,2020-11-18T16:16:50.8779098Z,2017,222,72,176,105,0,3,1,117,0,0,150,46,0,219,0,1,0
70672,9846,2020-11-18T16:16:50.8779098Z,2018,253,81,206,106,0,7,32,147,0,0,172,47,0,246,0,2,0
70672,9847,2020-11-18T16:16:50.8779098Z,2019,139,51,115,64,0,4,5,75,0,0,88,24,0,135,0,1,0
70672,9848,2020-11-18T16:16:50.8789098Z,2020,136,53,115,55,0,1,8,81,0,0,83,21,0,135,0,0,0
54940,25912,2021-06-24T05:35:12.8059996Z,2021,108,48,91,45,0,0,0,63,0,0,60,17,0,108,0,0,0
54940,7447,2020-11-18T16:16:33.7014544Z,2012,355,113,315,180,0,5,0,175,0,0,242,40,0,350,0,0,0
54940,7448,2020-11-18T16:16:33.7014544Z,2013,345,109,311,161,0,9,0,184,0,0,236,34,0,336,0,2,0
54940,7449,2020-11-18T16:16:33.7024553Z,2014,356,114,318,162,0,11,0,194,0,0,242,38,0,345,0,1,0
54940,7450,2020-11-18T16:16:33.7024553Z,2015,332,120,254,149,0,4,0,183,0,0,212,78,0,328,0,1,0
54940,7451,2020-11-18T16:16:33.7024553Z,2016,271,101,89,122,0,6,0,149,0,0,170,182,0,265,0,1,0
54940,7452,2020-11-18T16:16:33.7024553Z,2017,265,97,235,119,0,7,0,146,0,0,168,30,0,258,0,0,0
54940,7453,2020-11-18T16:16:33.7024553Z,2018,245,90,197,104,0,8,0,141,0,0,155,48,0,237,2,0,0
54940,7454,2020-11-18T16:16:33.7024553Z,2019,235,90,164,109,0,4,12,126,0,0,145,71,0,231,0,0,0
54940,7455,2020-11-18T16:16:33.7034557Z,2020,144,63,129,67,0,1,11,77,0,0,81,15,0,142,0,0,1
69039,31992,2021-06-24T05:35:20.3193867Z,2021,257,86,235,126,0,6,0,131,0,0,171,22,0,250,0,0,1
69039,9294,2020-11-18T16:16:46.7131335Z,2012,288,33,246,145,0,6,0,143,0,0,255,42,0,281,0,0,1
69039,9295,2020-11-18T16:16:46.7131335Z,2013,294,63,250,143,0,4,0,151,0,0,231,44,0,290,0,1,0
69039,9296,2020-11-18T16:16:46.7141349Z,2014,319,78,264,151,0,6,0,168,0,0,241,55,0,313,0,1,0
69039,9297,2020-11-18T16:16:46.7141349Z,2015,321,88,258,162,0,7,0,159,0,0,233,63,0,314,0,0,0
69039,9298,2020-11-18T16:16:46.7141349Z,2016,336,107,26,164,0,6,9,172,0,0,229,310,1,329,0,0,0
69039,9299,2020-11-18T16:16:46.7141349Z,2017,341,121,280,183,0,8,11,158,0,0,220,61,0,333,0,0,0
69039,9300,2020-11-18T16:16:46.7151349Z,2018,364,125,288,163,0,7,2,201,0,0,239,76,0,357,2,2,0
69039,9301,2020-11-18T16:16:47.368572Z,2019,437,151,367,205,0,8,1,232,0,0,286,70,0,429,2,0,0
69039,9302,2020-11-18T16:16:47.368572Z,2020,326,122,279,159,0,7,1,167,0,0,204,47,0,319,0,0,0
17186,1311,2020-11-18T16:15:54.3011853Z,2012,576,52,409,307,0,0,0,269,0,0,524,167,0,576,0,0,0
17186,1312,2020-11-18T16:15:54.3011853Z,2013,570,94,364,293,0,2,0,277,0,0,476,206,0,568,0,6,0
17186,1313,2020-11-18T16:15:54.3021875Z,2014,566,125,390,278,0,1,0,288,0,0,441,176,0,565,0,5,0
17186,1314,2020-11-18T16:15:54.3021875Z,2015,546,127,387,261,0,1,0,285,0,0,419,159,0,545,0,5,0
17186,1315,2020-11-18T16:15:54.3021875Z,2016,461,109,296,220,0,0,0,241,0,0,352,165,0,461,0,0,0
17186,1316,2020-11-18T16:15:54.3021875Z,2017,407,86,286,194,0,1,0,213,0,0,321,121,0,406,0,1,0
17186,1317,2020-11-18T16:15:54.3021875Z,2018,350,76,239,177,0,0,1,173,0,0,274,111,0,350,2,0,0
17186,1318,2020-11-18T16:15:54.3031862Z,2019,349,88,248,155,0,0,6,194,0,0,261,101,0,349,2,0,0
17186,1319,2020-11-18T16:15:54.3031862Z,2020,362,105,258,164,0,1,3,198,0,0,257,104,0,361,0,0,0
17186,31640,2021-06-24T05:35:14.650321Z,2021,348,95,264,156,0,0,6,192,0,0,253,84,0,348,0,0,0
61853,25956,2021-06-24T05:35:12.8770504Z,2021,580,143,482,282,0,12,14,298,0,0,437,98,0,568,0,0,0
61853,8439,2020-11-18T16:16:40.2117966Z,2012,609,0,415,318,0,14,0,291,0,0,609,194,17,577,0,0,1
61853,8440,2020-11-18T16:16:40.2127989Z,2013,566,2,401,292,0,21,0,274,0,0,564,165,7,537,0,1,1
61853,8441,2020-11-18T16:16:40.2127989Z,2014,528,27,391,280,0,22,0,248,0,0,501,137,5,501,0,3,0
61853,8442,2020-11-18T16:16:40.2127989Z,2015,616,43,485,327,0,18,0,289,0,0,573,131,3,595,0,3,0
61853,8443,2020-11-18T16:16:40.2127989Z,2016,707,106,451,378,0,12,2,329,0,0,601,256,3,692,0,4,0
61853,8444,2020-11-18T16:16:40.2137984Z,2017,678,122,541,372,0,10,1,306,0,0,556,137,1,667,0,2,0
61853,8445,2020-11-18T16:16:40.2137984Z,2018,574,74,442,310,0,6,2,264,0,0,500,132,1,567,1,1,0
61853,8446,2020-11-18T16:16:40.2137984Z,2019,626,118,513,321,0,11,26,305,0,0,508,113,1,614,2,1,0
61853,8447,2020-11-18T16:16:40.2137984Z,2020,599,147,494,295,0,12,20,304,0,0,452,105,0,587,0,0,0
12740,31638,2021-06-24T05:35:14.6383142Z,2021,210,86,188,105,0,0,0,105,0,0,124,22,0,210,4,2,0
12740,836,2020-11-18T16:15:51.3342035Z,2012,253,73,227,120,0,2,0,133,0,0,180,26,1,250,0,0,0
12740,837,2020-11-18T16:15:51.3342035Z,2013,257,82,226,123,0,0,0,134,0,0,175,31,0,257,0,0,0
12740,838,2020-11-18T16:15:51.3342035Z,2014,234,86,202,103,0,0,0,131,0,0,148,32,0,234,0,0,0
12740,839,2020-11-18T16:15:51.3342035Z,2015,211,80,185,94,0,0,0,117,0,0,131,26,0,211,0,0,0
12740,840,2020-11-18T16:15:51.335204Z,2016,183,77,133,74,0,0,0,109,0,0,106,50,0,183,0,0,0
12740,841,2020-11-18T16:15:51.335204Z,2017,183,77,162,83,0,0,2,100,0,0,106,21,0,183,0,0,0
12740,842,2020-11-18T16:15:51.335204Z,2018,194,66,170,95,0,1,0,99,0,0,128,24,0,193,2,0,0
12740,843,2020-11-18T16:15:51.336204Z,2019,243,103,207,128,0,0,10,115,0,1,140,36,0,243,6,4,0
12740,844,2020-11-18T16:15:51.336204Z,2020,219,91,192,113,0,1,2,106,0,0,128,27,0,218,6,1,0
71886,10525,2020-11-18T16:16:55.4209388Z,2012,1101,113,805,526,0,8,0,575,0,0,988,296,1,1091,0,0,1
71886,10526,2020-11-18T16:16:55.4209388Z,2013,966,158,815,474,0,7,0,492,0,0,808,151,1,958,0,1,0
71886,10527,2020-11-18T16:16:55.4219401Z,2014,672,118,582,329,0,6,0,343,0,0,554,90,1,665,0,1,0
71886,10528,2020-11-18T16:16:55.4219401Z,2015,835,160,695,398,0,8,0,437,0,0,675,140,1,826,0,1,0
71886,10529,2020-11-18T16:16:55.4219401Z,2016,754,192,348,370,0,10,7,384,0,0,562,406,1,743,0,0,0
71886,10530,2020-11-18T16:16:55.4229401Z,2017,589,162,518,292,0,7,4,297,0,0,427,71,0,582,0,0,0
71886,10531,2020-11-18T16:16:55.4229401Z,2018,512,128,438,249,0,9,4,263,0,0,384,74,0,503,0,1,0
71886,10532,2020-11-18T16:16:55.4229401Z,2019,466,136,417,223,0,8,3,243,0,0,330,49,0,458,0,1,0
71886,10533,2020-11-18T16:16:55.4239406Z,2020,389,124,357,184,0,6,1,205,0,0,265,32,0,383,0,1,0
71886,31625,2021-06-24T05:35:14.6233019Z,2021,359,128,311,164,0,5,2,195,0,0,231,48,0,354,1,1,0
55483,25914,2021-06-24T05:35:12.809002Z,2021,511,132,434,266,0,1,0,245,0,0,379,77,0,509,0,1,1
55483,7496,2020-11-18T16:16:33.7154633Z,2012,837,196,500,399,0,1,0,438,0,0,641,337,0,835,0,0,1
55483,7497,2020-11-18T16:16:33.7154633Z,2013,845,217,544,411,0,1,0,434,0,0,628,301,0,843,0,4,1
55483,7498,2020-11-18T16:16:33.7154633Z,2014,853,236,506,442,0,1,0,411,0,0,617,347,0,852,0,3,0
55483,7499,2020-11-18T16:16:33.7164638Z,2015,842,225,548,430,0,1,0,412,0,0,617,294,0,841,0,3,0
55483,7500,2020-11-18T16:16:33.7164638Z,2016,815,227,460,409,0,2,1,406,0,0,588,355,0,813,0,2,0
55483,7501,2020-11-18T16:16:34.5069923Z,2017,667,178,463,323,0,6,0,344,0,0,489,204,0,661,0,1,0
55483,7502,2020-11-18T16:16:34.5069923Z,2018,648,172,468,315,0,9,0,333,0,0,476,180,0,639,4,3,0
55483,7503,2020-11-18T16:16:34.5079941Z,2019,608,160,439,315,0,8,0,293,0,2,448,169,3,596,3,4,1
55483,7504,2020-11-18T16:16:34.5079941Z,2020,617,176,433,308,0,3,2,309,0,0,441,184,3,607,0,2,4
10637,151,2020-11-18T16:15:46.3798992Z,2012,107,39,90,46,0,1,0,61,0,0,68,17,0,106,0,0,0
10637,152,2020-11-18T16:15:46.3798992Z,2013,93,40,76,42,0,1,0,51,0,0,53,17,0,92,0,0,0
10637,153,2020-11-18T16:15:46.3798992Z,2014,112,40,91,49,0,3,0,63,0,0,72,21,0,109,0,1,0
10637,154,2020-11-18T16:15:46.3809005Z,2015,116,47,100,57,0,5,0,59,0,0,69,16,0,111,0,3,0
10637,155,2020-11-18T16:15:46.3809005Z,2016,250,98,221,111,0,5,1,139,0,0,152,29,0,245,0,4,0
10637,156,2020-11-18T16:15:46.3809005Z,2017,223,80,200,103,0,7,1,120,0,0,143,23,0,216,0,7,0
10637,157,2020-11-18T16:15:46.3819005Z,2018,214,65,193,108,0,3,16,106,0,0,149,21,0,211,0,0,0
10637,158,2020-11-18T16:15:46.3819005Z,2019,182,63,166,90,0,2,3,92,0,0,119,16,0,180,0,0,0
10637,159,2020-11-18T16:15:46.3819005Z,2020,198,65,185,91,0,2,0,107,0,0,133,13,0,196,0,0,0
10637,31584,2021-06-24T05:35:14.5252315Z,2021,183,59,151,87,0,2,0,96,0,0,124,32,0,181,2,0,0
51342,31883,2021-06-24T05:35:18.4560506Z,2021,226,71,179,105,0,3,0,121,0,0,155,47,0,223,0,0,0
51342,6444,2020-11-18T16:16:27.0440171Z,2012,284,73,211,147,0,1,0,137,0,0,211,73,14,269,0,0,0
51342,6445,2020-11-18T16:16:27.0450175Z,2013,270,75,205,128,0,0,0,142,0,0,195,65,1,269,0,1,0
51342,6446,2020-11-18T16:16:27.0450175Z,2014,265,71,192,126,0,0,0,139,0,0,194,73,0,265,0,3,0
51342,6447,2020-11-18T16:16:27.0450175Z,2015,232,68,164,109,0,0,0,123,0,0,164,68,0,232,0,1,0
51342,6448,2020-11-18T16:16:27.0460184Z,2016,188,54,138,83,0,1,3,105,0,0,134,50,0,187,0,0,0
51342,6449,2020-11-18T16:16:27.0460184Z,2017,180,59,137,81,0,1,5,99,0,0,121,43,0,179,0,0,0
51342,6450,2020-11-18T16:16:27.0460184Z,2018,277,80,201,122,0,1,16,155,0,0,197,76,2,274,0,0,0
51342,6451,2020-11-18T16:16:27.0470179Z,2019,285,88,205,128,0,2,0,157,0,0,197,80,1,282,0,0,0
51342,6452,2020-11-18T16:16:27.0470179Z,2020,227,75,164,102,0,3,0,125,0,0,152,63,0,224,0,0,0
17772,1450,2020-11-18T16:15:54.7624928Z,2012,723,0,469,335,0,4,0,388,0,0,723,254,1,715,0,0,3
17772,1451,2020-11-18T16:15:54.7624928Z,2013,718,1,487,341,0,5,0,377,0,0,717,231,3,706,0,14,4
17772,1452,2020-11-18T16:15:54.7624928Z,2014,708,28,494,355,0,3,0,353,0,0,680,214,2,697,0,8,6
17772,1453,2020-11-18T16:15:54.7624928Z,2015,647,48,459,332,0,1,0,315,0,0,599,188,2,640,0,2,4
17772,1454,2020-11-18T16:15:54.7634936Z,2016,711,123,226,354,0,4,1,357,0,0,588,485,0,703,0,1,4
17772,1455,2020-11-18T16:15:54.7634936Z,2017,727,124,521,344,0,3,3,383,0,0,603,206,1,720,0,3,3
17772,1456,2020-11-18T16:15:54.7634936Z,2018,741,136,516,355,0,3,24,386,0,0,605,225,1,735,1,2,2
17772,1457,2020-11-18T16:15:54.7634936Z,2019,725,147,518,341,0,3,5,384,0,0,578,207,1,721,0,1,0
17772,1458,2020-11-18T16:15:54.7644941Z,2020,726,211,542,356,0,8,0,370,0,0,515,184,0,717,0,1,1
17772,25612,2021-06-24T05:35:04.6321381Z,2021,707,216,542,349,0,5,2,358,0,0,491,165,0,698,0,0,4
40139,31816,2021-06-24T05:35:16.9199493Z,2021,211,64,175,97,0,1,0,114,0,0,147,36,2,208,0,0,0
40139,4637,2020-11-18T16:16:14.3985863Z,2012,332,93,223,182,0,7,0,150,0,0,239,109,0,324,0,0,1
40139,4638,2020-11-18T16:16:14.3985863Z,2013,286,84,204,155,0,5,0,131,0,0,202,82,0,280,0,1,1
40139,4639,2020-11-18T16:16:14.3995859Z,2014,323,95,203,172,0,5,0,151,0,0,228,120,0,316,0,3,2
40139,4640,2020-11-18T16:16:14.3995859Z,2015,327,90,228,171,0,6,0,156,0,0,237,99,0,321,0,1,0
40139,4641,2020-11-18T16:16:14.3995859Z,2016,319,87,101,163,0,5,0,156,0,0,232,218,1,311,0,1,2
40139,4642,2020-11-18T16:16:14.3995859Z,2017,316,82,222,154,0,9,0,162,0,0,234,94,1,306,0,1,0
40139,4643,2020-11-18T16:16:14.3995859Z,2018,303,62,211,145,0,9,12,158,0,0,241,92,1,293,2,0,0
40139,4644,2020-11-18T16:16:14.4005877Z,2019,262,64,203,133,0,6,0,129,0,1,198,59,1,255,0,0,0
40139,4645,2020-11-18T16:16:14.4005877Z,2020,211,52,161,104,0,3,0,107,0,0,159,50,1,207,0,0,0
33647,31785,2021-06-24T05:35:16.8619086Z,2021,445,111,352,225,0,3,0,220,0,0,334,93,0,442,0,0,0
33647,4094,2020-11-18T16:16:10.3378791Z,2012,639,130,442,309,0,1,0,330,0,0,509,197,0,638,0,0,0
33647,4095,2020-11-18T16:16:10.3388796Z,2013,591,137,429,287,0,0,0,304,0,0,454,162,0,591,0,1,0
33647,4096,2020-11-18T16:16:10.3388796Z,2014,598,132,396,292,0,3,0,306,0,0,466,202,0,594,0,1,1
33647,4097,2020-11-18T16:16:10.3388796Z,2015,581,131,391,290,0,1,0,291,0,0,450,190,0,578,0,0,2
33647,4098,2020-11-18T16:16:10.3398804Z,2016,567,127,115,298,0,1,0,269,0,0,440,452,1,565,0,1,0
33647,4099,2020-11-18T16:16:10.3398804Z,2017,600,133,445,330,0,1,0,270,0,0,467,155,2,597,0,0,0
33647,4100,2020-11-18T16:16:10.3398804Z,2018,474,93,308,262,0,1,0,212,0,0,381,166,1,472,0,0,0
33647,4101,2020-11-18T16:16:11.0053247Z,2019,383,93,279,184,0,4,0,199,0,0,290,104,0,379,0,0,0
33647,4102,2020-11-18T16:16:11.0053247Z,2020,430,106,311,216,0,3,0,214,0,0,324,119,0,427,0,0,0
61580,25951,2021-06-24T05:35:12.9030686Z,2021,252,65,244,120,0,22,0,132,0,0,187,8,0,230,0,0,0
61580,8304,2020-11-18T16:16:39.777507Z,2012,264,82,225,122,0,24,0,142,0,0,182,39,0,237,0,0,3
61580,8305,2020-11-18T16:16:39.777507Z,2013,354,105,311,170,0,40,0,184,0,0,249,43,0,310,0,4,4
61580,8306,2020-11-18T16:16:39.777507Z,2014,338,107,276,158,0,30,0,180,0,0,231,62,0,305,0,0,3
61580,8307,2020-11-18T16:16:39.777507Z,2015,379,107,341,173,0,39,0,206,0,0,272,38,0,338,0,0,2
61580,8308,2020-11-18T16:16:39.777507Z,2016,305,91,269,147,0,31,0,158,0,0,214,36,0,273,0,0,1
61580,8309,2020-11-18T16:16:39.7785074Z,2017,239,70,223,120,0,27,9,119,0,0,169,16,0,212,0,0,0
61580,8310,2020-11-18T16:16:39.7785074Z,2018,256,62,235,132,0,33,11,124,0,0,194,21,0,222,0,0,1
61580,8311,2020-11-18T16:16:39.7785074Z,2019,331,87,307,165,0,40,19,166,0,0,244,24,0,289,0,0,2
61580,8312,2020-11-18T16:16:39.7785074Z,2020,270,71,255,138,0,35,32,132,0,0,199,15,0,235,0,0,0
46672,31855,2021-06-24T05:35:18.4180229Z,2021,459,161,398,236,0,10,2,223,0,0,298,61,1,446,0,4,2
46672,5910,2020-11-18T16:16:23.5106589Z,2012,461,129,402,226,0,10,0,235,0,0,332,59,0,449,0,0,2
46672,5911,2020-11-18T16:16:23.5106589Z,2013,449,142,334,206,0,9,0,243,0,0,307,115,0,438,0,6,2
46672,5912,2020-11-18T16:16:23.5106589Z,2014,415,145,260,193,0,9,0,222,0,0,270,155,0,404,0,4,2
46672,5913,2020-11-18T16:16:23.5106589Z,2015,401,128,320,191,0,12,0,210,0,0,273,81,0,387,0,6,2
46672,5914,2020-11-18T16:16:23.5106589Z,2016,367,129,119,169,0,13,0,198,0,0,238,248,1,352,0,6,1
46672,5915,2020-11-18T16:16:23.5116598Z,2017,239,80,206,113,0,8,0,126,0,0,159,33,0,230,0,4,1
46672,5916,2020-11-18T16:16:23.5116598Z,2018,327,96,277,168,0,15,4,159,0,0,231,50,1,307,0,9,4
46672,5917,2020-11-18T16:16:23.5116598Z,2019,526,204,438,269,0,9,1,257,0,0,322,88,2,513,1,10,2
46672,5918,2020-11-18T16:16:23.5116598Z,2020,488,180,411,237,0,8,2,251,0,0,308,77,2,478,0,7,0
26492,25730,2021-06-24T05:35:08.68004Z,2021,373,239,293,151,0,7,4,222,0,0,134,80,0,366,0,2,0
26492,2972,2020-11-18T16:16:04.2958493Z,2012,343,57,304,131,0,4,0,212,0,0,286,39,0,338,0,0,1
26492,2973,2020-11-18T16:16:04.2958493Z,2013,302,67,266,124,0,6,0,178,0,0,235,36,0,295,0,4,1
26492,2974,2020-11-18T16:16:04.2968497Z,2014,280,89,255,113,0,4,0,167,0,0,191,25,0,275,0,2,1
26492,2975,2020-11-18T16:16:04.2968497Z,2015,205,76,187,81,0,3,0,124,0,0,129,18,0,202,0,2,0
26492,2976,2020-11-18T16:16:04.2968497Z,2016,193,104,142,75,0,2,3,118,0,0,89,51,0,191,0,1,0
26492,2977,2020-11-18T16:16:04.2968497Z,2017,186,106,167,69,0,4,3,117,0,0,80,19,0,182,0,1,0
26492,2978,2020-11-18T16:16:04.2978506Z,2018,296,149,256,127,0,3,8,169,0,0,147,40,0,293,0,1,0
26492,2979,2020-11-18T16:16:04.2978506Z,2019,350,186,294,147,0,8,2,203,0,0,164,56,0,342,0,3,0
26492,2980,2020-11-18T16:16:04.2978506Z,2020,352,216,300,148,0,6,2,204,0,0,136,52,0,346,0,2,0
28522,25752,2021-06-24T05:35:08.7180672Z,2021,800,75,546,441,0,7,0,359,0,0,725,254,0,793,0,2,0
28522,3150,2020-11-18T16:16:05.3355435Z,2012,585,1,321,314,0,2,0,271,0,0,584,264,0,583,0,0,0
28522,3151,2020-11-18T16:16:05.3355435Z,2013,588,1,309,313,0,3,0,275,0,0,587,279,0,585,0,0,0
28522,3152,2020-11-18T16:16:05.3355435Z,2014,585,16,306,315,0,1,0,270,0,0,569,279,0,584,0,0,0
28522,3153,2020-11-18T16:16:05.3355435Z,2015,629,16,308,335,0,1,0,294,0,0,613,321,0,628,0,1,0
28522,3154,2020-11-18T16:16:05.3365435Z,2016,628,24,257,342,0,1,0,286,0,0,604,371,0,627,0,0,0
28522,3155,2020-11-18T16:16:05.3365435Z,2017,620,22,323,360,0,3,0,260,0,0,598,297,0,617,0,0,0
28522,3156,2020-11-18T16:16:05.3365435Z,2018,588,22,309,336,0,7,0,252,0,0,566,279,0,581,0,0,0
28522,3157,2020-11-18T16:16:05.3365435Z,2019,700,48,395,406,0,8,2,294,0,0,652,305,0,692,0,1,0
28522,3158,2020-11-18T16:16:05.3375444Z,2020,768,74,431,430,0,7,2,338,0,0,694,337,0,761,0,0,0
15438,1210,2020-11-18T16:15:53.5957138Z,2012,287,106,224,132,0,6,0,155,0,0,181,63,0,281,0,0,0
15438,1211,2020-11-18T16:15:53.5957138Z,2013,312,114,248,147,0,8,0,165,0,0,198,64,0,303,0,4,1
15438,1212,2020-11-18T16:15:53.5957138Z,2014,304,110,223,154,0,8,0,150,0,0,194,81,0,296,0,3,0
15438,1213,2020-11-18T16:15:53.5957138Z,2015,306,104,234,154,0,9,0,152,0,0,202,72,0,297,0,3,0
15438,1214,2020-11-18T16:15:53.5957138Z,2016,289,101,226,140,0,9,0,149,0,0,188,63,0,280,0,2,0
15438,1215,2020-11-18T16:15:53.5967151Z,2017,262,77,208,130,0,6,0,132,0,0,185,54,0,256,0,0,0
15438,1216,2020-11-18T16:15:53.5967151Z,2018,264,78,208,137,0,7,0,127,0,0,186,56,0,257,0,0,0
15438,1217,2020-11-18T16:15:53.5967151Z,2019,303,96,256,143,0,9,0,160,0,0,207,47,0,294,0,1,0
15438,1218,2020-11-18T16:15:53.5967151Z,2020,295,87,231,135,0,7,0,160,0,0,208,64,0,287,0,1,1
15438,25810,2021-06-24T05:35:10.9046362Z,2021,290,74,246,130,0,4,1,160,0,0,216,44,0,286,0,0,0
40527,31821,2021-06-24T05:35:16.9259537Z,2021,311,51,224,163,0,9,15,148,0,0,260,87,0,302,0,3,0
40527,4816,2020-11-18T16:16:15.7815083Z,2012,308,30,173,140,0,11,0,168,0,0,278,135,1,296,0,0,0
40527,4817,2020-11-18T16:16:15.7815083Z,2013,332,31,182,147,0,10,0,185,0,0,301,150,2,319,0,19,1
40527,4818,2020-11-18T16:16:15.7815083Z,2014,302,31,129,140,0,6,0,162,0,0,271,173,1,294,0,9,1
40527,4819,2020-11-18T16:16:15.7825092Z,2015,292,30,146,137,0,21,0,155,0,0,262,146,1,268,0,8,2
40527,4820,2020-11-18T16:16:15.7825092Z,2016,297,28,50,151,0,17,22,146,0,0,269,247,1,278,0,4,1
40527,4821,2020-11-18T16:16:15.7825092Z,2017,311,29,187,175,0,17,23,136,0,0,282,124,0,293,0,7,1
40527,4822,2020-11-18T16:16:15.7825092Z,2018,290,37,191,171,0,14,12,119,0,0,253,99,1,275,2,1,0
40527,4823,2020-11-18T16:16:15.7825092Z,2019,325,50,212,171,0,12,14,154,0,1,275,113,1,312,1,2,0
40527,4824,2020-11-18T16:16:15.7835101Z,2020,343,54,207,185,0,12,14,158,0,0,289,136,1,329,1,2,1
55871,25915,2021-06-24T05:35:12.809002Z,2021,116,42,113,59,0,3,1,57,0,0,74,3,0,113,0,0,0
55871,7514,2020-11-18T16:16:34.5190012Z,2012,325,47,275,150,0,10,0,175,0,0,278,50,0,314,0,0,1
55871,7515,2020-11-18T16:16:34.5190012Z,2013,294,61,257,131,0,9,0,163,0,0,233,37,0,284,0,1,1
55871,7516,2020-11-18T16:16:34.5190012Z,2014,308,69,268,140,0,7,0,168,0,0,239,40,0,300,0,2,1
55871,7517,2020-11-18T16:16:34.5200016Z,2015,392,104,346,192,0,8,0,200,0,0,288,46,1,383,0,0,0
55871,7518,2020-11-18T16:16:34.5200016Z,2016,352,118,24,164,0,7,4,188,0,0,234,328,0,345,0,1,0
55871,7519,2020-11-18T16:16:34.5200016Z,2017,262,87,234,127,0,5,3,135,0,0,175,28,0,257,0,0,0
55871,7520,2020-11-18T16:16:34.5210025Z,2018,153,53,138,73,0,4,1,80,0,0,100,15,0,149,0,0,0
55871,7521,2020-11-18T16:16:34.5210025Z,2019,127,40,116,55,0,5,2,72,0,0,87,11,0,122,0,1,0
55871,7522,2020-11-18T16:16:34.5210025Z,2020,121,49,117,56,0,1,1,65,0,0,72,4,0,120,0,1,0
71738,10442,2020-11-18T16:16:54.7164673Z,2012,434,113,336,206,0,6,0,228,0,0,321,98,0,428,0,0,0
71738,10443,2020-11-18T16:16:54.7164673Z,2013,386,98,293,179,0,5,0,207,0,0,288,93,1,379,0,2,1
71738,10444,2020-11-18T16:16:54.7164673Z,2014,385,108,296,172,0,6,0,213,0,0,277,89,2,375,0,4,2
71738,10445,2020-11-18T16:16:54.7164673Z,2015,348,103,274,155,0,5,0,193,0,0,245,74,3,339,0,4,1
71738,10446,2020-11-18T16:16:54.7174682Z,2016,263,72,159,123,0,2,2,140,0,0,191,104,5,255,0,3,1
71738,10447,2020-11-18T16:16:54.7174682Z,2017,255,67,208,124,0,3,1,131,0,0,188,47,3,247,0,4,2
71738,10448,2020-11-18T16:16:54.7174682Z,2018,294,69,188,148,0,7,4,146,0,0,225,106,2,281,0,1,4
71738,10449,2020-11-18T16:16:54.7174682Z,2019,284,78,205,145,0,0,2,139,0,0,206,79,0,284,0,1,0
71738,10450,2020-11-18T16:16:54.7174682Z,2020,262,79,182,142,0,1,0,120,0,0,183,80,0,260,0,1,1
71738,25620,2021-06-24T05:35:04.6511519Z,2021,204,55,151,107,0,1,1,97,0,0,149,53,3,200,0,1,0
31054,31765,2021-06-24T05:35:16.8348886Z,2021,455,123,406,204,0,13,0,251,0,0,332,49,1,441,1,0,0
31054,3526,2020-11-18T16:16:07.6140591Z,2012,394,22,318,201,0,5,0,193,0,0,372,76,0,384,0,0,5
31054,3527,2020-11-18T16:16:07.6140591Z,2013,430,45,342,226,0,9,0,204,0,0,385,88,0,419,0,1,2
31054,3528,2020-11-18T16:16:07.6140591Z,2014,476,61,381,253,0,5,0,223,0,0,415,95,0,470,0,1,1
31054,3529,2020-11-18T16:16:07.6150609Z,2015,590,120,483,307,0,3,0,283,0,0,470,107,2,585,0,3,0
31054,3530,2020-11-18T16:16:07.6150609Z,2016,508,121,375,260,0,5,5,248,0,0,387,133,6,497,0,2,0
31054,3531,2020-11-18T16:16:07.6150609Z,2017,465,116,383,230,0,4,3,235,0,0,349,82,3,458,0,2,0
31054,3532,2020-11-18T16:16:07.6150609Z,2018,527,109,423,269,0,4,5,258,0,0,418,104,5,518,1,3,0
31054,3533,2020-11-18T16:16:07.6160605Z,2019,525,118,460,275,0,8,4,250,0,0,407,65,6,509,1,3,2
31054,3534,2020-11-18T16:16:07.6160605Z,2020,468,107,404,235,0,7,0,233,0,0,361,64,1,459,0,0,1
11023,25586,2021-06-24T05:35:04.5981141Z,2021,331,126,266,163,0,6,1,168,0,0,205,65,0,325,3,0,0
11023,275,2020-11-18T16:15:46.8712272Z,2012,676,126,470,338,0,18,0,338,0,0,550,206,0,658,0,0,0
11023,276,2020-11-18T16:15:46.8712272Z,2013,674,153,456,326,0,25,0,348,0,0,521,218,0,649,0,13,0
11023,277,2020-11-18T16:15:46.8712272Z,2014,642,162,430,305,0,27,0,337,0,0,480,212,0,615,0,10,0
11023,278,2020-11-18T16:15:46.8712272Z,2015,555,146,434,278,0,17,0,277,0,0,409,121,0,538,0,3,0
11023,279,2020-11-18T16:15:46.8722285Z,2016,470,125,339,242,0,15,1,228,0,0,345,131,0,455,0,1,0
11023,280,2020-11-18T16:15:46.8722285Z,2017,447,125,332,231,0,12,0,216,0,0,322,115,0,435,0,2,0
11023,281,2020-11-18T16:15:46.8722285Z,2018,428,119,311,215,0,0,1,213,0,0,309,117,0,428,1,0,0
11023,282,2020-11-18T16:15:46.8722285Z,2019,397,130,288,195,0,1,1,202,0,0,267,109,0,396,2,0,0
11023,283,2020-11-18T16:15:46.8722285Z,2020,365,129,274,176,0,3,1,189,0,0,236,91,0,362,5,0,0
35774,31801,2021-06-24T05:35:16.8769178Z,2021,291,58,242,161,0,2,0,130,0,0,233,49,1,287,1,1,1
35774,4410,2020-11-18T16:16:12.575368Z,2012,226,32,120,107,0,7,0,119,0,0,194,106,0,219,0,0,0
35774,4411,2020-11-18T16:16:12.575368Z,2013,202,34,119,95,0,5,0,107,0,0,168,83,0,197,0,1,0
35774,4412,2020-11-18T16:16:12.576368Z,2014,196,35,110,94,0,3,0,102,0,0,161,86,0,193,0,0,0
35774,4413,2020-11-18T16:16:12.576368Z,2015,199,31,131,96,0,0,0,103,0,0,168,68,0,199,0,3,0
35774,4414,2020-11-18T16:16:12.576368Z,2016,212,34,146,110,0,0,0,102,0,0,178,66,0,212,0,0,0
35774,4415,2020-11-18T16:16:12.5773693Z,2017,331,55,242,165,0,2,0,166,0,0,276,89,0,329,0,0,0
35774,4416,2020-11-18T16:16:12.5773693Z,2018,283,73,210,139,0,1,43,144,0,0,210,73,0,282,2,0,0
35774,4417,2020-11-18T16:16:12.5773693Z,2019,322,90,254,177,0,4,0,145,0,0,232,68,0,317,1,0,1
35774,4418,2020-11-18T16:16:12.5783702Z,2020,289,61,215,162,0,2,0,127,0,0,228,74,0,286,2,0,1
20776,1915,2020-11-18T16:15:58.4909776Z,2012,272,39,234,128,0,3,0,144,0,0,233,38,0,267,0,0,2
20776,1916,2020-11-18T16:15:58.4909776Z,2013,274,75,234,114,0,2,0,160,0,0,199,40,0,270,0,0,2
20776,1917,2020-11-18T16:15:58.4909776Z,2014,305,106,257,128,0,2,0,177,0,0,199,48,0,303,0,0,0
20776,1918,2020-11-18T16:15:58.491978Z,2015,362,121,296,167,0,2,0,195,0,0,241,66,0,360,0,0,0
20776,1919,2020-11-18T16:15:58.491978Z,2016,378,125,282,168,0,2,1,210,0,0,253,96,0,376,0,1,0
20776,1920,2020-11-18T16:15:58.491978Z,2017,439,151,346,204,0,2,4,235,0,0,288,93,0,437,0,1,0
20776,1921,2020-11-18T16:15:58.491978Z,2018,432,132,340,211,0,3,7,221,0,0,300,92,0,429,0,1,0
20776,1922,2020-11-18T16:15:58.491978Z,2019,403,151,320,188,0,1,28,215,0,0,252,83,0,401,0,1,1
20776,1923,2020-11-18T16:15:58.4929785Z,2020,411,145,322,191,0,3,13,220,0,0,266,89,0,408,0,0,0
20776,31700,2021-06-24T05:35:15.328808Z,2021,411,144,340,200,0,2,10,211,0,0,267,71,0,409,0,0,0
62422,31960,2021-06-24T05:35:20.2493365Z,2021,412,110,382,222,0,16,0,190,0,0,302,30,0,395,0,0,1
62422,8491,2020-11-18T16:16:40.2338113Z,2012,542,35,404,262,0,7,0,280,0,0,507,138,1,534,0,0,0
62422,8492,2020-11-18T16:16:40.2338113Z,2013,492,51,364,243,0,12,0,249,0,0,441,128,1,479,0,0,0
62422,8493,2020-11-18T16:16:40.2338113Z,2014,459,61,353,209,0,13,0,250,0,0,398,106,1,445,0,1,0
62422,8494,2020-11-18T16:16:40.2338113Z,2015,440,60,334,201,0,17,0,239,0,0,380,106,0,423,0,1,0
62422,8495,2020-11-18T16:16:40.2338113Z,2016,329,56,213,151,0,12,1,178,0,0,273,116,0,317,0,1,0
62422,8496,2020-11-18T16:16:40.2348122Z,2017,241,38,194,119,0,16,0,122,0,0,203,47,0,225,0,1,0
62422,8497,2020-11-18T16:16:40.2348122Z,2018,265,78,226,130,0,14,1,135,0,0,187,39,0,251,0,0,0
62422,8498,2020-11-18T16:16:40.2348122Z,2019,416,113,368,210,0,20,5,206,0,0,303,48,0,396,0,0,0
62422,8499,2020-11-18T16:16:40.2348122Z,2020,440,121,388,226,0,24,1,214,0,0,319,52,0,416,0,0,0
13342,25868,2021-06-24T05:35:10.9957009Z,2021,134,29,118,61,0,2,0,73,0,0,105,16,1,130,0,0,1
13342,986,2020-11-18T16:15:52.0466781Z,2012,185,42,175,89,0,1,0,96,0,0,143,10,0,184,0,0,0
13342,987,2020-11-18T16:15:52.0476795Z,2013,199,54,185,95,0,3,0,104,0,0,145,14,1,195,0,3,0
13342,988,2020-11-18T16:15:52.0476795Z,2014,213,57,190,97,0,0,0,116,0,0,156,23,1,212,0,1,0
13342,989,2020-11-18T16:15:52.0476795Z,2015,196,51,176,90,0,1,0,106,0,0,145,20,0,195,0,3,0
13342,990,2020-11-18T16:15:52.0486799Z,2016,194,49,169,93,0,1,3,101,0,0,145,25,0,193,0,1,0
13342,991,2020-11-18T16:15:52.0486799Z,2017,163,43,137,68,0,0,9,95,0,0,120,26,0,163,0,1,0
13342,992,2020-11-18T16:15:52.0486799Z,2018,180,44,140,77,0,0,20,103,0,0,136,40,0,180,2,1,0
13342,993,2020-11-18T16:15:52.0496804Z,2019,127,33,103,55,0,0,8,72,0,0,94,24,0,127,1,1,0
13342,994,2020-11-18T16:15:52.0496804Z,2020,131,30,114,59,0,2,0,72,0,0,101,17,0,129,0,1,0
30148,25753,2021-06-24T05:35:08.7140644Z,2021,240,64,206,122,0,5,0,118,0,0,176,34,0,233,0,3,2
30148,3224,2020-11-18T16:16:05.7127936Z,2012,688,84,460,323,0,6,0,365,0,0,604,228,0,681,0,0,1
30148,3225,2020-11-18T16:16:05.7137944Z,2013,658,112,482,313,0,8,0,345,0,0,546,176,0,649,0,6,1
30148,3226,2020-11-18T16:16:05.7137944Z,2014,632,119,501,308,0,4,0,324,0,0,513,131,0,627,0,4,1
30148,3227,2020-11-18T16:16:05.7137944Z,2015,490,99,433,248,0,0,0,242,0,0,391,57,0,489,0,6,1
30148,3228,2020-11-18T16:16:05.7137944Z,2016,337,78,214,162,0,5,3,175,0,0,259,123,0,330,0,5,2
30148,3229,2020-11-18T16:16:05.7147958Z,2017,370,88,331,176,0,7,1,194,0,0,282,39,0,363,0,9,0
30148,3230,2020-11-18T16:16:05.7147958Z,2018,368,95,336,186,0,4,1,182,0,0,273,32,0,364,3,5,0
30148,3231,2020-11-18T16:16:05.7147958Z,2019,332,91,307,163,0,7,1,169,0,0,241,25,0,325,2,0,0
30148,3232,2020-11-18T16:16:05.7157962Z,2020,278,78,258,142,0,7,0,136,0,0,200,20,0,270,0,2,1
12187,31600,2021-06-24T05:35:14.5622596Z,2021,236,107,231,110,0,2,6,126,0,0,129,5,0,234,0,1,0
12187,626,2020-11-18T16:15:50.2344703Z,2012,246,94,223,107,0,3,0,139,0,0,152,23,0,240,0,0,3
12187,627,2020-11-18T16:15:50.2344703Z,2013,207,85,175,92,0,1,0,115,0,0,122,32,0,204,0,1,2
12187,628,2020-11-18T16:15:50.2344703Z,2014,221,88,157,109,0,4,0,112,0,0,133,64,0,214,0,1,3
12187,629,2020-11-18T16:15:50.2344703Z,2015,214,82,159,110,0,3,0,104,0,0,132,55,0,209,0,1,2
12187,630,2020-11-18T16:15:50.2344703Z,2016,166,75,123,80,0,0,3,86,0,0,91,43,0,164,0,1,2
12187,631,2020-11-18T16:15:50.2354707Z,2017,167,72,161,79,0,2,2,88,0,0,95,6,0,165,0,0,0
12187,632,2020-11-18T16:15:50.2354707Z,2018,162,68,119,69,0,4,6,93,0,0,94,43,0,157,1,0,1
12187,633,2020-11-18T16:15:50.2354707Z,2019,235,121,219,111,0,1,3,124,0,0,114,16,0,233,1,0,1
12187,634,2020-11-18T16:15:50.2354707Z,2020,255,106,240,119,0,1,0,136,0,0,149,15,0,253,1,0,1
71761,10469,2020-11-18T16:16:54.7304771Z,2012,641,90,552,324,0,9,0,317,0,0,551,89,0,632,0,0,0
71761,10470,2020-11-18T16:16:54.7314776Z,2013,609,132,514,313,0,7,0,296,0,0,477,95,0,601,0,2,1
71761,10471,2020-11-18T16:16:54.7314776Z,2014,642,176,543,308,0,15,0,334,0,0,466,99,0,627,0,3,0
71761,10472,2020-11-18T16:16:54.7314776Z,2015,659,164,545,324,0,9,0,335,0,0,495,114,0,650,0,3,0
71761,10473,2020-11-18T16:16:54.7314776Z,2016,574,179,320,277,0,7,2,297,0,0,395,254,0,565,0,3,2
71761,10474,2020-11-18T16:16:54.7314776Z,2017,493,163,416,246,0,6,11,247,0,0,330,77,0,485,0,2,2
71761,10475,2020-11-18T16:16:54.732478Z,2018,636,186,538,314,0,9,32,322,0,0,450,98,0,626,0,0,1
71761,10476,2020-11-18T16:16:54.732478Z,2019,577,177,497,272,0,8,59,305,0,0,400,80,0,566,1,1,3
71761,10477,2020-11-18T16:16:54.732478Z,2020,490,173,428,229,0,9,2,261,0,0,317,62,0,479,1,1,2
71761,31623,2021-06-24T05:35:14.6243028Z,2021,424,157,380,199,0,11,12,225,0,0,267,44,0,411,0,2,2
40147,25815,2021-06-24T05:35:10.9056363Z,2021,481,151,424,230,0,8,22,251,0,0,330,57,0,472,6,2,1
40147,4646,2020-11-18T16:16:14.4015881Z,2012,419,127,357,203,0,18,0,216,0,0,292,62,0,401,0,0,0
40147,4647,2020-11-18T16:16:14.4015881Z,2013,373,125,323,173,0,15,0,200,0,0,248,50,0,358,0,1,0
40147,4648,2020-11-18T16:16:14.4025877Z,2014,364,118,294,164,0,9,0,200,0,0,246,70,1,353,0,2,1
40147,4649,2020-11-18T16:16:14.4025877Z,2015,312,101,242,136,0,5,0,176,0,0,211,70,0,307,0,1,0
40147,4650,2020-11-18T16:16:14.4025877Z,2016,316,104,233,142,0,7,0,174,0,0,212,83,0,308,0,3,1
40147,4651,2020-11-18T16:16:14.4035885Z,2017,361,118,281,157,0,10,2,204,0,0,243,80,0,351,0,4,0
40147,4652,2020-11-18T16:16:14.4035885Z,2018,501,140,378,239,0,14,11,262,0,0,361,123,0,487,9,1,0
40147,4653,2020-11-18T16:16:14.4035885Z,2019,526,162,418,243,0,10,5,283,0,0,364,108,0,516,9,3,0
40147,4654,2020-11-18T16:16:14.4045885Z,2020,534,163,420,252,0,7,25,282,0,0,371,114,0,524,8,2,3
51185,25880,2021-06-24T05:35:12.7729753Z,2021,344,110,268,155,0,5,1,189,0,0,234,76,0,339,1,0,0
51185,6404,2020-11-18T16:16:27.0300082Z,2012,639,75,490,293,0,1,0,346,0,0,564,149,0,637,0,0,1
51185,6405,2020-11-18T16:16:27.0300082Z,2013,610,113,492,282,0,6,0,328,0,0,497,118,0,604,0,3,0
51185,6406,2020-11-18T16:16:27.0310078Z,2014,560,128,445,255,0,6,0,305,0,0,432,115,0,553,0,6,1
51185,6407,2020-11-18T16:16:27.0310078Z,2015,522,105,410,249,0,9,0,273,0,0,417,112,0,512,0,5,1
51185,6408,2020-11-18T16:16:27.0310078Z,2016,475,114,347,240,0,10,1,235,0,0,361,128,0,464,0,3,1
51185,6409,2020-11-18T16:16:27.0310078Z,2017,412,109,321,204,0,10,0,208,0,0,303,91,0,401,0,1,1
51185,6410,2020-11-18T16:16:27.0320078Z,2018,299,104,235,134,0,6,0,165,0,2,195,64,0,293,1,0,0
51185,6411,2020-11-18T16:16:27.0320078Z,2019,412,136,350,188,0,8,4,224,0,0,276,62,0,404,1,0,0
51185,6412,2020-11-18T16:16:27.0320078Z,2020,398,133,338,184,0,7,17,214,0,0,265,60,0,390,0,0,1
53363,25902,2021-06-24T05:35:12.8019954Z,2021,201,63,169,96,0,0,0,105,0,0,138,32,0,201,1,0,0
53363,7233,2020-11-18T16:16:32.5086639Z,2012,283,64,214,133,0,0,0,150,0,0,219,69,0,283,0,0,0
53363,7234,2020-11-18T16:16:32.5086639Z,2013,270,68,183,125,0,0,0,145,0,0,202,87,0,270,0,0,0
53363,7235,2020-11-18T16:16:32.5096647Z,2014,255,72,199,115,0,1,0,140,0,0,183,56,0,254,0,0,0
53363,7236,2020-11-18T16:16:32.5096647Z,2015,303,83,215,139,0,2,0,164,0,0,220,88,0,301,0,0,0
53363,7237,2020-11-18T16:16:32.5096647Z,2016,319,85,143,137,0,1,0,182,0,0,234,176,0,318,0,0,0
53363,7238,2020-11-18T16:16:32.5106652Z,2017,290,78,220,125,0,0,1,165,0,0,212,70,0,290,0,0,0
53363,7239,2020-11-18T16:16:32.5106652Z,2018,234,61,178,112,0,1,0,122,0,1,173,56,0,233,2,0,0
53363,7240,2020-11-18T16:16:32.5106652Z,2019,251,67,213,120,0,0,0,131,0,1,184,38,0,250,2,0,1
53363,7241,2020-11-18T16:16:32.5116665Z,2020,248,70,200,122,0,1,3,126,0,0,178,48,0,246,2,0,1
57125,31924,2021-06-24T05:35:18.521097Z,2021,436,104,338,221,0,5,0,215,0,0,332,98,1,430,3,1,0
57125,7658,2020-11-18T16:16:35.0963862Z,2012,566,0,377,303,0,31,0,263,0,0,566,189,0,535,0,0,0
57125,7659,2020-11-18T16:16:35.0973871Z,2013,542,4,373,284,0,12,0,258,0,0,538,169,0,530,0,3,0
57125,7660,2020-11-18T16:16:35.0973871Z,2014,553,28,384,287,0,2,0,266,0,0,525,169,0,551,0,1,0
57125,7661,2020-11-18T16:16:35.0973871Z,2015,564,38,391,290,0,4,0,274,0,0,526,173,0,560,0,1,0
57125,7662,2020-11-18T16:16:35.0983876Z,2016,540,76,369,269,0,11,0,271,0,0,464,171,0,529,0,1,0
57125,7663,2020-11-18T16:16:35.0983876Z,2017,587,88,387,290,0,13,1,297,0,0,499,200,0,574,0,4,0
57125,7664,2020-11-18T16:16:35.0983876Z,2018,670,110,450,328,0,14,3,342,0,0,560,220,2,653,6,3,1
57125,7665,2020-11-18T16:16:35.099388Z,2019,590,91,424,283,0,11,1,307,0,0,499,166,1,577,6,2,1
57125,7666,2020-11-18T16:16:35.099388Z,2020,479,101,349,236,0,10,4,243,0,0,378,130,2,466,6,1,1
57620,31927,2021-06-24T05:35:18.5271013Z,2021,296,75,230,130,0,3,0,166,0,0,221,66,0,293,4,2,0
57620,7721,2020-11-18T16:16:35.9049263Z,2012,564,0,459,284,0,3,0,280,0,0,564,105,0,561,0,0,0
57620,7722,2020-11-18T16:16:35.9049263Z,2013,536,0,416,284,0,1,0,252,0,0,536,120,1,534,0,7,0
57620,7723,2020-11-18T16:16:35.9049263Z,2014,483,25,365,251,0,3,0,232,0,0,458,118,0,480,0,7,0
57620,7724,2020-11-18T16:16:35.9049263Z,2015,451,37,362,234,0,10,0,217,0,0,414,89,0,441,0,6,0
57620,7725,2020-11-18T16:16:35.9049263Z,2016,388,64,306,192,0,8,0,196,0,0,324,82,0,380,0,1,0
57620,7726,2020-11-18T16:16:35.9049263Z,2017,514,86,403,256,0,6,2,258,0,0,428,111,0,508,0,3,0
57620,7727,2020-11-18T16:16:35.9059268Z,2018,522,86,390,251,0,3,2,271,0,1,436,132,0,519,9,4,0
57620,7728,2020-11-18T16:16:35.9059268Z,2019,405,75,306,190,0,6,4,215,0,2,330,99,0,399,8,4,0
57620,7729,2020-11-18T16:16:35.9059268Z,2020,334,87,259,158,0,3,30,176,0,0,247,75,0,331,9,7,0
57018,31923,2021-06-24T05:35:19.739971Z,2021,279,77,228,123,0,2,0,156,0,0,202,51,0,276,0,1,1
57018,7640,2020-11-18T16:16:35.080376Z,2012,327,73,245,166,0,3,0,161,0,0,254,82,0,324,0,0,0
57018,7641,2020-11-18T16:16:35.080376Z,2013,327,73,246,158,0,7,0,169,0,0,254,81,0,317,0,6,3
57018,7642,2020-11-18T16:16:35.080376Z,2014,313,71,226,157,0,9,0,156,0,0,242,87,0,303,0,0,1
57018,7643,2020-11-18T16:16:35.0813764Z,2015,308,83,223,150,0,9,0,158,0,0,225,85,0,299,0,0,0
57018,7644,2020-11-18T16:16:35.0813764Z,2016,311,93,138,151,0,8,2,160,0,0,218,173,0,303,0,0,0
57018,7645,2020-11-18T16:16:35.0813764Z,2017,242,76,199,113,0,5,0,129,0,0,166,43,0,237,0,0,0
57018,7646,2020-11-18T16:16:35.0823782Z,2018,333,92,273,159,0,8,12,174,0,1,241,60,0,325,1,0,0
57018,7647,2020-11-18T16:16:35.0823782Z,2019,360,106,298,165,0,6,15,195,0,0,254,62,0,354,0,1,0
57018,7648,2020-11-18T16:16:35.0823782Z,2020,347,91,284,154,0,6,28,193,0,0,256,63,0,341,0,1,0
43505,25841,2021-06-24T05:35:10.9456646Z,2021,139,38,127,53,0,0,0,86,0,0,101,12,0,139,2,0,0
43505,5601,2020-11-18T16:16:21.1410828Z,2012,110,33,100,53,0,1,0,57,0,0,77,10,0,109,0,0,0
43505,5602,2020-11-18T16:16:21.1420832Z,2013,110,37,99,62,0,0,0,48,0,0,73,11,0,110,0,0,0
43505,5603,2020-11-18T16:16:21.1420832Z,2014,91,30,84,51,0,0,0,40,0,0,61,7,0,91,0,0,0
43505,5604,2020-11-18T16:16:21.1420832Z,2015,100,28,78,53,0,0,0,47,0,0,72,22,0,100,0,0,0
43505,5605,2020-11-18T16:16:21.1420832Z,2016,125,29,112,66,0,0,0,59,0,0,96,13,0,125,0,0,0
43505,5606,2020-11-18T16:16:21.1420832Z,2017,161,52,141,71,0,0,0,90,0,0,109,20,0,161,0,0,0
43505,5607,2020-11-18T16:16:21.1430836Z,2018,116,34,102,46,0,2,0,70,0,0,82,14,0,114,0,3,0
43505,5608,2020-11-18T16:16:21.1430836Z,2019,187,64,170,86,3,0,3,101,0,0,123,17,0,187,1,2,0
43505,5609,2020-11-18T16:16:21.1430836Z,2020,147,45,137,61,0,1,0,86,0,0,102,10,0,146,2,0,0
48025,25863,2021-06-24T05:35:10.9896975Z,2021,277,111,234,124,0,1,0,153,0,0,166,43,0,276,1,0,0
48025,6095,2020-11-18T16:16:23.9979852Z,2012,479,152,388,226,0,24,0,253,0,0,327,91,0,454,0,0,1
48025,6096,2020-11-18T16:16:23.9979852Z,2013,468,165,382,222,0,18,0,246,0,0,303,86,0,449,0,7,1
48025,6097,2020-11-18T16:16:23.9979852Z,2014,416,157,304,201,0,6,0,215,0,0,259,112,0,408,0,6,2
48025,6098,2020-11-18T16:16:23.9979852Z,2015,381,153,303,180,0,8,0,201,0,0,228,78,0,372,0,0,1
48025,6099,2020-11-18T16:16:23.998986Z,2016,373,148,276,166,0,6,12,207,0,0,225,97,0,366,0,0,1
48025,6100,2020-11-18T16:16:23.998986Z,2017,327,125,262,153,0,3,8,174,0,0,202,65,0,324,0,1,0
48025,6101,2020-11-18T16:16:25.0616946Z,2018,333,137,274,146,0,5,15,187,0,0,196,59,0,327,0,2,1
48025,6102,2020-11-18T16:16:25.0616946Z,2019,410,168,349,189,0,0,8,221,0,0,242,61,0,410,1,3,0
48025,6103,2020-11-18T16:16:25.0616946Z,2020,329,140,273,138,0,0,15,191,0,0,189,56,0,329,0,1,0
35626,31800,2021-06-24T05:35:16.8749168Z,2021,41,41,34,13,0,0,1,28,0,0,0,7,0,41,0,0,0
35626,4392,2020-11-18T16:16:12.1811066Z,2012,59,27,42,25,0,0,0,34,0,0,32,17,0,59,0,0,0
35626,4393,2020-11-18T16:16:12.1811066Z,2013,65,47,50,31,0,0,0,34,0,0,18,15,0,65,0,1,0
35626,4394,2020-11-18T16:16:12.1811066Z,2014,54,45,40,22,0,1,0,32,0,0,9,14,0,53,0,1,0
35626,4395,2020-11-18T16:16:12.1821071Z,2015,70,59,54,22,0,1,0,48,0,0,11,16,0,69,0,0,0
35626,4396,2020-11-18T16:16:12.1821071Z,2016,64,54,24,22,0,0,0,42,0,0,10,40,0,64,0,0,0
35626,4397,2020-11-18T16:16:12.1821071Z,2017,72,54,47,25,0,0,0,47,0,0,18,25,0,72,0,0,0
35626,4398,2020-11-18T16:16:12.1831075Z,2018,77,50,56,23,0,0,3,54,0,0,27,21,0,77,0,0,0
35626,4399,2020-11-18T16:16:12.1831075Z,2019,52,40,45,19,0,0,0,33,0,0,12,7,0,52,0,0,0
35626,4400,2020-11-18T16:16:12.1831075Z,2020,43,41,33,15,0,0,0,28,0,0,2,10,0,43,0,0,0
12435,31635,2021-06-24T05:35:14.6383142Z,2021,287,113,233,143,0,1,15,144,0,0,174,54,1,285,0,0,0
12435,747,2020-11-18T16:15:50.9049156Z,2012,405,103,319,183,0,5,0,222,0,0,302,86,0,400,0,0,0
12435,748,2020-11-18T16:15:50.9049156Z,2013,413,102,348,192,0,7,0,221,0,0,311,65,0,406,0,2,0
12435,749,2020-11-18T16:15:50.9049156Z,2014,383,94,262,180,0,3,0,203,0,0,289,121,0,380,0,0,0
12435,750,2020-11-18T16:15:50.9049156Z,2015,349,95,264,176,0,3,0,173,0,0,254,85,0,346,0,0,0
12435,751,2020-11-18T16:15:50.9059165Z,2016,295,94,102,151,0,2,0,144,0,0,201,193,0,293,0,1,0
12435,752,2020-11-18T16:15:50.9059165Z,2017,260,75,205,122,0,1,0,138,0,0,185,55,0,259,0,0,0
12435,753,2020-11-18T16:15:50.9059165Z,2018,232,67,175,112,0,0,1,120,0,0,165,57,0,232,0,0,0
12435,754,2020-11-18T16:15:50.9059165Z,2019,302,116,223,160,0,0,25,142,0,0,186,79,0,302,0,0,0
12435,755,2020-11-18T16:15:50.9059165Z,2020,314,112,238,161,0,1,20,153,0,0,202,76,0,313,0,0,0
43273,31839,2021-06-24T05:35:16.9669824Z,2021,151,47,122,82,0,0,0,69,0,0,104,29,0,149,1,0,2
43273,5497,2020-11-18T16:16:19.7941835Z,2012,176,66,137,88,0,1,0,88,0,0,110,39,0,175,0,0,0
43273,5498,2020-11-18T16:16:19.7941835Z,2013,163,67,128,77,0,0,0,86,0,0,96,35,0,163,0,0,0
43273,5499,2020-11-18T16:16:19.7941835Z,2014,178,70,143,89,0,0,0,89,0,0,108,35,0,178,0,0,0
43273,5500,2020-11-18T16:16:19.7941835Z,2015,187,69,146,106,0,0,0,81,0,0,118,41,0,187,0,0,0
43273,5501,2020-11-18T16:16:20.6997877Z,2016,160,52,119,94,0,0,0,66,0,0,108,41,0,160,0,0,0
43273,5502,2020-11-18T16:16:20.7007877Z,2017,178,51,142,99,0,0,0,79,0,0,127,36,0,178,0,0,0
43273,5503,2020-11-18T16:16:20.7007877Z,2018,187,49,155,99,0,0,11,88,0,0,138,32,0,187,0,0,0
43273,5504,2020-11-18T16:16:20.7007877Z,2019,204,62,172,105,0,0,3,99,0,0,142,32,0,204,1,0,0
43273,5505,2020-11-18T16:16:20.7007877Z,2020,177,51,133,92,0,0,3,85,0,0,126,44,0,177,2,0,0
71654,10397,2020-11-18T16:16:54.3342132Z,2012,462,61,352,216,0,13,0,246,0,0,401,110,0,449,0,0,0
71654,10398,2020-11-18T16:16:54.3342132Z,2013,478,101,352,221,0,4,0,257,0,0,377,126,0,473,0,4,1
71654,10399,2020-11-18T16:16:54.3342132Z,2014,508,127,362,229,0,7,0,279,0,0,381,146,0,501,0,3,0
71654,10400,2020-11-18T16:16:54.3342132Z,2015,570,127,381,268,0,16,0,302,0,0,443,189,0,553,0,4,1
71654,10401,2020-11-18T16:16:54.7044593Z,2016,658,179,175,329,0,18,0,329,0,0,479,483,0,639,0,2,1
71654,10402,2020-11-18T16:16:54.7044593Z,2017,735,221,558,373,0,20,1,362,0,0,514,177,0,713,0,3,2
71654,10403,2020-11-18T16:16:54.7044593Z,2018,651,173,477,328,0,18,0,323,0,0,478,174,0,632,0,2,1
71654,10404,2020-11-18T16:16:54.7054597Z,2019,528,163,389,253,0,15,0,275,0,0,365,139,0,513,0,2,0
71654,10405,2020-11-18T16:16:54.7054597Z,2020,494,176,370,236,0,16,0,258,0,0,318,124,0,477,0,2,1
71654,31676,2021-06-24T05:35:15.279773Z,2021,429,165,355,215,0,11,1,214,0,0,264,74,0,416,0,1,2
31120,31766,2021-06-24T05:35:16.8388914Z,2021,372,80,333,205,0,5,0,167,0,0,292,39,4,363,0,1,0
31120,3551,2020-11-18T16:16:07.6350738Z,2012,298,18,248,147,0,1,0,151,0,0,280,50,0,297,0,0,0
31120,3552,2020-11-18T16:16:07.6360747Z,2013,253,20,221,124,0,2,0,129,0,0,233,32,0,251,0,1,0
31120,3553,2020-11-18T16:16:07.6360747Z,2014,279,28,226,138,0,0,0,141,0,0,251,53,1,278,0,0,0
31120,3554,2020-11-18T16:16:07.6360747Z,2015,281,19,222,147,0,0,0,134,0,0,262,59,0,281,0,0,0
31120,3555,2020-11-18T16:16:07.6370756Z,2016,251,20,162,133,0,0,0,118,0,0,231,89,1,250,0,0,0
31120,3556,2020-11-18T16:16:07.6370756Z,2017,183,16,169,95,0,0,1,88,0,0,167,14,0,183,0,0,0
31120,3557,2020-11-18T16:16:07.6370756Z,2018,178,13,158,103,1,2,1,75,0,0,165,20,0,176,0,0,0
31120,3558,2020-11-18T16:16:07.6370756Z,2019,136,12,127,75,0,0,0,61,0,0,124,9,1,135,0,0,0
31120,3559,2020-11-18T16:16:07.6370756Z,2020,334,67,298,187,0,2,0,147,0,0,267,36,2,330,0,1,0
53744,25906,2021-06-24T05:35:12.8029968Z,2021,115,31,103,60,0,1,0,55,0,0,84,12,0,114,0,0,0
53744,7332,2020-11-18T16:16:33.2391478Z,2012,204,67,154,106,0,0,0,98,0,0,137,50,0,204,0,0,0
53744,7333,2020-11-18T16:16:33.2391478Z,2013,192,59,149,97,0,0,0,95,0,0,133,43,0,192,0,0,0
53744,7334,2020-11-18T16:16:33.2391478Z,2014,181,55,139,91,0,0,0,90,0,0,126,42,0,181,0,0,0
53744,7335,2020-11-18T16:16:33.2401478Z,2015,185,51,143,98,0,0,0,87,0,0,134,42,0,185,0,0,0
53744,7336,2020-11-18T16:16:33.2401478Z,2016,148,34,108,84,0,0,0,64,0,0,114,40,0,148,0,0,0
53744,7337,2020-11-18T16:16:33.2401478Z,2017,164,39,124,88,0,0,0,76,0,0,125,40,0,164,0,2,0
53744,7338,2020-11-18T16:16:33.2411482Z,2018,122,25,95,61,0,0,0,61,0,0,97,27,0,122,0,0,0
53744,7339,2020-11-18T16:16:33.2411482Z,2019,131,36,106,65,0,0,0,66,0,0,95,25,0,131,0,1,0
53744,7340,2020-11-18T16:16:33.2411482Z,2020,132,35,108,72,0,2,1,60,0,0,97,24,0,130,0,0,0
21097,2094,2020-11-18T16:15:58.9322717Z,2012,408,110,321,185,0,0,0,223,0,0,298,87,0,408,0,0,0
21097,2095,2020-11-18T16:15:58.9322717Z,2013,405,100,313,194,0,0,0,211,0,0,305,92,0,405,0,2,0
21097,2096,2020-11-18T16:15:58.933273Z,2014,361,98,274,168,0,0,0,193,0,0,263,87,0,361,0,1,0
21097,2097,2020-11-18T16:15:58.933273Z,2015,336,79,250,164,0,1,0,172,0,0,257,86,0,335,0,0,0
21097,2098,2020-11-18T16:15:58.933273Z,2016,314,102,241,149,0,4,4,165,0,0,212,73,0,310,0,1,0
21097,2099,2020-11-18T16:15:58.933273Z,2017,240,84,199,123,0,1,0,117,0,0,156,41,0,239,0,1,0
21097,2100,2020-11-18T16:15:58.933273Z,2018,330,119,277,156,0,2,12,174,0,0,211,53,0,328,1,0,0
21097,2101,2020-11-18T16:15:59.5767031Z,2019,390,143,327,197,0,2,1,193,0,0,247,63,0,388,2,1,0
21097,2102,2020-11-18T16:15:59.5767031Z,2020,372,118,294,182,0,0,0,190,0,0,254,78,0,371,0,0,1
21097,31707,2021-06-24T05:35:15.3398179Z,2021,385,102,321,190,0,2,2,195,0,0,283,64,0,383,0,1,0
21089,2085,2020-11-18T16:15:58.9302704Z,2012,501,70,360,247,0,2,0,254,0,0,431,141,0,499,0,0,0
21089,2086,2020-11-18T16:15:58.9302704Z,2013,550,126,398,277,0,0,0,273,0,0,424,152,0,550,0,1,0
21089,2087,2020-11-18T16:15:58.9302704Z,2014,561,141,413,267,0,1,0,294,0,0,420,148,0,560,0,1,0
21089,2088,2020-11-18T16:15:58.9302704Z,2015,535,120,371,242,0,2,0,293,0,0,415,164,0,533,0,1,0
21089,2089,2020-11-18T16:15:58.9302704Z,2016,482,111,320,237,0,1,0,245,0,0,371,162,0,481,0,0,0
21089,2090,2020-11-18T16:15:58.9312708Z,2017,354,95,271,192,0,2,2,162,0,0,259,83,0,352,0,0,0
21089,2091,2020-11-18T16:15:58.9312708Z,2018,483,144,361,248,0,4,0,235,0,0,339,122,0,479,0,1,0
21089,2092,2020-11-18T16:15:58.9312708Z,2019,468,150,351,243,0,2,0,225,0,1,318,117,0,466,0,0,0
21089,2093,2020-11-18T16:15:58.9322717Z,2020,412,141,303,215,0,2,4,197,0,0,271,109,0,410,1,1,0
21089,25705,2021-06-24T05:35:08.6660317Z,2021,344,117,278,176,0,0,0,168,0,0,227,66,0,344,1,1,0
20685,1872,2020-11-18T16:15:57.8645596Z,2012,269,98,254,127,0,0,0,142,0,0,171,15,0,269,0,0,0
20685,1873,2020-11-18T16:15:57.8645596Z,2013,235,88,190,105,0,1,0,130,0,0,147,45,0,234,0,3,0
20685,1874,2020-11-18T16:15:57.86556Z,2014,213,87,161,105,0,0,0,108,0,0,126,52,1,212,0,1,0
20685,1875,2020-11-18T16:15:57.86556Z,2015,254,109,223,126,0,1,0,128,0,0,145,31,1,252,0,0,0
20685,1876,2020-11-18T16:15:57.86556Z,2016,228,101,164,110,0,1,0,118,0,0,127,64,1,226,0,0,0
20685,1877,2020-11-18T16:15:57.8665605Z,2017,198,90,180,96,0,2,0,102,0,0,108,18,1,195,0,1,0
20685,1878,2020-11-18T16:15:57.8665605Z,2018,212,99,187,111,0,0,18,101,0,0,113,25,1,211,0,1,0
20685,1879,2020-11-18T16:15:57.8665605Z,2019,225,130,201,116,0,1,0,109,0,0,95,24,2,222,0,1,0
20685,1880,2020-11-18T16:15:57.8665605Z,2020,188,103,165,95,0,0,0,93,0,0,85,23,2,186,0,0,0
20685,31698,2021-06-24T05:35:15.3258069Z,2021,202,98,175,101,0,2,0,101,0,0,104,27,0,199,1,0,1
46656,31854,2021-06-24T05:35:17.0010072Z,2021,583,136,453,271,0,11,1,312,0,0,447,130,0,572,2,1,0
46656,5892,2020-11-18T16:16:22.5900453Z,2012,521,0,396,262,0,13,0,259,0,0,521,125,0,508,0,0,0
46656,5893,2020-11-18T16:16:22.5900453Z,2013,473,1,380,239,0,28,0,234,0,0,472,93,0,445,0,2,0
46656,5894,2020-11-18T16:16:22.5910462Z,2014,399,18,327,196,0,17,0,203,0,0,381,72,0,382,0,5,0
46656,5895,2020-11-18T16:16:22.5910462Z,2015,411,19,316,217,0,10,0,194,0,0,392,95,0,400,0,5,1
46656,5896,2020-11-18T16:16:22.5910462Z,2016,414,45,149,206,0,10,0,208,0,0,369,265,0,404,0,2,0
46656,5897,2020-11-18T16:16:22.5920466Z,2017,401,42,286,204,0,12,1,197,0,0,359,115,0,389,0,1,0
46656,5898,2020-11-18T16:16:22.5920466Z,2018,435,49,347,213,0,13,1,222,0,0,386,88,0,422,8,0,0
46656,5899,2020-11-18T16:16:22.5920466Z,2019,478,74,384,223,0,11,0,255,0,0,404,94,1,466,8,1,0
46656,5900,2020-11-18T16:16:22.5920466Z,2020,551,122,433,247,0,12,0,304,0,0,429,118,1,538,5,1,0
50492,31876,2021-06-24T05:35:18.4480453Z,2021,177,77,147,82,0,2,0,95,0,0,100,30,0,175,0,0,0
50492,6213,2020-11-18T16:16:25.4979865Z,2012,448,60,349,215,0,1,0,233,0,0,388,99,0,447,0,0,0
50492,6214,2020-11-18T16:16:25.4979865Z,2013,422,101,337,184,0,2,0,238,0,0,321,85,1,419,0,3,0
50492,6215,2020-11-18T16:16:25.4979865Z,2014,373,117,303,162,0,1,0,211,0,0,256,70,1,371,0,3,0
50492,6216,2020-11-18T16:16:25.4979865Z,2015,364,107,306,140,0,0,0,224,0,0,257,58,1,363,0,3,0
50492,6217,2020-11-18T16:16:25.4979865Z,2016,318,111,198,126,0,0,12,192,0,0,207,120,0,318,0,2,0
50492,6218,2020-11-18T16:16:25.4979865Z,2017,308,114,259,129,0,0,2,179,0,0,194,49,0,308,0,1,0
50492,6219,2020-11-18T16:16:25.4989874Z,2018,251,93,207,125,0,4,0,126,0,0,158,44,0,247,0,2,0
50492,6220,2020-11-18T16:16:25.4989874Z,2019,247,106,191,127,1,5,6,120,0,0,141,56,0,242,0,1,0
50492,6221,2020-11-18T16:16:25.4989874Z,2020,207,94,170,104,0,3,2,103,0,0,113,37,0,204,0,0,0
21105,2103,2020-11-18T16:15:59.5827067Z,2012,731,3,512,332,0,4,0,399,0,0,728,219,0,727,0,0,0
21105,2104,2020-11-18T16:15:59.5827067Z,2013,761,2,530,332,0,3,0,429,0,0,759,231,0,758,0,1,0
21105,2105,2020-11-18T16:15:59.5827067Z,2014,754,58,528,337,0,3,0,417,0,0,696,226,0,751,0,2,0
21105,2106,2020-11-18T16:15:59.5827067Z,2015,750,77,508,344,0,4,0,406,0,0,673,242,0,746,0,3,0
21105,2107,2020-11-18T16:15:59.5827067Z,2016,720,156,487,324,0,3,0,396,0,0,564,233,0,717,0,3,0
21105,2108,2020-11-18T16:15:59.5837075Z,2017,836,189,595,373,0,5,2,463,0,0,647,241,0,831,0,2,0
21105,2109,2020-11-18T16:15:59.5837075Z,2018,763,163,543,332,0,3,28,431,0,0,600,220,0,760,0,1,0
21105,2110,2020-11-18T16:15:59.5837075Z,2019,695,169,503,312,0,4,0,383,0,0,526,192,0,691,0,1,0
21105,2111,2020-11-18T16:15:59.5837075Z,2020,699,223,516,337,0,3,0,362,0,0,476,183,0,696,0,1,0
21105,25706,2021-06-24T05:35:08.6650294Z,2021,722,220,569,362,0,4,0,360,0,0,502,153,0,717,1,2,1
71290,10134,2020-11-18T16:16:53.2805154Z,2012,176,68,150,76,0,3,0,100,0,0,108,26,0,173,0,0,0
71290,10135,2020-11-18T16:16:53.2815159Z,2013,173,77,150,76,0,2,0,97,0,0,96,23,0,171,0,1,0
71290,10136,2020-11-18T16:16:53.2815159Z,2014,194,76,160,84,0,0,0,110,0,0,118,34,0,194,0,0,0
71290,10137,2020-11-18T16:16:53.2815159Z,2015,177,68,152,88,0,0,0,89,0,0,109,25,0,177,0,0,0
71290,10138,2020-11-18T16:16:53.2815159Z,2016,149,60,120,76,0,0,0,73,0,0,89,29,0,149,0,0,0
71290,10139,2020-11-18T16:16:53.2815159Z,2017,159,56,121,80,0,0,1,79,0,0,103,38,0,159,0,1,0
71290,10140,2020-11-18T16:16:53.2825154Z,2018,139,51,95,70,0,0,0,69,0,0,88,44,0,139,3,1,0
71290,10141,2020-11-18T16:16:53.2825154Z,2019,131,52,96,62,0,0,5,69,0,0,79,35,0,131,1,1,0
71290,10142,2020-11-18T16:16:53.2825154Z,2020,122,37,74,59,0,0,5,63,0,0,85,48,0,122,0,1,0
71290,31667,2021-06-24T05:35:15.2497519Z,2021,134,31,104,70,0,1,5,64,0,0,103,30,0,133,0,1,0
52696,31899,2021-06-24T05:35:18.474064Z,2021,1304,325,1039,679,0,5,0,625,0,0,979,265,0,1298,2,1,1
52696,6945,2020-11-18T16:16:30.8785743Z,2012,747,0,504,338,0,0,0,409,0,0,747,243,1,742,0,0,4
52696,6946,2020-11-18T16:16:30.8795761Z,2013,637,6,500,308,0,1,0,329,0,0,631,137,0,633,0,1,3
52696,6947,2020-11-18T16:16:30.8795761Z,2014,659,50,516,333,0,4,0,326,0,0,609,143,1,653,0,1,1
52696,6948,2020-11-18T16:16:30.8795761Z,2015,838,46,622,417,0,5,0,421,0,0,792,216,2,830,0,1,1
52696,6949,2020-11-18T16:16:30.8805761Z,2016,1000,103,691,506,0,8,1,494,0,0,897,309,3,988,0,0,1
52696,6950,2020-11-18T16:16:30.8805761Z,2017,1182,135,840,602,0,12,1,580,0,0,1047,342,2,1168,0,1,0
52696,6951,2020-11-18T16:16:30.8805761Z,2018,1311,182,926,668,0,17,2,643,0,0,1129,385,2,1291,2,1,1
52696,6952,2020-11-18T16:16:30.8805761Z,2019,1340,219,971,688,0,19,4,652,0,0,1121,369,0,1321,1,0,0
52696,6953,2020-11-18T16:16:30.881577Z,2020,1368,311,1008,728,0,12,12,640,0,0,1057,360,0,1356,0,0,0
13391,1007,2020-11-18T16:15:52.4809687Z,2012,600,96,461,306,0,0,0,294,0,0,504,139,0,600,0,0,0
13391,1008,2020-11-18T16:15:52.48197Z,2013,568,106,455,296,0,1,0,272,0,0,462,113,0,567,0,8,0
13391,1009,2020-11-18T16:15:52.48197Z,2014,486,106,381,266,0,0,0,220,0,0,380,105,0,486,0,4,0
13391,1010,2020-11-18T16:15:52.48197Z,2015,508,117,405,268,0,0,0,240,0,0,391,103,0,508,0,3,0
13391,1011,2020-11-18T16:15:52.48197Z,2016,420,87,340,220,0,0,1,200,0,0,333,80,0,420,0,2,0
13391,1012,2020-11-18T16:15:52.48197Z,2017,346,78,283,181,0,0,3,165,0,0,268,63,0,346,0,4,0
13391,1013,2020-11-18T16:15:52.4829705Z,2018,365,80,286,177,0,0,3,188,0,0,285,79,0,365,2,0,0
13391,1014,2020-11-18T16:15:52.4829705Z,2019,340,73,264,168,2,0,7,172,0,0,267,76,0,340,2,0,0
13391,1015,2020-11-18T16:15:52.4829705Z,2020,346,70,268,172,0,6,9,174,0,0,276,78,0,340,3,0,0
13391,25869,2021-06-24T05:35:11.004708Z,2021,283,61,226,137,0,7,4,146,0,0,222,57,0,276,3,0,0
70409,25648,2021-06-24T05:35:04.7001873Z,2021,314,87,251,155,0,5,0,159,0,0,227,63,0,306,0,0,3
70409,9641,2020-11-18T16:16:49.7241398Z,2012,328,100,243,170,0,9,0,158,0,0,228,85,0,319,0,0,0
70409,9642,2020-11-18T16:16:49.7241398Z,2013,278,85,212,148,0,7,0,130,0,0,193,66,0,271,0,1,0
70409,9643,2020-11-18T16:16:49.7241398Z,2014,265,79,202,138,0,7,0,127,0,0,186,63,0,258,0,1,0
70409,9644,2020-11-18T16:16:49.7251402Z,2015,277,91,211,137,0,5,0,140,0,0,186,66,1,271,0,0,0
70409,9645,2020-11-18T16:16:49.7251402Z,2016,235,74,84,118,0,2,1,117,0,0,161,151,2,231,0,0,0
70409,9646,2020-11-18T16:16:49.7251402Z,2017,230,78,190,122,0,1,1,108,0,0,152,40,1,228,0,2,0
70409,9647,2020-11-18T16:16:49.7251402Z,2018,340,104,251,176,0,8,1,164,0,0,236,89,1,331,2,2,0
70409,9648,2020-11-18T16:16:49.7251402Z,2019,373,118,272,183,0,4,2,190,0,0,255,101,0,369,0,0,0
70409,9649,2020-11-18T16:16:49.7251402Z,2020,336,104,256,166,0,4,3,170,0,0,232,80,0,331,0,0,1
33274,31783,2021-06-24T05:35:16.8609077Z,2021,340,65,293,189,0,7,6,151,0,0,275,47,0,332,0,0,1
33274,4049,2020-11-18T16:16:10.2968519Z,2012,642,96,467,319,0,22,0,323,0,0,546,175,0,614,0,0,6
33274,4050,2020-11-18T16:16:10.2978515Z,2013,601,100,442,307,0,20,0,294,0,0,501,159,0,572,0,15,9
33274,4051,2020-11-18T16:16:10.2978515Z,2014,609,96,444,296,0,17,0,313,0,0,513,165,0,587,0,7,5
33274,4052,2020-11-18T16:16:10.2978515Z,2015,628,120,480,301,0,10,0,327,0,0,508,148,1,609,0,6,8
33274,4053,2020-11-18T16:16:10.2988533Z,2016,626,116,438,314,0,9,5,312,0,0,510,188,1,609,0,5,7
33274,4054,2020-11-18T16:16:10.2988533Z,2017,452,81,353,245,0,10,0,207,0,0,371,99,0,439,0,8,3
33274,4055,2020-11-18T16:16:10.2988533Z,2018,434,77,344,231,0,9,0,203,0,0,357,90,0,423,1,3,2
33274,4056,2020-11-18T16:16:10.2998533Z,2019,360,63,292,191,0,9,0,169,0,1,297,68,0,351,1,0,0
33274,4057,2020-11-18T16:16:10.2998533Z,2020,345,61,283,190,0,7,0,155,0,0,284,62,0,336,0,0,2
67785,31989,2021-06-24T05:35:20.3163843Z,2021,231,60,210,105,0,6,7,126,0,0,171,21,2,220,0,0,3
67785,9240,2020-11-18T16:16:46.6981246Z,2012,311,91,280,153,0,11,0,158,0,0,220,31,0,300,0,0,0
67785,9241,2020-11-18T16:16:46.6981246Z,2013,298,95,286,146,0,14,0,152,0,0,203,12,0,284,0,0,0
67785,9242,2020-11-18T16:16:46.6981246Z,2014,253,86,237,121,0,8,0,132,0,0,167,16,1,244,0,0,0
67785,9243,2020-11-18T16:16:46.6981246Z,2015,241,97,200,121,0,13,0,120,0,0,144,41,1,227,0,1,0
67785,9244,2020-11-18T16:16:46.6991264Z,2016,202,82,175,94,0,10,4,108,0,0,120,27,0,192,0,1,0
67785,9245,2020-11-18T16:16:46.6991264Z,2017,217,79,208,112,0,5,0,105,0,0,138,9,0,211,0,1,1
67785,9246,2020-11-18T16:16:46.6991264Z,2018,216,58,212,106,0,10,0,110,0,0,158,4,0,206,0,0,0
67785,9247,2020-11-18T16:16:46.6991264Z,2019,297,86,289,144,1,9,1,153,0,0,211,8,0,286,0,0,2
67785,9248,2020-11-18T16:16:46.7001246Z,2020,259,63,252,115,0,10,9,144,0,0,196,7,0,247,0,0,2
67934,25988,2021-06-24T05:35:14.5052185Z,2021,277,101,264,130,0,11,0,147,0,0,176,13,0,265,0,0,1
67934,9249,2020-11-18T16:16:46.7041273Z,2012,429,68,361,211,0,17,0,218,0,0,361,68,0,412,0,0,0
67934,9250,2020-11-18T16:16:46.7041273Z,2013,412,87,373,203,0,15,0,209,0,0,325,39,2,395,0,1,0
67934,9251,2020-11-18T16:16:46.7051286Z,2014,425,109,376,209,0,16,0,216,0,0,316,49,2,407,0,1,0
67934,9252,2020-11-18T16:16:46.7051286Z,2015,471,136,438,218,0,11,0,253,0,0,335,33,2,458,0,0,0
67934,9253,2020-11-18T16:16:46.7051286Z,2016,372,144,89,161,0,6,3,211,0,0,228,283,0,366,0,0,0
67934,9254,2020-11-18T16:16:46.7061291Z,2017,338,119,168,141,0,9,3,197,0,0,219,170,0,329,0,0,0
67934,9255,2020-11-18T16:16:46.7061291Z,2018,346,93,252,159,0,14,3,187,0,0,253,94,1,331,0,0,0
67934,9256,2020-11-18T16:16:46.7061291Z,2019,377,104,307,180,0,14,1,197,0,0,273,70,1,361,0,2,1
67934,9257,2020-11-18T16:16:46.7061291Z,2020,302,105,256,151,0,11,2,151,0,0,197,46,0,290,0,0,1
67942,31990,2021-06-24T05:35:20.3173848Z,2021,248,66,221,126,0,10,0,122,0,0,182,27,0,238,0,0,0
67942,9258,2020-11-18T16:16:46.7041273Z,2012,350,1,309,197,0,6,0,153,0,0,349,41,1,343,0,0,0
67942,9259,2020-11-18T16:16:46.7041273Z,2013,271,0,226,155,0,5,0,116,0,0,271,45,1,265,0,0,0
67942,9260,2020-11-18T16:16:46.7051286Z,2014,352,26,297,192,0,14,0,160,0,0,326,55,0,338,0,0,0
67942,9261,2020-11-18T16:16:46.7051286Z,2015,332,22,273,183,0,13,0,149,0,0,310,59,0,319,0,1,0
67942,9262,2020-11-18T16:16:46.7051286Z,2016,460,68,267,253,0,21,2,207,0,0,392,193,2,437,0,0,0
67942,9263,2020-11-18T16:16:46.7051286Z,2017,428,67,343,241,0,18,3,187,0,0,361,85,2,407,0,1,1
67942,9264,2020-11-18T16:16:46.7061291Z,2018,493,73,417,266,0,18,6,227,0,0,420,76,2,471,0,0,2
67942,9265,2020-11-18T16:16:46.7061291Z,2019,317,55,278,165,0,9,14,152,0,0,262,39,1,307,0,0,0
67942,9266,2020-11-18T16:16:46.7061291Z,2020,320,71,281,160,0,7,1,160,0,0,249,39,1,312,0,0,0
56069,25916,2021-06-24T05:35:12.8110034Z,2021,261,101,233,120,0,0,2,141,0,0,160,28,1,260,2,0,0
56069,7532,2020-11-18T16:16:34.5240043Z,2012,401,0,320,202,0,3,0,199,0,0,401,81,0,398,0,0,0
56069,7533,2020-11-18T16:16:34.5240043Z,2013,381,0,297,193,0,2,0,188,0,0,381,84,0,379,0,0,0
56069,7534,2020-11-18T16:16:34.5240043Z,2014,296,14,236,149,0,2,0,147,0,0,282,60,0,294,0,0,0
56069,7535,2020-11-18T16:16:34.5250065Z,2015,243,20,198,122,0,0,0,121,0,0,223,45,0,242,0,1,1
56069,7536,2020-11-18T16:16:34.5250065Z,2016,364,73,323,180,0,0,3,184,0,0,291,41,0,364,0,1,0
56069,7537,2020-11-18T16:16:34.5250065Z,2017,370,86,324,182,0,1,2,188,0,0,284,46,0,369,0,1,0
56069,7538,2020-11-18T16:16:34.5260048Z,2018,345,78,306,159,0,5,1,186,0,0,267,39,0,340,1,1,0
56069,7539,2020-11-18T16:16:34.5260048Z,2019,323,83,276,143,0,3,2,180,0,0,240,47,1,319,3,1,0
56069,7540,2020-11-18T16:16:34.5260048Z,2020,275,120,231,118,0,1,11,157,0,0,155,44,1,273,4,1,0
75630,10766,2020-11-18T16:16:56.897925Z,2012,270,127,220,134,0,2,0,136,0,0,143,50,0,267,0,0,1
75630,10767,2020-11-18T16:16:56.897925Z,2013,238,114,201,122,0,3,0,116,0,0,124,37,0,235,0,2,0
75630,10768,2020-11-18T16:16:56.897925Z,2014,250,117,221,122,0,3,0,128,0,0,133,29,0,247,0,0,0
75630,10769,2020-11-18T16:16:56.8989254Z,2015,264,124,235,131,0,1,0,133,0,0,140,29,0,263,0,0,0
75630,10770,2020-11-18T16:16:56.8989254Z,2016,231,99,23,110,0,2,4,121,0,0,132,208,0,229,0,0,0
75630,10771,2020-11-18T16:16:56.8989254Z,2017,193,86,162,90,0,2,3,103,0,0,107,31,0,191,0,0,0
75630,10772,2020-11-18T16:16:56.8989254Z,2018,205,91,163,94,0,5,4,111,0,0,114,42,0,199,2,0,1
75630,10773,2020-11-18T16:16:56.8989254Z,2019,230,96,190,113,0,5,8,117,0,0,134,40,0,224,2,3,1
75630,10774,2020-11-18T16:16:56.8999254Z,2020,165,72,139,87,0,4,1,78,0,0,93,26,0,161,0,1,0
75630,31995,2021-06-24T05:35:20.3173848Z,2021,158,64,129,83,0,4,1,75,0,0,94,29,0,153,0,1,1
45393,25847,2021-06-24T05:35:10.9686813Z,2021,574,209,470,285,0,3,22,289,0,0,365,104,0,570,0,0,1
45393,5788,2020-11-18T16:16:22.121734Z,2012,492,81,384,242,0,0,0,250,0,0,411,108,0,492,0,0,0
45393,5789,2020-11-18T16:16:22.121734Z,2013,506,144,399,247,0,2,0,259,0,0,362,107,0,504,0,7,0
45393,5790,2020-11-18T16:16:22.1227345Z,2014,436,156,350,203,0,3,0,233,0,0,280,86,1,431,0,6,1
45393,5791,2020-11-18T16:16:22.1227345Z,2015,418,129,337,179,0,6,0,239,0,0,289,81,2,410,0,7,0
45393,5792,2020-11-18T16:16:22.1227345Z,2016,331,147,223,140,0,2,2,191,0,0,184,108,1,327,0,4,1
45393,5793,2020-11-18T16:16:22.1237353Z,2017,406,166,306,178,0,5,0,228,0,0,240,100,1,400,0,4,0
45393,5794,2020-11-18T16:16:22.1237353Z,2018,388,139,298,189,0,4,7,199,0,0,249,90,1,383,0,5,0
45393,5795,2020-11-18T16:16:22.1237353Z,2019,719,267,533,334,0,6,0,385,0,0,452,186,0,712,0,3,1
45393,5796,2020-11-18T16:16:22.1247367Z,2020,641,232,507,304,0,5,0,337,0,0,409,134,0,634,0,0,2
27565,3056,2020-11-18T16:16:04.7661625Z,2012,386,0,208,177,0,2,0,209,0,0,386,178,0,384,0,0,0
27565,3057,2020-11-18T16:16:04.7671634Z,2013,337,1,189,160,0,1,0,177,0,0,336,148,0,336,0,3,0
27565,3058,2020-11-18T16:16:04.7671634Z,2014,337,16,187,161,0,6,0,176,0,0,321,150,1,330,0,4,0
27565,3059,2020-11-18T16:16:04.7671634Z,2015,345,15,208,177,0,4,0,168,0,0,330,137,1,339,0,3,1
27565,3060,2020-11-18T16:16:04.7671634Z,2016,465,76,166,228,0,2,1,237,0,0,389,299,0,462,0,3,1
27565,3061,2020-11-18T16:16:04.7671634Z,2017,406,62,247,191,0,2,0,215,0,0,344,159,0,404,0,3,0
27565,3062,2020-11-18T16:16:04.7681639Z,2018,422,54,222,212,0,0,0,210,0,0,368,200,0,422,0,2,0
27565,3063,2020-11-18T16:16:04.7681639Z,2019,380,51,211,188,0,2,1,192,0,0,329,169,0,377,0,2,1
27565,3064,2020-11-18T16:16:04.7681639Z,2020,371,90,224,184,0,3,5,187,0,0,281,147,0,367,0,2,1
27565,31736,2021-06-24T05:35:15.4068648Z,2021,311,79,209,152,0,1,5,159,0,0,232,102,0,310,0,1,0
30429,31759,2021-06-24T05:35:16.8298843Z,2021,117,32,104,56,0,1,0,61,0,0,85,13,0,115,0,0,1
30429,3340,2020-11-18T16:16:06.3612231Z,2012,172,26,136,91,0,0,0,81,0,0,146,36,0,172,0,0,0
30429,3341,2020-11-18T16:16:06.3612231Z,2013,167,28,147,88,0,0,0,79,0,0,139,20,0,167,0,0,0
30429,3342,2020-11-18T16:16:06.362224Z,2014,158,22,128,86,0,0,0,72,0,0,136,30,0,158,0,0,0
30429,3343,2020-11-18T16:16:06.362224Z,2015,169,36,134,88,0,0,0,81,0,0,133,35,0,169,0,0,0
30429,3344,2020-11-18T16:16:06.362224Z,2016,149,34,113,75,0,0,0,74,0,0,115,36,0,149,0,0,0
30429,3345,2020-11-18T16:16:06.3632285Z,2017,142,40,113,69,0,0,0,73,0,0,102,29,0,142,0,0,0
30429,3346,2020-11-18T16:16:06.3632285Z,2018,183,46,146,89,0,0,0,94,0,0,137,37,0,183,2,0,0
30429,3347,2020-11-18T16:16:06.3632285Z,2019,161,49,135,84,0,0,0,77,0,0,112,26,0,161,2,0,0
30429,3348,2020-11-18T16:16:06.3642249Z,2020,158,46,138,86,0,1,0,72,0,0,112,20,0,157,2,0,0
41632,31827,2021-06-24T05:35:16.9299565Z,2021,87,30,81,45,0,0,0,42,0,0,57,6,0,87,0,0,0
41632,5029,2020-11-18T16:16:17.0963835Z,2012,125,44,118,52,0,4,0,73,0,0,81,7,0,120,0,0,1
41632,5030,2020-11-18T16:16:17.0963835Z,2013,111,40,99,40,0,4,0,71,0,0,71,12,0,106,0,0,1
41632,5031,2020-11-18T16:16:17.0973843Z,2014,107,39,97,42,0,1,0,65,0,0,68,10,0,105,0,0,1
41632,5032,2020-11-18T16:16:17.0973843Z,2015,94,31,88,37,0,1,0,57,0,0,63,6,0,92,0,0,1
41632,5033,2020-11-18T16:16:17.0973843Z,2016,97,33,89,34,0,1,0,63,0,0,64,8,0,95,0,0,1
41632,5034,2020-11-18T16:16:17.0973843Z,2017,84,28,79,28,0,1,0,56,0,0,56,5,0,81,0,0,2
41632,5035,2020-11-18T16:16:17.0973843Z,2018,71,20,61,26,0,1,1,45,0,0,51,10,0,69,0,0,1
41632,5036,2020-11-18T16:16:17.0973843Z,2019,84,35,77,37,0,0,0,47,0,0,49,7,0,84,0,0,0
41632,5037,2020-11-18T16:16:17.0983852Z,2020,89,33,81,43,0,0,0,46,0,0,56,8,0,89,0,0,0
70078,31643,2021-06-24T05:35:14.6553244Z,2021,545,147,388,299,0,8,0,246,0,0,398,157,0,535,4,2,2
70078,9438,2020-11-18T16:16:48.5063323Z,2012,291,70,218,144,0,6,0,147,0,0,221,73,0,284,0,0,1
70078,9439,2020-11-18T16:16:48.5063323Z,2013,274,94,204,137,0,7,0,137,0,0,180,70,0,266,0,1,1
70078,9440,2020-11-18T16:16:48.5073318Z,2014,349,118,262,188,0,5,0,161,0,0,231,87,2,342,0,2,0
70078,9441,2020-11-18T16:16:48.5073318Z,2015,536,124,389,281,0,15,0,255,0,0,412,147,1,519,0,3,1
70078,9442,2020-11-18T16:16:48.5073318Z,2016,532,135,366,294,0,14,1,238,0,0,397,166,1,515,0,3,2
70078,9443,2020-11-18T16:16:48.5073318Z,2017,557,134,468,315,0,10,2,242,0,0,423,89,1,544,0,1,2
70078,9444,2020-11-18T16:16:48.5083323Z,2018,556,108,405,311,0,9,5,245,0,0,448,151,1,544,1,1,2
70078,9445,2020-11-18T16:16:48.5083323Z,2019,560,130,405,301,0,9,0,259,0,0,430,155,1,548,4,1,2
70078,9446,2020-11-18T16:16:48.5083323Z,2020,544,138,414,302,0,11,0,242,0,0,406,130,0,531,4,1,2
33936,25785,2021-06-24T05:35:10.865608Z,2021,346,95,313,160,0,13,1,186,0,0,251,33,2,327,0,1,4
33936,4128,2020-11-18T16:16:11.0223368Z,2012,559,103,426,281,0,3,0,278,0,0,456,133,1,554,0,0,1
33936,4129,2020-11-18T16:16:11.0223368Z,2013,528,104,362,255,0,1,0,273,0,0,424,166,0,527,0,6,0
33936,4130,2020-11-18T16:16:11.0233363Z,2014,451,98,314,220,0,3,0,231,0,0,353,137,0,448,0,5,0
33936,4131,2020-11-18T16:16:11.0233363Z,2015,427,67,297,210,0,6,0,217,0,0,360,130,0,417,0,10,4
33936,4132,2020-11-18T16:16:11.0233363Z,2016,388,57,273,196,0,3,0,192,0,0,331,115,0,381,0,5,4
33936,4133,2020-11-18T16:16:11.0233363Z,2017,402,82,313,200,0,11,0,202,0,0,320,89,0,390,0,3,1
33936,4134,2020-11-18T16:16:11.0233363Z,2018,409,79,322,195,0,9,0,214,0,0,330,87,0,397,0,1,3
33936,4135,2020-11-18T16:16:11.0243372Z,2019,433,132,326,205,0,12,0,228,0,0,301,107,1,412,0,2,8
33936,4136,2020-11-18T16:16:11.0243372Z,2020,365,108,317,174,0,13,0,191,0,0,257,48,0,346,0,1,6
30304,25757,2021-06-24T05:35:08.7260734Z,2021,262,56,243,135,0,2,0,127,0,0,206,19,0,260,0,0,0
30304,3314,2020-11-18T16:16:06.3542183Z,2012,360,63,258,178,0,3,0,182,0,0,297,102,0,357,0,0,0
30304,3315,2020-11-18T16:16:06.3542183Z,2013,350,72,263,164,0,4,0,186,0,0,278,87,0,346,0,2,0
30304,3316,2020-11-18T16:16:06.3552187Z,2014,329,66,245,157,0,6,0,172,0,0,263,84,0,323,0,6,0
30304,3317,2020-11-18T16:16:06.3552187Z,2015,346,80,263,159,0,5,0,187,0,0,266,83,0,341,0,2,0
30304,3318,2020-11-18T16:16:06.3552187Z,2016,320,74,186,151,0,3,0,169,0,0,246,134,0,317,0,0,0
30304,3319,2020-11-18T16:16:06.3562196Z,2017,356,87,270,165,0,5,0,191,0,0,269,86,0,351,0,0,0
30304,3320,2020-11-18T16:16:06.3562196Z,2018,406,94,292,201,0,3,6,205,0,0,312,114,0,403,2,0,0
30304,3321,2020-11-18T16:16:06.3562196Z,2019,265,68,216,126,0,1,1,139,0,0,197,49,0,264,2,0,0
30304,3322,2020-11-18T16:16:06.3572205Z,2020,242,65,205,124,0,1,0,118,0,0,177,37,0,241,2,0,0
52183,31893,2021-06-24T05:35:18.4650573Z,2021,126,43,109,63,0,3,0,63,0,0,83,17,0,123,0,0,0
52183,6744,2020-11-18T16:16:28.8962512Z,2012,207,65,177,101,0,1,0,106,0,0,142,30,0,206,0,0,0
52183,6745,2020-11-18T16:16:28.8972521Z,2013,198,59,171,97,0,1,0,101,0,0,139,27,0,197,0,4,0
52183,6746,2020-11-18T16:16:28.8972521Z,2014,203,66,169,99,0,1,0,104,0,0,137,34,0,202,0,2,0
52183,6747,2020-11-18T16:16:28.8972521Z,2015,192,62,159,93,0,0,0,99,0,0,130,33,0,192,0,0,0
52183,6748,2020-11-18T16:16:28.8972521Z,2016,164,58,142,70,0,0,0,94,0,0,106,22,0,164,0,0,0
52183,6749,2020-11-18T16:16:28.8982525Z,2017,143,41,110,67,0,0,0,76,0,0,102,33,0,143,0,0,0
52183,6750,2020-11-18T16:16:28.8982525Z,2018,158,48,116,73,0,2,0,85,0,2,110,42,0,156,1,0,0
52183,6751,2020-11-18T16:16:28.8982525Z,2019,160,60,130,71,0,2,0,89,0,0,100,30,0,157,0,0,1
52183,6752,2020-11-18T16:16:28.8992525Z,2020,133,47,110,63,0,3,0,70,0,0,86,23,0,130,0,0,0
70433,31651,2021-06-24T05:35:14.6843463Z,2021,367,144,315,178,0,9,2,189,0,0,223,52,0,355,0,1,3
70433,9668,2020-11-18T16:16:49.7261402Z,2012,295,115,252,140,0,8,0,155,0,0,180,43,0,287,0,0,0
70433,9669,2020-11-18T16:16:49.7261402Z,2013,330,128,274,163,0,7,0,167,0,0,202,56,1,322,0,5,0
70433,9670,2020-11-18T16:16:49.7271411Z,2014,340,130,257,164,0,12,0,176,0,0,210,83,0,328,0,3,0
70433,9671,2020-11-18T16:16:49.7271411Z,2015,310,117,259,146,0,15,0,164,0,0,193,51,0,294,0,3,1
70433,9672,2020-11-18T16:16:49.7271411Z,2016,286,99,211,127,0,12,2,159,0,0,187,75,0,274,0,3,0
70433,9673,2020-11-18T16:16:49.7271411Z,2017,260,100,217,117,0,16,2,143,0,0,160,43,0,243,0,1,1
70433,9674,2020-11-18T16:16:49.7271411Z,2018,302,104,247,142,0,7,2,160,0,0,198,55,1,294,0,0,0
70433,9675,2020-11-18T16:16:49.728142Z,2019,345,132,285,173,0,4,2,172,0,0,213,60,0,339,0,0,2
70433,9676,2020-11-18T16:16:49.728142Z,2020,381,149,311,184,0,7,0,197,0,0,232,70,0,372,0,0,2
33662,25784,2021-06-24T05:35:10.8616056Z,2021,302,116,262,129,0,6,4,173,0,0,186,40,0,296,1,1,0
33662,4103,2020-11-18T16:16:11.0113288Z,2012,502,49,360,244,0,9,0,258,0,0,453,142,1,490,0,0,2
33662,4104,2020-11-18T16:16:11.0113288Z,2013,459,74,351,234,0,9,0,225,0,0,385,108,1,448,0,2,1
33662,4105,2020-11-18T16:16:11.0123292Z,2014,492,107,409,263,0,12,0,229,0,0,385,83,0,478,0,3,2
33662,4106,2020-11-18T16:16:11.0123292Z,2015,462,110,372,238,0,10,0,224,0,0,352,90,0,451,0,1,1
33662,4107,2020-11-18T16:16:11.0123292Z,2016,463,137,386,219,0,11,1,244,0,0,326,77,0,452,0,1,0
33662,4108,2020-11-18T16:16:11.0123292Z,2017,263,88,231,125,0,9,2,138,0,0,175,32,0,254,0,1,0
33662,4109,2020-11-18T16:16:11.0123292Z,2018,247,89,216,119,0,11,2,128,0,0,158,31,0,236,4,2,0
33662,4110,2020-11-18T16:16:11.0133292Z,2019,330,125,292,152,0,5,2,178,0,0,205,38,0,325,2,3,0
33662,4111,2020-11-18T16:16:11.0133292Z,2020,297,130,260,126,0,7,0,171,0,0,167,37,0,290,0,2,0
30791,31762,2021-06-24T05:35:16.8338881Z,2021,217,42,171,102,0,4,0,115,0,0,175,46,0,211,2,0,2
30791,3455,2020-11-18T16:16:07.0256661Z,2012,327,69,261,156,0,11,0,171,0,0,258,66,0,316,0,0,0
30791,3456,2020-11-18T16:16:07.0256661Z,2013,328,74,256,160,0,11,0,168,0,0,254,72,0,317,0,2,0
30791,3457,2020-11-18T16:16:07.0256661Z,2014,332,79,270,163,0,11,0,169,0,0,253,62,0,320,0,2,1
30791,3458,2020-11-18T16:16:07.0266661Z,2015,327,85,258,174,0,9,0,153,0,0,242,69,0,318,0,3,0
30791,3459,2020-11-18T16:16:07.0266661Z,2016,261,71,211,136,0,10,0,125,0,0,190,50,0,251,0,1,0
30791,3460,2020-11-18T16:16:07.0266661Z,2017,240,67,186,124,0,12,0,116,0,0,173,54,0,228,0,2,0
30791,3461,2020-11-18T16:16:07.0266661Z,2018,310,70,237,151,0,10,0,159,0,0,240,73,0,300,3,0,0
30791,3462,2020-11-18T16:16:07.0266661Z,2019,288,69,198,139,0,6,0,149,0,0,219,90,0,282,3,0,0
30791,3463,2020-11-18T16:16:07.027667Z,2020,274,59,227,133,0,2,0,141,0,0,215,47,0,272,3,0,0
71662,10406,2020-11-18T16:16:54.7104633Z,2012,286,87,248,149,0,3,0,137,0,0,199,38,0,283,0,0,0
71662,10407,2020-11-18T16:16:54.7104633Z,2013,310,101,262,159,0,3,0,151,0,0,209,48,0,307,0,20,0
71662,10408,2020-11-18T16:16:54.7104633Z,2014,279,97,236,141,0,4,0,138,0,0,182,43,0,275,0,15,0
71662,10409,2020-11-18T16:16:54.7104633Z,2015,303,98,252,148,0,2,0,155,0,0,205,51,0,301,0,9,0
71662,10410,2020-11-18T16:16:54.7104633Z,2016,229,71,192,112,0,6,0,117,0,0,158,37,0,223,0,3,0
71662,10411,2020-11-18T16:16:54.7114637Z,2017,227,81,179,111,0,4,0,116,0,0,146,48,0,223,0,3,0
71662,10412,2020-11-18T16:16:54.7114637Z,2018,227,90,170,110,0,10,0,117,0,0,137,57,0,217,0,1,0
71662,10413,2020-11-18T16:16:54.7114637Z,2019,298,117,240,137,0,13,0,161,0,0,181,58,2,282,0,0,1
71662,10414,2020-11-18T16:16:54.7114637Z,2020,285,95,227,134,0,7,0,151,0,0,190,58,0,278,0,0,0
71662,25675,2021-06-24T05:35:04.7442189Z,2021,258,82,213,115,0,3,0,143,0,0,176,45,0,255,0,2,0
56119,31920,2021-06-24T05:35:18.4920769Z,2021,373,82,286,178,0,11,3,195,0,0,291,87,0,362,0,1,0
56119,7577,2020-11-18T16:16:34.5540239Z,2012,595,0,400,290,0,0,0,305,0,0,595,195,0,595,0,0,0
56119,7578,2020-11-18T16:16:34.5540239Z,2013,578,0,365,278,0,1,0,300,0,0,578,213,1,576,0,1,0
56119,7579,2020-11-18T16:16:34.5540239Z,2014,569,23,380,296,0,3,0,273,0,0,546,189,0,565,0,1,1
56119,7580,2020-11-18T16:16:34.5550248Z,2015,539,33,362,299,0,4,0,240,0,0,506,177,1,531,0,0,3
56119,7581,2020-11-18T16:16:34.5550248Z,2016,486,52,320,280,0,3,1,206,0,0,434,166,3,477,0,0,3
56119,7582,2020-11-18T16:16:34.5550248Z,2017,457,37,310,254,0,7,1,203,0,0,420,147,4,443,0,1,3
56119,7583,2020-11-18T16:16:34.5560253Z,2018,387,29,262,224,0,9,26,163,0,0,358,125,3,374,1,0,1
56119,7584,2020-11-18T16:16:34.5560253Z,2019,392,55,266,212,0,9,1,180,0,0,337,126,0,382,0,0,1
56119,7585,2020-11-18T16:16:34.5560253Z,2020,397,83,279,195,0,8,0,202,0,0,314,118,0,388,0,1,1
30841,25761,2021-06-24T05:35:08.7330791Z,2021,340,150,278,153,0,3,3,187,0,0,190,62,0,336,0,0,1
30841,3471,2020-11-18T16:16:07.0606897Z,2012,489,212,377,215,0,4,0,274,0,0,277,112,1,484,0,0,0
30841,3472,2020-11-18T16:16:07.0616906Z,2013,474,210,421,214,0,1,0,260,0,0,264,53,0,473,0,0,0
30841,3473,2020-11-18T16:16:07.0616906Z,2014,422,176,321,204,0,4,0,218,0,0,246,101,0,418,0,1,0
30841,3474,2020-11-18T16:16:07.0626906Z,2015,403,150,326,193,0,5,0,210,0,0,253,77,0,398,0,1,0
30841,3475,2020-11-18T16:16:07.0626906Z,2016,405,159,157,187,0,4,0,218,0,0,246,248,0,401,0,0,0
30841,3476,2020-11-18T16:16:07.0626906Z,2017,277,118,248,124,0,6,0,153,0,0,159,29,0,271,0,0,0
30841,3477,2020-11-18T16:16:07.0626906Z,2018,288,122,241,126,0,5,0,162,0,0,166,47,0,283,1,0,0
30841,3478,2020-11-18T16:16:07.0626906Z,2019,377,170,320,154,0,4,2,223,0,0,207,57,0,371,0,0,2
30841,3479,2020-11-18T16:16:07.0636919Z,2020,363,163,317,155,0,2,4,208,0,0,200,46,0,360,0,0,1
24687,2654,2020-11-18T16:16:02.5206634Z,2019,385,79,240,198,0,0,0,187,0,2,306,145,0,383,0,2,2
24687,2655,2020-11-18T16:16:02.5206634Z,2020,406,75,243,215,0,7,2,191,0,0,331,163,0,397,0,3,2
24687,31722,2021-06-24T05:35:15.3828463Z,2021,416,75,321,218,0,4,0,198,0,0,341,95,0,410,0,3,2
47613,31860,2021-06-24T05:35:18.4250299Z,2021,315,136,292,145,0,0,2,170,0,0,179,23,0,314,0,0,1
47613,6014,2020-11-18T16:16:23.9709664Z,2012,251,105,230,114,0,18,0,137,0,0,146,21,0,233,0,0,0
47613,6015,2020-11-18T16:16:23.9709664Z,2013,302,119,267,141,0,17,0,161,0,0,183,35,0,285,0,2,0
47613,6016,2020-11-18T16:16:23.9719673Z,2014,334,144,227,158,0,21,0,176,0,0,190,107,2,311,0,4,0
47613,6017,2020-11-18T16:16:23.9719673Z,2015,349,142,303,165,0,16,0,184,0,0,207,46,2,331,0,2,0
47613,6018,2020-11-18T16:16:23.9719673Z,2016,365,148,305,171,0,20,3,194,0,0,217,60,2,343,0,2,0
47613,6019,2020-11-18T16:16:23.9719673Z,2017,321,135,282,156,0,17,2,165,0,0,186,39,1,303,0,1,0
47613,6020,2020-11-18T16:16:23.9719673Z,2018,324,125,285,158,0,13,40,166,0,0,199,39,1,310,0,1,0
47613,6021,2020-11-18T16:16:23.9729678Z,2019,410,181,366,208,0,4,5,202,0,0,229,44,0,406,0,1,0
47613,6022,2020-11-18T16:16:23.9729678Z,2020,370,163,322,173,0,2,5,197,0,0,207,48,0,367,0,1,1
20180,1627,2020-11-18T16:15:56.5716946Z,2012,665,148,520,325,0,1,0,340,0,0,517,145,0,664,0,0,0
20180,1628,2020-11-18T16:15:56.5716946Z,2013,627,156,510,299,0,0,0,328,0,0,471,117,0,627,0,2,0
20180,1629,2020-11-18T16:15:56.5716946Z,2014,569,157,471,271,0,2,0,298,0,0,412,98,1,566,0,1,0
20180,1630,2020-11-18T16:15:56.5716946Z,2015,540,155,439,261,0,0,0,279,0,0,385,101,1,539,0,2,0
20180,1631,2020-11-18T16:15:56.572696Z,2016,573,187,453,264,0,1,25,309,0,0,386,120,1,571,0,1,0
20180,1632,2020-11-18T16:15:56.572696Z,2017,485,162,391,232,0,2,10,253,0,0,323,94,1,482,0,1,0
20180,1633,2020-11-18T16:15:56.572696Z,2018,463,160,359,217,0,3,17,246,0,0,303,104,1,459,0,1,0
20180,1634,2020-11-18T16:15:56.572696Z,2019,513,174,396,247,0,4,13,266,0,0,339,117,2,507,0,1,0
20180,1635,2020-11-18T16:15:56.572696Z,2020,546,172,416,258,0,4,26,288,0,0,374,130,1,541,0,1,0
20180,31689,2021-06-24T05:35:15.2997869Z,2021,547,171,445,268,0,6,16,279,0,0,376,102,1,540,0,2,0
35964,31805,2021-06-24T05:35:16.8949307Z,2021,336,98,271,159,0,2,0,177,0,0,238,65,0,333,3,2,1
35964,4488,2020-11-18T16:16:12.5943804Z,2012,530,36,393,255,0,6,0,275,0,0,494,137,0,523,0,0,1
35964,4489,2020-11-18T16:16:12.5943804Z,2013,487,69,329,225,0,7,0,262,0,0,418,158,0,480,0,0,0
35964,4490,2020-11-18T16:16:12.59538Z,2014,469,93,328,218,0,9,0,251,0,0,376,141,0,460,0,0,0
35964,4491,2020-11-18T16:16:12.59538Z,2015,495,113,341,238,0,7,0,257,0,0,382,154,0,488,0,0,0
35964,4492,2020-11-18T16:16:12.5963822Z,2016,417,100,299,206,0,5,1,211,0,0,317,118,0,412,0,1,0
35964,4493,2020-11-18T16:16:12.5963822Z,2017,389,92,313,196,0,0,0,193,0,0,297,76,0,389,0,2,0
35964,4494,2020-11-18T16:16:12.5963822Z,2018,347,76,265,178,0,5,1,169,0,0,271,82,0,342,2,2,0
35964,4495,2020-11-18T16:16:12.5973813Z,2019,336,86,259,173,0,4,0,163,0,0,250,77,0,331,2,3,1
35964,4496,2020-11-18T16:16:12.5973813Z,2020,336,86,275,169,0,4,1,167,0,0,250,61,0,332,5,1,0
66225,25984,2021-06-24T05:35:14.5032153Z,2021,163,81,156,73,0,5,0,90,0,0,82,7,0,158,0,0,0
66225,9177,2020-11-18T16:16:45.5063278Z,2012,193,61,176,73,0,2,0,120,0,0,132,17,1,190,0,0,0
66225,9178,2020-11-18T16:16:45.5073287Z,2013,194,77,149,69,0,5,0,125,0,0,117,45,2,187,0,1,0
66225,9179,2020-11-18T16:16:45.5073287Z,2014,184,91,138,57,0,5,0,127,0,0,93,46,1,178,0,2,0
66225,9180,2020-11-18T16:16:45.5073287Z,2015,208,93,135,59,0,5,0,149,0,0,115,73,1,202,0,0,0
66225,9181,2020-11-18T16:16:45.5073287Z,2016,135,65,88,43,0,6,0,92,0,0,70,47,0,129,0,0,0
66225,9182,2020-11-18T16:16:45.5083292Z,2017,219,125,199,76,0,7,0,143,0,0,94,20,1,211,0,0,0
66225,9183,2020-11-18T16:16:45.5083292Z,2018,219,115,199,80,0,7,0,139,0,0,104,20,0,212,0,0,0
66225,9184,2020-11-18T16:16:45.5083292Z,2019,241,131,227,101,0,7,0,140,0,0,110,14,0,234,0,0,0
66225,9185,2020-11-18T16:16:45.5083292Z,2020,209,121,198,88,0,6,0,121,0,0,88,11,0,203,0,0,0
70540,25653,2021-06-24T05:35:04.7011878Z,2021,324,145,286,153,0,7,1,171,0,0,179,38,0,317,0,0,0
70540,9756,2020-11-18T16:16:50.4756411Z,2012,383,157,263,192,0,3,0,191,0,0,226,120,0,379,0,0,1
70540,9757,2020-11-18T16:16:50.4756411Z,2013,361,154,243,171,0,4,0,190,0,0,207,118,1,355,0,1,1
70540,9758,2020-11-18T16:16:50.4756411Z,2014,346,142,229,157,0,5,0,189,0,0,204,117,1,340,0,0,0
70540,9759,2020-11-18T16:16:50.4756411Z,2015,384,140,221,177,0,13,0,207,0,0,244,163,1,370,0,0,0
70540,9760,2020-11-18T16:16:50.476642Z,2016,366,150,284,178,0,5,0,188,0,0,216,82,1,360,0,0,0
70540,9761,2020-11-18T16:16:50.476642Z,2017,319,144,251,149,0,9,0,170,0,0,175,68,0,310,0,9,0
70540,9762,2020-11-18T16:16:50.476642Z,2018,377,171,316,181,0,12,7,196,0,0,206,61,0,365,0,9,0
70540,9763,2020-11-18T16:16:50.476642Z,2019,361,177,301,170,0,9,3,191,0,0,184,60,0,352,0,5,0
70540,9764,2020-11-18T16:16:50.476642Z,2020,370,172,313,179,0,9,2,191,0,0,198,57,0,361,0,2,0
11411,31592,2021-06-24T05:35:14.5552531Z,2021,321,93,286,149,0,3,0,172,0,0,228,35,0,318,0,0,0
11411,397,2020-11-18T16:15:47.5977124Z,2012,257,78,201,136,0,0,0,121,0,0,179,56,1,255,0,0,1
11411,398,2020-11-18T16:15:47.5987142Z,2013,253,75,192,132,0,0,0,121,0,0,178,61,1,252,0,0,0
11411,399,2020-11-18T16:15:47.5987142Z,2014,240,77,183,113,0,0,0,127,0,0,163,57,1,239,0,0,0
11411,400,2020-11-18T16:15:47.5987142Z,2015,260,75,197,130,0,0,0,130,0,0,185,63,0,260,0,0,0
11411,401,2020-11-18T16:15:48.007987Z,2016,266,82,183,128,0,3,0,138,0,0,184,83,0,263,0,0,0
11411,402,2020-11-18T16:15:48.007987Z,2017,275,88,205,128,0,2,0,147,0,0,187,70,0,268,0,3,5
11411,403,2020-11-18T16:15:48.0089874Z,2018,267,76,210,126,0,0,14,141,0,1,191,57,0,262,2,0,5
11411,404,2020-11-18T16:15:48.0089874Z,2019,353,119,273,168,0,0,0,185,0,1,234,80,0,353,2,0,0
11411,405,2020-11-18T16:15:48.0089874Z,2020,356,106,287,165,0,3,0,191,0,0,250,69,0,353,2,0,0
30502,25758,2021-06-24T05:35:08.7270744Z,2021,195,67,166,92,0,1,0,103,0,0,128,29,0,194,2,0,0
30502,3361,2020-11-18T16:16:06.3722306Z,2012,229,56,184,124,0,8,0,105,0,0,173,45,0,221,0,0,0
30502,3362,2020-11-18T16:16:06.3732315Z,2013,238,63,198,118,0,7,0,120,0,0,175,40,0,231,0,1,0
30502,3363,2020-11-18T16:16:06.3732315Z,2014,221,57,190,115,0,8,0,106,0,0,164,31,0,213,0,0,0
30502,3364,2020-11-18T16:16:06.3732315Z,2015,218,60,185,120,0,9,0,98,0,0,158,33,0,209,0,0,0
30502,3365,2020-11-18T16:16:06.3742319Z,2016,222,57,191,119,0,9,1,103,0,0,165,31,0,213,0,0,0
30502,3366,2020-11-18T16:16:06.3742319Z,2017,221,63,197,107,0,6,1,114,0,0,158,24,0,215,0,0,0
30502,3367,2020-11-18T16:16:06.3742319Z,2018,222,61,189,108,0,7,0,114,0,0,161,33,0,215,1,0,0
30502,3368,2020-11-18T16:16:06.3752319Z,2019,220,65,187,102,0,5,0,118,0,0,155,33,0,215,2,0,0
30502,3369,2020-11-18T16:16:06.3752319Z,2020,185,55,157,85,0,3,3,100,0,0,130,28,0,182,2,0,0
57182,25923,2021-06-24T05:35:12.8170069Z,2021,211,83,180,101,0,9,0,110,0,0,128,31,0,202,0,1,0
57182,7667,2020-11-18T16:16:35.099388Z,2012,456,133,344,215,0,3,0,241,0,0,323,112,0,453,0,0,0
57182,7668,2020-11-18T16:16:35.099388Z,2013,393,131,294,182,0,0,0,211,0,0,262,99,0,393,0,0,0
57182,7669,2020-11-18T16:16:35.099388Z,2014,406,149,318,194,0,1,0,212,0,0,257,88,0,404,0,0,1
57182,7670,2020-11-18T16:16:35.099388Z,2015,401,148,320,181,0,1,0,220,0,0,253,81,0,400,0,1,0
57182,7671,2020-11-18T16:16:35.1003884Z,2016,341,125,212,155,0,3,4,186,0,0,216,129,0,338,0,0,0
57182,7672,2020-11-18T16:16:35.1003884Z,2017,336,130,292,152,0,2,0,184,0,0,206,44,0,334,0,0,0
57182,7673,2020-11-18T16:16:35.1003884Z,2018,294,121,228,141,0,1,0,153,0,0,173,66,0,293,0,0,0
57182,7674,2020-11-18T16:16:35.1003884Z,2019,331,138,221,164,0,12,5,167,0,0,193,110,0,319,1,1,0
57182,7675,2020-11-18T16:16:35.1013898Z,2020,299,119,239,141,0,12,16,158,0,0,180,60,0,287,0,1,0
32250,31773,2021-06-24T05:35:16.8549029Z,2021,333,92,274,134,0,5,1,199,0,0,241,59,0,328,0,2,0
32250,3807,2020-11-18T16:16:09.1720997Z,2012,292,21,257,140,0,1,0,152,0,0,271,35,0,291,0,0,0
32250,3808,2020-11-18T16:16:09.1720997Z,2013,271,41,233,125,0,0,0,146,0,0,230,38,0,271,0,1,0
32250,3809,2020-11-18T16:16:09.1720997Z,2014,309,66,273,145,0,1,0,164,0,0,243,36,0,307,0,1,1
32250,3810,2020-11-18T16:16:09.1720997Z,2015,298,61,266,142,0,5,0,156,0,0,237,32,0,292,0,4,1
32250,3811,2020-11-18T16:16:09.1720997Z,2016,280,63,229,144,0,4,0,136,0,0,217,51,0,276,0,3,0
32250,3812,2020-11-18T16:16:09.1731001Z,2017,290,65,260,150,0,4,1,140,0,0,225,30,1,285,0,2,0
32250,3813,2020-11-18T16:16:09.1731001Z,2018,295,66,260,145,0,9,1,150,0,0,229,35,1,285,0,1,0
32250,3814,2020-11-18T16:16:09.1731001Z,2019,546,101,472,255,0,12,2,291,0,0,445,74,1,533,0,2,0
32250,3815,2020-11-18T16:16:09.1731001Z,2020,420,99,366,179,0,7,1,241,0,0,321,54,0,413,0,2,0
25049,25750,2021-06-24T05:35:08.7080605Z,2021,285,95,238,134,0,13,0,151,0,0,190,47,0,271,0,1,1
25049,2798,2020-11-18T16:16:03.2781688Z,2012,352,105,235,167,0,1,0,185,0,0,247,117,0,351,0,0,0
25049,2799,2020-11-18T16:16:03.2791692Z,2013,326,104,272,151,0,1,0,175,0,0,222,54,0,325,0,0,0
25049,2800,2020-11-18T16:16:03.2791692Z,2014,372,119,312,171,0,5,0,201,0,0,253,60,0,367,0,0,0
25049,2801,2020-11-18T16:16:03.6744344Z,2015,345,115,303,160,0,7,0,185,0,0,230,42,0,338,0,2,0
25049,2802,2020-11-18T16:16:03.6744344Z,2016,288,109,175,125,0,5,9,163,0,0,179,113,0,283,0,2,0
25049,2803,2020-11-18T16:16:03.6754348Z,2017,245,92,208,112,0,6,12,133,0,0,153,37,0,239,0,2,0
25049,2804,2020-11-18T16:16:03.6754348Z,2018,309,97,257,141,0,9,0,168,0,0,212,52,0,299,0,0,1
25049,2805,2020-11-18T16:16:03.6754348Z,2019,329,122,291,160,0,11,8,169,0,0,207,38,0,317,0,3,1
25049,2806,2020-11-18T16:16:03.6754348Z,2020,306,118,263,146,0,8,4,160,0,0,188,43,0,297,0,1,1
34793,31793,2021-06-24T05:35:16.8689121Z,2021,338,47,308,163,0,1,0,175,0,0,291,30,0,337,0,0,0
34793,4257,2020-11-18T16:16:11.4716371Z,2012,523,72,453,257,0,0,0,266,0,0,451,70,0,523,0,0,0
34793,4258,2020-11-18T16:16:11.4716371Z,2013,479,59,384,241,0,0,0,238,0,0,420,95,0,479,0,0,0
34793,4259,2020-11-18T16:16:11.4726362Z,2014,446,59,395,226,0,0,0,220,0,0,387,51,0,446,0,0,0
34793,4260,2020-11-18T16:16:11.4726362Z,2015,420,56,374,217,0,0,0,203,0,0,364,46,0,420,0,0,0
34793,4261,2020-11-18T16:16:11.4726362Z,2016,395,51,355,206,0,0,0,189,0,0,344,40,0,395,0,0,0
34793,4262,2020-11-18T16:16:11.4726362Z,2017,349,55,315,172,0,0,0,177,0,0,294,34,0,349,0,0,0
34793,4263,2020-11-18T16:16:11.4736371Z,2018,323,32,291,150,1,0,2,173,0,0,291,32,0,323,0,0,0
34793,4264,2020-11-18T16:16:11.4736371Z,2019,386,45,352,189,0,0,0,197,0,0,341,34,0,386,0,0,0
34793,4265,2020-11-18T16:16:11.4736371Z,2020,365,39,343,184,0,3,0,181,0,0,326,22,0,362,0,0,0
61572,31952,2021-06-24T05:35:18.5651286Z,2021,574,68,205,410,0,16,1,164,0,0,506,369,1,554,10,0,3
61572,8295,2020-11-18T16:16:39.0810417Z,2012,655,26,180,417,0,8,0,238,0,0,629,475,1,645,0,0,1
61572,8296,2020-11-18T16:16:39.0820431Z,2013,639,35,191,411,0,11,0,228,0,0,604,448,0,627,0,0,1
61572,8297,2020-11-18T16:16:39.0820431Z,2014,623,48,190,388,0,12,0,235,0,0,575,433,0,610,0,0,1
61572,8298,2020-11-18T16:16:39.0820431Z,2015,641,58,214,409,0,8,0,232,0,0,583,427,1,629,0,0,3
61572,8299,2020-11-18T16:16:39.0830431Z,2016,673,81,100,442,0,9,0,231,0,0,592,573,1,661,0,0,2
61572,8300,2020-11-18T16:16:39.0830431Z,2017,682,63,225,464,0,13,0,218,0,0,619,457,1,665,0,0,3
61572,8301,2020-11-18T16:16:39.7715025Z,2018,668,67,234,443,0,13,0,225,0,0,601,434,2,651,12,0,2
61572,8302,2020-11-18T16:16:39.7715025Z,2019,650,73,212,450,0,15,0,200,0,0,577,438,0,632,13,0,3
61572,8303,2020-11-18T16:16:39.7715025Z,2020,569,71,179,403,0,13,0,166,0,0,498,390,1,552,16,0,3
23887,25719,2021-06-24T05:35:08.6700337Z,2021,72,72,64,21,0,1,3,51,0,0,0,8,0,71,0,1,0
23887,2614,2020-11-18T16:16:02.5156594Z,2012,165,4,144,45,0,1,0,120,0,0,161,21,0,164,0,0,0
23887,2615,2020-11-18T16:16:02.5156594Z,2013,172,13,149,49,0,0,0,123,0,0,159,23,0,172,0,1,0
23887,2616,2020-11-18T16:16:02.5166612Z,2014,173,48,157,48,0,1,0,125,0,0,125,16,0,172,0,0,0
23887,2617,2020-11-18T16:16:02.5166612Z,2015,151,40,134,42,0,2,0,109,0,0,111,17,0,149,0,1,0
23887,2618,2020-11-18T16:16:02.5166612Z,2016,129,77,114,31,0,2,1,98,0,0,52,15,0,127,0,1,0
23887,2619,2020-11-18T16:16:02.5166612Z,2017,117,73,107,24,0,2,0,93,0,0,44,10,0,115,0,2,0
23887,2620,2020-11-18T16:16:02.5166612Z,2018,128,82,101,30,0,0,1,98,0,0,46,27,0,128,0,2,0
23887,2621,2020-11-18T16:16:02.5176607Z,2019,119,88,109,26,0,1,3,93,0,0,31,10,0,118,0,2,0
23887,2622,2020-11-18T16:16:02.5176607Z,2020,84,84,74,22,0,1,3,62,0,0,0,10,0,83,0,2,0
73494,10646,2020-11-18T16:16:56.1134014Z,2012,132,13,105,33,0,4,0,99,0,0,119,27,0,128,0,0,0
73494,10647,2020-11-18T16:16:56.1134014Z,2013,127,23,119,32,0,2,0,95,0,0,104,8,0,125,0,0,0
73494,10648,2020-11-18T16:16:56.1144014Z,2014,124,53,115,30,0,2,0,94,0,0,71,9,0,122,0,0,0
73494,10649,2020-11-18T16:16:56.1144014Z,2015,114,49,110,27,0,1,0,87,0,0,65,4,0,113,0,0,0
73494,10650,2020-11-18T16:16:56.1144014Z,2016,135,102,122,27,0,3,4,108,0,0,33,13,0,132,0,0,0
73494,10651,2020-11-18T16:16:56.1144014Z,2017,150,114,146,37,0,2,8,113,0,0,36,4,0,148,0,0,0
73494,10652,2020-11-18T16:16:56.1154022Z,2018,144,85,135,32,0,1,16,112,0,0,59,9,0,143,0,0,0
73494,10653,2020-11-18T16:16:56.1154022Z,2019,115,73,110,26,0,0,8,89,0,0,42,5,0,115,0,0,0
73494,10654,2020-11-18T16:16:56.1154022Z,2020,100,100,94,22,0,2,3,78,0,0,0,6,0,98,0,0,0
73494,25626,2021-06-24T05:35:04.6641606Z,2021,92,90,84,23,0,2,6,69,0,0,2,8,0,90,0,0,0
61366,31944,2021-06-24T05:35:18.5391104Z,2021,176,167,135,65,0,3,14,111,0,0,9,41,0,173,2,0,0
61366,8129,2020-11-18T16:16:38.5997209Z,2012,117,8,108,39,0,1,0,78,0,0,109,9,0,116,0,0,0
61366,8130,2020-11-18T16:16:38.6007213Z,2013,127,17,116,46,0,3,0,81,0,0,110,11,0,124,0,0,0
61366,8131,2020-11-18T16:16:38.6007213Z,2014,119,47,102,44,0,6,0,75,0,0,72,17,0,113,0,0,0
61366,8132,2020-11-18T16:16:38.6007213Z,2015,124,25,109,49,0,4,0,75,0,0,99,15,0,120,0,0,0
61366,8133,2020-11-18T16:16:38.6017222Z,2016,133,72,114,44,0,4,2,89,0,0,61,19,0,129,0,0,0
61366,8134,2020-11-18T16:16:38.6017222Z,2017,128,89,109,38,0,5,11,90,0,0,39,19,0,123,0,0,0
61366,8135,2020-11-18T16:16:38.6017222Z,2018,142,89,126,41,0,6,13,101,0,0,53,16,1,135,0,1,0
61366,8136,2020-11-18T16:16:38.6017222Z,2019,133,91,116,38,0,1,10,95,0,0,42,17,1,131,0,1,0
61366,8137,2020-11-18T16:16:38.6027218Z,2020,145,143,103,49,0,4,10,96,0,0,2,42,1,140,0,1,0
30167,31755,2021-06-24T05:35:16.821879Z,2021,183,5,74,102,0,2,0,81,0,0,178,109,0,180,0,0,1
30167,3236,2020-11-18T16:16:05.717798Z,2016,227,3,18,123,0,1,0,104,0,0,224,209,0,225,0,0,1
30167,3237,2020-11-18T16:16:05.717798Z,2017,242,0,67,141,0,1,0,101,0,0,242,175,0,240,0,0,1
30167,3238,2020-11-18T16:16:05.717798Z,2018,244,0,80,136,0,0,0,108,0,0,244,164,0,243,0,0,1
30167,3239,2020-11-18T16:16:05.7187993Z,2019,208,1,67,106,0,0,0,102,0,0,207,141,0,207,0,0,1
30167,3240,2020-11-18T16:16:05.7187993Z,2020,183,2,59,101,0,2,0,82,0,0,181,124,0,180,0,0,1
44560,25845,2021-06-24T05:35:10.9656807Z,2021,235,3,76,123,0,5,0,112,0,0,232,159,0,230,0,0,0
44560,5720,2020-11-18T16:16:22.0997195Z,2012,152,0,38,81,0,1,0,71,0,0,152,114,0,151,0,0,0
44560,5721,2020-11-18T16:16:22.1007199Z,2013,87,0,28,49,0,2,0,38,0,0,87,59,0,85,0,0,0
44560,5722,2020-11-18T16:16:22.1007199Z,2014,143,0,45,82,0,3,0,61,0,0,143,98,0,140,0,0,0
44560,5723,2020-11-18T16:16:22.1007199Z,2015,120,0,50,64,0,2,0,56,0,0,120,70,0,118,0,0,0
44560,5724,2020-11-18T16:16:22.1017208Z,2016,152,0,56,84,0,1,0,68,0,0,152,96,0,151,0,0,0
44560,5725,2020-11-18T16:16:22.1017208Z,2017,175,2,86,93,0,2,0,82,0,0,173,89,0,173,0,0,0
44560,5726,2020-11-18T16:16:22.1017208Z,2018,236,0,69,113,0,1,1,123,0,1,236,167,1,234,0,0,0
44560,5727,2020-11-18T16:16:22.1027212Z,2019,237,1,65,132,0,2,0,105,0,0,236,172,0,235,0,0,0
44560,5728,2020-11-18T16:16:22.1027212Z,2020,244,3,76,140,0,2,0,104,0,0,241,168,1,241,0,1,0
54862,25911,2021-06-24T05:35:12.8049996Z,2021,240,5,100,136,0,3,0,104,0,0,235,140,1,235,0,0,1
54862,7422,2020-11-18T16:16:33.6954499Z,2016,104,3,16,62,0,1,0,42,0,0,101,88,1,102,0,0,0
54862,7423,2020-11-18T16:16:33.6954499Z,2017,219,7,86,115,0,0,0,104,0,0,212,133,2,217,0,0,0
54862,7424,2020-11-18T16:16:33.6954499Z,2018,225,6,90,119,0,0,0,106,0,0,219,135,2,223,0,0,0
54862,7425,2020-11-18T16:16:33.6964508Z,2019,226,6,79,131,0,1,0,95,0,0,220,147,1,223,1,0,1
54862,7426,2020-11-18T16:16:33.6964508Z,2020,221,7,71,122,0,2,0,99,0,0,214,150,1,217,0,0,1
45310,31848,2021-06-24T05:35:16.9759886Z,2021,107,106,95,29,0,3,0,78,0,0,1,12,0,104,0,1,0
45310,5779,2020-11-18T16:16:22.1177318Z,2012,154,32,109,37,0,5,0,117,0,0,122,45,0,149,0,0,0
45310,5780,2020-11-18T16:16:22.1177318Z,2013,128,30,90,34,0,4,0,94,0,0,98,38,0,124,0,1,0
45310,5781,2020-11-18T16:16:22.1187332Z,2014,139,76,121,31,0,3,0,108,0,0,63,18,0,136,0,2,0
45310,5782,2020-11-18T16:16:22.1187332Z,2015,127,60,106,28,0,3,0,99,0,0,67,21,0,124,0,2,0
45310,5783,2020-11-18T16:16:22.1187332Z,2016,121,80,96,26,0,4,5,95,0,0,41,25,0,117,0,2,0
45310,5784,2020-11-18T16:16:22.1187332Z,2017,123,79,116,26,0,2,5,97,0,0,44,7,0,121,0,1,0
45310,5785,2020-11-18T16:16:22.1197327Z,2018,126,83,117,20,0,0,8,106,0,0,43,9,0,126,0,1,0
45310,5786,2020-11-18T16:16:22.1197327Z,2019,128,87,115,21,0,1,0,107,0,0,41,13,0,127,1,1,0
45310,5787,2020-11-18T16:16:22.1197327Z,2020,107,103,95,22,0,2,0,85,0,0,4,12,0,105,0,2,0
42572,31834,2021-06-24T05:35:16.96298Z,2021,199,50,161,95,0,3,12,104,0,0,149,38,0,196,3,0,0
42572,5302,2020-11-18T16:16:19.3268715Z,2012,152,44,129,71,0,1,0,81,0,0,108,23,0,151,0,0,0
42572,5303,2020-11-18T16:16:19.3268715Z,2013,151,51,128,70,0,1,0,81,0,0,100,23,0,150,0,0,0
42572,5304,2020-11-18T16:16:19.3268715Z,2014,129,44,109,53,0,1,0,76,0,0,85,20,0,128,0,0,0
42572,5305,2020-11-18T16:16:19.3278711Z,2015,129,41,110,52,0,1,0,77,0,0,88,19,0,128,0,0,0
42572,5306,2020-11-18T16:16:19.3278711Z,2016,203,50,83,98,0,3,0,105,0,0,153,120,0,200,0,0,0
42572,5307,2020-11-18T16:16:19.3278711Z,2017,162,43,131,71,0,1,0,91,0,0,119,31,0,161,0,0,0
42572,5308,2020-11-18T16:16:19.3278711Z,2018,169,43,139,67,0,0,19,102,0,0,126,30,1,168,3,0,0
42572,5309,2020-11-18T16:16:19.3278711Z,2019,173,50,143,76,0,4,12,97,0,0,123,30,0,169,3,0,0
42572,5310,2020-11-18T16:16:19.3288715Z,2020,184,48,143,86,0,3,16,98,0,0,136,41,0,180,3,0,1
23259,2528,2020-11-18T16:16:02.0643582Z,2012,238,67,174,116,0,0,0,122,0,0,171,64,0,238,0,0,0
23259,2529,2020-11-18T16:16:02.0653595Z,2013,198,59,157,102,0,1,0,96,0,0,139,41,0,197,0,0,0
23259,2530,2020-11-18T16:16:02.0653595Z,2014,189,65,152,99,0,2,0,90,0,0,124,37,0,187,0,0,0
23259,2531,2020-11-18T16:16:02.0653595Z,2015,180,55,139,86,0,0,0,94,0,0,125,41,0,180,0,0,0
23259,2532,2020-11-18T16:16:02.0663604Z,2016,159,48,126,77,0,0,0,82,0,0,111,33,0,159,0,0,0
23259,2533,2020-11-18T16:16:02.0663604Z,2017,134,41,106,68,0,0,1,66,0,0,93,28,0,134,0,0,0
23259,2534,2020-11-18T16:16:02.0663604Z,2018,238,70,186,121,0,1,13,117,0,0,168,52,0,237,0,0,0
23259,2535,2020-11-18T16:16:02.0673608Z,2019,233,87,186,114,0,2,0,119,0,0,146,47,0,230,0,0,1
23259,2536,2020-11-18T16:16:02.0673608Z,2020,187,52,145,94,0,2,5,93,0,0,135,42,0,185,0,0,0
23259,31718,2021-06-24T05:35:15.3778429Z,2021,132,34,105,71,0,1,5,61,0,0,98,27,0,131,0,0,0
20727,1897,2020-11-18T16:15:57.8685623Z,2012,234,83,200,109,0,0,0,125,0,0,151,34,0,234,0,0,0
20727,1898,2020-11-18T16:15:57.8695632Z,2013,240,93,209,113,0,0,0,127,0,0,147,31,0,240,0,0,0
20727,1899,2020-11-18T16:15:57.8695632Z,2014,222,91,186,102,0,0,0,120,0,0,131,36,0,222,0,0,0
20727,1900,2020-11-18T16:15:57.8695632Z,2015,226,86,186,104,0,0,0,122,0,0,140,40,0,226,0,0,0
20727,1901,2020-11-18T16:15:58.4819714Z,2016,274,100,232,125,0,0,0,149,0,0,174,42,0,274,0,0,0
20727,1902,2020-11-18T16:15:58.4819714Z,2017,234,92,206,100,0,0,1,134,0,0,142,28,0,234,0,0,0
20727,1903,2020-11-18T16:15:58.4829718Z,2018,209,73,184,88,0,2,19,121,0,0,136,25,0,207,0,0,0
20727,1904,2020-11-18T16:15:58.4829718Z,2019,195,71,170,93,0,2,1,102,0,0,124,25,0,193,0,0,0
20727,1905,2020-11-18T16:15:58.4829718Z,2020,177,56,153,87,0,1,0,90,0,0,121,24,0,176,0,0,0
20727,31699,2021-06-24T05:35:15.3258069Z,2021,172,46,156,79,0,1,1,93,0,0,126,16,0,171,0,0,0
28100,25737,2021-06-24T05:35:08.6850442Z,2021,147,71,126,57,0,1,1,90,0,0,76,21,0,146,0,0,0
28100,3116,2020-11-18T16:16:05.3255364Z,2012,306,127,276,137,0,0,0,169,0,0,179,30,0,306,0,0,0
28100,3117,2020-11-18T16:16:05.3265373Z,2013,301,129,272,136,0,1,0,165,0,0,172,29,0,300,0,2,0
28100,3118,2020-11-18T16:16:05.3265373Z,2014,272,129,256,115,0,0,0,157,0,0,143,16,0,272,0,2,0
28100,3119,2020-11-18T16:16:05.3265373Z,2015,249,118,227,107,0,0,0,142,0,0,131,22,0,249,0,1,0
28100,3120,2020-11-18T16:16:05.3265373Z,2016,273,113,234,118,0,3,9,155,0,0,160,39,0,270,0,4,0
28100,3121,2020-11-18T16:16:05.3265373Z,2017,224,93,201,100,0,2,6,124,0,0,131,23,0,222,0,2,0
28100,3122,2020-11-18T16:16:05.3275382Z,2018,175,78,155,71,0,2,8,104,0,0,97,20,0,173,1,0,0
28100,3123,2020-11-18T16:16:05.3275382Z,2019,181,81,166,83,0,3,6,98,0,0,100,15,0,178,1,0,0
28100,3124,2020-11-18T16:16:05.3275382Z,2020,164,74,148,72,0,1,8,92,0,0,90,16,0,163,1,0,0
21493,2205,2020-11-18T16:16:00.0159963Z,2012,540,130,428,271,0,2,0,269,0,0,410,112,0,538,0,0,0
21493,2206,2020-11-18T16:16:00.0169963Z,2013,498,139,377,257,0,5,0,241,0,0,359,121,0,493,0,0,0
21493,2207,2020-11-18T16:16:00.0169963Z,2014,471,142,351,240,0,6,0,231,0,0,329,120,0,465,0,3,0
21493,2208,2020-11-18T16:16:00.0169963Z,2015,484,147,383,239,0,8,0,245,0,0,337,101,0,476,0,4,0
21493,2209,2020-11-18T16:16:00.0169963Z,2016,451,148,329,214,0,8,6,237,0,0,303,122,0,443,0,1,0
21493,2210,2020-11-18T16:16:00.0179981Z,2017,346,126,294,167,0,1,5,179,0,0,220,52,0,345,0,1,0
21493,2211,2020-11-18T16:16:00.0179981Z,2018,342,108,290,167,0,0,8,175,0,0,234,52,0,342,2,1,0
21493,2212,2020-11-18T16:16:00.0179981Z,2019,389,129,337,182,0,13,1,207,0,0,260,52,0,376,2,1,0
21493,2213,2020-11-18T16:16:00.018999Z,2020,377,130,315,164,0,5,0,213,0,0,247,62,0,372,2,1,0
21493,25708,2021-06-24T05:35:08.6650294Z,2021,372,133,331,166,0,6,2,206,0,0,239,41,0,366,3,1,0
74237,10705,2020-11-18T16:16:56.8829147Z,2012,534,97,407,258,0,2,0,276,0,0,437,127,0,532,0,0,0
74237,10706,2020-11-18T16:16:56.8829147Z,2013,479,120,375,240,0,3,0,239,0,0,359,104,0,476,0,3,0
74237,10707,2020-11-18T16:16:56.8829147Z,2014,384,103,302,199,0,2,0,185,0,0,281,82,0,382,0,0,0
74237,10708,2020-11-18T16:16:56.8829147Z,2015,268,76,217,132,0,1,0,136,0,0,192,51,0,266,0,0,1
74237,10709,2020-11-18T16:16:56.8829147Z,2016,178,56,149,82,0,1,1,96,0,0,122,29,0,176,0,0,1
74237,10710,2020-11-18T16:16:56.8839152Z,2017,343,127,309,156,0,3,0,187,0,0,216,34,0,340,0,1,0
74237,10711,2020-11-18T16:16:56.8839152Z,2018,367,135,333,167,0,2,0,200,0,0,232,34,0,365,1,0,0
74237,10712,2020-11-18T16:16:56.8839152Z,2019,376,147,334,172,0,1,0,204,0,0,229,42,0,375,0,0,0
74237,10713,2020-11-18T16:16:56.8839152Z,2020,343,121,300,159,0,1,3,184,0,0,222,43,0,342,1,0,0
74237,31680,2021-06-24T05:35:15.2847773Z,2021,311,119,280,151,0,1,0,160,0,0,192,31,0,310,1,0,0
23143,2505,2020-11-18T16:16:02.0553519Z,2012,417,137,330,227,0,3,0,190,0,0,280,87,1,413,0,0,0
23143,2506,2020-11-18T16:16:02.0563537Z,2013,381,132,306,203,0,2,0,178,0,0,249,75,0,379,0,2,0
23143,2507,2020-11-18T16:16:02.0563537Z,2014,359,127,298,180,0,2,0,179,0,0,232,61,0,357,0,0,0
23143,2508,2020-11-18T16:16:02.0563537Z,2015,326,122,269,173,0,1,0,153,0,0,204,57,0,325,0,0,0
23143,2509,2020-11-18T16:16:02.0563537Z,2016,227,102,181,110,0,1,1,117,0,0,125,46,0,226,0,0,0
23143,2510,2020-11-18T16:16:02.0573537Z,2017,209,81,185,106,0,0,0,103,0,0,128,24,0,209,0,0,0
23143,2511,2020-11-18T16:16:02.0573537Z,2018,209,68,174,99,0,2,19,110,0,0,141,35,0,207,0,0,0
23143,2512,2020-11-18T16:16:02.0573537Z,2019,193,81,163,95,0,1,18,98,0,0,112,30,0,192,0,0,0
23143,2513,2020-11-18T16:16:02.0583541Z,2020,224,92,195,104,0,3,19,120,0,0,132,29,0,221,0,0,0
23143,25716,2021-06-24T05:35:08.6830423Z,2021,206,85,179,88,0,3,4,118,0,0,121,27,0,203,0,1,0
42911,31836,2021-06-24T05:35:16.96398Z,2021,212,64,177,85,0,9,0,127,0,0,148,35,0,200,1,5,3
42911,5380,2020-11-18T16:16:19.3478849Z,2012,274,72,216,119,0,17,0,155,0,0,202,58,3,254,0,0,0
42911,5381,2020-11-18T16:16:19.3488849Z,2013,213,64,165,94,0,12,0,119,0,0,149,48,0,200,0,17,1
42911,5382,2020-11-18T16:16:19.3488849Z,2014,173,64,140,76,0,6,0,97,0,0,109,33,0,167,0,4,0
42911,5383,2020-11-18T16:16:19.3488849Z,2015,145,53,108,62,0,10,0,83,0,0,92,37,0,134,0,5,1
42911,5384,2020-11-18T16:16:19.3488849Z,2016,209,64,69,94,0,10,1,115,0,0,145,140,2,197,0,11,0
42911,5385,2020-11-18T16:16:19.3488849Z,2017,199,62,172,80,0,11,0,119,0,0,137,27,1,187,0,12,0
42911,5386,2020-11-18T16:16:19.3498867Z,2018,192,68,160,78,0,11,0,114,0,0,124,32,2,179,0,6,0
42911,5387,2020-11-18T16:16:19.3498867Z,2019,197,74,160,74,0,10,0,123,0,0,123,37,0,184,2,4,3
42911,5388,2020-11-18T16:16:19.3498867Z,2020,245,81,204,101,0,14,4,144,0,0,164,41,0,226,2,6,5
52886,25743,2021-06-24T05:35:08.6960515Z,2021,216,67,192,103,0,4,20,113,0,0,149,24,0,210,0,0,2
52886,7041,2020-11-18T16:16:31.316868Z,2012,205,24,159,93,0,1,0,112,0,0,181,46,6,198,0,0,0
52886,7042,2020-11-18T16:16:31.3178684Z,2013,200,34,160,93,0,0,0,107,0,0,166,40,6,194,0,5,0
52886,7043,2020-11-18T16:16:31.3178684Z,2014,166,42,142,74,0,3,0,92,0,0,124,24,8,155,0,4,0
52886,7044,2020-11-18T16:16:31.3178684Z,2015,258,70,211,114,0,5,0,144,0,0,188,47,0,253,0,5,0
52886,7045,2020-11-18T16:16:31.3178684Z,2016,57,23,35,22,0,2,0,35,0,0,34,22,0,55,0,0,0
52886,7046,2020-11-18T16:16:31.3178684Z,2017,161,54,128,69,0,6,3,92,0,0,107,33,0,155,0,2,0
52886,7047,2020-11-18T16:16:31.3188693Z,2018,163,51,127,70,0,3,5,93,0,0,112,36,0,160,0,1,0
52886,7048,2020-11-18T16:16:31.3188693Z,2019,233,77,203,118,0,7,19,115,0,0,156,30,0,226,0,2,0
52886,7049,2020-11-18T16:16:31.3188693Z,2020,235,76,201,115,0,1,29,120,0,0,159,34,0,232,0,0,2
58503,31935,2021-06-24T05:35:18.5341066Z,2021,395,140,312,205,0,8,4,190,0,0,255,83,0,387,2,2,0
58503,7897,2020-11-18T16:16:36.3662343Z,2012,371,0,238,168,0,1,0,203,0,0,371,133,0,370,0,0,0
58503,7898,2020-11-18T16:16:36.3662343Z,2013,341,2,227,173,0,1,0,168,0,0,339,114,0,340,0,1,0
58503,7899,2020-11-18T16:16:36.3662343Z,2014,281,18,199,148,0,1,0,133,0,0,263,82,0,280,0,0,0
58503,7900,2020-11-18T16:16:36.3672352Z,2015,281,21,192,154,0,3,0,127,0,0,260,89,0,278,0,0,0
58503,7901,2020-11-18T16:16:37.0737075Z,2016,269,47,187,129,0,2,0,140,0,0,222,82,0,267,0,0,0
58503,7902,2020-11-18T16:16:37.0737075Z,2017,372,79,266,149,0,1,2,223,0,0,293,106,0,371,0,0,0
58503,7903,2020-11-18T16:16:37.0737075Z,2018,330,75,223,145,0,1,21,185,0,0,255,107,0,329,4,0,0
58503,7904,2020-11-18T16:16:37.0747075Z,2019,328,92,246,146,0,2,7,182,0,0,236,82,0,326,5,0,0
58503,7905,2020-11-18T16:16:37.0747075Z,2020,361,134,261,157,0,3,6,204,0,0,227,100,0,358,5,0,0
70425,25649,2021-06-24T05:35:04.6971849Z,2021,217,93,194,98,0,12,0,119,0,0,124,23,0,205,2,0,0
70425,9659,2020-11-18T16:16:49.7241398Z,2012,397,136,301,182,0,17,0,215,0,0,261,96,0,380,0,0,0
70425,9660,2020-11-18T16:16:49.7241398Z,2013,398,143,310,184,0,18,0,214,0,0,255,88,1,379,0,6,0
70425,9661,2020-11-18T16:16:49.7241398Z,2014,365,134,282,170,0,12,0,195,0,0,231,83,0,353,0,4,0
70425,9662,2020-11-18T16:16:49.7251402Z,2015,332,121,274,160,0,11,0,172,0,0,211,58,0,321,0,2,0
70425,9663,2020-11-18T16:16:49.7251402Z,2016,241,89,196,119,0,7,0,122,0,0,152,45,0,234,0,0,0
70425,9664,2020-11-18T16:16:49.7251402Z,2017,207,73,180,104,0,9,0,103,0,0,134,27,0,198,0,0,0
70425,9665,2020-11-18T16:16:49.7251402Z,2018,246,79,198,118,0,10,1,128,0,0,167,48,0,236,1,0,0
70425,9666,2020-11-18T16:16:49.7251402Z,2019,179,71,146,86,0,3,0,93,0,0,108,33,0,176,1,0,0
70425,9667,2020-11-18T16:16:49.7261402Z,2020,195,77,160,88,0,8,1,107,0,0,118,35,0,184,1,0,3
32714,31779,2021-06-24T05:35:16.8539015Z,2021,250,59,224,138,0,9,1,112,0,0,191,26,0,240,0,0,1
32714,3963,2020-11-18T16:16:09.8875779Z,2012,310,54,250,156,0,1,0,154,0,0,256,60,3,306,0,0,0
32714,3964,2020-11-18T16:16:09.8875779Z,2013,252,60,197,127,0,1,0,125,0,0,192,55,0,251,0,0,0
32714,3965,2020-11-18T16:16:09.8885787Z,2014,281,75,212,141,0,0,0,140,0,0,206,69,4,277,0,1,0
32714,3966,2020-11-18T16:16:09.8895796Z,2015,272,75,218,131,0,1,0,141,0,0,197,54,1,269,0,3,1
32714,3967,2020-11-18T16:16:09.8895796Z,2016,246,73,198,117,0,1,0,129,0,0,173,48,1,243,0,1,1
32714,3968,2020-11-18T16:16:09.8905801Z,2017,298,80,245,149,0,4,0,149,0,0,218,53,1,292,0,2,1
32714,3969,2020-11-18T16:16:09.8905801Z,2018,264,65,195,142,0,3,0,122,0,0,199,69,0,260,1,0,1
32714,3970,2020-11-18T16:16:09.8905801Z,2019,270,67,215,150,0,3,10,120,0,0,203,55,0,267,0,0,0
32714,3971,2020-11-18T16:16:09.891581Z,2020,261,62,214,143,0,1,9,118,0,0,199,47,0,259,0,0,1
76562,10960,2020-11-18T16:16:58.1147383Z,2012,261,65,182,132,0,3,0,129,0,0,196,79,0,258,0,0,0
76562,10961,2020-11-18T16:16:58.1147383Z,2013,192,52,143,96,0,1,0,96,0,0,140,49,0,191,0,1,0
76562,10962,2020-11-18T16:16:58.1157383Z,2014,206,60,147,103,0,1,0,103,0,0,146,59,0,205,0,1,0
76562,10963,2020-11-18T16:16:58.1157383Z,2015,201,50,170,101,0,1,0,100,0,0,151,31,0,200,0,0,0
76562,10964,2020-11-18T16:16:58.1157383Z,2016,198,65,157,98,0,0,0,100,0,0,133,41,0,198,0,0,0
76562,10965,2020-11-18T16:16:58.1157383Z,2017,198,73,163,100,0,0,1,98,0,0,125,35,0,198,0,0,0
76562,10966,2020-11-18T16:16:58.1157383Z,2018,146,57,119,75,0,4,0,71,0,0,89,27,0,142,0,0,0
76562,10967,2020-11-18T16:16:58.1157383Z,2019,232,94,198,102,0,4,0,130,0,0,138,34,0,228,0,0,0
76562,10968,2020-11-18T16:16:58.1167396Z,2020,292,109,257,127,0,4,0,165,0,0,183,35,0,288,0,0,0
76562,25628,2021-06-24T05:35:04.667163Z,2021,330,123,299,152,0,3,0,178,0,0,207,31,0,327,0,1,0
51334,25881,2021-06-24T05:35:12.77898Z,2021,118,47,103,57,0,0,0,61,0,0,71,15,0,117,1,0,1
51334,6435,2020-11-18T16:16:27.0420157Z,2012,212,95,165,110,0,2,0,102,0,0,117,47,0,210,0,0,0
51334,6436,2020-11-18T16:16:27.0420157Z,2013,158,84,128,70,0,3,0,88,0,0,74,30,0,155,0,0,0
51334,6437,2020-11-18T16:16:27.0420157Z,2014,187,90,154,79,0,4,0,108,0,0,97,33,0,183,0,2,0
51334,6438,2020-11-18T16:16:27.0430166Z,2015,164,69,138,69,0,4,0,95,0,0,95,26,0,160,0,0,0
51334,6439,2020-11-18T16:16:27.0430166Z,2016,144,72,54,60,0,3,4,84,0,0,72,90,0,141,0,0,0
51334,6440,2020-11-18T16:16:27.0430166Z,2017,139,69,110,69,0,2,3,70,0,0,70,29,0,137,0,0,0
51334,6441,2020-11-18T16:16:27.0440171Z,2018,147,70,123,73,0,2,4,74,0,0,77,24,0,145,1,0,0
51334,6442,2020-11-18T16:16:27.0440171Z,2019,169,75,140,75,0,2,0,94,0,0,94,29,0,167,2,0,0
51334,6443,2020-11-18T16:16:27.0440171Z,2020,137,57,123,68,0,2,1,69,0,0,80,14,0,134,2,0,1
58263,25932,2021-06-24T05:35:12.8300164Z,2021,369,111,303,185,0,2,1,184,0,0,258,66,0,367,0,0,0
58263,7870,2020-11-18T16:16:36.3582294Z,2012,477,119,341,243,0,3,0,234,0,0,358,136,0,472,0,0,2
58263,7871,2020-11-18T16:16:36.3582294Z,2013,436,117,271,225,0,6,0,211,0,0,319,165,0,429,0,2,1
58263,7872,2020-11-18T16:16:36.3592307Z,2014,417,105,264,204,0,7,0,213,0,0,312,153,0,410,0,0,0
58263,7873,2020-11-18T16:16:36.3592307Z,2015,403,102,239,208,0,6,0,195,0,0,301,164,0,397,0,0,0
58263,7874,2020-11-18T16:16:36.3592307Z,2016,355,91,97,182,0,7,6,173,0,0,264,258,0,348,0,0,0
58263,7875,2020-11-18T16:16:36.3592307Z,2017,306,87,221,159,0,5,0,147,0,0,219,85,0,301,0,0,0
58263,7876,2020-11-18T16:16:36.3592307Z,2018,282,81,210,146,0,2,14,136,0,0,201,72,0,280,0,0,0
58263,7877,2020-11-18T16:16:36.3602302Z,2019,373,119,275,190,0,0,1,183,0,0,254,98,0,373,0,0,0
58263,7878,2020-11-18T16:16:36.3602302Z,2020,372,121,288,191,0,0,1,181,0,0,251,84,0,372,0,0,0
17673,1414,2020-11-18T16:15:54.752487Z,2012,292,102,244,141,0,3,0,151,0,0,190,48,0,289,0,0,0
17673,1415,2020-11-18T16:15:54.752487Z,2013,297,109,254,138,0,5,0,159,0,0,188,43,0,292,0,1,0
17673,1416,2020-11-18T16:15:54.752487Z,2014,313,101,251,149,0,9,0,164,0,0,212,62,0,304,0,1,0
17673,1417,2020-11-18T16:15:54.753487Z,2015,352,125,298,169,0,9,0,183,0,0,227,54,0,343,0,1,0
17673,1418,2020-11-18T16:15:54.753487Z,2016,376,130,302,182,0,17,2,194,0,0,246,74,0,359,0,1,0
17673,1419,2020-11-18T16:15:54.753487Z,2017,396,136,323,189,0,15,1,207,0,0,260,73,0,381,0,0,0
17673,1420,2020-11-18T16:15:54.753487Z,2018,448,155,361,222,0,17,3,226,0,0,293,87,0,431,3,2,0
17673,1421,2020-11-18T16:15:54.753487Z,2019,425,141,349,211,0,13,0,214,0,0,284,76,0,412,3,0,0
17673,1422,2020-11-18T16:15:54.7544874Z,2020,394,126,314,199,0,12,2,195,0,0,268,80,0,382,0,0,0
17673,31612,2021-06-24T05:35:14.6112937Z,2021,313,108,258,151,0,5,0,162,0,0,205,55,0,307,0,0,1
71639,10379,2020-11-18T16:16:54.3272083Z,2012,355,90,268,165,0,4,0,190,0,0,265,87,0,348,0,0,3
71639,10380,2020-11-18T16:16:54.3282097Z,2013,344,100,242,170,0,3,0,174,0,0,244,102,0,340,0,0,1
71639,10381,2020-11-18T16:16:54.3282097Z,2014,304,93,213,150,0,3,0,154,0,0,211,91,0,300,0,0,1
71639,10382,2020-11-18T16:16:54.3282097Z,2015,316,99,237,149,0,2,0,167,0,0,217,79,0,314,0,0,0
71639,10383,2020-11-18T16:16:54.3282097Z,2016,218,64,162,100,0,2,0,118,0,0,154,56,0,216,0,0,0
71639,10384,2020-11-18T16:16:54.3282097Z,2017,231,80,171,104,0,1,0,127,0,0,151,60,0,230,0,0,0
71639,10385,2020-11-18T16:16:54.3292101Z,2018,247,71,173,119,0,0,0,128,0,0,176,74,0,246,0,0,1
71639,10386,2020-11-18T16:16:54.3292101Z,2019,260,85,187,134,0,2,0,126,0,0,175,73,0,258,0,0,0
71639,10387,2020-11-18T16:16:54.3292101Z,2020,240,76,160,120,0,2,1,120,0,0,164,80,0,238,0,0,0
71639,31675,2021-06-24T05:35:15.279773Z,2021,221,68,164,106,0,1,2,115,0,0,153,57,0,220,0,0,0
20735,1906,2020-11-18T16:15:58.4879749Z,2012,149,48,129,74,0,0,0,75,0,0,101,20,0,149,0,0,0
20735,1907,2020-11-18T16:15:58.4879749Z,2013,167,57,144,89,0,0,0,78,0,0,110,23,0,167,0,0,0
20735,1908,2020-11-18T16:15:58.4879749Z,2014,186,74,147,92,0,0,0,94,0,0,112,39,0,186,0,0,0
20735,1909,2020-11-18T16:15:58.4879749Z,2015,189,74,142,94,0,0,0,95,0,0,115,47,0,189,0,0,0
20735,1910,2020-11-18T16:15:58.4879749Z,2016,194,79,26,96,0,0,4,98,0,0,115,168,0,194,0,0,0
20735,1911,2020-11-18T16:15:58.4889758Z,2017,198,86,169,98,0,0,6,100,0,0,112,29,0,198,0,0,0
20735,1912,2020-11-18T16:15:58.4889758Z,2018,165,59,136,81,0,1,35,84,0,0,106,29,0,162,0,0,2
20735,1913,2020-11-18T16:15:58.4889758Z,2019,161,69,133,77,0,0,4,84,0,0,92,28,0,158,0,2,3
20735,1914,2020-11-18T16:15:58.4889758Z,2020,165,68,139,74,0,0,15,91,0,0,97,26,0,164,0,2,1
20735,25698,2021-06-24T05:35:08.6620279Z,2021,165,64,141,71,0,0,8,94,0,0,101,24,0,164,0,2,1
26153,25729,2021-06-24T05:35:08.6850442Z,2021,130,61,106,66,0,1,0,64,0,0,69,24,1,123,0,0,5
26153,2954,2020-11-18T16:16:04.2938475Z,2012,231,63,171,117,0,4,0,114,0,0,168,60,0,227,0,0,0
26153,2955,2020-11-18T16:16:04.2938475Z,2013,230,67,165,107,0,3,0,123,0,0,163,65,0,226,0,2,1
26153,2956,2020-11-18T16:16:04.2948493Z,2014,205,66,127,96,0,4,0,109,0,0,139,78,0,200,0,1,1
26153,2957,2020-11-18T16:16:04.2948493Z,2015,237,71,171,117,0,2,0,120,0,0,166,66,0,235,0,1,0
26153,2958,2020-11-18T16:16:04.2948493Z,2016,171,60,121,88,0,0,0,83,0,0,111,50,0,171,0,1,0
26153,2959,2020-11-18T16:16:04.2948493Z,2017,144,50,107,77,0,1,0,67,0,0,94,37,0,143,0,0,0
26153,2960,2020-11-18T16:16:04.2958493Z,2018,101,40,78,50,0,2,2,51,0,0,61,23,0,99,0,0,0
26153,2961,2020-11-18T16:16:04.2958493Z,2019,115,63,90,53,0,0,0,62,0,0,52,25,0,115,0,0,0
26153,2962,2020-11-18T16:16:04.2958493Z,2020,137,66,113,67,0,0,0,70,0,0,71,24,0,134,0,0,3
11643,25593,2021-06-24T05:35:04.604118Z,2021,886,227,680,451,0,22,0,435,0,0,659,206,0,864,8,4,0
11643,468,2020-11-18T16:15:48.3322031Z,2012,731,8,455,376,0,9,0,355,0,0,723,276,0,722,0,0,0
11643,469,2020-11-18T16:15:48.3322031Z,2013,798,16,569,414,0,17,0,384,0,0,782,229,0,781,0,2,0
11643,470,2020-11-18T16:15:48.3322031Z,2014,901,67,663,470,0,27,0,431,0,0,834,238,0,874,0,2,0
11643,471,2020-11-18T16:15:48.3322031Z,2015,934,63,709,468,0,26,0,466,0,0,871,225,0,908,0,3,0
11643,472,2020-11-18T16:15:48.3322031Z,2016,873,115,607,475,0,32,1,398,0,0,758,266,0,841,0,4,0
11643,473,2020-11-18T16:15:48.3322031Z,2017,772,87,579,428,0,27,0,344,0,0,685,193,1,744,0,3,0
11643,474,2020-11-18T16:15:48.3332044Z,2018,923,129,677,495,0,30,22,428,0,0,794,246,0,893,0,1,0
11643,475,2020-11-18T16:15:48.3332044Z,2019,950,151,709,485,0,21,5,465,0,2,799,241,0,929,0,0,0
11643,476,2020-11-18T16:15:48.3332044Z,2020,892,192,659,463,0,17,0,429,0,0,700,233,0,875,0,1,0
50252,31874,2021-06-24T05:35:18.4430406Z,2021,112,35,93,46,0,1,0,66,0,0,77,19,0,111,1,0,0
50252,6163,2020-11-18T16:16:25.0937169Z,2012,143,28,123,70,0,0,0,73,0,0,115,20,0,143,0,0,0
50252,6164,2020-11-18T16:16:25.0937169Z,2013,132,31,120,69,0,0,0,63,0,0,101,12,0,132,0,0,0
50252,6165,2020-11-18T16:16:25.0937169Z,2014,127,32,114,62,0,0,0,65,0,0,95,13,0,127,0,1,0
50252,6166,2020-11-18T16:16:25.0937169Z,2015,124,27,108,59,0,0,0,65,0,0,97,16,0,124,0,2,0
50252,6167,2020-11-18T16:16:25.0947178Z,2016,132,31,111,62,0,0,0,70,0,0,101,21,0,132,0,3,0
50252,6168,2020-11-18T16:16:25.0947178Z,2017,114,33,99,47,0,0,0,67,0,0,81,15,0,114,0,3,0
50252,6169,2020-11-18T16:16:25.0947178Z,2018,117,35,97,51,0,0,24,66,0,0,82,20,0,117,1,3,0
50252,6170,2020-11-18T16:16:25.0947178Z,2019,105,27,91,44,0,0,25,61,0,0,78,14,0,105,1,0,0
50252,6171,2020-11-18T16:16:25.0957182Z,2020,105,31,93,42,0,2,0,63,0,0,74,12,0,103,1,0,0
58081,25928,2021-06-24T05:35:12.8280154Z,2021,358,123,288,171,0,5,3,187,0,0,235,70,0,353,1,0,0
58081,7775,2020-11-18T16:16:35.9179352Z,2012,321,101,282,148,0,0,0,173,0,0,220,39,0,321,0,0,0
58081,7776,2020-11-18T16:16:35.9179352Z,2013,318,113,268,156,0,0,0,162,0,0,205,50,0,318,0,3,0
58081,7777,2020-11-18T16:16:35.9179352Z,2014,224,72,163,114,0,1,0,110,0,0,152,61,0,223,0,0,0
58081,7778,2020-11-18T16:16:35.9179352Z,2015,439,118,332,232,0,6,0,207,0,0,321,107,0,433,0,1,0
58081,7779,2020-11-18T16:16:35.9189357Z,2016,450,154,207,233,0,5,1,217,0,0,296,243,0,444,0,1,1
58081,7780,2020-11-18T16:16:35.9189357Z,2017,425,154,327,214,0,5,0,211,0,0,271,98,0,418,0,0,2
58081,7781,2020-11-18T16:16:35.9189357Z,2018,435,157,356,217,3,10,65,218,0,0,278,79,0,422,0,0,3
58081,7782,2020-11-18T16:16:35.9189357Z,2019,446,158,317,224,0,9,31,222,0,0,288,129,0,436,0,1,1
58081,7783,2020-11-18T16:16:35.9189357Z,2020,427,152,344,209,0,10,14,218,0,0,275,83,0,416,1,0,1
35907,31804,2021-06-24T05:35:16.8879264Z,2021,386,133,364,175,0,8,3,211,0,0,253,22,0,374,0,0,4
35907,4470,2020-11-18T16:16:12.5913773Z,2012,533,114,405,258,0,5,0,275,0,0,419,128,0,528,0,0,0
35907,4471,2020-11-18T16:16:12.5923787Z,2013,536,126,425,277,0,4,0,259,0,0,410,111,0,532,0,4,0
35907,4472,2020-11-18T16:16:12.5923787Z,2014,484,116,390,252,0,7,0,232,0,0,368,94,1,476,0,4,0
35907,4473,2020-11-18T16:16:12.5923787Z,2015,427,110,356,219,0,5,0,208,0,0,317,71,0,422,0,5,0
35907,4474,2020-11-18T16:16:12.5933787Z,2016,395,104,293,202,0,5,18,193,0,0,291,102,0,390,0,4,0
35907,4475,2020-11-18T16:16:12.5933787Z,2017,361,102,305,189,0,1,15,172,0,0,259,56,0,360,0,2,0
35907,4476,2020-11-18T16:16:12.5933787Z,2018,357,111,305,177,0,0,0,180,0,0,246,52,0,357,0,0,0
35907,4477,2020-11-18T16:16:12.5943804Z,2019,435,147,379,213,0,5,1,222,0,0,288,56,0,427,0,1,3
35907,4478,2020-11-18T16:16:12.5943804Z,2020,386,127,332,183,0,3,0,203,0,0,259,54,0,379,0,0,4
70516,25652,2021-06-24T05:35:04.6981863Z,2021,392,123,330,196,0,13,0,196,0,0,269,62,0,379,0,0,0
70516,9732,2020-11-18T16:16:50.4686362Z,2012,903,3,339,505,0,12,0,398,0,0,900,564,0,891,0,0,0
70516,9733,2020-11-18T16:16:50.4686362Z,2013,826,5,530,455,0,24,0,371,0,0,821,296,0,802,0,0,0
70516,9734,2020-11-18T16:16:50.4686362Z,2014,737,45,505,438,0,31,0,299,0,0,692,232,2,704,0,3,0
70516,9735,2020-11-18T16:16:50.4696362Z,2015,625,49,445,377,0,31,0,248,0,0,576,180,2,589,0,2,3
70516,9736,2020-11-18T16:16:50.4696362Z,2016,724,150,290,406,0,39,1,318,0,0,574,434,2,681,0,2,2
70516,9737,2020-11-18T16:16:50.4696362Z,2017,659,137,519,366,0,34,2,293,0,0,522,140,0,622,0,0,3
70516,9738,2020-11-18T16:16:50.4696362Z,2018,574,95,437,323,0,28,0,251,0,0,479,137,0,546,0,1,0
70516,9739,2020-11-18T16:16:50.4696362Z,2019,446,83,343,248,0,20,2,198,0,0,363,103,0,426,0,0,0
70516,9740,2020-11-18T16:16:50.4706375Z,2020,436,121,346,231,0,20,0,205,0,0,315,90,0,415,0,0,1
54866,31913,2021-06-24T05:35:18.4830702Z,2021,171,56,153,88,0,0,0,83,0,0,115,18,0,170,2,0,1
54866,7427,2020-11-18T16:16:33.6974513Z,2012,178,14,156,91,0,0,0,87,0,0,164,22,0,176,0,0,2
54866,7428,2020-11-18T16:16:33.6984517Z,2013,189,32,179,84,0,0,0,105,0,0,157,10,1,188,0,1,0
54866,7429,2020-11-18T16:16:33.6984517Z,2014,130,30,126,55,0,0,0,75,0,0,100,4,1,129,0,1,0
54866,7430,2020-11-18T16:16:33.6984517Z,2015,118,26,110,48,0,0,0,70,0,0,92,8,0,118,0,1,0
54866,7431,2020-11-18T16:16:33.6984517Z,2016,218,70,71,109,0,0,0,109,0,0,148,147,1,217,0,1,0
54866,7432,2020-11-18T16:16:33.6994531Z,2017,268,90,207,135,0,0,1,133,0,0,178,61,1,265,0,1,2
54866,7433,2020-11-18T16:16:33.6994531Z,2018,248,85,206,116,0,1,1,132,0,0,163,42,0,246,0,0,1
54866,7434,2020-11-18T16:16:33.6994531Z,2019,284,97,232,128,0,2,0,156,0,0,187,52,0,280,0,0,2
54866,7435,2020-11-18T16:16:33.6994531Z,2020,206,82,191,91,0,1,6,115,0,0,124,15,0,204,0,0,1
61333,31943,2021-06-24T05:35:18.5391104Z,2021,273,59,176,153,0,3,0,120,0,0,214,97,2,268,0,0,0
61333,8105,2020-11-18T16:16:38.5947164Z,2012,328,59,214,170,0,2,0,158,0,0,269,114,0,324,0,0,2
61333,8106,2020-11-18T16:16:38.5947164Z,2013,321,55,209,175,0,2,0,146,0,0,266,112,0,317,0,0,2
61333,8107,2020-11-18T16:16:38.5947164Z,2014,319,54,206,179,0,2,0,140,0,0,265,113,0,316,0,0,1
61333,8108,2020-11-18T16:16:38.5947164Z,2015,334,55,210,195,0,3,0,139,0,0,279,124,0,331,0,0,0
61333,8109,2020-11-18T16:16:38.5957178Z,2016,340,57,182,194,0,1,1,146,0,0,283,158,0,339,0,0,0
61333,8110,2020-11-18T16:16:38.5957178Z,2017,288,58,170,179,0,2,0,109,0,0,230,118,0,286,0,0,0
61333,8111,2020-11-18T16:16:38.5957178Z,2018,291,49,170,175,0,3,0,116,0,0,242,121,0,288,0,0,0
61333,8112,2020-11-18T16:16:38.5967187Z,2019,287,65,177,164,0,3,0,123,0,0,222,110,0,284,0,0,0
61333,8113,2020-11-18T16:16:38.5967187Z,2020,277,59,175,162,0,4,0,115,0,0,218,102,2,271,0,0,0
40022,25813,2021-06-24T05:35:10.9026344Z,2021,864,170,587,486,0,7,1,378,0,0,694,277,0,855,17,2,2
40022,4581,2020-11-18T16:16:13.2057877Z,2012,720,2,456,409,0,6,0,311,0,0,718,264,1,712,0,0,1
40022,4582,2020-11-18T16:16:13.2057877Z,2013,750,3,484,418,0,15,0,332,0,0,747,266,4,731,0,3,0
40022,4583,2020-11-18T16:16:13.2057877Z,2014,743,11,483,386,0,14,0,357,0,0,732,260,4,725,0,7,0
40022,4584,2020-11-18T16:16:13.2057877Z,2015,795,4,493,439,0,5,0,356,0,0,791,302,1,789,0,8,0
40022,4585,2020-11-18T16:16:13.2067886Z,2016,819,56,357,439,0,15,0,380,0,0,763,462,0,804,0,3,0
40022,4586,2020-11-18T16:16:13.2067886Z,2017,804,66,483,429,0,9,1,375,0,0,738,321,0,795,0,1,0
40022,4587,2020-11-18T16:16:13.2067886Z,2018,832,59,476,459,0,13,22,373,0,1,773,356,1,817,10,0,1
40022,4588,2020-11-18T16:16:13.2067886Z,2019,901,92,544,495,0,19,6,406,0,1,809,357,0,880,22,0,2
40022,4589,2020-11-18T16:16:13.2067886Z,2020,828,155,484,467,0,17,0,361,0,0,673,344,0,810,17,1,1
10439,100,2020-11-18T16:15:45.5563493Z,2013,476,206,259,231,0,7,0,245,0,0,270,217,0,469,0,0,0
10439,101,2020-11-18T16:15:46.3658903Z,2014,587,247,399,283,0,4,0,304,0,0,340,188,0,583,0,1,0
10439,102,2020-11-18T16:15:46.3658903Z,2015,637,251,431,296,0,2,0,341,0,0,386,206,0,635,0,0,0
10439,103,2020-11-18T16:15:46.3658903Z,2016,580,247,218,264,0,3,0,316,0,0,333,362,0,577,0,1,0
10439,104,2020-11-18T16:15:46.3658903Z,2017,558,224,396,262,0,1,1,296,0,0,334,162,2,555,0,2,0
10439,105,2020-11-18T16:15:46.3658903Z,2018,490,186,359,233,0,1,1,257,0,0,304,131,0,489,2,1,0
10439,106,2020-11-18T16:15:46.3668911Z,2019,599,253,453,288,0,3,0,311,0,0,346,146,0,596,2,0,0
10439,107,2020-11-18T16:15:46.3668911Z,2020,574,227,428,281,0,1,0,293,0,0,347,146,0,573,3,0,0
10439,31582,2021-06-24T05:35:14.5222292Z,2021,547,223,446,272,0,0,1,275,0,0,324,101,0,547,3,0,0
10439,99,2020-11-18T16:15:45.5563493Z,2012,472,179,283,237,0,7,0,235,0,0,293,189,0,465,0,0,0
17707,1423,2020-11-18T16:15:54.7614928Z,2012,237,55,175,120,0,4,0,117,0,0,182,62,0,233,0,0,0
17707,1424,2020-11-18T16:15:54.7614928Z,2013,191,49,139,93,0,5,0,98,0,0,142,52,0,186,0,3,0
17707,1425,2020-11-18T16:15:54.7614928Z,2014,181,40,137,86,0,3,0,95,0,0,141,44,0,178,0,2,0
17707,1426,2020-11-18T16:15:54.7614928Z,2015,167,50,137,79,0,1,0,88,0,0,117,30,0,166,0,2,0
17707,1427,2020-11-18T16:15:54.7624928Z,2016,166,45,131,82,0,0,0,84,0,0,121,35,0,166,0,2,0
17707,1428,2020-11-18T16:15:54.7624928Z,2017,136,44,112,58,0,1,0,78,0,0,92,24,0,135,0,3,0
17707,1429,2020-11-18T16:15:54.7624928Z,2018,169,48,135,74,0,0,0,95,0,0,121,34,0,169,0,2,0
17707,1430,2020-11-18T16:15:54.7624928Z,2019,149,47,126,65,0,0,0,84,0,0,102,23,0,149,0,2,0
17707,1431,2020-11-18T16:15:54.7634936Z,2020,137,33,113,61,0,0,0,76,0,0,104,24,0,137,0,1,0
17707,25871,2021-06-24T05:35:11.0057081Z,2021,123,25,105,57,0,3,0,66,0,0,98,18,0,120,0,1,0
71647,10388,2020-11-18T16:16:54.3322123Z,2012,475,126,339,228,0,11,0,247,0,0,349,136,0,464,0,0,0
71647,10389,2020-11-18T16:16:54.3332128Z,2013,438,131,281,218,0,7,0,220,0,0,307,157,1,430,0,5,0
71647,10390,2020-11-18T16:16:54.3332128Z,2014,428,141,304,211,0,8,0,217,0,0,287,124,1,419,0,0,0
71647,10391,2020-11-18T16:16:54.3332128Z,2015,422,129,300,206,0,9,0,216,0,0,293,122,1,412,0,2,0
71647,10392,2020-11-18T16:16:54.3332128Z,2016,330,108,57,145,0,8,0,185,0,0,222,273,0,322,0,1,0
71647,10393,2020-11-18T16:16:54.3332128Z,2017,295,109,210,133,0,13,0,162,0,0,186,85,0,282,0,1,0
71647,10394,2020-11-18T16:16:54.3332128Z,2018,315,112,222,148,0,13,1,167,0,0,203,93,0,302,1,1,0
71647,10395,2020-11-18T16:16:54.3342132Z,2019,415,183,303,189,0,13,10,226,0,0,232,112,0,400,1,1,2
71647,10396,2020-11-18T16:16:54.3342132Z,2020,382,151,308,168,0,9,0,214,0,0,231,74,0,372,1,0,1
71647,25674,2021-06-24T05:35:04.7402156Z,2021,349,141,296,164,0,6,0,185,0,0,208,53,0,343,0,0,0
46003,31851,2021-06-24T05:35:16.9809924Z,2021,421,131,330,196,0,5,0,225,0,0,290,91,0,416,3,2,0
46003,5839,2020-11-18T16:16:22.5750346Z,2012,432,29,344,193,0,7,0,239,0,0,403,88,0,425,0,0,0
46003,5840,2020-11-18T16:16:22.5760351Z,2013,477,61,342,232,0,15,0,245,0,0,416,135,0,462,0,3,0
46003,5841,2020-11-18T16:16:22.5760351Z,2014,493,91,352,259,0,9,0,234,0,0,402,141,0,483,0,1,1
46003,5842,2020-11-18T16:16:22.5760351Z,2015,534,103,389,274,0,6,0,260,0,0,431,145,0,526,0,2,2
46003,5843,2020-11-18T16:16:22.5770351Z,2016,505,112,304,238,0,5,3,267,0,0,393,201,0,500,0,1,0
46003,5844,2020-11-18T16:16:22.5770351Z,2017,472,124,316,215,0,5,1,257,0,0,348,156,0,466,0,4,1
46003,5845,2020-11-18T16:16:22.5770351Z,2018,351,106,265,159,0,6,7,192,0,0,245,86,0,343,0,4,2
46003,5846,2020-11-18T16:16:22.5780364Z,2019,536,167,428,246,0,7,1,290,0,0,369,108,0,529,2,6,0
46003,5847,2020-11-18T16:16:22.5780364Z,2020,451,159,371,198,0,11,3,253,0,0,292,80,0,440,3,6,0
61655,31954,2021-06-24T05:35:18.5671314Z,2021,471,152,400,233,0,103,0,238,0,0,319,71,1,363,0,0,4
61655,8345,2020-11-18T16:16:39.7875137Z,2012,357,32,222,151,0,41,0,206,0,0,325,135,0,316,0,0,0
61655,8346,2020-11-18T16:16:39.7875137Z,2013,270,40,214,108,0,46,0,162,0,0,230,56,0,224,0,0,0
61655,8347,2020-11-18T16:16:39.7875137Z,2014,362,79,326,140,0,53,0,222,0,0,283,36,0,306,0,0,3
61655,8348,2020-11-18T16:16:39.7885137Z,2015,339,85,317,131,0,42,0,208,0,0,254,22,0,293,0,0,4
61655,8349,2020-11-18T16:16:39.7885137Z,2016,326,104,283,159,0,36,5,167,0,0,222,43,0,288,0,0,2
61655,8350,2020-11-18T16:16:39.7885137Z,2017,429,126,410,211,0,62,3,218,0,0,303,19,0,367,0,0,0
61655,8351,2020-11-18T16:16:39.7885137Z,2018,304,93,278,148,0,57,1,156,0,0,211,26,0,245,0,0,2
61655,8352,2020-11-18T16:16:39.789515Z,2019,495,121,456,245,0,111,2,250,0,0,374,39,2,378,0,0,4
61655,8353,2020-11-18T16:16:39.789515Z,2020,508,153,476,257,0,115,4,251,0,0,355,32,1,388,0,0,4
61622,25952,2021-06-24T05:35:12.873047Z,2021,257,96,237,134,0,16,8,123,0,0,161,20,0,241,0,1,0
61622,8322,2020-11-18T16:16:39.7815105Z,2012,416,172,370,207,0,35,0,209,0,0,244,46,0,381,0,0,0
61622,8323,2020-11-18T16:16:39.7825101Z,2013,431,173,380,205,0,38,0,226,0,0,258,51,2,391,0,1,0
61622,8324,2020-11-18T16:16:39.7825101Z,2014,391,157,351,202,0,36,0,189,0,0,234,40,0,355,0,3,0
61622,8325,2020-11-18T16:16:39.7825101Z,2015,362,142,316,183,0,26,0,179,0,0,220,46,0,336,0,3,0
61622,8326,2020-11-18T16:16:39.7825101Z,2016,247,87,210,126,0,14,2,121,0,0,160,37,0,233,0,1,0
61622,8327,2020-11-18T16:16:39.7835105Z,2017,214,76,191,95,0,12,7,119,0,0,138,23,0,202,0,1,0
61622,8328,2020-11-18T16:16:39.7835105Z,2018,183,69,157,76,0,16,10,107,0,0,114,26,0,167,0,1,0
61622,8329,2020-11-18T16:16:39.7835105Z,2019,241,93,207,115,0,18,12,126,0,0,148,34,0,223,0,1,0
61622,8330,2020-11-18T16:16:39.7835105Z,2020,246,84,215,124,0,17,4,122,0,0,162,31,0,228,0,1,1
15792,1269,2020-11-18T16:15:53.6087218Z,2012,545,0,336,298,0,36,0,247,0,0,545,209,0,509,0,0,0
15792,1270,2020-11-18T16:15:53.6087218Z,2013,552,0,353,306,0,32,0,246,0,0,552,199,1,519,0,2,0
15792,1271,2020-11-18T16:15:53.6097222Z,2014,541,22,357,303,0,22,0,238,0,0,519,184,0,519,0,4,0
15792,1272,2020-11-18T16:15:53.6097222Z,2015,503,73,395,224,0,13,0,279,0,0,430,108,3,487,0,3,0
15792,1273,2020-11-18T16:15:53.6097222Z,2016,558,165,304,253,0,15,0,305,0,0,393,254,2,541,0,3,0
15792,1274,2020-11-18T16:15:53.6097222Z,2017,650,183,465,292,0,18,0,358,0,0,467,185,0,632,0,6,0
15792,1275,2020-11-18T16:15:53.6097222Z,2018,748,200,561,349,0,16,10,399,0,0,548,187,0,732,7,5,0
15792,1276,2020-11-18T16:15:53.6107231Z,2019,766,208,577,353,0,21,5,413,0,0,558,189,0,745,7,5,0
15792,1277,2020-11-18T16:15:53.6107231Z,2020,763,265,572,359,0,25,10,404,0,0,498,191,0,738,6,4,0
15792,25812,2021-06-24T05:35:10.9026344Z,2021,751,271,549,365,0,26,0,386,0,0,480,202,0,725,4,2,0
70136,31644,2021-06-24T05:35:14.6553244Z,2021,356,114,320,174,0,12,0,182,0,0,242,36,0,342,0,0,2
70136,9475,2020-11-18T16:16:48.5273457Z,2012,270,122,248,132,0,6,0,138,0,0,148,22,0,261,0,0,3
70136,9476,2020-11-18T16:16:48.5283461Z,2013,218,84,194,114,0,4,0,104,0,0,134,24,0,211,0,1,3
70136,9477,2020-11-18T16:16:48.5283461Z,2014,307,114,231,149,0,5,0,158,0,0,193,76,0,297,0,2,5
70136,9478,2020-11-18T16:16:48.5283461Z,2015,358,155,311,175,0,5,0,183,0,0,203,47,0,348,0,3,5
70136,9479,2020-11-18T16:16:48.5283461Z,2016,336,132,176,156,0,6,0,180,0,0,204,160,0,326,0,3,4
70136,9480,2020-11-18T16:16:48.5293724Z,2017,303,120,246,148,0,8,2,155,0,0,183,57,0,290,0,3,5
70136,9481,2020-11-18T16:16:48.5293724Z,2018,342,129,247,167,0,14,1,175,0,0,213,95,0,325,0,1,3
70136,9482,2020-11-18T16:16:48.5293724Z,2019,349,147,303,180,0,7,0,169,0,0,202,46,0,339,0,0,3
70136,9483,2020-11-18T16:16:48.5293724Z,2020,350,126,311,174,0,12,0,176,0,0,224,39,0,335,0,1,3
70490,25651,2021-06-24T05:35:04.6991859Z,2021,396,193,358,179,0,10,0,217,0,0,203,38,4,382,0,5,0
70490,9714,2020-11-18T16:16:50.465634Z,2012,230,48,192,95,0,14,0,135,0,0,182,38,0,216,0,0,0
70490,9715,2020-11-18T16:16:50.465634Z,2013,272,103,218,115,0,10,0,157,0,0,169,54,0,262,0,3,0
70490,9716,2020-11-18T16:16:50.465634Z,2014,424,182,332,205,0,14,0,219,0,0,242,92,0,410,0,2,0
70490,9717,2020-11-18T16:16:50.465634Z,2015,422,174,326,205,0,24,0,217,0,0,248,96,0,398,0,3,0
70490,9718,2020-11-18T16:16:50.465634Z,2016,482,206,365,224,0,20,0,258,0,0,276,117,0,462,0,2,0
70490,9719,2020-11-18T16:16:50.4666353Z,2017,521,234,416,236,0,19,3,285,0,0,287,105,0,502,0,3,0
70490,9720,2020-11-18T16:16:50.4666353Z,2018,455,178,370,195,0,20,3,260,0,0,277,85,0,435,0,2,0
70490,9721,2020-11-18T16:16:50.4666353Z,2019,417,188,346,184,0,14,1,233,0,0,229,71,0,403,0,1,0
70490,9722,2020-11-18T16:16:50.4676353Z,2020,384,186,335,169,0,19,0,215,0,0,198,49,0,365,0,2,0
52084,25890,2021-06-24T05:35:12.7829829Z,2021,125,40,122,61,0,0,0,64,0,0,85,3,0,124,0,0,1
52084,6691,2020-11-18T16:16:28.2608261Z,2012,233,75,219,108,0,5,0,125,0,0,158,14,0,228,0,0,0
52084,6692,2020-11-18T16:16:28.2618265Z,2013,242,76,231,120,0,7,0,122,0,0,166,11,1,234,0,6,0
52084,6693,2020-11-18T16:16:28.2618265Z,2014,182,63,168,88,0,2,0,94,0,0,119,14,0,180,0,1,0
52084,6694,2020-11-18T16:16:28.2618265Z,2015,194,56,167,99,0,1,0,95,0,0,138,27,0,193,0,1,0
52084,6695,2020-11-18T16:16:28.2628278Z,2016,159,50,62,81,0,0,0,78,0,0,109,97,0,159,0,1,0
52084,6696,2020-11-18T16:16:28.2628278Z,2017,105,33,101,56,0,3,0,49,0,0,72,4,0,102,0,0,0
52084,6697,2020-11-18T16:16:28.2628278Z,2018,137,53,132,74,0,2,0,63,0,0,84,5,0,135,1,0,0
52084,6698,2020-11-18T16:16:28.2638292Z,2019,160,65,155,94,0,1,0,66,0,0,95,5,0,159,1,0,0
52084,6699,2020-11-18T16:16:28.2638292Z,2020,152,51,145,75,0,0,4,77,0,0,101,7,0,151,1,0,1
61663,25953,2021-06-24T05:35:12.8750485Z,2021,255,95,209,126,0,9,5,129,0,0,160,46,0,246,0,0,0
61663,8354,2020-11-18T16:16:39.7905159Z,2012,118,1,109,64,0,9,0,54,0,0,117,9,0,109,0,0,0
61663,8355,2020-11-18T16:16:39.7915163Z,2013,133,17,119,68,0,4,0,65,0,0,116,14,0,129,0,0,0
61663,8356,2020-11-18T16:16:39.7915163Z,2014,240,52,195,113,0,15,0,127,0,0,188,45,0,225,0,0,0
61663,8357,2020-11-18T16:16:39.7915163Z,2015,251,46,205,129,0,7,0,122,0,0,205,46,0,244,0,0,0
61663,8358,2020-11-18T16:16:39.7915163Z,2016,247,70,189,130,0,6,1,117,0,0,177,58,0,241,0,0,0
61663,8359,2020-11-18T16:16:39.7915163Z,2017,257,69,199,129,0,2,2,128,0,0,188,58,0,255,0,0,0
61663,8360,2020-11-18T16:16:39.7925168Z,2018,296,76,241,154,0,5,5,142,0,0,220,55,0,291,0,0,0
61663,8361,2020-11-18T16:16:39.7925168Z,2019,276,70,213,136,0,10,18,140,0,0,206,63,0,266,0,1,0
61663,8362,2020-11-18T16:16:39.7925168Z,2020,279,96,215,143,0,5,8,136,0,0,183,64,0,273,0,0,1
65003,25978,2021-06-24T05:35:14.4982124Z,2021,458,105,389,223,0,38,0,235,0,0,353,69,0,418,0,2,2
65003,9014,2020-11-18T16:16:44.8799089Z,2012,429,7,244,205,0,31,0,224,0,0,422,185,0,396,0,0,2
65003,9015,2020-11-18T16:16:44.8799089Z,2013,640,12,406,328,0,53,0,312,0,0,628,234,1,584,0,4,2
65003,9016,2020-11-18T16:16:44.8809103Z,2014,504,24,363,274,0,32,0,230,0,0,480,141,0,469,0,3,3
65003,9017,2020-11-18T16:16:44.8809103Z,2015,461,32,342,238,0,25,0,223,0,0,429,119,0,435,0,1,1
65003,9018,2020-11-18T16:16:44.8809103Z,2016,476,66,319,237,0,25,0,239,0,0,410,157,1,448,0,0,2
65003,9019,2020-11-18T16:16:44.8809103Z,2017,490,65,373,257,0,29,4,233,0,0,425,117,1,460,0,0,0
65003,9020,2020-11-18T16:16:44.8809103Z,2018,752,118,592,394,0,57,1,358,0,0,634,160,2,693,0,1,0
65003,9021,2020-11-18T16:16:44.8819103Z,2019,574,104,455,284,0,33,2,290,0,0,470,119,0,540,0,1,1
65003,9022,2020-11-18T16:16:44.8819103Z,2020,475,113,375,233,0,34,1,242,0,0,362,100,0,439,0,2,2
20362,1700,2020-11-18T16:15:56.6087191Z,2012,571,0,380,319,0,0,0,252,0,0,571,191,0,571,0,0,0
20362,1701,2020-11-18T16:15:57.3922432Z,2013,545,1,357,279,0,1,0,266,0,0,544,188,0,544,0,3,0
20362,1702,2020-11-18T16:15:57.3932445Z,2014,531,35,347,281,0,1,0,250,0,0,496,184,0,528,0,2,2
20362,1703,2020-11-18T16:15:57.3932445Z,2015,551,26,364,282,0,3,0,269,0,0,525,187,1,547,0,0,0
20362,1704,2020-11-18T16:15:57.3932445Z,2016,512,60,287,274,0,2,1,238,0,0,452,225,1,509,0,0,0
20362,1705,2020-11-18T16:15:57.3942454Z,2017,567,119,373,303,0,1,1,264,0,0,448,194,2,564,0,0,0
20362,1706,2020-11-18T16:15:57.3942454Z,2018,594,120,383,317,0,2,1,277,0,0,474,211,1,590,1,1,1
20362,1707,2020-11-18T16:15:57.3942454Z,2019,529,125,356,266,0,2,4,263,0,0,404,173,0,526,1,1,1
20362,1708,2020-11-18T16:15:57.3942454Z,2020,491,158,334,258,0,0,0,233,0,0,333,157,0,490,0,0,1
20362,31692,2021-06-24T05:35:15.3057912Z,2021,480,161,347,250,0,0,0,230,0,0,319,133,0,480,1,0,0
71043,10011,2020-11-18T16:16:52.5730422Z,2012,443,104,358,228,0,5,0,215,0,0,339,85,0,438,0,0,0
71043,10012,2020-11-18T16:16:52.5730422Z,2013,445,124,358,237,0,2,0,208,0,0,321,87,0,443,0,0,0
71043,10013,2020-11-18T16:16:52.5730422Z,2014,393,120,320,217,0,3,0,176,0,0,273,73,0,389,0,1,1
71043,10014,2020-11-18T16:16:52.5730422Z,2015,354,103,270,199,0,3,0,155,0,0,251,84,0,350,0,0,1
71043,10015,2020-11-18T16:16:52.5730422Z,2016,301,98,46,160,0,1,5,141,0,0,203,255,0,298,0,0,2
71043,10016,2020-11-18T16:16:52.5740422Z,2017,296,98,235,153,0,1,8,143,0,0,198,61,0,294,0,0,1
71043,10017,2020-11-18T16:16:52.5740422Z,2018,399,120,335,200,0,3,8,199,0,0,279,64,0,394,0,2,2
71043,10018,2020-11-18T16:16:52.5740422Z,2019,479,151,423,232,0,4,4,247,0,0,328,56,0,473,0,1,2
71043,10019,2020-11-18T16:16:52.5740422Z,2020,499,182,426,247,0,2,6,252,0,0,317,73,0,495,0,0,2
71043,25663,2021-06-24T05:35:04.7352126Z,2021,496,180,435,240,0,4,6,256,0,0,316,61,0,491,1,0,1
20818,1948,2020-11-18T16:15:58.498982Z,2012,599,1,464,303,0,3,0,296,0,0,598,135,0,596,0,0,0
20818,1949,2020-11-18T16:15:58.498982Z,2013,554,5,410,259,0,2,0,295,0,0,549,144,0,552,0,3,0
20818,1950,2020-11-18T16:15:58.498982Z,2014,445,29,349,206,0,2,0,239,0,0,416,96,0,443,0,1,0
20818,1951,2020-11-18T16:15:58.4999834Z,2015,389,44,306,186,0,2,0,203,0,0,345,83,0,387,0,1,0
20818,1952,2020-11-18T16:15:58.4999834Z,2016,397,88,303,179,0,0,1,218,0,0,309,94,0,396,0,0,1
20818,1953,2020-11-18T16:15:58.4999834Z,2017,404,103,324,186,0,2,4,218,0,0,301,80,0,399,0,3,3
20818,1954,2020-11-18T16:15:58.4999834Z,2018,377,98,307,184,0,3,2,193,0,0,279,70,0,371,0,4,3
20818,1955,2020-11-18T16:15:58.4999834Z,2019,336,124,269,166,0,2,0,170,0,0,212,67,0,333,0,1,1
20818,1956,2020-11-18T16:15:58.5009838Z,2020,327,167,267,148,0,0,1,179,0,0,160,60,0,326,0,1,1
20818,25700,2021-06-24T05:35:08.659026Z,2021,261,138,211,99,0,2,0,162,0,0,123,50,0,259,0,0,0
63073,31972,2021-06-24T05:35:20.2793585Z,2021,245,69,223,116,0,3,0,129,0,0,176,22,0,240,0,1,2
63073,8845,2020-11-18T16:16:43.9102614Z,2012,311,82,287,149,0,10,0,162,0,0,229,24,0,292,0,0,9
63073,8846,2020-11-18T16:16:43.9102614Z,2013,300,85,284,141,0,13,0,159,0,0,215,16,0,279,0,0,8
63073,8847,2020-11-18T16:16:43.9102614Z,2014,279,86,262,131,0,11,0,148,0,0,193,17,0,264,0,0,4
63073,8848,2020-11-18T16:16:43.9112632Z,2015,306,91,296,163,0,11,0,143,0,0,215,10,0,294,0,0,1
63073,8849,2020-11-18T16:16:43.9112632Z,2016,349,101,331,172,0,10,0,177,0,0,248,18,0,338,0,0,1
63073,8850,2020-11-18T16:16:43.9112632Z,2017,299,89,281,150,0,12,0,149,0,0,210,18,0,287,0,0,0
63073,8851,2020-11-18T16:16:43.9112632Z,2018,294,76,269,152,0,19,1,142,0,0,218,25,0,273,0,0,2
63073,8852,2020-11-18T16:16:43.9112632Z,2019,301,90,283,149,0,12,2,152,0,0,211,18,0,285,0,1,4
63073,8853,2020-11-18T16:16:43.9122632Z,2020,267,85,254,121,0,5,1,146,0,0,182,13,0,257,0,1,5
57877,25927,2021-06-24T05:35:12.8260131Z,2021,475,175,367,235,0,12,0,240,0,0,300,108,0,463,9,3,0
57877,7757,2020-11-18T16:16:35.9139321Z,2012,565,44,433,279,0,0,0,286,0,0,521,132,0,565,0,0,0
57877,7758,2020-11-18T16:16:35.9139321Z,2013,517,67,399,248,0,3,0,269,0,0,450,118,0,514,0,2,0
57877,7759,2020-11-18T16:16:35.9149326Z,2014,511,99,383,234,0,7,0,277,0,0,412,128,0,504,0,0,0
57877,7760,2020-11-18T16:16:35.9149326Z,2015,470,84,349,219,0,10,0,251,0,0,386,121,0,460,0,0,0
57877,7761,2020-11-18T16:16:35.9149326Z,2016,449,115,113,211,0,10,9,238,0,0,334,336,0,439,0,0,0
57877,7762,2020-11-18T16:16:35.9149326Z,2017,443,134,328,216,0,12,8,227,0,0,309,115,0,431,0,1,0
57877,7763,2020-11-18T16:16:35.9149326Z,2018,474,130,338,233,0,9,42,241,0,0,344,136,0,465,3,1,0
57877,7764,2020-11-18T16:16:35.9159339Z,2019,466,131,319,236,0,16,10,230,0,0,335,147,0,450,6,3,0
57877,7765,2020-11-18T16:16:35.9159339Z,2020,453,161,322,225,0,8,0,228,0,0,292,131,0,445,5,2,0
66001,31983,2021-06-24T05:35:20.2853619Z,2021,317,115,282,160,0,8,0,157,0,0,202,35,0,309,0,0,0
66001,9132,2020-11-18T16:16:45.4953203Z,2012,386,128,276,180,0,10,0,206,0,0,258,110,1,375,0,0,0
66001,9133,2020-11-18T16:16:45.4963216Z,2013,355,124,278,162,0,8,0,193,0,0,231,77,0,347,0,1,0
66001,9134,2020-11-18T16:16:45.4963216Z,2014,327,115,246,149,0,8,0,178,0,0,212,81,0,319,0,0,0
66001,9135,2020-11-18T16:16:45.4963216Z,2015,326,107,278,156,0,7,0,170,0,0,219,48,1,318,0,1,0
66001,9136,2020-11-18T16:16:45.4973211Z,2016,276,98,149,133,0,7,5,143,0,0,178,127,0,269,0,3,0
66001,9137,2020-11-18T16:16:45.4973211Z,2017,285,105,265,152,0,7,5,133,0,0,180,20,0,278,0,3,0
66001,9138,2020-11-18T16:16:45.4973211Z,2018,189,62,170,102,1,0,0,87,0,0,127,19,0,189,0,1,0
66001,9139,2020-11-18T16:16:45.4983216Z,2019,367,144,323,188,0,7,1,179,0,0,223,44,0,360,0,0,0
66001,9140,2020-11-18T16:16:45.4983216Z,2020,349,127,286,184,0,7,3,165,0,0,222,63,0,342,0,0,0
12872,25600,2021-06-24T05:35:04.6151256Z,2021,144,81,113,63,0,4,0,81,0,0,63,31,0,140,5,1,0
12872,874,2020-11-18T16:15:51.341208Z,2012,325,59,265,154,0,2,0,171,0,0,266,60,0,323,0,0,0
12872,875,2020-11-18T16:15:51.341208Z,2013,304,92,235,145,0,2,0,159,0,0,212,69,0,302,0,3,0
12872,876,2020-11-18T16:15:51.341208Z,2014,295,107,241,137,0,0,0,158,0,0,188,54,0,295,0,1,0
12872,877,2020-11-18T16:15:51.3422084Z,2015,258,95,213,122,0,1,0,136,0,0,163,45,0,257,0,1,0
12872,878,2020-11-18T16:15:51.3422084Z,2016,221,84,172,94,0,1,1,127,0,0,137,49,0,220,0,1,0
12872,879,2020-11-18T16:15:51.3422084Z,2017,243,104,195,101,0,2,1,142,0,0,139,48,0,240,0,3,1
12872,880,2020-11-18T16:15:51.3422084Z,2018,230,88,189,102,0,2,5,128,0,0,142,41,0,227,0,1,1
12872,881,2020-11-18T16:15:51.3422084Z,2019,180,66,152,90,0,1,2,90,0,0,114,28,0,178,2,0,1
12872,882,2020-11-18T16:15:51.3432089Z,2020,151,71,120,71,0,3,0,80,0,0,80,31,0,148,4,0,0
27540,3038,2020-11-18T16:16:04.728138Z,2012,303,48,230,161,0,3,0,142,0,0,255,73,0,300,0,0,0
27540,3039,2020-11-18T16:16:04.729138Z,2013,177,50,130,83,0,4,0,94,0,0,127,47,0,173,0,0,0
27540,3040,2020-11-18T16:16:04.729138Z,2014,381,122,282,165,0,8,0,216,0,0,259,99,0,373,0,0,0
27540,3041,2020-11-18T16:16:04.729138Z,2015,543,173,434,251,0,9,0,292,0,0,370,109,0,534,0,0,0
27540,3042,2020-11-18T16:16:04.729138Z,2016,499,194,171,241,0,6,3,258,0,0,305,328,0,493,0,0,0
27540,3043,2020-11-18T16:16:04.729138Z,2017,430,166,353,212,0,6,6,218,0,0,264,77,0,424,0,0,0
27540,3044,2020-11-18T16:16:04.7301385Z,2018,430,155,344,216,0,3,0,214,0,0,275,86,0,427,0,0,0
27540,3045,2020-11-18T16:16:04.7301385Z,2019,284,100,223,137,0,0,4,147,0,0,184,61,0,283,0,0,1
27540,3046,2020-11-18T16:16:04.7301385Z,2020,243,86,192,122,0,0,6,121,0,0,157,51,0,243,0,0,0
27540,31735,2021-06-24T05:35:15.4068648Z,2021,211,79,161,100,0,0,6,111,0,0,132,50,0,211,0,0,0
31286,25766,2021-06-24T05:35:08.7430854Z,2021,264,41,243,144,0,9,0,120,0,0,223,21,2,253,0,0,0
31286,3625,2020-11-18T16:16:08.0363412Z,2012,489,81,471,233,0,16,0,256,0,0,408,18,2,471,0,0,0
31286,3626,2020-11-18T16:16:08.0363412Z,2013,477,79,448,232,0,17,0,245,0,0,398,29,0,460,0,2,0
31286,3627,2020-11-18T16:16:08.0373421Z,2014,438,77,405,210,0,18,0,228,0,0,361,33,4,416,0,1,0
31286,3628,2020-11-18T16:16:08.0373421Z,2015,379,66,319,175,0,12,0,204,0,0,313,60,4,363,0,0,0
31286,3629,2020-11-18T16:16:08.0383435Z,2016,326,69,260,156,0,13,83,170,0,0,257,66,6,307,0,0,0
31286,3630,2020-11-18T16:16:08.0383435Z,2017,320,63,312,157,0,14,159,163,0,0,257,8,2,303,0,0,1
31286,3631,2020-11-18T16:16:08.0383435Z,2018,251,52,240,122,0,9,77,129,0,0,199,11,1,240,0,1,1
31286,3632,2020-11-18T16:16:08.0383435Z,2019,354,74,286,195,0,8,97,159,0,0,280,68,2,342,0,1,2
31286,3633,2020-11-18T16:16:08.039343Z,2020,318,51,303,167,0,16,64,151,0,0,267,15,2,299,0,1,1
55889,31917,2021-06-24T05:35:18.4890741Z,2021,246,103,193,121,0,6,0,125,0,0,143,53,0,239,0,0,1
55889,7523,2020-11-18T16:16:34.5240043Z,2012,317,109,258,169,0,11,0,148,0,0,208,59,0,306,0,0,0
55889,7524,2020-11-18T16:16:34.5240043Z,2013,307,100,239,165,0,8,0,142,0,0,207,68,0,299,0,4,0
55889,7525,2020-11-18T16:16:34.5240043Z,2014,305,117,237,158,0,6,0,147,0,0,188,68,0,299,0,1,0
55889,7526,2020-11-18T16:16:34.5240043Z,2015,305,118,240,153,0,5,0,152,0,0,187,65,1,299,0,6,0
55889,7527,2020-11-18T16:16:34.5240043Z,2016,275,108,219,133,0,5,0,142,0,0,167,56,0,270,0,3,0
55889,7528,2020-11-18T16:16:34.5250065Z,2017,257,107,203,122,0,4,0,135,0,0,150,54,0,253,0,2,0
55889,7529,2020-11-18T16:16:34.5250065Z,2018,347,134,265,174,0,17,57,173,0,0,213,82,0,330,3,2,0
55889,7530,2020-11-18T16:16:34.5250065Z,2019,299,140,235,139,0,13,10,160,0,0,159,64,0,286,0,1,0
55889,7531,2020-11-18T16:16:34.5260048Z,2020,267,118,216,132,0,12,0,135,0,0,149,51,1,254,0,1,0
57299,31925,2021-06-24T05:35:18.5251003Z,2021,73,4,32,27,0,2,4,46,0,0,69,41,2,68,0,1,1
57299,7685,2020-11-18T16:16:35.1154Z,2012,397,64,362,178,0,4,0,219,0,0,333,35,2,391,0,0,0
57299,7686,2020-11-18T16:16:35.1154Z,2013,372,92,349,161,0,10,0,211,0,0,280,23,1,361,0,2,0
57299,7687,2020-11-18T16:16:35.1154Z,2014,338,100,311,155,0,10,0,183,0,0,238,27,0,328,0,4,0
57299,7688,2020-11-18T16:16:35.1164005Z,2015,281,90,258,124,0,5,0,157,0,0,191,23,0,276,0,1,0
57299,7689,2020-11-18T16:16:35.1164005Z,2016,217,70,198,95,0,5,0,122,0,0,147,19,0,212,0,1,0
57299,7690,2020-11-18T16:16:35.1164005Z,2017,161,58,144,75,0,8,0,86,0,0,103,17,0,153,0,3,0
57299,7691,2020-11-18T16:16:35.1164005Z,2018,131,1,72,63,0,0,4,68,0,0,130,59,0,131,0,0,0
57299,7692,2020-11-18T16:16:35.1174005Z,2019,124,1,61,53,0,2,0,71,0,0,123,63,0,122,0,0,0
57299,7693,2020-11-18T16:16:35.1174005Z,2020,102,3,54,40,0,2,0,62,0,0,99,48,1,99,0,1,0
71670,10415,2020-11-18T16:16:54.7134651Z,2012,678,0,436,381,0,38,0,297,0,0,678,242,0,640,0,0,0
71670,10416,2020-11-18T16:16:54.7134651Z,2013,785,1,473,456,0,31,0,329,0,0,784,312,0,754,0,1,0
71670,10417,2020-11-18T16:16:54.714466Z,2014,735,33,436,414,0,25,0,321,0,0,702,299,0,710,0,0,0
71670,10418,2020-11-18T16:16:54.714466Z,2015,705,34,439,373,0,27,0,332,0,0,671,266,0,678,0,2,0
71670,10419,2020-11-18T16:16:54.714466Z,2016,902,125,542,461,0,34,4,441,0,0,777,360,0,865,0,3,3
71670,10420,2020-11-18T16:16:54.714466Z,2017,797,115,514,419,0,24,1,378,0,0,682,283,1,771,0,1,1
71670,10421,2020-11-18T16:16:54.7154664Z,2018,703,80,452,375,0,21,1,328,0,0,623,251,1,681,0,0,0
71670,10422,2020-11-18T16:16:54.7154664Z,2019,744,106,473,397,0,21,0,347,0,0,638,271,1,722,0,1,0
71670,10423,2020-11-18T16:16:54.7154664Z,2020,628,148,446,342,0,21,1,286,0,0,480,182,0,607,0,0,0
71670,31677,2021-06-24T05:35:15.281774Z,2021,599,142,455,301,0,15,0,298,0,0,457,144,0,583,1,1,1
42077,25828,2021-06-24T05:35:10.9256511Z,2021,952,363,810,444,0,25,0,508,0,0,589,142,2,925,1,1,0
42077,5119,2020-11-18T16:16:17.8088564Z,2012,1085,1,708,495,0,12,0,590,0,0,1084,377,1,1071,0,0,1
42077,5120,2020-11-18T16:16:17.8088564Z,2013,1040,18,817,514,0,17,0,526,0,0,1022,223,1,1019,0,3,3
42077,5121,2020-11-18T16:16:17.8088564Z,2014,1064,123,878,511,0,15,0,553,0,0,941,186,0,1047,0,2,2
42077,5122,2020-11-18T16:16:17.8088564Z,2015,1009,96,850,492,0,18,0,517,0,0,913,159,0,991,0,2,0
42077,5123,2020-11-18T16:16:17.8098568Z,2016,895,185,680,442,0,25,2,453,0,0,710,215,0,870,0,4,0
42077,5124,2020-11-18T16:16:17.8098568Z,2017,923,208,760,441,0,32,1,482,0,0,715,163,0,891,0,2,0
42077,5125,2020-11-18T16:16:17.8098568Z,2018,956,243,823,470,0,23,5,486,0,1,713,133,2,931,0,3,0
42077,5126,2020-11-18T16:16:17.8098568Z,2019,922,241,804,436,0,20,0,486,0,2,681,118,4,898,0,2,0
42077,5127,2020-11-18T16:16:17.8098568Z,2020,864,323,746,407,0,22,0,457,0,0,541,118,3,838,0,1,1
52688,25897,2021-06-24T05:35:12.7939906Z,2021,330,120,268,154,0,1,0,176,0,0,210,62,0,328,0,0,1
52688,6936,2020-11-18T16:16:30.8775743Z,2012,640,3,353,335,0,1,0,305,0,0,637,287,0,639,0,0,0
52688,6937,2020-11-18T16:16:30.8775743Z,2013,512,5,419,272,0,0,0,240,0,0,507,93,1,511,0,0,0
52688,6938,2020-11-18T16:16:30.8775743Z,2014,515,62,426,235,0,3,0,280,0,0,453,89,1,511,0,2,0
52688,6939,2020-11-18T16:16:30.8785743Z,2015,488,56,408,224,0,2,0,264,0,0,432,80,1,484,0,1,1
52688,6940,2020-11-18T16:16:30.8785743Z,2016,501,112,117,244,0,5,2,257,0,0,389,384,0,496,0,1,0
52688,6941,2020-11-18T16:16:30.8785743Z,2017,513,124,427,258,0,6,2,255,0,0,389,86,0,507,0,0,0
52688,6942,2020-11-18T16:16:30.8785743Z,2018,437,129,374,224,0,4,13,213,0,0,308,63,1,432,3,0,0
52688,6943,2020-11-18T16:16:30.8785743Z,2019,403,119,349,191,0,3,1,212,0,0,284,54,1,399,2,0,0
52688,6944,2020-11-18T16:16:30.8795761Z,2020,404,146,366,186,0,3,6,218,0,0,258,38,1,399,1,0,1
24810,2715,2020-11-18T16:16:03.2731661Z,2012,348,1,280,195,0,1,0,153,0,0,347,68,0,347,0,0,0
24810,2716,2020-11-18T16:16:03.2731661Z,2013,531,8,390,274,0,6,0,257,0,0,523,141,0,525,0,1,0
24810,2717,2020-11-18T16:16:03.2731661Z,2014,473,26,375,237,0,5,0,236,0,0,447,98,0,468,0,2,0
24810,2718,2020-11-18T16:16:03.2731661Z,2015,429,26,335,205,0,8,0,224,0,0,403,94,0,420,0,6,1
24810,2719,2020-11-18T16:16:03.2731661Z,2016,502,69,400,237,0,6,3,265,0,0,433,102,1,495,0,3,0
24810,2720,2020-11-18T16:16:03.2741661Z,2017,373,68,303,175,0,7,2,198,0,0,305,70,0,366,0,2,0
24810,2721,2020-11-18T16:16:03.2741661Z,2018,391,79,317,183,0,3,7,208,0,0,312,74,0,388,4,1,0
24810,2722,2020-11-18T16:16:03.2741661Z,2019,528,132,449,283,0,4,2,245,0,0,396,79,3,521,6,1,0
24810,2723,2020-11-18T16:16:03.2741661Z,2020,528,166,460,272,0,3,20,256,0,0,362,68,4,521,7,0,0
24810,31724,2021-06-24T05:35:15.3818467Z,2021,501,171,392,251,0,8,15,250,0,0,330,109,4,489,1,0,0
52522,25895,2021-06-24T05:35:12.7889872Z,2021,212,61,178,103,0,3,0,109,0,0,151,34,0,208,1,0,1
52522,6879,2020-11-18T16:16:30.1680997Z,2012,279,38,256,148,0,1,0,131,0,0,241,23,1,277,0,0,0
52522,6880,2020-11-18T16:16:30.1680997Z,2013,307,63,273,151,0,1,0,156,0,0,244,34,0,305,0,0,1
52522,6881,2020-11-18T16:16:30.1680997Z,2014,390,102,345,194,0,2,0,196,0,0,288,45,0,388,0,1,0
52522,6882,2020-11-18T16:16:30.1680997Z,2015,433,109,370,212,0,3,0,221,0,0,324,63,0,427,0,6,3
52522,6883,2020-11-18T16:16:30.1680997Z,2016,448,117,381,220,0,3,0,228,0,0,331,67,0,442,0,3,3
52522,6884,2020-11-18T16:16:30.169101Z,2017,460,141,391,221,0,2,2,239,0,0,319,69,0,457,0,1,1
52522,6885,2020-11-18T16:16:30.169101Z,2018,431,131,361,206,0,1,4,225,0,0,300,70,0,429,1,0,1
52522,6886,2020-11-18T16:16:30.169101Z,2019,282,93,232,142,0,0,1,140,0,0,189,50,0,279,0,0,3
52522,6887,2020-11-18T16:16:30.169101Z,2020,238,77,201,123,0,2,2,115,0,0,161,37,0,234,0,0,2
25627,25726,2021-06-24T05:35:08.6840428Z,2021,385,160,308,207,0,5,2,178,0,0,225,77,0,380,3,0,0
25627,2893,2020-11-18T16:16:03.7034535Z,2012,566,76,340,276,0,1,0,290,0,0,490,226,0,565,0,0,0
25627,2894,2020-11-18T16:16:03.7034535Z,2013,536,119,356,260,0,7,0,276,0,0,417,180,0,529,0,2,0
25627,2895,2020-11-18T16:16:03.7044535Z,2014,463,116,331,226,0,4,0,237,0,0,347,132,0,459,0,0,0
25627,2896,2020-11-18T16:16:03.7044535Z,2015,457,126,320,218,0,4,0,239,0,0,331,137,0,453,0,5,0
25627,2897,2020-11-18T16:16:03.7044535Z,2016,304,104,207,138,0,1,1,166,0,0,200,97,0,303,0,3,0
25627,2898,2020-11-18T16:16:03.705454Z,2017,295,99,201,136,0,1,0,159,0,0,196,94,1,293,0,1,0
25627,2899,2020-11-18T16:16:03.705454Z,2018,500,176,344,251,0,4,36,249,0,0,324,156,0,495,0,0,1
25627,2900,2020-11-18T16:16:03.705454Z,2019,469,167,334,247,0,4,2,222,0,0,302,135,0,463,0,0,2
25627,2901,2020-11-18T16:16:04.2598247Z,2020,406,163,301,206,0,2,1,200,0,0,243,105,0,403,3,0,1
30247,25756,2021-06-24T05:35:08.7260734Z,2021,286,75,232,142,0,3,2,144,0,0,211,54,0,281,1,1,2
30247,3282,2020-11-18T16:16:05.735809Z,2012,473,1,378,271,0,5,0,202,0,0,472,95,1,467,0,0,0
30247,3283,2020-11-18T16:16:05.735809Z,2013,499,3,365,269,0,9,0,230,0,0,496,134,2,488,0,1,0
30247,3284,2020-11-18T16:16:05.735809Z,2014,562,33,388,292,0,4,0,270,0,0,529,174,4,554,0,2,0
30247,3285,2020-11-18T16:16:05.7368099Z,2015,525,19,371,262,0,8,0,263,0,0,506,154,1,515,0,3,1
30247,3286,2020-11-18T16:16:05.7368099Z,2016,567,49,371,296,0,10,1,271,0,0,518,196,1,555,0,3,1
30247,3287,2020-11-18T16:16:05.7368099Z,2017,582,90,479,297,0,8,3,285,0,0,492,103,0,573,0,4,1
30247,3288,2020-11-18T16:16:05.7368099Z,2018,405,56,333,219,0,8,4,186,0,0,349,72,0,396,1,3,1
30247,3289,2020-11-18T16:16:05.7378108Z,2019,280,48,243,155,0,5,2,125,0,0,232,37,0,274,2,1,1
30247,3290,2020-11-18T16:16:05.7378108Z,2020,285,80,251,150,0,4,1,135,0,0,205,34,0,279,1,2,2
41699,25826,2021-06-24T05:35:10.9156439Z,2021,74,24,65,31,0,2,0,43,0,0,50,9,0,72,0,0,0
41699,5038,2020-11-18T16:16:17.0973843Z,2012,140,45,123,63,0,0,0,77,0,0,95,17,0,140,0,0,0
41699,5039,2020-11-18T16:16:17.0973843Z,2013,133,46,116,63,0,0,0,70,0,0,87,17,0,133,0,0,0
41699,5040,2020-11-18T16:16:17.0973843Z,2014,140,46,93,66,0,1,0,74,0,0,94,47,0,139,0,0,0
41699,5041,2020-11-18T16:16:17.0973843Z,2015,152,52,112,80,0,0,0,72,0,0,100,40,0,152,0,0,0
41699,5042,2020-11-18T16:16:17.0983852Z,2016,102,29,24,56,0,1,0,46,0,0,73,78,0,101,0,0,0
41699,5043,2020-11-18T16:16:17.0983852Z,2017,116,30,81,56,0,2,0,60,0,0,86,35,0,114,0,0,0
41699,5044,2020-11-18T16:16:17.0983852Z,2018,95,32,76,47,0,2,0,48,0,0,63,19,0,92,0,1,1
41699,5045,2020-11-18T16:16:17.0983852Z,2019,96,40,80,44,0,2,0,52,0,0,56,16,0,94,0,0,0
41699,5046,2020-11-18T16:16:17.0983852Z,2020,84,36,69,40,0,1,0,44,0,0,48,15,0,83,0,0,0
28076,25736,2021-06-24T05:35:08.6870452Z,2021,350,138,293,167,0,6,9,183,0,0,212,57,0,341,3,2,3
28076,3098,2020-11-18T16:16:04.7701652Z,2012,296,92,202,140,0,1,0,156,0,0,204,94,1,294,0,0,0
28076,3099,2020-11-18T16:16:04.7701652Z,2013,259,92,188,127,0,1,0,132,0,0,167,71,0,258,0,4,0
28076,3100,2020-11-18T16:16:04.7711661Z,2014,268,97,190,128,0,3,0,140,0,0,171,78,0,265,0,1,0
28076,3101,2020-11-18T16:16:05.3215337Z,2015,256,110,163,117,0,3,0,139,0,0,146,93,1,252,0,1,0
28076,3102,2020-11-18T16:16:05.3215337Z,2016,305,130,91,139,0,3,3,166,0,0,175,214,0,302,0,2,0
28076,3103,2020-11-18T16:16:05.3215337Z,2017,299,122,232,128,0,2,4,171,0,0,177,67,0,297,0,2,0
28076,3104,2020-11-18T16:16:05.3215337Z,2018,393,140,305,171,0,5,2,222,0,0,253,88,2,386,4,1,0
28076,3105,2020-11-18T16:16:05.3225342Z,2019,400,159,297,183,0,3,17,217,0,0,241,103,1,396,4,1,0
28076,3106,2020-11-18T16:16:05.3225342Z,2020,380,149,308,177,0,5,10,203,0,0,231,72,0,375,4,1,0
26773,2999,2020-11-18T16:16:04.2978506Z,2012,703,1,457,366,0,9,0,337,0,0,702,246,0,694,0,0,0
26773,3000,2020-11-18T16:16:04.2978506Z,2013,682,6,476,364,0,7,0,318,0,0,676,206,0,674,0,3,1
26773,3001,2020-11-18T16:16:04.7081247Z,2014,681,69,488,389,0,6,0,292,0,0,612,193,0,675,0,3,0
26773,3002,2020-11-18T16:16:04.7081247Z,2015,632,58,441,353,0,2,0,279,0,0,574,191,0,630,0,4,0
26773,3003,2020-11-18T16:16:04.7081247Z,2016,618,128,305,345,0,3,3,273,0,0,490,313,0,615,0,1,0
26773,3004,2020-11-18T16:16:04.7091282Z,2017,734,152,544,370,0,1,2,364,0,0,582,190,0,733,0,1,0
26773,3005,2020-11-18T16:16:04.7091282Z,2018,649,121,478,338,0,2,1,311,0,0,528,171,0,647,0,0,0
26773,3006,2020-11-18T16:16:04.7091282Z,2019,523,140,399,254,0,2,1,269,0,0,383,124,1,520,0,0,0
26773,3007,2020-11-18T16:16:04.7091282Z,2020,525,204,411,253,0,1,2,272,0,0,321,114,1,522,0,0,1
26773,31733,2021-06-24T05:35:15.4428898Z,2021,511,199,415,238,0,2,3,273,0,0,312,96,1,508,1,0,0
28563,31742,2021-06-24T05:35:15.4098672Z,2021,1135,244,835,595,0,15,6,540,0,0,891,300,4,1116,1,4,0
28563,3186,2020-11-18T16:16:05.347552Z,2012,1025,18,548,440,0,16,0,585,0,0,1007,477,0,1006,0,0,3
28563,3187,2020-11-18T16:16:05.3485516Z,2013,785,31,612,337,0,13,0,448,0,0,754,173,1,769,0,1,2
28563,3188,2020-11-18T16:16:05.3485516Z,2014,933,107,687,447,0,6,0,486,0,0,826,246,0,923,0,2,4
28563,3189,2020-11-18T16:16:05.3485516Z,2015,1010,84,740,463,0,13,0,547,0,0,926,270,3,991,0,2,3
28563,3190,2020-11-18T16:16:05.3485516Z,2016,1020,169,789,472,0,17,6,548,0,0,851,231,1,999,0,2,3
28563,3191,2020-11-18T16:16:05.3495529Z,2017,1191,212,879,585,0,22,9,606,0,0,979,312,3,1165,0,3,1
28563,3192,2020-11-18T16:16:05.3495529Z,2018,1152,191,889,582,0,20,7,570,0,0,961,263,3,1128,4,4,1
28563,3193,2020-11-18T16:16:05.3495529Z,2019,1094,202,826,570,0,17,6,524,0,1,892,268,3,1074,1,2,0
28563,3194,2020-11-18T16:16:05.3495529Z,2020,1129,235,824,597,0,18,5,532,0,0,894,305,3,1108,1,3,0
27607,3071,2020-11-18T16:16:04.7691648Z,2012,687,90,461,361,0,5,0,326,0,0,597,226,0,679,0,0,3
27607,3072,2020-11-18T16:16:04.7701652Z,2013,655,106,427,339,0,4,0,316,0,0,549,228,0,651,0,4,0
27607,3073,2020-11-18T16:16:04.7701652Z,2014,647,117,408,328,0,3,0,319,0,0,530,239,0,644,0,2,0
27607,3074,2020-11-18T16:16:04.7701652Z,2015,649,113,422,334,0,4,0,315,0,0,536,227,0,645,0,2,0
27607,3075,2020-11-18T16:16:04.7701652Z,2016,596,118,388,294,0,6,1,302,0,0,478,208,0,590,0,0,0
27607,3076,2020-11-18T16:16:04.7701652Z,2017,586,117,400,286,0,6,0,300,0,0,469,186,0,579,0,0,1
27607,3077,2020-11-18T16:16:04.7711661Z,2018,561,116,401,269,0,2,0,292,0,0,445,160,0,558,0,0,1
27607,3078,2020-11-18T16:16:04.7711661Z,2019,578,130,431,288,0,3,1,290,0,0,448,147,0,574,0,0,1
27607,3079,2020-11-18T16:16:04.7711661Z,2020,552,113,409,281,0,3,0,271,0,0,439,143,0,548,0,0,1
27607,31753,2021-06-24T05:35:15.4358845Z,2021,527,108,419,251,0,2,1,276,0,0,419,108,0,524,0,0,1
37507,31809,2021-06-24T05:35:16.9009364Z,2021,135,32,118,60,0,6,3,75,0,0,103,17,0,129,0,0,0
37507,4565,2020-11-18T16:16:13.1967833Z,2012,103,30,52,51,0,1,0,52,0,0,73,51,0,100,0,0,2
37507,4566,2020-11-18T16:16:13.1967833Z,2013,96,26,49,46,0,0,0,50,0,0,70,47,0,93,0,1,3
37507,4567,2020-11-18T16:16:13.1967833Z,2014,207,40,82,109,0,2,0,98,0,0,167,125,0,200,0,1,5
37507,4568,2020-11-18T16:16:13.1967833Z,2015,185,41,71,92,0,3,0,93,0,0,144,114,0,180,0,1,2
37507,4569,2020-11-18T16:16:13.1977833Z,2016,185,44,114,95,0,3,0,90,0,0,141,71,0,182,0,1,0
37507,4570,2020-11-18T16:16:13.1977833Z,2017,169,46,121,92,0,5,0,77,0,0,123,48,0,164,0,1,0
37507,4571,2020-11-18T16:16:13.1977833Z,2018,173,39,127,89,0,4,0,84,0,0,134,46,0,169,0,0,0
37507,4572,2020-11-18T16:16:13.1977833Z,2019,146,35,110,72,0,8,6,74,0,0,111,36,0,138,0,0,0
37507,4573,2020-11-18T16:16:13.1977833Z,2020,128,35,90,58,0,4,0,70,0,0,93,38,0,124,0,0,0
34314,31789,2021-06-24T05:35:16.866912Z,2021,251,42,216,124,0,2,0,127,0,0,209,35,1,248,0,0,0
34314,4185,2020-11-18T16:16:11.0363448Z,2012,489,108,393,252,0,6,0,237,0,0,381,96,0,483,0,0,0
34314,4186,2020-11-18T16:16:11.0373457Z,2013,457,99,378,245,0,10,0,212,0,0,358,79,2,444,0,4,1
34314,4187,2020-11-18T16:16:11.0373457Z,2014,399,86,311,211,0,7,0,188,0,0,313,88,2,388,0,4,2
34314,4188,2020-11-18T16:16:11.0373457Z,2015,432,102,371,228,0,6,0,204,0,0,330,61,1,424,0,2,1
34314,4189,2020-11-18T16:16:11.0373457Z,2016,425,104,352,211,0,5,0,214,0,0,321,73,2,418,0,1,0
34314,4190,2020-11-18T16:16:11.0373457Z,2017,375,81,330,177,0,8,1,198,0,0,294,45,1,366,0,1,0
34314,4191,2020-11-18T16:16:11.038347Z,2018,374,60,321,184,0,8,2,190,0,0,314,53,1,363,0,0,2
34314,4192,2020-11-18T16:16:11.038347Z,2019,425,81,319,220,0,6,3,205,0,0,344,106,1,417,1,0,1
34314,4193,2020-11-18T16:16:11.038347Z,2020,292,53,257,154,0,4,0,138,0,0,239,35,1,286,0,0,1
34926,31794,2021-06-24T05:35:16.8679116Z,2021,231,50,180,106,0,0,0,125,0,0,181,51,0,231,0,0,0
34926,4278,2020-11-18T16:16:11.4776402Z,2012,280,1,197,119,0,1,0,161,0,0,279,83,0,278,0,0,1
34926,4279,2020-11-18T16:16:11.4776402Z,2013,248,2,194,118,0,4,0,130,0,0,246,54,0,244,0,0,0
34926,4280,2020-11-18T16:16:11.4776402Z,2014,264,19,204,129,0,2,0,135,0,0,245,60,0,261,0,1,1
34926,4281,2020-11-18T16:16:11.4776402Z,2015,266,14,204,122,0,1,0,144,0,0,252,62,0,265,0,1,0
34926,4282,2020-11-18T16:16:11.4786407Z,2016,245,37,82,113,0,1,0,132,0,0,208,163,0,244,0,1,0
34926,4283,2020-11-18T16:16:11.4786407Z,2017,255,48,222,119,0,1,0,136,0,0,207,33,0,254,0,1,0
34926,4284,2020-11-18T16:16:11.4786407Z,2018,239,45,206,108,0,1,0,131,0,0,194,33,0,238,0,0,0
34926,4285,2020-11-18T16:16:11.4796411Z,2019,256,47,220,121,0,1,1,135,0,0,209,36,0,255,0,0,0
34926,4286,2020-11-18T16:16:11.4796411Z,2020,256,56,228,118,0,1,0,138,0,0,200,28,0,255,0,0,0
60301,31939,2021-06-24T05:35:18.5321056Z,2021,150,41,111,82,0,11,0,68,0,0,109,39,0,139,0,1,0
60301,7970,2020-11-18T16:16:37.1127329Z,2012,237,34,207,117,0,26,0,120,0,0,203,30,1,210,0,0,0
60301,7971,2020-11-18T16:16:37.1137343Z,2013,201,37,175,95,0,18,0,106,0,0,164,26,0,183,0,0,0
60301,7972,2020-11-18T16:16:37.1137343Z,2014,194,50,167,87,0,8,0,107,0,0,144,27,0,186,0,0,0
60301,7973,2020-11-18T16:16:37.1137343Z,2015,157,45,138,79,0,9,0,78,0,0,112,19,0,148,0,0,0
60301,7974,2020-11-18T16:16:37.1137343Z,2016,131,45,111,60,0,10,0,71,0,0,86,20,0,121,0,1,0
60301,7975,2020-11-18T16:16:37.1147343Z,2017,127,50,104,56,0,8,0,71,0,0,77,23,0,119,0,1,0
60301,7976,2020-11-18T16:16:37.1147343Z,2018,153,42,114,70,0,12,0,83,0,0,111,39,0,141,0,0,0
60301,7977,2020-11-18T16:16:37.1147343Z,2019,169,38,135,87,0,15,2,82,0,0,131,34,0,154,0,0,0
60301,7978,2020-11-18T16:16:37.1147343Z,2020,165,44,114,89,0,12,0,76,0,0,121,51,0,153,0,0,0
52118,31892,2021-06-24T05:35:18.4620549Z,2021,244,77,232,127,0,5,0,117,0,0,167,12,0,239,0,1,0
52118,6705,2020-11-18T16:16:28.8842436Z,2012,305,39,283,139,0,1,0,166,0,0,266,22,0,304,0,0,0
52118,6706,2020-11-18T16:16:28.8842436Z,2013,282,65,262,125,0,0,0,157,0,0,217,20,0,282,0,1,0
52118,6707,2020-11-18T16:16:28.8852432Z,2014,218,60,199,107,0,0,0,111,0,0,158,19,0,218,0,0,0
52118,6708,2020-11-18T16:16:28.8852432Z,2015,197,48,175,96,0,0,0,101,0,0,149,22,0,197,0,0,0
52118,6709,2020-11-18T16:16:28.8852432Z,2016,270,95,245,131,0,2,2,139,0,0,175,25,0,268,0,0,0
52118,6710,2020-11-18T16:16:28.8852432Z,2017,344,118,311,160,0,3,5,184,0,0,226,33,0,341,0,0,0
52118,6711,2020-11-18T16:16:28.8852432Z,2018,380,118,337,192,0,1,4,188,0,0,262,43,0,379,0,1,0
52118,6712,2020-11-18T16:16:28.8862445Z,2019,404,135,373,214,3,5,12,190,0,0,269,31,0,399,0,3,0
52118,6713,2020-11-18T16:16:28.8862445Z,2020,320,103,299,180,0,2,17,140,0,0,217,21,0,318,0,2,0
21576,2239,2020-11-18T16:16:00.0240017Z,2014,288,21,106,163,0,2,0,125,0,0,267,182,0,285,0,0,1
21576,2240,2020-11-18T16:16:00.0240017Z,2015,330,22,146,186,0,2,0,144,0,0,308,184,0,325,0,1,3
21576,2241,2020-11-18T16:16:00.0240017Z,2016,361,28,138,199,0,1,6,162,0,0,333,223,1,357,0,3,2
21576,2242,2020-11-18T16:16:00.0250021Z,2017,371,28,152,207,0,1,8,164,0,0,343,219,1,368,0,2,1
21576,2243,2020-11-18T16:16:00.0250021Z,2018,402,30,154,219,0,0,23,183,0,0,372,248,1,400,0,1,1
21576,2244,2020-11-18T16:16:00.0250021Z,2019,393,32,138,206,0,0,0,187,0,0,361,255,0,390,0,0,3
21576,2245,2020-11-18T16:16:00.0260039Z,2020,456,40,202,249,0,2,6,207,0,0,416,254,0,451,0,0,3
21576,31711,2021-06-24T05:35:15.3628324Z,2021,466,44,269,257,0,2,5,209,0,0,422,197,0,460,0,0,4
60095,31938,2021-06-24T05:35:18.5341066Z,2021,301,122,259,148,0,7,0,153,0,0,179,42,1,293,0,0,0
60095,7933,2020-11-18T16:16:37.0897182Z,2012,303,81,234,140,0,0,0,163,0,0,222,69,0,303,0,0,0
60095,7934,2020-11-18T16:16:37.0897182Z,2013,287,70,227,129,0,2,0,158,0,0,217,60,0,285,0,0,0
60095,7935,2020-11-18T16:16:37.0907191Z,2014,288,73,207,134,0,4,0,154,0,0,215,81,0,284,0,1,0
60095,7936,2020-11-18T16:16:37.0907191Z,2015,290,89,208,137,0,5,0,153,0,0,201,82,0,285,0,1,0
60095,7937,2020-11-18T16:16:37.0907191Z,2016,300,102,210,135,0,10,0,165,0,0,198,90,0,290,0,1,0
60095,7938,2020-11-18T16:16:37.0917218Z,2017,322,101,240,160,0,6,0,162,0,0,221,82,0,315,0,1,1
60095,7939,2020-11-18T16:16:37.0917218Z,2018,293,93,228,146,0,4,0,147,0,0,200,65,0,289,0,0,0
60095,7940,2020-11-18T16:16:37.0917218Z,2019,294,117,226,143,0,8,0,151,0,0,177,68,1,285,0,0,0
60095,7941,2020-11-18T16:16:37.0917218Z,2020,317,104,240,149,0,9,0,168,0,0,213,77,1,307,0,0,0
20412,1734,2020-11-18T16:15:57.4022503Z,2012,191,65,159,88,0,0,0,103,0,0,126,32,0,191,0,0,0
20412,1735,2020-11-18T16:15:57.4032517Z,2013,191,67,150,87,0,0,0,104,0,0,124,41,0,191,0,0,0
20412,1736,2020-11-18T16:15:57.4032517Z,2014,184,72,149,85,0,1,0,99,0,0,112,35,0,183,0,1,0
20412,1737,2020-11-18T16:15:57.4032517Z,2015,185,60,146,93,0,1,0,92,0,0,125,39,0,184,0,1,0
20412,1738,2020-11-18T16:15:57.4032517Z,2016,184,56,144,92,0,2,3,92,0,0,128,40,0,182,0,0,0
20412,1739,2020-11-18T16:15:57.4042521Z,2017,166,56,127,79,0,2,0,87,0,0,110,39,0,164,0,0,0
20412,1740,2020-11-18T16:15:57.4042521Z,2018,178,46,135,91,0,2,0,87,0,0,132,43,0,176,0,0,0
20412,1741,2020-11-18T16:15:57.4042521Z,2019,161,54,131,72,0,1,4,89,0,0,107,30,0,160,0,0,0
20412,1742,2020-11-18T16:15:57.4042521Z,2020,150,43,123,76,0,2,0,74,0,0,107,27,0,147,0,0,1
20412,25692,2021-06-24T05:35:08.6380107Z,2021,140,38,125,72,0,3,0,68,0,0,102,15,0,136,0,0,1
66076,31984,2021-06-24T05:35:20.2903661Z,2021,301,131,261,125,0,2,2,176,0,0,170,40,1,297,0,0,1
66076,9150,2020-11-18T16:16:45.4993229Z,2012,316,100,252,150,0,3,0,166,0,0,216,64,6,306,0,0,1
66076,9151,2020-11-18T16:16:45.5003238Z,2013,309,108,225,145,0,3,0,164,0,0,201,84,4,301,0,1,1
66076,9152,2020-11-18T16:16:45.5003238Z,2014,283,98,170,143,0,5,0,140,0,0,185,113,4,274,0,1,0
66076,9153,2020-11-18T16:16:45.5003238Z,2015,317,132,248,154,0,8,0,163,0,0,185,69,3,306,0,0,0
66076,9154,2020-11-18T16:16:45.5013247Z,2016,257,109,155,125,0,5,6,132,0,0,148,102,2,250,0,1,0
66076,9155,2020-11-18T16:16:45.5013247Z,2017,250,104,218,114,0,5,6,136,0,0,146,32,0,245,0,1,0
66076,9156,2020-11-18T16:16:45.5013247Z,2018,237,90,194,97,2,8,0,140,0,0,147,43,0,229,0,0,0
66076,9157,2020-11-18T16:16:45.5013247Z,2019,324,134,270,145,3,4,7,179,0,0,190,54,0,318,0,1,2
66076,9158,2020-11-18T16:16:45.5023247Z,2020,317,134,258,137,0,1,1,180,0,0,183,59,1,315,0,1,0
46086,31852,2021-06-24T05:35:16.9809924Z,2021,429,110,336,225,0,14,1,204,0,0,319,93,0,414,9,3,1
46086,5857,2020-11-18T16:16:22.5800386Z,2012,690,21,518,355,0,9,0,335,0,0,669,172,0,681,0,0,0
46086,5858,2020-11-18T16:16:22.5800386Z,2013,499,20,372,248,0,4,0,251,0,0,479,127,0,495,0,3,0
46086,5859,2020-11-18T16:16:22.5810395Z,2014,562,72,428,309,0,15,0,253,0,0,490,134,0,547,0,3,0
46086,5860,2020-11-18T16:16:22.5810395Z,2015,527,70,424,278,0,16,0,249,0,0,457,103,0,511,0,0,0
46086,5861,2020-11-18T16:16:22.5810395Z,2016,453,82,311,238,0,10,1,215,0,0,371,142,0,442,0,1,1
46086,5862,2020-11-18T16:16:22.5820386Z,2017,410,71,318,213,0,6,0,197,0,0,339,92,0,403,0,1,1
46086,5863,2020-11-18T16:16:22.5820386Z,2018,279,51,213,143,0,2,4,136,0,0,228,66,0,277,7,0,0
46086,5864,2020-11-18T16:16:22.5820386Z,2019,337,72,257,172,0,8,0,165,0,0,265,80,0,329,7,2,0
46086,5865,2020-11-18T16:16:22.58304Z,2020,411,111,298,213,0,17,0,198,0,0,300,113,0,394,10,2,0
15024,1110,2020-11-18T16:15:53.1284023Z,2012,344,103,209,169,0,2,0,175,0,0,241,135,0,342,0,0,0
15024,1111,2020-11-18T16:15:53.1294023Z,2013,340,103,205,172,0,2,0,168,0,0,237,135,0,338,0,1,0
15024,1112,2020-11-18T16:15:53.1294023Z,2014,337,104,168,179,0,0,0,158,0,0,233,169,0,337,0,4,0
15024,1113,2020-11-18T16:15:53.1294023Z,2015,360,105,212,185,0,2,0,175,0,0,255,148,0,358,0,3,0
15024,1114,2020-11-18T16:15:53.1294023Z,2016,348,98,88,182,0,2,0,166,0,0,250,260,1,345,0,2,0
15024,1115,2020-11-18T16:15:53.1304023Z,2017,341,88,209,180,0,2,0,161,0,0,253,132,0,339,0,1,0
15024,1116,2020-11-18T16:15:53.1304023Z,2018,345,92,233,180,0,0,19,165,0,0,253,112,0,345,3,1,0
15024,1117,2020-11-18T16:15:53.1304023Z,2019,399,132,288,191,0,1,1,208,0,0,267,111,0,398,4,0,0
15024,1118,2020-11-18T16:15:53.1304023Z,2020,370,117,278,179,0,1,3,191,0,0,253,92,0,369,5,0,0
15024,25604,2021-06-24T05:35:04.620129Z,2021,329,102,265,168,0,3,5,161,0,0,227,64,0,325,4,0,1
61358,25942,2021-06-24T05:35:12.844026Z,2021,251,91,206,119,0,8,9,132,0,0,160,45,1,242,1,1,0
61358,8120,2020-11-18T16:16:38.5967187Z,2012,329,91,188,152,0,5,0,177,0,0,238,141,2,321,0,0,1
61358,8121,2020-11-18T16:16:38.5967187Z,2013,318,87,207,149,0,11,0,169,0,0,231,111,2,303,0,5,2
61358,8122,2020-11-18T16:16:38.5967187Z,2014,317,91,204,146,0,9,0,171,0,0,226,113,3,305,0,2,0
61358,8123,2020-11-18T16:16:38.59772Z,2015,330,96,235,157,0,14,0,173,0,0,234,95,5,311,0,3,0
61358,8124,2020-11-18T16:16:38.59772Z,2016,324,97,233,148,0,11,1,176,0,0,227,91,5,308,0,3,0
61358,8125,2020-11-18T16:16:38.59772Z,2017,279,97,205,133,0,5,2,146,0,0,182,74,3,270,0,5,1
61358,8126,2020-11-18T16:16:38.59772Z,2018,253,67,195,116,0,5,15,137,0,0,186,58,2,245,4,3,1
61358,8127,2020-11-18T16:16:38.5987191Z,2019,278,95,218,135,0,8,9,143,0,0,183,60,2,267,1,1,1
61358,8128,2020-11-18T16:16:38.5987191Z,2020,269,92,222,135,0,8,12,134,0,0,177,47,1,260,1,1,0
35923,25803,2021-06-24T05:35:10.8946295Z,2021,189,22,146,85,0,3,0,104,0,0,167,43,0,185,1,0,1
35923,4479,2020-11-18T16:16:12.5913773Z,2012,284,50,204,142,0,0,0,142,0,0,234,80,0,284,0,0,0
35923,4480,2020-11-18T16:16:12.5913773Z,2013,282,45,192,142,0,0,0,140,0,0,237,90,0,282,0,0,0
35923,4481,2020-11-18T16:16:12.5913773Z,2014,260,42,178,123,0,0,0,137,0,0,218,82,0,260,0,0,0
35923,4482,2020-11-18T16:16:12.5923787Z,2015,246,36,173,119,0,0,0,127,0,0,210,73,0,246,0,0,0
35923,4483,2020-11-18T16:16:12.5923787Z,2016,251,41,163,127,0,2,0,124,0,0,210,88,0,249,0,0,0
35923,4484,2020-11-18T16:16:12.5933787Z,2017,234,44,160,120,0,2,1,114,0,0,190,74,0,232,0,0,0
35923,4485,2020-11-18T16:16:12.5933787Z,2018,233,36,157,124,0,2,0,109,0,0,197,76,0,228,1,0,3
35923,4486,2020-11-18T16:16:12.5933787Z,2019,160,31,108,81,0,2,0,79,0,0,129,52,0,158,1,1,0
35923,4487,2020-11-18T16:16:12.5943804Z,2020,185,29,145,82,0,3,0,103,0,0,156,40,0,181,1,0,1
18259,1549,2020-11-18T16:15:55.3648965Z,2013,291,80,190,142,0,1,0,149,0,0,211,101,0,289,0,2,1
18259,1550,2020-11-18T16:15:55.3648965Z,2014,344,94,242,166,0,2,0,178,0,0,250,102,0,341,0,3,1
18259,1551,2020-11-18T16:15:55.3648965Z,2015,321,83,230,159,0,3,0,162,0,0,238,91,0,318,0,4,0
18259,1552,2020-11-18T16:15:55.3658969Z,2016,323,101,196,166,0,5,0,157,0,0,222,127,0,318,0,3,0
18259,1553,2020-11-18T16:15:55.3658969Z,2017,324,104,240,160,0,2,0,164,0,0,220,84,0,322,0,1,0
18259,1554,2020-11-18T16:15:55.3658969Z,2018,286,90,215,143,0,1,0,143,0,0,196,71,0,285,0,1,0
18259,1555,2020-11-18T16:15:55.3668974Z,2019,547,186,419,287,0,3,5,260,0,0,361,128,0,544,0,2,0
18259,1556,2020-11-18T16:15:55.3668974Z,2020,533,175,419,275,0,6,8,258,0,0,358,114,0,527,0,2,0
18259,25616,2021-06-24T05:35:04.6461481Z,2021,542,171,454,276,0,3,10,266,0,0,371,88,0,539,1,1,0
77289,10969,2020-11-18T16:16:58.1197414Z,2012,275,85,254,140,0,29,0,135,0,0,190,21,0,246,0,0,0
77289,10970,2020-11-18T16:16:58.1197414Z,2013,259,82,221,130,0,33,0,129,0,0,177,38,0,226,0,2,0
77289,10971,2020-11-18T16:16:58.1197414Z,2014,249,86,219,118,0,32,0,131,0,0,163,30,0,217,0,0,0
77289,10972,2020-11-18T16:16:58.1197414Z,2015,248,81,229,111,0,23,0,137,0,0,167,19,0,225,0,0,0
77289,10973,2020-11-18T16:16:58.1197414Z,2016,246,73,189,109,0,30,0,137,0,0,173,57,0,216,0,0,0
77289,10974,2020-11-18T16:16:58.1207418Z,2017,228,73,206,102,0,27,0,126,0,0,155,22,2,199,0,3,0
77289,10975,2020-11-18T16:16:58.1207418Z,2018,250,68,225,113,0,24,2,137,0,0,182,25,0,226,0,0,0
77289,10976,2020-11-18T16:16:58.1207418Z,2019,239,79,219,113,0,24,1,126,0,0,160,20,0,215,0,0,0
77289,10977,2020-11-18T16:16:58.1207418Z,2020,225,81,209,106,0,20,1,119,0,0,144,16,0,205,0,0,0
77289,32001,2021-06-24T05:35:20.3313953Z,2021,220,77,204,101,0,23,0,119,0,0,143,16,0,196,0,0,1
12369,25632,2021-06-24T05:35:04.6871778Z,2021,287,120,261,128,0,6,34,159,0,0,167,26,0,281,1,1,0
12369,700,2020-11-18T16:15:50.2564844Z,2012,380,102,317,193,0,6,0,187,0,0,278,63,0,374,0,0,0
12369,701,2020-11-18T16:15:50.8889054Z,2013,360,98,275,182,0,5,0,178,0,0,262,85,0,355,0,2,0
12369,702,2020-11-18T16:15:50.8899067Z,2014,339,115,244,168,0,6,0,171,0,0,224,95,0,333,0,2,0
12369,703,2020-11-18T16:15:50.8899067Z,2015,340,108,215,163,0,2,0,177,0,0,232,125,0,338,0,1,0
12369,704,2020-11-18T16:15:50.8899067Z,2016,359,130,86,161,0,3,0,198,0,0,229,273,0,356,0,0,0
12369,705,2020-11-18T16:15:50.8899067Z,2017,352,136,288,159,0,1,2,193,0,0,216,64,0,351,0,1,0
12369,706,2020-11-18T16:15:50.8899067Z,2018,362,137,321,155,0,3,3,207,0,0,225,41,0,359,1,1,0
12369,707,2020-11-18T16:15:50.8909072Z,2019,335,146,306,142,0,4,0,193,0,0,189,29,0,331,1,1,0
12369,708,2020-11-18T16:15:50.8909072Z,2020,313,139,281,134,0,5,39,179,0,0,174,32,0,308,1,1,0
71720,10433,2020-11-18T16:16:54.7174682Z,2012,298,138,272,139,0,4,0,159,0,0,160,26,0,294,0,0,0
71720,10434,2020-11-18T16:16:54.7174682Z,2013,272,134,253,119,0,11,0,153,0,0,138,19,0,261,0,2,0
71720,10435,2020-11-18T16:16:54.7174682Z,2014,259,128,233,110,0,11,0,149,0,0,131,26,0,248,0,1,0
71720,10436,2020-11-18T16:16:54.7184682Z,2015,260,136,240,97,0,10,0,163,0,0,124,20,0,248,0,4,2
71720,10437,2020-11-18T16:16:54.7184682Z,2016,218,113,180,77,0,11,5,141,0,0,105,38,0,206,0,3,1
71720,10438,2020-11-18T16:16:54.7184682Z,2017,206,111,182,78,0,8,4,128,0,0,95,24,0,198,0,2,0
71720,10439,2020-11-18T16:16:54.7184682Z,2018,211,106,188,80,0,10,6,131,0,0,105,23,0,201,0,1,0
71720,10440,2020-11-18T16:16:54.7184682Z,2019,201,108,184,93,0,5,0,108,0,0,93,17,1,195,1,0,0
71720,10441,2020-11-18T16:16:54.7194691Z,2020,197,106,180,89,0,4,1,108,0,0,91,17,2,191,1,0,0
71720,31621,2021-06-24T05:35:14.6182989Z,2021,173,97,161,75,0,3,1,98,0,0,76,12,0,170,0,1,0
50120,25865,2021-06-24T05:35:10.9906984Z,2021,456,148,358,222,0,9,21,234,0,0,308,98,0,447,1,0,0
50120,6138,2020-11-18T16:16:25.0857124Z,2012,576,225,426,293,0,1,0,283,0,0,351,150,0,575,0,0,0
50120,6139,2020-11-18T16:16:25.0857124Z,2013,563,223,442,279,0,0,0,284,0,0,340,121,0,563,0,6,0
50120,6140,2020-11-18T16:16:25.0857124Z,2014,591,232,460,295,0,3,0,296,0,0,359,131,0,587,0,7,1
50120,6141,2020-11-18T16:16:25.0857124Z,2015,547,219,435,277,0,5,0,270,0,0,328,112,0,541,0,7,1
50120,6142,2020-11-18T16:16:25.086712Z,2016,517,202,393,256,0,6,0,261,0,0,315,124,0,510,0,3,1
50120,6143,2020-11-18T16:16:25.086712Z,2017,496,191,390,232,0,6,0,264,0,0,305,106,0,490,0,0,0
50120,6144,2020-11-18T16:16:25.086712Z,2018,445,168,339,219,0,7,10,226,0,1,277,106,0,438,1,0,0
50120,6145,2020-11-18T16:16:25.086712Z,2019,533,199,420,262,0,13,6,271,0,1,334,113,0,520,2,0,0
50120,6146,2020-11-18T16:16:25.0877124Z,2020,500,173,378,252,0,10,34,248,0,0,327,122,0,490,2,0,0
18176,1495,2020-11-18T16:15:54.7755012Z,2012,548,168,492,259,0,5,0,289,0,0,380,56,0,543,0,0,0
18176,1496,2020-11-18T16:15:54.7755012Z,2013,555,180,492,259,0,7,0,296,0,0,375,63,0,546,0,6,2
18176,1497,2020-11-18T16:15:54.7765021Z,2014,534,187,459,250,0,8,0,284,0,0,347,75,0,523,0,5,3
18176,1498,2020-11-18T16:15:54.7765021Z,2015,466,158,397,228,0,4,0,238,0,0,308,69,0,462,0,0,0
18176,1499,2020-11-18T16:15:54.7765021Z,2016,419,147,202,198,0,7,2,221,0,0,272,217,0,412,0,0,0
18176,1500,2020-11-18T16:15:54.7765021Z,2017,397,139,336,183,0,6,1,214,0,0,258,61,0,390,0,0,1
18176,1501,2020-11-18T16:15:55.3789045Z,2018,335,114,227,161,0,1,0,174,0,0,221,108,0,333,0,0,1
18176,1502,2020-11-18T16:15:55.3789045Z,2019,352,139,286,184,0,1,1,168,0,0,213,66,0,350,0,0,1
18176,1503,2020-11-18T16:15:55.3789045Z,2020,340,126,291,172,0,4,0,168,0,0,214,49,0,335,0,0,1
18176,31615,2021-06-24T05:35:14.6112937Z,2021,309,121,230,149,0,9,3,160,0,0,188,79,0,298,0,0,2
71795,10494,2020-11-18T16:16:54.7384816Z,2012,182,52,143,89,0,5,0,93,0,0,130,39,2,171,0,0,4
71795,10495,2020-11-18T16:16:54.7384816Z,2013,205,72,166,94,0,8,0,111,0,0,133,39,2,191,0,0,4
71795,10496,2020-11-18T16:16:54.7384816Z,2014,157,50,120,73,0,5,0,84,0,0,107,37,1,147,0,0,4
71795,10497,2020-11-18T16:16:54.7384816Z,2015,199,57,156,104,0,5,0,95,0,0,142,43,1,189,0,0,4
71795,10498,2020-11-18T16:16:54.7384816Z,2016,200,68,155,101,0,4,2,99,0,0,132,45,0,193,0,0,3
71795,10499,2020-11-18T16:16:54.7394829Z,2017,185,58,141,97,0,10,2,88,0,0,127,44,0,173,0,0,2
71795,10500,2020-11-18T16:16:54.7394829Z,2018,183,55,139,85,0,7,0,98,0,0,128,44,1,173,0,0,2
71795,10501,2020-11-18T16:16:55.4089308Z,2019,190,72,150,100,0,4,0,90,0,0,118,40,0,186,0,0,0
71795,10502,2020-11-18T16:16:55.4089308Z,2020,168,70,137,82,0,3,0,86,0,0,98,31,0,165,0,0,0
71795,31624,2021-06-24T05:35:14.6243028Z,2021,164,70,137,75,0,5,0,89,0,0,94,27,0,159,0,0,0
25601,25725,2021-06-24T05:35:08.6810414Z,2021,342,107,226,170,0,5,0,172,0,0,235,116,1,335,0,0,1
25601,2875,2020-11-18T16:16:03.6964486Z,2012,545,1,333,289,0,13,0,256,0,0,544,212,0,532,0,0,0
25601,2876,2020-11-18T16:16:03.6974491Z,2013,536,6,302,297,0,10,0,239,0,0,530,234,0,525,0,0,1
25601,2877,2020-11-18T16:16:03.6974491Z,2014,579,53,327,308,0,15,0,271,0,0,526,252,0,564,0,1,0
25601,2878,2020-11-18T16:16:03.6974491Z,2015,585,38,366,288,0,12,0,297,0,0,547,219,1,572,0,2,0
25601,2879,2020-11-18T16:16:03.69845Z,2016,562,78,261,286,0,4,0,276,0,0,484,301,1,557,0,0,0
25601,2880,2020-11-18T16:16:03.69845Z,2017,444,71,291,231,0,5,0,213,0,0,373,153,1,438,0,0,0
25601,2881,2020-11-18T16:16:03.69845Z,2018,490,92,310,256,0,3,6,234,0,0,398,180,2,485,0,0,0
25601,2882,2020-11-18T16:16:03.6994513Z,2019,385,94,262,190,0,3,0,195,0,0,291,123,2,380,0,0,0
25601,2883,2020-11-18T16:16:03.6994513Z,2020,381,111,262,178,0,3,2,203,0,0,270,119,1,376,0,0,1
45955,25849,2021-06-24T05:35:10.9686813Z,2021,604,211,525,279,0,10,0,325,0,0,393,79,0,594,0,3,0
45955,5830,2020-11-18T16:16:22.5740333Z,2012,394,49,303,211,0,4,0,183,0,0,345,91,0,389,0,0,1
45955,5831,2020-11-18T16:16:22.5740333Z,2013,424,93,355,220,0,4,0,204,0,0,331,69,0,420,0,0,0
45955,5832,2020-11-18T16:16:22.5750346Z,2014,439,120,382,225,0,8,0,214,0,0,319,57,0,431,0,2,0
45955,5833,2020-11-18T16:16:22.5750346Z,2015,464,120,399,227,0,7,0,237,0,0,344,65,0,456,0,1,1
45955,5834,2020-11-18T16:16:22.5750346Z,2016,434,134,209,201,0,6,0,233,0,0,300,225,0,427,0,0,1
45955,5835,2020-11-18T16:16:22.5760351Z,2017,376,119,315,166,0,4,1,210,0,0,257,61,0,372,0,1,0
45955,5836,2020-11-18T16:16:22.5760351Z,2018,358,114,298,162,0,9,0,196,0,0,244,60,0,349,0,1,0
45955,5837,2020-11-18T16:16:22.5760351Z,2019,674,249,588,338,0,10,1,336,0,0,425,86,0,664,0,4,0
45955,5838,2020-11-18T16:16:22.5770351Z,2020,653,239,567,314,0,11,2,339,0,0,414,86,0,642,0,3,0
50690,31878,2021-06-24T05:35:18.4480453Z,2021,128,34,105,64,0,0,9,64,0,0,94,23,0,128,2,2,0
50690,6301,2020-11-18T16:16:26.2614976Z,2012,170,47,140,75,0,1,0,95,0,0,123,30,0,169,0,0,0
50690,6302,2020-11-18T16:16:26.2614976Z,2013,155,44,126,64,0,0,0,91,0,0,111,29,0,155,0,0,0
50690,6303,2020-11-18T16:16:26.2624981Z,2014,145,33,104,53,0,0,0,92,0,0,112,41,0,145,0,0,0
50690,6304,2020-11-18T16:16:26.2624981Z,2015,129,31,106,54,0,1,0,75,0,0,98,23,0,125,0,1,3
50690,6305,2020-11-18T16:16:26.2624981Z,2016,126,37,51,51,0,1,0,75,0,0,89,75,0,124,0,1,1
50690,6306,2020-11-18T16:16:26.2634981Z,2017,108,40,94,42,0,0,6,66,0,0,68,14,0,108,0,0,0
50690,6307,2020-11-18T16:16:26.2634981Z,2018,101,36,85,43,0,0,6,58,0,0,65,16,0,101,1,0,0
50690,6308,2020-11-18T16:16:26.2634981Z,2019,165,44,128,77,0,2,12,88,0,0,121,37,0,163,2,2,0
50690,6309,2020-11-18T16:16:26.2644994Z,2020,153,39,117,70,0,0,19,83,0,0,114,36,0,152,2,2,1
57703,25926,2021-06-24T05:35:12.8240134Z,2021,334,106,262,171,0,1,0,163,0,0,228,72,2,331,0,2,0
57703,7730,2020-11-18T16:16:35.9059268Z,2012,619,1,450,326,0,1,0,293,0,0,618,169,2,616,0,0,0
57703,7731,2020-11-18T16:16:35.9059268Z,2013,516,2,402,266,0,2,0,250,0,0,514,114,2,512,0,1,0
57703,7732,2020-11-18T16:16:35.9059268Z,2014,570,35,464,274,0,1,0,296,0,0,535,106,0,569,0,5,0
57703,7733,2020-11-18T16:16:35.9069277Z,2015,528,35,421,253,0,1,0,275,0,0,493,107,0,527,0,5,0
57703,7734,2020-11-18T16:16:35.9069277Z,2016,557,75,372,272,0,0,1,285,0,0,482,185,0,557,0,3,0
57703,7735,2020-11-18T16:16:35.9069277Z,2017,475,70,388,229,0,1,10,246,0,0,405,87,0,474,0,3,0
57703,7736,2020-11-18T16:16:35.9069277Z,2018,408,66,344,195,0,1,18,213,0,0,342,64,0,407,1,4,0
57703,7737,2020-11-18T16:16:35.9069277Z,2019,398,76,322,200,0,0,12,198,0,0,322,76,0,398,0,3,0
57703,7738,2020-11-18T16:16:35.907929Z,2020,356,107,277,183,0,1,0,173,0,0,249,79,0,355,0,3,0
53603,25904,2021-06-24T05:35:12.8009958Z,2021,222,76,183,109,0,1,1,113,0,0,146,39,0,221,1,0,0
53603,7282,2020-11-18T16:16:32.5186964Z,2012,469,84,367,216,0,2,0,253,0,0,385,102,0,467,0,0,0
53603,7283,2020-11-18T16:16:32.5186964Z,2013,427,111,317,192,0,2,0,235,0,0,316,110,0,425,0,2,0
53603,7284,2020-11-18T16:16:32.5186964Z,2014,410,123,312,174,0,2,0,236,0,0,287,98,1,407,0,3,0
53603,7285,2020-11-18T16:16:32.5196714Z,2015,379,103,302,159,0,2,0,220,0,0,276,77,1,376,0,4,0
53603,7286,2020-11-18T16:16:32.5196714Z,2016,343,97,267,154,0,2,3,189,0,0,246,76,1,340,0,3,0
53603,7287,2020-11-18T16:16:32.5206719Z,2017,314,82,242,148,0,1,5,166,0,0,232,72,0,313,0,3,0
53603,7288,2020-11-18T16:16:32.5206719Z,2018,287,82,227,126,0,1,7,161,0,0,205,60,0,286,8,7,0
53603,7289,2020-11-18T16:16:32.5216723Z,2019,292,87,227,126,0,0,1,166,0,2,205,65,0,292,7,3,0
53603,7290,2020-11-18T16:16:32.5216723Z,2020,267,82,212,132,0,0,0,135,0,0,185,55,0,267,4,0,0
21188,2119,2020-11-18T16:15:59.590712Z,2012,200,85,172,94,0,2,0,106,0,0,115,28,0,198,0,0,0
21188,2120,2020-11-18T16:15:59.590712Z,2013,182,75,160,83,0,0,0,99,0,0,107,22,0,182,0,0,0
21188,2121,2020-11-18T16:15:59.590712Z,2014,180,71,153,88,0,0,0,92,0,0,109,27,0,180,0,0,0
21188,2122,2020-11-18T16:15:59.5917124Z,2015,190,64,166,97,0,1,0,93,0,0,126,24,0,189,0,0,0
21188,2123,2020-11-18T16:15:59.5917124Z,2016,217,81,190,100,0,1,6,117,0,0,136,27,0,216,0,0,0
21188,2124,2020-11-18T16:15:59.5917124Z,2017,352,140,287,157,0,1,3,195,0,0,212,65,0,351,0,0,0
21188,2125,2020-11-18T16:15:59.5917124Z,2018,326,121,293,155,0,1,2,171,0,1,205,33,0,325,0,0,0
21188,2126,2020-11-18T16:15:59.5917124Z,2019,453,178,362,226,0,1,5,227,0,2,275,91,0,452,0,0,0
21188,2127,2020-11-18T16:15:59.5927133Z,2020,421,158,340,201,0,0,6,220,0,0,263,81,0,421,0,0,0
21188,31708,2021-06-24T05:35:15.3398179Z,2021,369,133,311,187,0,1,4,182,0,0,236,58,0,368,0,0,0
62513,31961,2021-06-24T05:35:20.2493365Z,2021,125,55,115,68,0,5,3,57,0,0,70,10,0,120,0,2,0
62513,8535,2020-11-18T16:16:40.8802445Z,2012,145,64,131,51,0,10,0,94,0,0,81,14,0,135,0,0,0
62513,8536,2020-11-18T16:16:40.8802445Z,2013,130,64,115,53,0,5,0,77,0,0,66,15,0,125,0,1,0
62513,8537,2020-11-18T16:16:40.8812454Z,2014,144,67,100,58,0,7,0,86,0,0,77,44,0,137,0,0,0
62513,8538,2020-11-18T16:16:40.8812454Z,2015,155,75,135,66,0,9,0,89,0,0,80,20,1,145,0,0,0
62513,8539,2020-11-18T16:16:40.8812454Z,2016,149,74,118,60,0,8,0,89,0,0,75,31,1,140,0,0,0
62513,8540,2020-11-18T16:16:40.8822463Z,2017,149,69,131,54,0,5,2,95,0,0,80,18,0,144,0,0,0
62513,8541,2020-11-18T16:16:40.8822463Z,2018,131,54,117,50,0,7,0,81,0,0,77,14,0,123,0,0,1
62513,8542,2020-11-18T16:16:40.8832458Z,2019,167,85,141,78,0,5,0,89,0,0,82,26,0,162,0,2,0
62513,8543,2020-11-18T16:16:40.8832458Z,2020,149,67,129,73,0,6,7,76,0,0,82,20,0,143,0,2,0
70888,25661,2021-06-24T05:35:04.7342113Z,2021,685,152,576,363,0,2,0,322,0,0,533,109,0,683,1,0,0
70888,9954,2020-11-18T16:16:51.5353497Z,2012,1041,1,779,536,0,5,0,505,0,0,1040,262,1,1035,0,0,0
70888,9955,2020-11-18T16:16:51.5353497Z,2013,956,2,723,490,0,8,0,466,0,0,954,233,0,948,0,0,0
70888,9956,2020-11-18T16:16:51.5353497Z,2014,803,32,618,393,0,7,0,410,0,0,771,185,0,796,0,0,0
70888,9957,2020-11-18T16:16:51.5363501Z,2015,990,82,709,466,0,6,0,524,0,0,908,281,0,984,0,0,0
70888,9958,2020-11-18T16:16:51.5363501Z,2016,954,134,360,464,0,5,1,490,0,0,820,594,0,949,0,0,0
70888,9959,2020-11-18T16:16:51.5363501Z,2017,1014,167,770,501,0,5,1,513,0,0,847,244,0,1008,0,0,1
70888,9960,2020-11-18T16:16:51.537351Z,2018,912,127,669,477,0,6,0,435,0,0,785,243,0,906,4,0,0
70888,9961,2020-11-18T16:16:51.537351Z,2019,763,122,568,392,0,5,0,371,0,0,641,195,0,757,3,0,1
70888,9962,2020-11-18T16:16:51.537351Z,2020,748,163,564,385,0,2,0,363,0,0,585,184,0,746,1,0,0
46201,25851,2021-06-24T05:35:10.9706827Z,2021,284,105,232,138,0,0,0,146,0,0,179,52,0,283,0,1,1
46201,5866,2020-11-18T16:16:22.5800386Z,2012,419,31,332,199,0,2,0,220,0,0,388,87,0,417,0,0,0
46201,5867,2020-11-18T16:16:22.5810395Z,2013,352,48,288,156,0,2,0,196,0,0,304,64,0,350,0,1,0
46201,5868,2020-11-18T16:16:22.5810395Z,2014,262,45,227,111,0,0,0,151,0,0,217,35,0,262,0,1,0
46201,5869,2020-11-18T16:16:22.5810395Z,2015,181,33,164,78,0,0,0,103,0,0,148,17,0,181,0,1,0
46201,5870,2020-11-18T16:16:22.5810395Z,2016,144,31,32,67,0,1,4,77,0,0,113,112,0,143,0,0,0
46201,5871,2020-11-18T16:16:22.5820386Z,2017,42,5,13,14,0,1,2,28,0,0,37,29,0,41,0,1,0
46201,5872,2020-11-18T16:16:22.5820386Z,2019,377,143,311,177,0,1,5,200,0,0,234,66,0,376,1,7,0
46201,5873,2020-11-18T16:16:22.5820386Z,2020,355,132,293,176,0,0,0,179,0,0,223,62,5,350,0,3,0
15404,1188,2020-11-18T16:15:53.1534179Z,2012,193,73,154,85,0,11,0,108,0,0,120,39,0,182,0,0,0
15404,1189,2020-11-18T16:15:53.1544183Z,2013,184,76,142,82,0,10,0,102,0,0,108,42,0,174,0,5,0
15404,1190,2020-11-18T16:15:53.1544183Z,2014,180,76,140,77,0,11,0,103,0,0,104,40,0,168,0,2,1
15404,1191,2020-11-18T16:15:53.1544183Z,2015,170,74,129,72,0,13,0,98,0,0,96,41,0,157,0,3,0
15404,1192,2020-11-18T16:15:53.1544183Z,2016,187,71,143,83,0,14,0,104,0,0,116,44,0,173,0,2,0
15404,1193,2020-11-18T16:15:53.1544183Z,2017,204,81,162,94,0,9,0,110,0,0,123,42,0,195,0,2,0
15404,1194,2020-11-18T16:15:53.1554192Z,2018,199,76,165,87,0,7,4,112,0,0,123,34,0,192,0,1,0
15404,1195,2020-11-18T16:15:53.1554192Z,2019,217,92,170,107,0,5,0,110,0,0,125,47,0,212,0,1,0
15404,1196,2020-11-18T16:15:53.1554192Z,2020,222,92,172,111,0,4,0,111,0,0,130,50,0,218,0,0,0
15404,31811,2021-06-24T05:35:16.9019364Z,2021,236,94,201,116,0,4,0,120,0,0,142,35,0,232,0,0,0
70144,25643,2021-06-24T05:35:04.6941826Z,2021,253,87,220,137,0,4,0,116,0,0,166,33,3,246,0,1,0
70144,9484,2020-11-18T16:16:48.5293724Z,2012,312,85,235,156,0,3,0,156,0,0,227,77,0,307,0,0,2
70144,9485,2020-11-18T16:16:48.5293724Z,2013,286,78,182,146,0,4,0,140,0,0,208,104,0,282,0,0,0
70144,9486,2020-11-18T16:16:48.5293724Z,2014,279,90,181,139,0,7,0,140,0,0,189,98,0,272,0,1,0
70144,9487,2020-11-18T16:16:48.5303479Z,2015,278,86,200,136,0,7,0,142,0,0,192,78,1,270,0,1,0
70144,9488,2020-11-18T16:16:48.5303479Z,2016,187,70,135,93,0,7,0,94,0,0,117,52,1,179,0,1,0
70144,9489,2020-11-18T16:16:48.5303479Z,2017,162,66,136,81,0,5,0,81,0,0,96,26,2,155,0,0,0
70144,9490,2020-11-18T16:16:48.5313492Z,2018,196,75,159,90,0,5,3,106,0,0,121,37,1,190,0,0,0
70144,9491,2020-11-18T16:16:48.5313492Z,2019,379,130,336,194,0,4,1,185,0,0,249,43,1,374,0,0,0
70144,9492,2020-11-18T16:16:48.5313492Z,2020,314,103,292,163,0,5,3,151,0,0,211,22,1,308,0,0,0
71571,10337,2020-11-18T16:16:54.3162013Z,2012,474,166,416,247,0,3,0,227,0,0,308,58,0,471,0,0,0
71571,10338,2020-11-18T16:16:54.3162013Z,2013,419,154,316,211,0,7,0,208,0,0,265,103,0,412,0,2,0
71571,10339,2020-11-18T16:16:54.3162013Z,2014,397,145,356,201,0,3,0,196,0,0,252,41,0,393,0,1,1
71571,10340,2020-11-18T16:16:54.3162013Z,2015,398,152,350,213,0,6,0,185,0,0,246,48,0,392,0,1,0
71571,10341,2020-11-18T16:16:54.3172022Z,2016,273,108,228,146,0,7,0,127,0,0,165,45,0,266,0,0,0
71571,10342,2020-11-18T16:16:54.3172022Z,2017,235,91,212,123,0,12,0,112,0,0,144,23,0,223,0,0,0
71571,10343,2020-11-18T16:16:54.3172022Z,2018,244,86,219,118,0,11,8,126,0,0,158,25,0,233,0,0,0
71571,10344,2020-11-18T16:16:54.3172022Z,2019,165,74,158,74,0,1,0,91,0,0,91,7,0,164,0,0,0
71571,10345,2020-11-18T16:16:54.3172022Z,2020,218,91,198,100,0,49,0,118,0,0,127,20,0,169,0,0,0
71571,25673,2021-06-24T05:35:04.7432179Z,2021,230,97,210,100,0,38,0,130,0,0,133,20,0,192,0,0,0
46805,25854,2021-06-24T05:35:10.9716837Z,2021,503,100,418,247,0,3,0,256,0,0,403,85,1,499,1,2,0
46805,5919,2020-11-18T16:16:23.5086581Z,2012,575,35,433,308,0,1,0,267,0,0,540,142,0,574,0,0,0
46805,5920,2020-11-18T16:16:23.5096581Z,2013,520,66,383,265,0,2,0,255,0,0,454,137,0,518,0,5,0
46805,5921,2020-11-18T16:16:23.5096581Z,2014,508,78,352,245,0,11,0,263,0,0,430,156,0,497,0,5,0
46805,5922,2020-11-18T16:16:23.5096581Z,2015,496,87,376,240,0,8,0,256,0,0,409,120,0,487,0,6,1
46805,5923,2020-11-18T16:16:23.5096581Z,2016,419,92,326,213,0,5,7,206,0,0,327,93,0,414,0,2,0
46805,5924,2020-11-18T16:16:23.5096581Z,2017,384,88,302,206,0,2,7,178,0,0,296,82,0,382,0,3,0
46805,5925,2020-11-18T16:16:23.5106589Z,2018,655,161,521,320,0,6,44,335,0,0,494,134,2,647,5,5,0
46805,5926,2020-11-18T16:16:23.5106589Z,2019,537,137,410,263,2,3,12,274,0,0,400,127,2,532,3,2,0
46805,5927,2020-11-18T16:16:23.5106589Z,2020,501,130,408,243,0,2,0,258,0,0,371,93,1,498,0,3,0
53470,31904,2021-06-24T05:35:18.4800674Z,2021,379,47,190,245,0,0,0,134,0,0,332,189,0,379,26,0,0
53470,7249,2020-11-18T16:16:32.5096647Z,2012,359,20,214,214,0,0,0,145,0,0,339,145,0,359,0,0,0
53470,7250,2020-11-18T16:16:32.5106652Z,2013,379,32,197,220,0,0,0,159,0,0,347,182,0,379,0,0,0
53470,7251,2020-11-18T16:16:32.5106652Z,2014,381,39,200,227,0,2,0,154,0,0,342,181,0,379,0,2,0
53470,7252,2020-11-18T16:16:32.5106652Z,2015,391,38,177,224,0,4,0,167,0,0,353,214,0,387,0,2,0
53470,7253,2020-11-18T16:16:32.5116665Z,2016,393,40,175,228,0,5,1,165,0,0,353,218,0,388,0,0,0
53470,7254,2020-11-18T16:16:32.5116665Z,2017,401,41,184,241,0,3,1,160,0,0,360,217,0,398,0,1,0
53470,7255,2020-11-18T16:16:32.5116665Z,2018,432,43,180,272,0,3,8,160,0,0,389,252,0,429,21,0,0
53470,7256,2020-11-18T16:16:32.5126661Z,2019,437,41,183,281,0,3,0,156,0,0,396,254,0,434,29,0,0
53470,7257,2020-11-18T16:16:32.5126661Z,2020,426,49,192,274,0,1,2,152,0,0,377,234,0,425,24,0,0
54288,25907,2021-06-24T05:35:12.8029968Z,2021,276,124,247,122,0,5,12,154,0,0,152,29,0,268,0,0,3
54288,7350,2020-11-18T16:16:33.2411482Z,2012,119,16,107,58,0,5,0,61,0,0,103,12,0,114,0,0,0
54288,7351,2020-11-18T16:16:33.2411482Z,2013,124,31,115,67,0,1,0,57,0,0,93,9,0,123,0,0,0
54288,7352,2020-11-18T16:16:33.2421495Z,2014,131,45,126,58,0,1,0,73,0,0,86,5,0,130,0,0,0
54288,7353,2020-11-18T16:16:33.2421495Z,2015,158,65,149,58,0,1,0,100,0,0,93,9,0,157,0,0,0
54288,7354,2020-11-18T16:16:33.2421495Z,2016,212,92,39,91,0,2,5,121,0,0,120,173,0,204,0,0,6
54288,7355,2020-11-18T16:16:33.2431504Z,2017,311,141,282,133,0,6,9,178,0,0,170,29,0,299,0,1,6
54288,7356,2020-11-18T16:16:33.2431504Z,2018,286,123,270,118,0,5,32,168,0,0,163,16,0,276,1,0,5
54288,7357,2020-11-18T16:16:33.2431504Z,2019,338,139,318,139,0,6,8,199,0,0,199,20,0,327,0,0,5
54288,7358,2020-11-18T16:16:33.2431504Z,2020,309,135,298,127,0,5,16,182,0,0,174,11,0,301,0,0,3
63131,25973,2021-06-24T05:35:12.9130762Z,2021,241,87,228,120,0,29,0,121,0,0,154,13,0,212,0,0,0
63131,8890,2020-11-18T16:16:43.9292739Z,2012,412,67,390,204,0,58,0,208,0,0,345,22,0,354,0,0,0
63131,8891,2020-11-18T16:16:43.9292739Z,2013,395,90,361,200,0,53,0,195,0,0,305,34,0,342,0,0,0
63131,8892,2020-11-18T16:16:43.9292739Z,2014,352,87,303,190,0,52,0,162,0,0,265,49,0,299,0,0,1
63131,8893,2020-11-18T16:16:43.9292739Z,2015,291,77,253,129,0,35,0,162,0,0,214,38,0,254,0,1,2
63131,8894,2020-11-18T16:16:43.9292739Z,2016,194,67,183,84,0,26,0,110,0,0,127,11,0,168,0,1,0
63131,8895,2020-11-18T16:16:43.9302752Z,2017,177,65,167,87,0,27,0,90,0,0,112,10,0,150,0,0,0
63131,8896,2020-11-18T16:16:43.9302752Z,2018,184,58,160,87,0,24,1,97,0,0,126,24,0,159,0,0,1
63131,8897,2020-11-18T16:16:43.9302752Z,2019,327,98,307,158,0,33,3,169,0,0,229,20,0,294,0,0,0
63131,8898,2020-11-18T16:16:43.9302752Z,2020,240,78,219,115,0,29,2,125,0,0,162,21,0,211,0,0,0
64402,25975,2021-06-24T05:35:12.9120753Z,2021,448,42,230,241,0,9,0,207,0,0,406,218,1,438,1,0,0
64402,8946,2020-11-18T16:16:44.4476202Z,2012,690,37,254,324,0,44,0,366,0,0,653,436,2,641,0,0,3
64402,8947,2020-11-18T16:16:44.4476202Z,2013,623,51,254,299,0,30,0,324,0,0,572,369,2,589,0,0,2
64402,8948,2020-11-18T16:16:44.4486211Z,2014,582,64,244,281,0,26,0,301,0,0,518,338,3,552,0,0,1
64402,8949,2020-11-18T16:16:44.4486211Z,2015,571,43,235,287,0,24,0,284,0,0,528,336,3,543,0,0,1
64402,8950,2020-11-18T16:16:44.4486211Z,2016,579,44,157,307,0,21,0,272,0,0,535,422,4,553,0,0,1
64402,8951,2020-11-18T16:16:44.4486211Z,2017,583,41,249,309,0,14,0,274,0,0,542,334,2,566,0,0,1
64402,8952,2020-11-18T16:16:44.4486211Z,2018,576,32,224,309,0,15,2,267,0,0,544,352,2,558,0,1,1
64402,8953,2020-11-18T16:16:44.4496215Z,2019,483,33,166,255,0,10,2,228,0,0,450,317,2,471,0,0,0
64402,8954,2020-11-18T16:16:44.4496215Z,2020,472,37,169,252,0,10,0,220,0,0,435,303,1,461,0,0,0
28555,25740,2021-06-24T05:35:08.6910481Z,2021,184,69,168,84,0,2,5,100,0,0,115,16,0,182,0,0,0
28555,3177,2020-11-18T16:16:05.3435489Z,2012,275,64,233,134,0,0,0,141,0,0,211,42,0,275,0,0,0
28555,3178,2020-11-18T16:16:05.3445493Z,2013,257,60,224,128,0,1,0,129,0,0,197,33,0,256,0,0,0
28555,3179,2020-11-18T16:16:05.3445493Z,2014,241,59,183,124,0,1,0,117,0,0,182,58,0,240,0,0,0
28555,3180,2020-11-18T16:16:05.3445493Z,2015,265,76,175,124,0,2,0,141,0,0,189,90,0,263,0,0,0
28555,3181,2020-11-18T16:16:05.3445493Z,2016,257,68,193,116,0,2,0,141,0,0,189,64,0,255,0,1,0
28555,3182,2020-11-18T16:16:05.3445493Z,2017,225,60,191,98,0,3,0,127,0,0,165,34,0,222,0,0,0
28555,3183,2020-11-18T16:16:05.3445493Z,2018,216,61,176,98,0,1,0,118,0,0,155,40,0,215,0,0,0
28555,3184,2020-11-18T16:16:05.3455498Z,2019,177,57,134,84,0,0,5,93,0,0,120,43,0,177,0,0,0
28555,3185,2020-11-18T16:16:05.3455498Z,2020,208,66,173,95,0,2,6,113,0,0,142,35,0,206,0,0,0
36012,31806,2021-06-24T05:35:16.8949307Z,2021,521,23,180,371,0,9,0,150,0,0,498,341,1,508,0,2,3
36012,4506,2020-11-18T16:16:13.1797708Z,2012,411,4,122,270,0,10,0,141,0,0,407,289,0,401,0,0,0
36012,4507,2020-11-18T16:16:13.1797708Z,2013,406,6,111,275,0,10,0,131,0,0,400,295,0,396,0,1,0
36012,4508,2020-11-18T16:16:13.1797708Z,2014,365,8,96,245,0,9,0,120,0,0,357,269,0,356,0,0,0
36012,4509,2020-11-18T16:16:13.1797708Z,2015,386,10,107,258,0,7,0,128,0,0,376,279,0,379,0,0,0
36012,4510,2020-11-18T16:16:13.1807708Z,2016,425,12,106,292,0,9,0,133,0,0,413,319,1,415,0,0,0
36012,4511,2020-11-18T16:16:13.1807708Z,2017,481,11,144,344,0,11,0,137,0,0,470,337,2,468,0,0,0
36012,4512,2020-11-18T16:16:13.1807708Z,2018,494,11,133,357,0,10,0,137,0,0,483,361,2,482,1,0,0
36012,4513,2020-11-18T16:16:13.1807708Z,2019,502,15,135,357,0,8,1,145,0,0,487,367,2,492,0,0,0
36012,4514,2020-11-18T16:16:13.1807708Z,2020,497,18,122,358,0,11,0,139,0,0,479,375,1,484,0,0,1
48017,31864,2021-06-24T05:35:18.4310329Z,2021,334,107,296,145,0,4,1,189,0,0,227,38,0,330,0,0,0
48017,6086,2020-11-18T16:16:23.9979852Z,2012,329,125,247,147,0,16,0,182,0,0,204,82,0,313,0,0,0
48017,6087,2020-11-18T16:16:23.9979852Z,2013,314,123,226,147,0,13,0,167,0,0,191,88,0,301,0,1,0
48017,6088,2020-11-18T16:16:23.9979852Z,2014,375,145,279,179,0,12,0,196,0,0,230,96,0,363,0,0,0
48017,6089,2020-11-18T16:16:23.998986Z,2015,351,130,271,163,0,8,0,188,0,0,221,80,0,343,0,0,0
48017,6090,2020-11-18T16:16:23.998986Z,2016,289,108,102,135,0,5,1,154,0,0,181,187,0,284,0,0,0
48017,6091,2020-11-18T16:16:23.998986Z,2017,285,91,218,137,0,5,0,148,0,0,194,67,0,280,0,0,0
48017,6092,2020-11-18T16:16:23.998986Z,2018,323,102,252,156,0,6,0,167,0,0,221,71,0,317,1,0,0
48017,6093,2020-11-18T16:16:23.9999865Z,2019,347,113,272,171,0,9,2,176,0,0,234,75,0,338,0,0,0
48017,6094,2020-11-18T16:16:23.9999865Z,2020,345,115,283,165,0,7,0,180,0,0,230,62,0,338,0,0,0
40519,25819,2021-06-24T05:35:10.9096392Z,2021,345,21,176,185,0,13,1,160,0,0,324,169,1,331,6,0,0
40519,4807,2020-11-18T16:16:15.778507Z,2012,364,64,296,184,0,8,0,180,0,0,300,68,0,356,0,0,0
40519,4808,2020-11-18T16:16:15.779507Z,2013,350,89,286,171,0,10,0,179,0,0,261,64,0,340,0,3,0
40519,4809,2020-11-18T16:16:15.779507Z,2014,298,95,247,139,0,10,0,159,0,0,203,51,0,288,0,2,0
40519,4810,2020-11-18T16:16:15.779507Z,2015,263,79,232,118,0,7,0,145,0,0,184,31,0,256,0,2,0
40519,4811,2020-11-18T16:16:15.779507Z,2016,172,68,151,78,0,4,0,94,0,0,104,21,0,168,0,1,0
40519,4812,2020-11-18T16:16:15.779507Z,2017,239,5,94,127,0,9,0,112,0,0,234,145,2,228,0,0,0
40519,4813,2020-11-18T16:16:15.7805074Z,2018,332,10,153,172,0,9,1,160,0,0,322,179,2,320,4,1,1
40519,4814,2020-11-18T16:16:15.7805074Z,2019,337,19,167,167,0,12,1,170,0,0,318,170,2,323,6,1,0
40519,4815,2020-11-18T16:16:15.7805074Z,2020,348,20,153,176,0,10,3,172,0,0,328,195,1,337,5,1,0
22772,2474,2020-11-18T16:16:01.4339379Z,2014,40,4,21,27,0,0,0,13,0,0,36,19,0,40,0,0,0
22772,2475,2020-11-18T16:16:01.4339379Z,2015,108,16,51,70,0,2,0,38,0,0,92,57,0,105,0,1,1
22772,2476,2020-11-18T16:16:01.4339379Z,2016,132,25,49,87,0,3,0,45,0,0,107,83,0,128,0,0,1
22772,2477,2020-11-18T16:16:01.4339379Z,2017,238,26,102,164,0,2,0,74,0,0,212,136,0,236,0,0,0
22772,2478,2020-11-18T16:16:01.4349379Z,2018,252,38,104,168,0,4,6,84,0,0,214,148,0,248,2,0,0
22772,2479,2020-11-18T16:16:01.4349379Z,2019,243,36,108,160,0,3,0,83,0,0,207,135,0,240,2,1,0
22772,2480,2020-11-18T16:16:01.4349379Z,2020,235,43,32,157,0,4,0,78,0,0,192,203,0,231,2,1,0
22772,31716,2021-06-24T05:35:15.3758424Z,2021,258,45,142,176,0,6,0,82,0,0,213,116,0,251,2,0,1
12260,31632,2021-06-24T05:35:14.6323085Z,2021,201,73,174,109,0,1,9,92,0,0,128,27,0,200,0,0,0
12260,669,2020-11-18T16:15:50.2434756Z,2012,257,70,200,126,0,1,0,131,0,0,187,57,0,256,0,0,0
12260,670,2020-11-18T16:15:50.2434756Z,2013,234,68,179,108,0,1,0,126,0,0,166,55,0,233,0,0,0
12260,671,2020-11-18T16:15:50.2434756Z,2014,225,63,174,109,0,0,0,116,0,0,162,51,0,225,0,0,0
12260,672,2020-11-18T16:15:50.2434756Z,2015,233,73,182,114,0,0,0,119,0,0,160,51,1,232,0,1,0
12260,673,2020-11-18T16:15:50.2434756Z,2016,221,70,141,115,0,1,12,106,0,0,151,80,1,219,0,1,0
12260,674,2020-11-18T16:15:50.2444765Z,2017,198,59,161,107,0,0,2,91,0,0,139,37,0,198,0,0,0
12260,675,2020-11-18T16:15:50.2444765Z,2018,194,52,154,94,0,0,8,100,0,0,142,40,0,194,0,0,0
12260,676,2020-11-18T16:15:50.2444765Z,2019,261,92,201,124,0,0,13,137,0,0,169,60,0,261,0,0,0
12260,677,2020-11-18T16:15:50.2444765Z,2020,223,81,168,115,0,0,10,108,0,0,142,55,0,223,0,0,0
40626,25820,2021-06-24T05:35:10.9096392Z,2021,236,76,217,113,0,1,0,123,0,0,160,19,0,235,0,0,0
40626,4825,2020-11-18T16:16:15.7805074Z,2012,348,94,289,175,0,10,0,173,0,0,254,59,0,338,0,0,0
40626,4826,2020-11-18T16:16:15.7805074Z,2013,326,90,267,167,0,8,0,159,0,0,236,59,0,318,0,2,0
40626,4827,2020-11-18T16:16:15.7805074Z,2014,311,82,254,159,0,7,0,152,0,0,229,57,0,304,0,0,0
40626,4828,2020-11-18T16:16:15.7815083Z,2015,306,84,252,156,0,2,0,150,0,0,222,54,0,304,0,1,0
40626,4829,2020-11-18T16:16:15.7815083Z,2016,274,78,227,136,0,0,0,138,0,0,196,47,0,274,0,0,0
40626,4830,2020-11-18T16:16:15.7815083Z,2017,232,66,187,112,0,0,0,120,0,0,166,45,0,232,0,0,0
40626,4831,2020-11-18T16:16:15.7815083Z,2018,255,77,219,115,0,0,24,140,0,0,178,36,0,255,0,0,0
40626,4832,2020-11-18T16:16:15.7815083Z,2019,246,87,204,118,0,0,0,128,0,0,159,42,0,246,0,0,0
40626,4833,2020-11-18T16:16:15.7815083Z,2020,246,94,213,125,0,0,0,121,0,0,152,33,0,246,0,0,0
47084,31858,2021-06-24T05:35:18.4260295Z,2021,314,115,261,160,0,6,0,154,0,0,199,53,1,307,1,0,0
47084,5964,2020-11-18T16:16:23.526671Z,2012,169,19,136,94,0,5,0,75,0,0,150,33,0,164,0,0,0
47084,5965,2020-11-18T16:16:23.526671Z,2013,200,38,166,97,0,10,0,103,0,0,162,34,0,190,0,0,0
47084,5966,2020-11-18T16:16:23.526671Z,2014,194,40,157,89,0,6,0,105,0,0,154,37,0,187,0,0,1
47084,5967,2020-11-18T16:16:23.526671Z,2015,198,53,168,88,0,7,0,110,0,0,145,30,0,190,0,0,1
47084,5968,2020-11-18T16:16:23.526671Z,2016,189,66,48,95,0,4,0,94,0,0,123,141,0,185,0,0,0
47084,5969,2020-11-18T16:16:23.5276705Z,2017,178,59,158,95,0,4,0,83,0,0,119,20,0,174,0,0,0
47084,5970,2020-11-18T16:16:23.5276705Z,2018,277,94,244,137,0,6,1,140,0,0,183,33,0,271,1,1,0
47084,5971,2020-11-18T16:16:23.5276705Z,2019,395,145,352,188,0,10,1,207,0,0,250,43,0,385,1,1,0
47084,5972,2020-11-18T16:16:23.5276705Z,2020,365,131,325,180,0,9,3,185,0,0,234,40,0,356,2,0,0
46664,25853,2021-06-24T05:35:10.9746856Z,2021,392,133,305,182,0,9,3,210,0,0,259,87,0,383,3,1,0
46664,5901,2020-11-18T16:16:23.5066563Z,2012,448,47,374,239,0,7,0,209,0,0,401,74,1,440,0,0,0
46664,5902,2020-11-18T16:16:23.5066563Z,2013,465,93,378,240,0,6,0,225,0,0,372,87,0,459,0,1,0
46664,5903,2020-11-18T16:16:23.5066563Z,2014,452,103,340,222,0,9,0,230,0,0,349,112,0,443,0,3,0
46664,5904,2020-11-18T16:16:23.5076567Z,2015,419,94,318,201,0,8,0,218,0,0,325,101,1,409,0,4,1
46664,5905,2020-11-18T16:16:23.5076567Z,2016,347,92,281,176,0,9,1,171,0,0,255,66,1,337,0,4,0
46664,5906,2020-11-18T16:16:23.5076567Z,2017,370,93,286,174,0,8,1,196,0,0,277,84,0,362,0,4,0
46664,5907,2020-11-18T16:16:23.5076567Z,2018,416,104,338,187,0,7,12,229,0,0,312,78,0,409,0,7,0
46664,5908,2020-11-18T16:16:23.5076567Z,2019,395,123,340,168,0,7,25,227,0,0,272,55,0,388,2,6,0
46664,5909,2020-11-18T16:16:23.5086581Z,2020,392,128,322,182,0,9,6,210,0,0,264,70,0,383,3,3,0
31617,25770,2021-06-24T05:35:08.7420849Z,2021,232,63,204,112,0,5,0,120,0,0,169,28,0,227,0,1,0
31617,3741,2020-11-18T16:16:08.7217989Z,2012,450,78,388,205,0,6,0,245,0,0,372,62,0,444,0,0,0
31617,3742,2020-11-18T16:16:08.7217989Z,2013,428,94,376,199,0,2,0,229,0,0,334,52,0,426,0,0,0
31617,3743,2020-11-18T16:16:08.7217989Z,2014,449,103,374,212,0,3,0,237,0,0,346,75,0,446,0,0,0
31617,3744,2020-11-18T16:16:08.7217989Z,2015,473,110,434,234,0,4,0,239,0,0,363,39,1,468,0,2,0
31617,3745,2020-11-18T16:16:08.7217989Z,2016,475,112,219,230,0,10,0,245,0,0,363,256,0,465,0,4,0
31617,3746,2020-11-18T16:16:08.7228016Z,2017,334,92,307,162,0,10,0,172,0,0,242,27,0,323,0,4,1
31617,3747,2020-11-18T16:16:08.7228016Z,2018,298,72,262,152,0,10,2,146,0,0,226,36,0,288,0,0,0
31617,3748,2020-11-18T16:16:08.7228016Z,2019,251,65,219,115,0,7,0,136,0,0,186,32,0,244,0,0,0
31617,3749,2020-11-18T16:16:08.7228016Z,2020,260,68,216,132,0,8,0,128,0,0,192,44,0,250,0,0,2
57281,31746,2021-06-24T05:35:15.4148697Z,2021,298,47,177,157,0,5,10,141,0,0,251,121,0,293,3,0,0
57281,7676,2020-11-18T16:16:35.1043911Z,2012,302,6,160,154,0,2,0,148,0,0,296,142,0,300,0,0,0
57281,7677,2020-11-18T16:16:35.1043911Z,2013,296,8,158,147,0,2,0,149,0,0,288,138,0,294,0,0,0
57281,7678,2020-11-18T16:16:35.1043911Z,2014,297,18,144,147,0,1,0,150,0,0,279,153,0,296,0,1,0
57281,7679,2020-11-18T16:16:35.105392Z,2015,274,22,136,130,0,0,0,144,0,0,252,138,0,273,0,0,1
57281,7680,2020-11-18T16:16:35.105392Z,2016,304,32,140,149,0,0,0,155,0,0,272,164,0,303,0,0,1
57281,7681,2020-11-18T16:16:35.105392Z,2017,315,33,142,153,0,1,0,162,0,0,282,173,0,313,0,1,1
57281,7682,2020-11-18T16:16:35.1063938Z,2018,324,23,144,159,0,3,0,165,0,1,301,180,0,320,4,2,1
57281,7683,2020-11-18T16:16:35.1063938Z,2019,315,27,135,161,0,3,33,154,0,2,288,180,0,311,5,0,1
57281,7684,2020-11-18T16:16:35.1063938Z,2020,307,40,157,154,0,5,12,153,0,0,267,150,0,302,4,0,0
56440,31922,2021-06-24T05:35:18.5140922Z,2021,389,126,324,169,0,11,1,220,0,0,263,65,0,378,0,2,0
56440,7613,2020-11-18T16:16:35.0743724Z,2012,645,90,445,306,0,2,0,339,0,0,555,200,0,643,0,0,0
56440,7614,2020-11-18T16:16:35.0743724Z,2013,702,139,592,321,0,4,0,381,0,0,563,110,1,697,0,2,0
56440,7615,2020-11-18T16:16:35.0743724Z,2014,525,118,436,244,0,2,0,281,0,0,407,89,2,520,0,1,1
56440,7616,2020-11-18T16:16:35.075372Z,2015,375,102,317,182,0,2,0,193,0,0,273,58,1,372,0,0,0
56440,7617,2020-11-18T16:16:35.075372Z,2016,289,109,234,135,0,1,4,154,0,0,180,55,0,288,0,2,0
56440,7618,2020-11-18T16:16:35.075372Z,2017,448,174,397,196,0,3,11,252,0,0,274,51,2,443,0,1,0
56440,7619,2020-11-18T16:16:35.0763728Z,2018,451,149,389,203,0,2,0,248,0,0,302,62,3,446,2,1,0
56440,7620,2020-11-18T16:16:35.0763728Z,2019,387,132,321,174,0,2,1,213,0,0,255,66,0,385,0,1,0
56440,7621,2020-11-18T16:16:35.0763728Z,2020,393,124,344,184,0,8,9,209,0,0,269,49,1,384,1,1,0
10272,31580,2021-06-24T05:35:14.5192277Z,2021,238,88,212,114,0,3,15,124,0,0,150,26,0,235,0,0,0
10272,49,2020-11-18T16:15:45.5233274Z,2012,591,145,387,282,0,1,0,309,0,0,446,204,0,590,0,0,0
10272,50,2020-11-18T16:15:45.5233274Z,2013,584,165,437,292,0,0,0,292,0,0,419,147,0,584,0,1,0
10272,51,2020-11-18T16:15:45.5233274Z,2014,529,160,391,260,0,1,0,269,0,0,369,138,0,528,0,1,0
10272,52,2020-11-18T16:15:45.5243274Z,2015,455,160,373,216,0,0,0,239,0,0,295,82,0,455,0,0,0
10272,53,2020-11-18T16:15:45.5243274Z,2016,360,135,282,177,0,6,2,183,0,0,225,78,0,354,0,0,0
10272,54,2020-11-18T16:15:45.5243274Z,2017,273,106,225,140,0,2,2,133,0,0,167,48,0,271,0,0,0
10272,55,2020-11-18T16:15:45.5243274Z,2018,248,92,209,121,0,1,47,127,0,0,156,39,0,247,0,0,0
10272,56,2020-11-18T16:15:45.5243274Z,2019,240,87,207,118,0,2,17,122,0,0,153,33,0,238,0,0,0
10272,57,2020-11-18T16:15:45.5253283Z,2020,246,82,214,114,0,3,0,132,0,0,164,32,0,243,0,0,0
11403,25590,2021-06-24T05:35:04.600116Z,2021,259,102,239,125,0,3,0,134,0,0,157,20,1,253,1,0,2
11403,388,2020-11-18T16:15:47.596712Z,2012,366,114,315,172,0,3,0,194,0,0,252,51,0,363,0,0,0
11403,389,2020-11-18T16:15:47.596712Z,2013,351,114,302,173,0,3,0,178,0,0,237,49,0,348,0,1,0
11403,390,2020-11-18T16:15:47.596712Z,2014,335,127,264,164,0,3,0,171,0,0,208,71,0,332,0,1,0
11403,391,2020-11-18T16:15:47.596712Z,2015,303,107,262,155,0,2,0,148,0,0,196,41,0,301,0,1,0
11403,392,2020-11-18T16:15:47.5977124Z,2016,280,108,232,145,0,1,0,135,0,0,172,48,0,278,0,1,1
11403,393,2020-11-18T16:15:47.5977124Z,2017,246,91,217,131,0,1,0,115,0,0,155,29,0,244,0,0,1
11403,394,2020-11-18T16:15:47.5977124Z,2018,194,65,165,99,0,1,0,95,0,0,129,29,0,192,1,0,1
11403,395,2020-11-18T16:15:47.5977124Z,2019,282,126,253,130,0,1,0,152,0,0,156,29,0,280,1,0,1
11403,396,2020-11-18T16:15:47.5987142Z,2020,268,124,246,118,0,3,0,150,0,0,144,22,0,264,1,0,1
47977,25862,2021-06-24T05:35:10.9886956Z,2021,473,164,398,222,0,7,0,251,0,0,309,75,0,466,0,0,0
47977,6077,2020-11-18T16:16:23.9959838Z,2012,269,28,214,135,0,8,0,134,0,0,241,55,0,261,0,0,0
47977,6078,2020-11-18T16:16:23.9969856Z,2013,227,37,184,113,0,9,0,114,0,0,190,43,0,218,0,3,0
47977,6079,2020-11-18T16:16:23.9969856Z,2014,214,47,180,113,0,8,0,101,0,0,167,34,0,206,0,1,0
47977,6080,2020-11-18T16:16:23.9969856Z,2015,206,39,181,106,0,7,0,100,0,0,167,25,0,199,0,1,0
47977,6081,2020-11-18T16:16:23.9969856Z,2016,210,51,175,101,0,6,0,109,0,0,159,35,0,204,0,1,0
47977,6082,2020-11-18T16:16:23.9969856Z,2017,172,59,144,81,0,2,0,91,0,0,113,28,0,170,0,1,0
47977,6083,2020-11-18T16:16:23.9979852Z,2018,179,52,135,95,0,0,0,84,0,0,127,44,0,179,0,0,0
47977,6084,2020-11-18T16:16:23.9979852Z,2019,532,171,436,251,1,5,1,281,0,0,361,96,0,526,0,0,1
47977,6085,2020-11-18T16:16:23.9979852Z,2020,512,172,434,241,0,5,0,271,0,0,340,78,0,506,0,1,1
48298,25864,2021-06-24T05:35:10.9906984Z,2021,687,173,609,381,0,11,0,306,0,0,514,78,0,675,0,0,1
48298,6113,2020-11-18T16:16:25.0696999Z,2012,908,0,624,478,0,5,0,430,0,0,908,284,0,903,0,0,0
48298,6114,2020-11-18T16:16:25.0707008Z,2013,850,4,590,473,0,8,0,377,0,0,846,260,0,842,0,4,0
48298,6115,2020-11-18T16:16:25.0707008Z,2014,897,44,642,513,0,7,0,384,0,0,853,255,0,890,0,6,0
48298,6116,2020-11-18T16:16:25.0707008Z,2015,877,40,615,481,0,17,0,396,0,0,837,262,0,859,0,9,1
48298,6117,2020-11-18T16:16:25.0707008Z,2016,858,83,279,449,0,16,0,409,0,0,775,579,0,841,0,6,1
48298,6118,2020-11-18T16:16:25.0707008Z,2017,974,137,768,521,0,20,1,453,0,0,837,206,0,951,0,5,3
48298,6119,2020-11-18T16:16:25.0717017Z,2018,892,103,726,495,0,20,3,397,0,0,789,166,0,869,0,1,3
48298,6120,2020-11-18T16:16:25.0717017Z,2019,823,118,691,463,0,29,2,360,0,0,705,132,0,794,0,0,0
48298,6121,2020-11-18T16:16:25.0717017Z,2020,770,165,663,428,0,17,2,342,0,0,605,107,0,753,0,0,0
46219,31853,2021-06-24T05:35:17.0010072Z,2021,338,94,284,189,0,1,0,149,0,0,244,54,0,336,0,1,1
46219,5874,2020-11-18T16:16:22.58304Z,2012,265,0,221,150,0,0,0,115,0,0,265,44,0,265,0,0,0
46219,5875,2020-11-18T16:16:22.58304Z,2013,255,0,209,142,0,1,0,113,0,0,255,46,0,254,0,0,0
46219,5876,2020-11-18T16:16:22.58304Z,2014,242,15,183,131,0,3,0,111,0,0,227,59,0,239,0,2,0
46219,5877,2020-11-18T16:16:22.5840413Z,2015,221,13,165,124,0,4,0,97,0,0,208,56,0,217,0,1,0
46219,5878,2020-11-18T16:16:22.5840413Z,2016,143,10,112,77,0,5,3,66,0,0,133,31,0,138,0,2,0
46219,5879,2020-11-18T16:16:22.5840413Z,2017,280,41,221,161,0,4,1,119,0,0,239,59,0,276,0,0,0
46219,5880,2020-11-18T16:16:22.5850404Z,2018,301,55,235,158,0,4,0,143,0,1,246,66,0,297,0,0,0
46219,5881,2020-11-18T16:16:22.5850404Z,2019,306,61,252,164,0,3,4,142,0,2,245,54,0,303,0,0,0
46219,5882,2020-11-18T16:16:22.5850404Z,2020,321,79,259,176,0,2,2,145,0,0,242,62,0,319,0,0,0
12138,25598,2021-06-24T05:35:04.6141251Z,2021,105,38,91,47,0,0,0,58,0,0,67,14,0,105,0,0,0
12138,610,2020-11-18T16:15:50.2274663Z,2012,166,47,146,73,0,0,0,93,0,0,119,20,0,166,0,0,0
12138,611,2020-11-18T16:15:50.2274663Z,2013,184,60,166,87,0,1,0,97,0,0,124,18,0,183,0,0,0
12138,612,2020-11-18T16:15:50.2274663Z,2014,175,50,131,78,0,2,0,97,0,0,125,44,0,173,0,0,0
12138,613,2020-11-18T16:15:50.2274663Z,2015,163,51,137,71,0,2,0,92,0,0,112,26,0,161,0,0,0
12138,614,2020-11-18T16:15:50.2274663Z,2016,153,52,127,69,0,2,0,84,0,0,101,26,0,151,0,0,0
12138,615,2020-11-18T16:15:50.2274663Z,2017,149,56,122,66,0,2,0,83,0,0,93,27,0,147,0,0,0
12138,616,2020-11-18T16:15:50.2284659Z,2018,134,53,119,61,0,2,0,73,0,1,81,15,0,132,0,0,0
12138,617,2020-11-18T16:15:50.2284659Z,2019,121,48,106,60,0,0,0,61,0,0,73,15,0,121,0,0,0
12138,618,2020-11-18T16:15:50.2284659Z,2020,111,45,98,51,0,0,0,60,0,0,66,13,0,111,0,0,0
61556,31951,2021-06-24T05:35:18.5641276Z,2021,230,75,203,108,0,4,0,122,0,0,155,27,0,226,0,0,0
61556,8277,2020-11-18T16:16:39.0790408Z,2012,363,165,354,170,0,5,0,193,0,0,198,9,0,358,0,0,0
61556,8278,2020-11-18T16:16:39.0790408Z,2013,353,170,304,153,0,4,0,200,0,0,183,49,0,349,0,0,0
61556,8279,2020-11-18T16:16:39.0790408Z,2014,329,158,315,153,0,2,0,176,0,0,171,14,0,327,0,0,0
61556,8280,2020-11-18T16:16:39.0800413Z,2015,340,137,332,162,0,4,0,178,0,0,203,8,0,336,0,0,0
61556,8281,2020-11-18T16:16:39.0800413Z,2016,328,123,309,154,0,6,1,174,0,0,205,19,0,322,0,0,0
61556,8282,2020-11-18T16:16:39.0800413Z,2017,365,136,355,175,0,5,1,190,0,0,229,10,0,360,0,2,0
61556,8283,2020-11-18T16:16:39.0800413Z,2018,350,124,337,172,0,5,1,178,0,0,226,13,0,345,0,0,0
61556,8284,2020-11-18T16:16:39.0800413Z,2019,292,99,252,149,0,2,0,143,0,0,193,40,0,290,0,0,0
61556,8285,2020-11-18T16:16:39.0810417Z,2020,292,95,276,146,0,7,1,146,0,0,197,16,0,285,0,0,0
17780,1459,2020-11-18T16:15:54.7664954Z,2012,485,144,329,238,0,5,0,247,0,0,341,156,0,480,0,0,0
17780,1460,2020-11-18T16:15:54.7664954Z,2013,451,138,300,210,0,5,0,241,0,0,313,151,0,446,0,5,0
17780,1461,2020-11-18T16:15:54.7664954Z,2014,451,130,258,215,0,4,0,236,0,0,321,193,0,446,0,2,1
17780,1462,2020-11-18T16:15:54.7674968Z,2015,496,147,300,243,0,4,0,253,0,0,349,196,0,492,0,0,0
17780,1463,2020-11-18T16:15:54.7674968Z,2016,452,144,72,218,0,3,0,234,0,0,308,380,0,449,0,0,0
17780,1464,2020-11-18T16:15:54.7674968Z,2017,480,147,294,231,0,5,0,249,0,0,333,186,0,475,0,0,0
17780,1465,2020-11-18T16:15:54.7674968Z,2018,398,122,229,197,0,0,4,201,0,0,276,169,0,397,0,0,1
17780,1466,2020-11-18T16:15:54.7674968Z,2019,393,122,259,193,0,1,0,200,0,0,271,134,0,391,0,0,1
17780,1467,2020-11-18T16:15:54.7674968Z,2020,375,136,256,182,0,0,0,193,0,0,239,119,0,375,0,0,0
17780,31614,2021-06-24T05:35:14.6112937Z,2021,370,127,270,175,0,0,0,195,0,0,243,100,0,369,0,0,1
69021,25990,2021-06-24T05:35:14.5112224Z,2021,306,119,272,135,0,8,0,171,0,0,187,34,0,298,0,0,0
69021,9285,2020-11-18T16:16:46.7131335Z,2012,365,107,299,156,0,11,0,209,0,0,258,66,0,354,0,0,0
69021,9286,2020-11-18T16:16:46.7131335Z,2013,378,116,315,165,0,9,0,213,0,0,262,63,0,369,0,0,0
69021,9287,2020-11-18T16:16:46.7131335Z,2014,342,108,289,145,0,8,0,197,0,0,234,53,0,334,0,0,0
69021,9288,2020-11-18T16:16:46.7131335Z,2015,340,122,291,139,0,10,0,201,0,0,218,49,0,330,0,0,0
69021,9289,2020-11-18T16:16:46.7141349Z,2016,348,126,231,155,0,10,0,193,0,0,222,117,0,338,0,0,0
69021,9290,2020-11-18T16:16:46.7141349Z,2017,322,114,271,147,0,10,1,175,0,0,208,51,0,312,0,0,0
69021,9291,2020-11-18T16:16:46.7141349Z,2018,248,87,204,114,0,9,0,134,0,0,161,44,0,239,0,0,0
69021,9292,2020-11-18T16:16:46.7141349Z,2019,290,115,252,129,0,10,0,161,0,0,175,38,0,280,0,0,0
69021,9293,2020-11-18T16:16:46.7151349Z,2020,307,116,265,135,0,8,0,172,0,0,191,42,0,299,0,0,0
70599,31657,2021-06-24T05:35:15.2367419Z,2021,205,72,172,107,0,6,0,98,0,0,133,33,0,199,0,1,0
70599,9801,2020-11-18T16:16:50.8689031Z,2012,199,80,111,95,0,3,0,104,0,0,119,88,0,196,0,0,0
70599,9802,2020-11-18T16:16:50.8689031Z,2013,181,82,94,84,0,7,0,97,0,0,99,87,0,174,0,1,0
70599,9803,2020-11-18T16:16:50.869904Z,2014,158,66,136,73,0,7,0,85,0,0,92,22,0,151,0,0,0
70599,9804,2020-11-18T16:16:50.869904Z,2015,153,58,115,75,0,6,0,78,0,0,95,38,0,147,0,1,0
70599,9805,2020-11-18T16:16:50.869904Z,2016,248,93,167,129,0,8,0,119,0,0,155,81,0,239,0,1,1
70599,9806,2020-11-18T16:16:50.869904Z,2017,227,99,214,117,0,9,0,110,0,0,128,13,0,217,0,1,1
70599,9807,2020-11-18T16:16:50.8709045Z,2018,150,73,138,74,0,9,0,76,0,0,77,12,0,141,0,1,0
70599,9808,2020-11-18T16:16:50.8709045Z,2019,215,89,187,110,0,10,0,105,0,0,126,28,0,204,0,1,1
70599,9809,2020-11-18T16:16:50.8709045Z,2020,209,79,196,108,0,6,0,101,0,0,130,13,0,202,0,0,1
63032,25970,2021-06-24T05:35:12.9080728Z,2021,319,64,262,172,0,25,2,147,0,0,255,57,0,293,0,0,1
63032,8823,2020-11-18T16:16:43.9042579Z,2012,312,37,259,192,0,11,0,120,0,0,275,53,0,301,0,0,0
63032,8824,2020-11-18T16:16:43.9042579Z,2013,310,57,262,192,0,12,0,118,0,0,253,48,0,298,0,0,0
63032,8825,2020-11-18T16:16:43.9042579Z,2014,306,69,256,174,0,16,0,132,0,0,237,50,0,290,0,0,0
63032,8826,2020-11-18T16:16:43.9042579Z,2015,294,70,260,157,0,18,0,137,0,0,224,34,0,275,0,0,1
63032,8827,2020-11-18T16:16:43.9052579Z,2016,318,75,281,160,0,24,0,158,0,0,243,37,0,293,0,0,1
63032,8828,2020-11-18T16:16:43.9052579Z,2017,324,78,274,160,0,11,1,164,0,0,246,50,0,312,0,0,1
63032,8829,2020-11-18T16:16:43.9052579Z,2018,361,92,305,195,0,18,1,166,0,0,269,56,0,342,1,1,1
63032,8830,2020-11-18T16:16:43.9052579Z,2019,381,107,309,199,0,26,0,182,0,0,274,72,0,354,1,1,1
63032,8831,2020-11-18T16:16:43.9052579Z,2020,345,73,271,186,0,28,0,159,0,0,272,74,0,316,0,1,1
20552,1805,2020-11-18T16:15:57.8365409Z,2012,718,168,516,373,0,0,0,345,0,0,550,202,1,717,0,0,0
20552,1806,2020-11-18T16:15:57.8365409Z,2013,693,198,518,353,0,0,0,340,0,0,495,175,0,693,0,11,0
20552,1807,2020-11-18T16:15:57.8365409Z,2014,621,181,466,322,0,0,0,299,0,0,440,155,0,621,0,8,0
20552,1808,2020-11-18T16:15:57.8375418Z,2015,613,174,482,315,0,0,0,298,0,0,439,131,1,612,0,7,0
20552,1809,2020-11-18T16:15:57.8375418Z,2016,576,172,428,306,0,0,0,270,0,0,404,148,0,576,0,4,0
20552,1810,2020-11-18T16:15:57.8375418Z,2017,448,152,336,234,0,0,1,214,0,0,296,112,0,448,0,2,0
20552,1811,2020-11-18T16:15:57.8375418Z,2018,420,123,310,224,0,0,14,196,0,0,297,110,0,420,10,0,0
20552,1812,2020-11-18T16:15:57.8385422Z,2019,484,151,402,243,2,0,0,241,0,0,333,82,0,484,16,0,0
20552,1813,2020-11-18T16:15:57.8385422Z,2020,458,142,391,230,0,0,1,228,0,0,316,67,0,458,15,0,0
20552,25694,2021-06-24T05:35:08.6380107Z,2021,443,132,401,230,0,1,0,213,0,0,311,42,0,442,8,0,0
27599,25735,2021-06-24T05:35:08.6880466Z,2021,274,121,237,125,0,3,0,149,0,0,153,37,1,269,0,0,1
27599,3065,2020-11-18T16:16:04.7681639Z,2015,340,123,256,159,0,2,0,181,0,0,217,84,0,338,0,2,0
27599,3066,2020-11-18T16:16:04.7681639Z,2016,273,105,172,122,0,3,0,151,0,0,168,101,0,270,0,0,0
27599,3067,2020-11-18T16:16:04.7681639Z,2017,275,114,209,125,0,4,1,150,0,0,161,66,0,271,0,1,0
27599,3068,2020-11-18T16:16:04.7681639Z,2018,329,134,253,148,0,5,23,181,0,0,195,76,0,324,1,1,0
27599,3069,2020-11-18T16:16:04.7681639Z,2019,314,138,224,154,0,3,3,160,0,0,176,90,1,310,1,0,0
27599,3070,2020-11-18T16:16:04.7681639Z,2020,276,118,221,136,0,2,2,140,0,0,158,55,1,272,1,0,1
51631,31886,2021-06-24T05:35:18.4560506Z,2021,344,143,276,173,0,9,0,171,0,0,201,68,0,335,0,2,0
51631,6534,2020-11-18T16:16:27.7975172Z,2012,791,105,572,392,0,1,0,399,0,0,686,219,0,789,0,0,1
51631,6535,2020-11-18T16:16:27.7975172Z,2013,741,164,532,357,0,1,0,384,0,0,577,209,0,740,0,1,0
51631,6536,2020-11-18T16:16:27.7985168Z,2014,677,180,489,303,0,2,0,374,0,0,497,188,0,675,0,1,0
51631,6537,2020-11-18T16:16:27.7985168Z,2015,683,180,498,308,0,2,0,375,0,0,503,185,0,681,0,2,0
51631,6538,2020-11-18T16:16:27.7985168Z,2016,582,180,217,272,0,6,1,310,0,0,402,365,3,573,0,3,0
51631,6539,2020-11-18T16:16:27.7985168Z,2017,516,177,396,240,0,3,1,276,0,0,339,120,0,513,0,4,0
51631,6540,2020-11-18T16:16:27.7985168Z,2018,501,170,369,220,0,2,2,281,0,0,331,132,0,498,0,4,1
51631,6541,2020-11-18T16:16:27.7995186Z,2019,510,191,384,229,0,15,1,281,0,0,319,126,0,493,0,5,2
51631,6542,2020-11-18T16:16:27.7995186Z,2020,396,158,310,193,0,19,0,203,0,0,238,86,0,377,0,5,0
62521,25960,2021-06-24T05:35:12.9010676Z,2021,251,91,240,120,0,6,0,131,0,0,160,11,0,245,0,0,0
62521,8544,2020-11-18T16:16:40.8822463Z,2012,422,113,399,204,0,11,0,218,0,0,309,23,0,411,0,0,0
62521,8545,2020-11-18T16:16:40.8822463Z,2013,393,102,379,181,0,10,0,212,0,0,291,14,0,383,0,0,0
62521,8546,2020-11-18T16:16:40.8822463Z,2014,387,105,371,176,0,7,0,211,0,0,282,16,0,379,0,1,1
62521,8547,2020-11-18T16:16:40.8832458Z,2015,383,113,362,179,0,10,0,204,0,0,270,21,0,372,0,0,1
62521,8548,2020-11-18T16:16:40.8832458Z,2016,355,103,118,184,0,17,1,171,0,0,252,237,0,338,0,0,0
62521,8549,2020-11-18T16:16:40.8832458Z,2017,356,106,338,185,0,14,1,171,0,0,250,18,0,342,0,0,0
62521,8550,2020-11-18T16:16:40.8842472Z,2018,267,70,246,133,0,6,1,134,0,0,197,21,0,261,0,0,0
62521,8551,2020-11-18T16:16:40.8842472Z,2019,305,98,293,141,0,11,5,164,0,0,207,12,0,294,0,0,0
62521,8552,2020-11-18T16:16:40.8842472Z,2020,279,94,269,128,0,5,0,151,0,0,185,10,0,274,0,0,0
25619,2884,2020-11-18T16:16:03.7014522Z,2012,373,47,253,172,0,3,0,201,0,0,326,120,4,365,0,0,1
25619,2885,2020-11-18T16:16:03.7024517Z,2013,432,113,302,193,0,3,0,239,0,0,319,130,0,429,0,1,0
25619,2886,2020-11-18T16:16:03.7024517Z,2014,431,134,308,209,0,3,0,222,0,0,297,123,0,428,0,0,0
25619,2887,2020-11-18T16:16:03.7024517Z,2015,435,121,307,221,0,6,0,214,0,0,314,128,0,429,0,3,0
25619,2888,2020-11-18T16:16:03.7024517Z,2016,414,129,226,209,0,6,8,205,0,0,285,188,0,408,0,2,0
25619,2889,2020-11-18T16:16:03.7034535Z,2017,391,141,291,196,0,6,9,195,0,0,250,100,0,385,0,1,0
25619,2890,2020-11-18T16:16:03.7034535Z,2018,449,128,333,239,0,8,0,210,0,0,321,116,0,441,0,2,0
25619,2891,2020-11-18T16:16:03.7034535Z,2019,347,103,257,172,0,2,15,175,0,0,244,90,0,345,0,1,0
25619,2892,2020-11-18T16:16:03.7044535Z,2020,387,139,288,185,0,4,21,202,0,0,248,99,0,383,0,0,0
25619,31727,2021-06-24T05:35:15.38685Z,2021,395,163,302,198,0,3,3,197,0,0,232,93,0,392,0,0,0
12070,31598,2021-06-24T05:35:14.5582554Z,2021,312,98,272,156,0,3,0,156,0,0,214,40,2,303,0,0,4
12070,579,2020-11-18T16:15:49.8171939Z,2012,292,81,270,120,0,3,0,172,0,0,211,22,0,289,0,0,0
12070,580,2020-11-18T16:15:49.8171939Z,2013,284,86,268,115,0,3,0,169,0,0,198,16,0,281,0,0,0
12070,581,2020-11-18T16:15:49.8171939Z,2014,280,82,218,124,0,6,0,156,0,0,198,62,0,274,0,1,0
12070,582,2020-11-18T16:15:49.8171939Z,2015,284,71,220,129,0,8,0,155,0,0,213,64,0,276,0,1,0
12070,583,2020-11-18T16:15:49.8181944Z,2016,279,69,73,128,0,11,2,151,0,0,210,206,0,268,0,0,0
12070,584,2020-11-18T16:15:49.8181944Z,2017,284,80,239,131,0,8,1,153,0,0,204,45,0,276,0,0,0
12070,585,2020-11-18T16:15:49.8181944Z,2018,305,90,256,135,0,3,0,170,0,0,215,49,0,302,0,0,0
12070,586,2020-11-18T16:15:49.8181944Z,2019,342,110,284,166,0,5,0,176,0,0,232,58,0,337,0,0,0
12070,587,2020-11-18T16:15:49.8181944Z,2020,325,107,278,170,0,3,0,155,0,0,218,47,2,320,0,0,0
52795,31744,2021-06-24T05:35:15.4128682Z,2021,184,63,165,91,0,6,9,93,0,0,121,19,0,178,2,0,0
52795,6992,2020-11-18T16:16:30.9005894Z,2012,366,91,311,167,0,18,0,199,0,0,275,55,0,348,0,0,0
52795,6993,2020-11-18T16:16:30.9015908Z,2013,322,93,269,141,0,20,0,181,0,0,229,53,0,302,0,2,0
52795,6994,2020-11-18T16:16:30.9015908Z,2014,310,94,257,132,0,23,0,178,0,0,216,53,0,287,0,5,0
52795,6995,2020-11-18T16:16:30.9015908Z,2015,299,89,265,133,0,20,0,166,0,0,210,34,0,279,0,7,0
52795,6996,2020-11-18T16:16:30.9015908Z,2016,242,65,216,120,0,13,9,122,0,0,177,26,0,229,0,6,0
52795,6997,2020-11-18T16:16:30.9025912Z,2017,215,60,191,105,0,11,0,110,0,0,155,24,0,204,0,5,0
52795,6998,2020-11-18T16:16:30.9025912Z,2018,195,57,165,96,0,14,3,99,0,0,138,30,0,181,1,1,0
52795,6999,2020-11-18T16:16:30.9025912Z,2019,179,60,162,91,0,12,0,88,0,0,119,17,0,167,2,1,0
52795,7000,2020-11-18T16:16:30.9035917Z,2020,185,67,161,92,0,6,14,93,0,0,118,24,0,179,2,0,0
35535,31798,2021-06-24T05:35:16.8709135Z,2021,270,85,237,124,0,2,1,146,0,0,185,33,0,267,0,0,1
35535,4356,2020-11-18T16:16:12.1680973Z,2012,468,105,369,222,0,4,0,246,0,0,363,99,0,464,0,0,0
35535,4357,2020-11-18T16:16:12.1680973Z,2013,466,115,358,229,0,3,0,237,0,0,351,108,0,463,0,0,0
35535,4358,2020-11-18T16:16:12.1690987Z,2014,488,125,400,241,0,0,0,247,0,0,363,88,0,488,0,0,0
35535,4359,2020-11-18T16:16:12.1690987Z,2015,476,117,401,230,0,1,0,246,0,0,359,75,0,475,0,0,0
35535,4360,2020-11-18T16:16:12.1690987Z,2016,420,120,336,194,0,2,1,226,0,0,300,84,0,418,0,1,0
35535,4361,2020-11-18T16:16:12.1701004Z,2017,337,108,272,152,0,2,1,185,0,0,229,65,0,335,0,1,0
35535,4362,2020-11-18T16:16:12.1701004Z,2018,340,98,269,157,0,4,2,183,0,0,242,71,0,336,1,2,0
35535,4363,2020-11-18T16:16:12.1701004Z,2019,310,106,260,138,0,4,1,172,0,0,204,50,0,306,0,1,0
35535,4364,2020-11-18T16:16:12.1710991Z,2020,282,97,231,130,0,3,0,152,0,0,185,51,0,279,0,0,0
36350,31808,2021-06-24T05:35:16.9019364Z,2021,291,72,252,140,0,0,0,151,0,0,219,39,0,290,0,0,1
36350,4551,2020-11-18T16:16:13.1947806Z,2012,256,44,227,126,0,0,0,130,0,0,212,29,0,256,0,0,0
36350,4552,2020-11-18T16:16:13.1947806Z,2013,350,63,272,170,0,0,0,180,0,0,287,78,0,350,0,0,0
36350,4553,2020-11-18T16:16:13.195782Z,2014,352,71,294,167,0,0,0,185,0,0,281,58,0,352,0,0,0
36350,4554,2020-11-18T16:16:13.195782Z,2015,331,67,262,162,0,0,0,169,0,0,264,69,0,331,0,0,0
36350,4555,2020-11-18T16:16:13.195782Z,2016,319,70,26,150,0,0,0,169,0,0,249,293,0,319,0,0,0
36350,4556,2020-11-18T16:16:13.195782Z,2017,295,74,264,138,0,0,0,157,0,0,221,31,0,295,0,0,0
36350,4557,2020-11-18T16:16:13.195782Z,2018,297,72,232,153,0,2,0,144,0,0,225,65,0,295,0,0,0
36350,4558,2020-11-18T16:16:13.195782Z,2019,320,81,227,166,0,1,0,154,0,0,239,93,0,319,0,0,0
36350,4559,2020-11-18T16:16:13.1967833Z,2020,301,78,229,149,0,1,0,152,0,0,223,72,0,300,0,0,0
12088,25597,2021-06-24T05:35:04.6121242Z,2021,383,125,316,192,0,3,0,191,0,0,258,67,1,378,0,1,1
12088,588,2020-11-18T16:15:49.7001162Z,2012,516,1,392,274,0,12,0,242,0,0,515,124,3,501,0,0,0
12088,589,2020-11-18T16:15:49.7001162Z,2013,507,0,421,265,0,5,0,242,0,0,507,86,7,495,0,2,0
12088,590,2020-11-18T16:15:49.7001162Z,2014,539,40,453,285,0,3,0,254,0,0,499,86,8,528,0,5,0
12088,591,2020-11-18T16:15:49.7001162Z,2015,556,30,457,282,0,5,0,274,0,0,526,99,6,544,0,6,1
12088,592,2020-11-18T16:15:49.7011176Z,2016,333,30,46,170,0,2,0,163,0,0,303,287,3,328,0,4,0
12088,593,2020-11-18T16:15:49.7011176Z,2017,518,67,439,261,0,7,0,257,0,0,451,79,0,511,0,3,0
12088,594,2020-11-18T16:15:49.7011176Z,2018,607,113,535,310,0,0,3,297,0,0,494,72,0,607,0,1,0
12088,595,2020-11-18T16:15:49.7011176Z,2019,526,109,487,264,0,0,2,262,0,0,417,39,1,525,0,2,0
12088,596,2020-11-18T16:15:49.702118Z,2020,429,133,402,205,0,2,0,224,0,0,296,27,1,426,0,1,0
52050,31891,2021-06-24T05:35:18.4630563Z,2021,452,176,386,209,0,5,0,243,0,0,276,66,0,447,0,1,0
52050,6678,2020-11-18T16:16:28.2618265Z,2012,609,199,567,300,0,15,0,309,0,0,410,42,0,594,0,0,0
52050,6679,2020-11-18T16:16:28.2628278Z,2013,580,184,506,298,0,8,0,282,0,0,396,74,0,572,0,1,0
52050,6680,2020-11-18T16:16:28.2628278Z,2014,543,178,456,278,0,9,0,265,0,0,365,87,0,534,0,3,0
52050,6681,2020-11-18T16:16:28.2628278Z,2015,512,186,462,263,0,12,0,249,0,0,326,50,0,500,0,4,0
52050,6682,2020-11-18T16:16:28.2638292Z,2016,479,194,409,240,0,4,0,239,0,0,285,70,0,475,0,4,0
52050,6683,2020-11-18T16:16:28.2638292Z,2017,399,152,350,196,0,2,7,203,0,0,247,49,0,397,0,3,0
52050,6684,2020-11-18T16:16:28.2638292Z,2018,504,198,442,239,0,3,0,265,0,0,306,62,0,500,0,3,1
52050,6685,2020-11-18T16:16:28.2638292Z,2019,517,203,433,246,0,13,2,271,0,0,314,84,0,504,0,1,0
52050,6686,2020-11-18T16:16:28.2648283Z,2020,513,196,433,244,0,8,7,269,0,0,317,80,0,505,0,1,0
10702,167,2020-11-18T16:15:46.3829014Z,2012,729,0,534,368,0,12,0,361,0,0,729,195,0,715,0,0,2
10702,168,2020-11-18T16:15:46.3829014Z,2013,755,8,542,382,0,18,0,373,0,0,747,213,1,736,0,6,0
10702,169,2020-11-18T16:15:46.3829014Z,2014,753,46,556,388,0,20,0,365,0,0,707,197,1,732,0,7,0
10702,170,2020-11-18T16:15:46.3829014Z,2015,760,61,547,392,0,13,0,368,0,0,699,213,0,746,0,3,1
10702,171,2020-11-18T16:15:46.3829014Z,2016,728,114,233,380,0,10,0,348,0,0,614,495,0,718,0,2,0
10702,172,2020-11-18T16:15:46.3839018Z,2017,686,117,498,366,0,3,1,320,0,0,569,188,0,683,0,1,0
10702,173,2020-11-18T16:15:46.3839018Z,2018,619,115,458,336,0,4,1,283,0,0,504,161,2,613,0,0,0
10702,174,2020-11-18T16:15:46.3839018Z,2019,707,164,550,376,0,5,2,331,0,0,543,157,1,700,0,0,1
10702,175,2020-11-18T16:15:46.3839018Z,2020,674,222,541,370,0,5,0,304,0,0,452,133,0,668,0,0,1
10702,25583,2021-06-24T05:35:04.5931094Z,2021,620,188,509,345,0,6,0,275,0,0,432,111,0,614,0,1,0
70904,31663,2021-06-24T05:35:15.2447481Z,2021,359,108,311,175,0,1,31,184,0,0,251,48,1,356,2,0,1
70904,9963,2020-11-18T16:16:51.5403519Z,2012,456,101,327,234,0,3,0,222,0,0,355,129,0,453,0,0,0
70904,9964,2020-11-18T16:16:51.5403519Z,2013,534,122,397,273,0,4,0,261,0,0,412,137,0,530,0,1,0
70904,9965,2020-11-18T16:16:51.5403519Z,2014,521,122,383,269,0,2,0,252,0,0,399,138,0,519,0,1,0
70904,9966,2020-11-18T16:16:51.5403519Z,2015,580,133,424,301,0,4,0,279,0,0,447,156,0,576,0,1,0
70904,9967,2020-11-18T16:16:51.5413528Z,2016,474,123,89,233,0,4,28,241,0,0,351,385,0,470,0,0,0
70904,9968,2020-11-18T16:16:51.5413528Z,2017,510,136,368,256,0,3,33,254,0,0,374,142,0,507,0,0,0
70904,9969,2020-11-18T16:16:51.5413528Z,2018,489,119,323,239,0,4,42,250,0,0,370,166,0,485,4,0,0
70904,9970,2020-11-18T16:16:51.5423532Z,2019,437,128,303,214,1,1,67,223,0,1,309,134,0,436,3,0,0
70904,9971,2020-11-18T16:16:51.5423532Z,2020,361,99,281,170,0,2,70,191,0,0,262,80,0,359,3,0,0
33225,31782,2021-06-24T05:35:16.8599054Z,2021,219,45,194,117,0,9,1,102,0,0,174,25,0,209,1,0,1
33225,4031,2020-11-18T16:16:10.2938488Z,2012,293,18,247,142,0,11,0,151,0,0,275,46,0,282,0,0,0
33225,4032,2020-11-18T16:16:10.2938488Z,2013,270,27,213,126,0,10,0,144,0,0,243,57,0,260,0,1,0
33225,4033,2020-11-18T16:16:10.2948506Z,2014,285,28,250,140,0,7,0,145,0,0,257,35,0,278,0,0,0
33225,4034,2020-11-18T16:16:10.2948506Z,2015,333,32,282,165,0,7,0,168,0,0,301,51,0,326,0,0,0
33225,4035,2020-11-18T16:16:10.2948506Z,2016,347,41,134,161,0,7,1,186,0,0,306,213,0,340,0,1,0
33225,4036,2020-11-18T16:16:10.2958506Z,2017,342,53,285,159,0,5,0,183,0,0,289,57,0,337,0,3,0
33225,4037,2020-11-18T16:16:10.2958506Z,2018,339,52,287,170,0,6,1,169,0,0,287,52,0,332,0,2,1
33225,4038,2020-11-18T16:16:10.2958506Z,2019,274,56,223,150,0,2,0,124,0,0,218,51,0,272,0,0,0
33225,4039,2020-11-18T16:16:10.2968519Z,2020,242,54,199,136,0,5,0,106,0,0,188,43,0,237,0,0,0
35592,31799,2021-06-24T05:35:16.8749168Z,2021,428,126,344,214,0,6,0,214,0,0,302,84,0,422,2,2,0
35592,4374,2020-11-18T16:16:12.1771035Z,2012,497,0,290,262,0,2,0,235,0,0,497,207,0,495,0,0,0
35592,4375,2020-11-18T16:16:12.1771035Z,2013,512,2,302,273,0,4,0,239,0,0,510,210,0,508,0,1,0
35592,4376,2020-11-18T16:16:12.1771035Z,2014,471,17,297,263,0,6,0,208,0,0,454,174,0,464,0,0,1
35592,4377,2020-11-18T16:16:12.178104Z,2015,401,32,253,233,0,5,0,168,0,0,369,148,0,395,0,1,1
35592,4378,2020-11-18T16:16:12.178104Z,2016,520,86,350,273,0,8,1,247,0,0,434,170,0,511,0,1,1
35592,4379,2020-11-18T16:16:12.1791044Z,2017,501,90,394,227,0,5,0,274,0,0,411,107,0,495,0,0,1
35592,4380,2020-11-18T16:16:12.1791044Z,2018,547,93,420,262,0,7,0,285,0,0,454,127,1,538,0,0,1
35592,4381,2020-11-18T16:16:12.1791044Z,2019,466,84,355,236,0,3,0,230,0,0,382,111,1,461,0,0,1
35592,4382,2020-11-18T16:16:12.1791044Z,2020,425,119,333,207,0,4,1,218,0,0,306,92,0,421,0,1,0
55350,25913,2021-06-24T05:35:12.809002Z,2021,347,89,272,183,0,16,1,164,0,0,258,75,0,331,3,2,0
55350,7478,2020-11-18T16:16:33.7154633Z,2012,551,68,393,290,0,3,0,261,0,0,483,158,0,548,0,0,0
55350,7479,2020-11-18T16:16:33.7164638Z,2013,503,95,331,287,0,4,0,216,0,0,408,172,0,499,0,0,0
55350,7480,2020-11-18T16:16:33.7164638Z,2014,465,94,307,257,0,5,0,208,0,0,371,158,0,460,0,1,0
55350,7481,2020-11-18T16:16:33.7164638Z,2015,376,94,256,205,0,4,0,171,0,0,282,120,0,372,0,1,0
55350,7482,2020-11-18T16:16:33.7164638Z,2016,342,98,214,155,0,6,2,187,0,0,244,128,0,336,0,2,0
55350,7483,2020-11-18T16:16:33.7164638Z,2017,373,95,256,174,0,14,1,199,0,0,278,117,0,359,0,0,0
55350,7484,2020-11-18T16:16:33.7174651Z,2018,320,76,207,150,0,11,13,170,0,0,244,113,0,309,6,1,0
55350,7485,2020-11-18T16:16:33.7174651Z,2019,344,91,249,144,0,16,9,200,0,0,253,95,0,328,8,0,0
55350,7486,2020-11-18T16:16:33.7174651Z,2020,363,105,259,176,0,16,18,187,0,0,258,104,0,347,7,1,0
71704,10424,2020-11-18T16:16:54.714466Z,2012,244,86,220,126,0,11,0,118,0,0,158,24,0,231,0,0,2
71704,10425,2020-11-18T16:16:54.714466Z,2013,236,74,188,122,0,5,0,114,0,0,162,48,0,229,0,4,2
71704,10426,2020-11-18T16:16:54.714466Z,2014,204,66,179,106,0,6,0,98,0,0,138,25,0,194,0,1,4
71704,10427,2020-11-18T16:16:54.714466Z,2015,195,62,167,98,0,7,0,97,0,0,133,28,0,184,0,1,4
71704,10428,2020-11-18T16:16:54.7154664Z,2016,184,67,84,92,0,3,1,92,0,0,117,100,0,179,0,1,2
71704,10429,2020-11-18T16:16:54.7154664Z,2017,396,158,339,195,0,12,1,201,0,0,238,57,1,378,0,9,5
71704,10430,2020-11-18T16:16:54.7154664Z,2018,398,152,356,198,0,10,1,200,0,0,246,42,0,386,2,2,2
71704,10431,2020-11-18T16:16:54.7154664Z,2019,396,161,339,195,0,13,0,201,0,0,235,57,0,382,3,0,1
71704,10432,2020-11-18T16:16:54.7154664Z,2020,321,137,284,147,0,20,1,174,0,0,184,37,0,300,2,0,1
71704,25676,2021-06-24T05:35:04.7452189Z,2021,293,108,270,138,0,19,0,155,0,0,185,23,0,274,1,0,0
27318,3020,2020-11-18T16:16:04.71713Z,2012,843,54,615,394,0,24,0,449,0,0,789,228,0,818,0,0,1
27318,3021,2020-11-18T16:16:04.71713Z,2013,511,89,415,221,0,11,0,290,0,0,422,96,0,499,0,6,1
27318,3022,2020-11-18T16:16:04.71713Z,2014,399,88,316,180,0,5,0,219,0,0,311,83,0,393,0,5,1
27318,3023,2020-11-18T16:16:04.7181309Z,2015,359,89,287,177,0,2,0,182,0,0,270,72,1,356,0,2,0
27318,3024,2020-11-18T16:16:04.7181309Z,2016,328,116,82,158,0,4,4,170,0,0,212,246,0,324,0,1,0
27318,3025,2020-11-18T16:16:04.7181309Z,2017,298,103,236,135,0,4,0,163,0,0,195,62,0,294,0,3,0
27318,3026,2020-11-18T16:16:04.7181309Z,2018,387,133,320,162,0,12,1,225,0,0,254,67,6,369,1,2,0
27318,3027,2020-11-18T16:16:04.7181309Z,2019,370,156,275,163,0,11,2,207,0,0,214,95,2,355,0,1,2
27318,3028,2020-11-18T16:16:04.7191313Z,2020,398,158,284,180,0,12,0,218,0,0,240,114,3,382,0,2,1
27318,31734,2021-06-24T05:35:15.4048629Z,2021,386,127,327,188,0,12,0,198,0,0,259,59,1,370,0,1,3
78733,11020,2020-11-18T16:16:58.5130034Z,2012,384,0,302,173,0,3,0,211,0,0,384,82,1,380,0,0,0
78733,11021,2020-11-18T16:16:58.5140043Z,2013,368,8,286,183,0,3,0,185,0,0,360,82,0,365,0,1,0
78733,11022,2020-11-18T16:16:58.5140043Z,2014,421,38,326,215,0,5,0,206,0,0,383,95,0,414,0,1,2
78733,11023,2020-11-18T16:16:58.5140043Z,2015,374,54,303,193,0,3,0,181,0,0,320,71,0,370,0,0,1
78733,11024,2020-11-18T16:16:58.5140043Z,2016,547,154,127,291,0,6,19,256,0,0,393,420,0,541,0,1,0
78733,11025,2020-11-18T16:16:58.5140043Z,2017,497,126,394,258,0,5,15,239,0,0,371,103,0,492,0,4,0
78733,11026,2020-11-18T16:16:58.5150052Z,2018,496,121,380,264,0,6,10,232,0,0,375,116,0,490,1,2,0
78733,11027,2020-11-18T16:16:58.5150052Z,2019,464,110,360,234,0,6,16,230,0,0,354,104,0,458,1,1,0
78733,11028,2020-11-18T16:16:58.5150052Z,2020,449,150,357,212,0,11,17,237,0,0,299,92,0,438,0,1,0
78733,31685,2021-06-24T05:35:15.2897798Z,2021,443,158,347,222,0,5,1,221,0,0,285,96,0,438,1,0,0
13326,25867,2021-06-24T05:35:10.9967014Z,2021,172,34,150,88,0,0,0,84,0,0,138,22,0,172,0,3,0
13326,968,2020-11-18T16:15:52.0416755Z,2012,298,73,235,140,0,2,0,158,0,0,225,63,0,291,0,0,5
13326,969,2020-11-18T16:15:52.0416755Z,2013,283,73,228,133,0,2,0,150,0,0,210,55,0,280,0,9,1
13326,970,2020-11-18T16:15:52.0416755Z,2014,260,71,205,125,0,2,0,135,0,0,189,55,0,258,0,7,0
13326,971,2020-11-18T16:15:52.0416755Z,2015,238,63,191,113,0,0,0,125,0,0,175,47,0,238,0,9,0
13326,972,2020-11-18T16:15:52.0426786Z,2016,225,56,152,111,0,0,0,114,0,0,169,73,0,225,0,5,0
13326,973,2020-11-18T16:15:52.0426786Z,2017,195,47,154,104,0,0,0,91,0,0,148,41,0,195,0,6,0
13326,974,2020-11-18T16:15:52.0426786Z,2018,185,46,143,97,0,0,0,88,0,0,139,42,0,185,2,3,0
13326,975,2020-11-18T16:15:52.0436768Z,2019,208,59,167,107,0,0,0,101,0,0,149,41,0,208,2,2,0
13326,976,2020-11-18T16:15:52.0436768Z,2020,195,43,164,107,0,1,0,88,0,0,152,31,0,194,1,2,0
78956,11056,2020-11-18T16:16:58.5480274Z,2012,454,157,366,226,0,1,0,228,0,0,297,88,0,453,0,0,0
78956,11057,2020-11-18T16:16:58.5490278Z,2013,472,170,336,229,0,2,0,243,0,0,302,136,0,470,0,4,0
78956,11058,2020-11-18T16:16:58.5490278Z,2014,462,181,338,219,0,2,0,243,0,0,281,124,0,460,0,2,0
78956,11059,2020-11-18T16:16:58.5490278Z,2015,440,174,296,208,0,6,0,232,0,0,266,144,0,434,0,2,0
78956,11060,2020-11-18T16:16:58.5500287Z,2016,342,136,212,159,0,5,0,183,0,0,206,130,0,336,0,1,1
78956,11061,2020-11-18T16:16:58.5500287Z,2017,349,160,193,144,0,2,2,205,0,0,189,156,0,346,0,0,1
78956,11062,2020-11-18T16:16:58.5500287Z,2018,353,163,231,143,0,4,14,210,0,0,190,122,0,349,5,0,0
78956,11063,2020-11-18T16:16:58.5500287Z,2019,413,188,335,181,0,5,1,232,0,0,225,78,0,408,4,0,0
78956,11064,2020-11-18T16:16:58.5510296Z,2020,411,183,350,189,0,8,0,222,0,0,228,61,0,403,3,0,0
78956,31687,2021-06-24T05:35:15.2937831Z,2021,368,163,326,160,0,5,0,208,0,0,205,42,0,363,2,1,0
70284,25646,2021-06-24T05:35:04.6951839Z,2021,765,282,656,368,0,14,3,397,0,0,483,109,0,750,0,2,1
70284,9588,2020-11-18T16:16:49.2248075Z,2012,446,4,310,209,0,15,0,237,0,0,442,136,1,430,0,0,0
70284,9589,2020-11-18T16:16:49.2248075Z,2013,449,9,324,232,0,11,0,217,0,0,440,125,1,437,0,1,0
70284,9590,2020-11-18T16:16:49.2248075Z,2014,485,50,347,249,0,6,0,236,0,0,435,138,3,474,0,0,2
70284,9591,2020-11-18T16:16:49.2258079Z,2015,572,62,411,282,0,9,0,290,0,0,510,161,3,559,0,2,1
70284,9592,2020-11-18T16:16:49.2258079Z,2016,696,143,527,355,0,14,2,341,0,0,553,169,1,680,0,2,1
70284,9593,2020-11-18T16:16:49.2258079Z,2017,606,118,463,312,0,12,1,294,0,0,488,143,0,593,0,3,1
70284,9594,2020-11-18T16:16:49.2258079Z,2018,522,98,407,261,0,8,0,261,0,0,424,115,0,513,0,5,1
70284,9595,2020-11-18T16:16:49.2258079Z,2019,744,247,610,364,0,12,2,380,0,0,497,134,0,731,0,3,1
70284,9596,2020-11-18T16:16:49.2268083Z,2020,766,285,647,370,0,10,6,396,0,0,481,119,0,755,0,2,1
65987,31982,2021-06-24T05:35:20.2863633Z,2021,559,148,418,288,0,5,2,271,0,0,411,141,3,549,0,0,2
65987,9114,2020-11-18T16:16:45.4923185Z,2012,666,155,457,329,0,10,0,337,0,0,511,209,0,656,0,0,0
65987,9115,2020-11-18T16:16:45.4923185Z,2013,663,157,460,319,0,7,0,344,0,0,506,203,0,656,0,5,0
65987,9116,2020-11-18T16:16:45.4933185Z,2014,583,132,405,289,0,4,0,294,0,0,451,178,0,579,0,1,0
65987,9117,2020-11-18T16:16:45.4933185Z,2015,649,143,423,319,0,1,0,330,0,0,506,226,0,648,0,1,0
65987,9118,2020-11-18T16:16:45.4933185Z,2016,665,145,400,333,0,3,0,332,0,0,520,265,0,662,0,1,0
65987,9119,2020-11-18T16:16:45.4933185Z,2017,677,163,427,355,0,3,1,322,0,0,514,250,0,674,0,0,0
65987,9120,2020-11-18T16:16:45.4933185Z,2018,611,157,388,315,0,4,1,296,0,0,454,223,0,604,1,0,3
65987,9121,2020-11-18T16:16:45.4943198Z,2019,591,177,389,306,0,6,1,285,0,0,414,202,1,582,1,0,2
65987,9122,2020-11-18T16:16:45.4943198Z,2020,565,163,393,287,0,7,1,278,0,0,402,172,1,555,0,0,2
15248,1145,2020-11-18T16:15:53.1404094Z,2012,736,2,547,361,0,15,0,375,0,0,734,189,0,721,0,0,0
15248,1146,2020-11-18T16:15:53.1404094Z,2013,644,6,479,318,0,14,0,326,0,0,638,165,3,627,0,8,0
15248,1147,2020-11-18T16:15:53.1404094Z,2014,652,64,495,302,0,15,0,350,0,0,588,157,4,633,0,4,0
15248,1148,2020-11-18T16:15:53.1404094Z,2015,723,41,502,394,0,27,0,329,0,0,682,221,1,695,0,3,0
15248,1149,2020-11-18T16:15:53.1404094Z,2016,744,88,440,418,0,21,1,326,0,0,656,304,0,723,0,3,0
15248,1150,2020-11-18T16:15:53.1414099Z,2017,749,92,512,410,0,22,0,339,0,0,657,237,0,727,0,9,0
15248,1151,2020-11-18T16:15:53.1414099Z,2018,868,135,611,446,0,24,27,422,0,0,733,257,0,844,13,10,0
15248,1152,2020-11-18T16:15:53.1414099Z,2019,760,127,527,396,0,26,0,364,0,0,633,233,0,734,14,6,0
15248,1153,2020-11-18T16:15:53.1414099Z,2020,697,171,475,363,0,19,0,334,0,0,526,222,0,677,18,5,1
15248,31810,2021-06-24T05:35:16.9019364Z,2021,704,200,472,360,0,18,0,344,0,0,504,232,0,683,9,5,3
12062,25596,2021-06-24T05:35:04.6061199Z,2021,79,26,74,32,0,1,0,47,0,0,53,5,0,78,0,0,0
12062,570,2020-11-18T16:15:49.6941131Z,2012,169,52,156,80,0,2,0,89,0,0,117,13,0,166,0,0,1
12062,571,2020-11-18T16:15:49.6941131Z,2013,171,56,159,78,0,1,0,93,0,0,115,12,0,167,0,1,3
12062,572,2020-11-18T16:15:49.6951127Z,2014,160,47,153,80,0,3,0,80,0,0,113,7,0,155,0,1,2
12062,573,2020-11-18T16:15:49.6951127Z,2015,153,46,145,73,0,2,0,80,0,0,107,8,0,150,0,2,1
12062,574,2020-11-18T16:15:49.6951127Z,2016,131,42,39,61,0,1,0,70,0,0,89,92,0,129,0,1,1
12062,575,2020-11-18T16:15:49.6961145Z,2017,134,46,123,61,0,0,0,73,0,0,88,11,0,134,0,1,0
12062,576,2020-11-18T16:15:49.6961145Z,2018,135,44,120,56,0,1,18,79,0,0,91,15,0,134,0,1,0
12062,577,2020-11-18T16:15:49.6961145Z,2019,76,28,71,31,0,0,0,45,0,0,48,5,0,76,0,1,0
12062,578,2020-11-18T16:15:49.6971145Z,2020,72,21,65,28,0,0,0,44,0,0,51,7,0,72,0,1,0
71225,10118,2020-11-18T16:16:53.2785132Z,2012,660,1,523,321,0,3,0,339,0,0,659,137,0,655,0,0,2
71225,10119,2020-11-18T16:16:53.2785132Z,2013,649,4,516,354,0,3,0,295,0,0,645,133,0,645,0,0,1
71225,10120,2020-11-18T16:16:53.2785132Z,2014,574,67,446,317,0,8,0,257,0,0,507,128,0,565,0,1,1
71225,10121,2020-11-18T16:16:53.2785132Z,2015,522,67,409,291,0,7,0,231,0,0,455,113,0,515,0,2,0
71225,10122,2020-11-18T16:16:53.2795132Z,2016,757,196,309,387,0,8,0,370,0,0,561,448,0,749,0,3,0
71225,10123,2020-11-18T16:16:53.2795132Z,2017,616,145,470,325,0,3,0,291,0,0,471,146,0,613,0,1,0
71225,10124,2020-11-18T16:16:53.2795132Z,2018,563,130,433,272,0,1,0,291,0,0,433,130,0,562,0,1,0
71225,10125,2020-11-18T16:16:53.2795132Z,2019,400,86,303,197,0,1,1,203,0,0,314,97,0,399,1,1,0
71225,10126,2020-11-18T16:16:53.2805154Z,2020,308,113,259,151,0,2,0,157,0,0,195,49,0,306,1,0,0
71225,25665,2021-06-24T05:35:04.7362118Z,2021,329,136,291,166,0,4,0,163,0,0,193,38,0,325,2,0,0
70813,25660,2021-06-24T05:35:04.7302084Z,2021,598,157,529,313,0,13,1,285,0,0,441,69,1,583,0,0,1
70813,9912,2020-11-18T16:16:51.5163359Z,2012,504,1,412,252,0,5,0,252,0,0,503,92,6,493,0,0,0
70813,9913,2020-11-18T16:16:51.5163359Z,2013,504,10,395,249,0,8,0,255,0,0,494,109,3,492,0,0,1
70813,9914,2020-11-18T16:16:51.5163359Z,2014,502,42,409,255,0,5,0,247,0,0,460,93,5,492,0,0,0
70813,9915,2020-11-18T16:16:51.5173367Z,2015,528,46,438,296,0,13,0,232,0,0,482,90,3,512,0,0,0
70813,9916,2020-11-18T16:16:51.5173367Z,2016,507,82,201,285,0,13,0,222,0,0,425,306,5,489,0,2,0
70813,9917,2020-11-18T16:16:51.5173367Z,2017,752,129,661,413,0,21,2,339,0,0,623,91,2,726,0,2,3
70813,9918,2020-11-18T16:16:51.5183376Z,2018,678,91,577,376,0,15,0,302,0,0,587,101,4,658,0,1,1
70813,9919,2020-11-18T16:16:51.5183376Z,2019,599,98,519,323,0,11,1,276,0,0,501,80,1,587,0,0,0
70813,9920,2020-11-18T16:16:51.5183376Z,2020,608,154,507,327,0,15,2,281,0,0,454,101,1,592,0,0,0
14787,1101,2020-11-18T16:15:53.1263996Z,2012,487,136,351,248,0,2,0,239,0,0,351,136,1,484,0,0,0
14787,1102,2020-11-18T16:15:53.1263996Z,2013,419,132,272,209,0,1,0,210,0,0,287,147,1,417,0,0,0
14787,1103,2020-11-18T16:15:53.1263996Z,2014,429,151,259,214,0,4,0,215,0,0,278,170,1,424,0,0,0
14787,1104,2020-11-18T16:15:53.1274014Z,2015,433,133,325,211,0,3,0,222,0,0,300,108,1,429,0,0,0
14787,1105,2020-11-18T16:15:53.1274014Z,2016,425,138,269,203,0,4,0,222,0,0,287,156,1,419,0,0,1
14787,1106,2020-11-18T16:15:53.1274014Z,2017,421,136,306,212,0,5,0,209,0,0,285,115,0,414,0,0,2
14787,1107,2020-11-18T16:15:53.1274014Z,2018,345,109,256,169,0,5,0,176,0,0,236,89,2,336,0,3,2
14787,1108,2020-11-18T16:15:53.1274014Z,2019,393,148,294,194,0,1,0,199,0,0,245,99,2,388,0,1,2
14787,1109,2020-11-18T16:15:53.1284023Z,2020,369,122,287,185,0,3,0,184,0,0,247,82,0,364,0,1,2
14787,31605,2021-06-24T05:35:14.5802712Z,2021,307,103,249,149,0,1,0,158,0,0,204,58,0,303,0,0,3
58255,31933,2021-06-24T05:35:18.5311046Z,2021,254,67,224,122,0,24,0,132,0,0,187,30,0,229,4,0,1
58255,7861,2020-11-18T16:16:36.3602302Z,2012,373,112,310,187,0,38,0,186,0,0,261,63,0,335,0,0,0
58255,7862,2020-11-18T16:16:36.3602302Z,2013,341,102,249,175,0,37,0,166,0,0,239,92,0,304,0,0,0
58255,7863,2020-11-18T16:16:36.3602302Z,2014,315,94,249,171,0,47,0,144,0,0,221,66,0,267,0,0,1
58255,7864,2020-11-18T16:16:36.3612311Z,2015,282,91,201,150,0,32,0,132,0,0,191,81,0,250,0,1,0
58255,7865,2020-11-18T16:16:36.3612311Z,2016,248,69,41,130,0,34,3,118,0,0,179,207,0,214,0,0,0
58255,7866,2020-11-18T16:16:36.3612311Z,2017,252,70,230,130,0,35,6,122,0,0,182,22,0,216,0,1,1
58255,7867,2020-11-18T16:16:36.3612311Z,2018,306,88,252,158,0,42,46,148,0,0,218,54,0,263,6,0,1
58255,7868,2020-11-18T16:16:36.362232Z,2019,261,78,230,126,3,40,4,135,0,0,183,31,0,219,5,2,2
58255,7869,2020-11-18T16:16:36.362232Z,2020,243,65,216,113,0,35,0,130,0,0,178,27,0,207,5,0,1
13151,25866,2021-06-24T05:35:10.9926989Z,2021,299,66,238,146,0,4,0,153,0,0,233,61,1,294,0,1,0
13151,943,2020-11-18T16:15:52.0346706Z,2012,560,31,409,273,0,4,0,287,0,0,529,151,0,554,0,0,2
13151,944,2020-11-18T16:15:52.0346706Z,2013,570,49,406,277,0,2,0,293,0,0,521,164,0,567,0,0,1
13151,945,2020-11-18T16:15:52.0346706Z,2014,646,61,508,305,0,2,0,341,0,0,585,138,0,644,0,0,0
13151,946,2020-11-18T16:15:52.035671Z,2015,599,76,469,283,0,0,0,316,0,0,523,130,0,599,0,0,0
13151,947,2020-11-18T16:15:52.035671Z,2016,534,83,300,254,0,0,2,280,0,0,451,234,1,533,0,1,0
13151,948,2020-11-18T16:15:52.035671Z,2017,434,82,357,209,0,0,1,225,0,0,352,77,0,434,0,0,0
13151,949,2020-11-18T16:15:52.035671Z,2018,387,54,291,194,0,1,32,193,0,0,333,96,0,386,4,0,0
13151,950,2020-11-18T16:15:52.035671Z,2019,345,61,235,172,0,0,0,173,0,0,284,110,1,344,1,0,0
13151,951,2020-11-18T16:15:52.035671Z,2020,315,53,215,154,0,1,3,161,0,0,262,100,1,313,0,1,0
12245,25630,2021-06-24T05:35:04.6861777Z,2021,325,117,285,141,0,4,0,184,0,0,208,40,0,321,1,0,0
12245,660,2020-11-18T16:15:50.2394738Z,2012,398,48,336,196,0,5,0,202,0,0,350,62,0,393,0,0,0
12245,661,2020-11-18T16:15:50.2394738Z,2013,383,76,317,180,0,5,0,203,0,0,307,66,0,378,0,3,0
12245,662,2020-11-18T16:15:50.2394738Z,2014,352,82,298,151,0,4,0,201,0,0,270,54,0,348,0,1,0
12245,663,2020-11-18T16:15:50.2404738Z,2015,331,87,279,153,0,3,0,178,0,0,244,52,0,328,0,2,0
12245,664,2020-11-18T16:15:50.2404738Z,2016,304,89,243,155,0,2,7,149,0,0,215,61,0,302,0,1,0
12245,665,2020-11-18T16:15:50.2404738Z,2017,274,85,225,131,0,1,3,143,0,0,189,49,0,272,0,1,1
12245,666,2020-11-18T16:15:50.2404738Z,2018,289,84,231,142,0,2,1,147,0,0,205,58,0,286,5,2,1
12245,667,2020-11-18T16:15:50.2404738Z,2019,358,121,297,169,0,3,4,189,0,0,237,61,1,353,5,2,1
12245,668,2020-11-18T16:15:50.2414747Z,2020,345,117,289,155,0,6,0,190,0,0,228,56,0,339,0,2,0
76356,10951,2020-11-18T16:16:58.1117351Z,2012,263,91,220,120,0,0,0,143,0,0,172,43,0,259,0,0,4
76356,10952,2020-11-18T16:16:58.1117351Z,2013,245,91,202,99,0,1,0,146,0,0,154,43,0,240,0,1,4
76356,10953,2020-11-18T16:16:58.1117351Z,2014,227,85,191,94,0,2,0,133,0,0,142,36,0,221,0,0,4
76356,10954,2020-11-18T16:16:58.1127365Z,2015,230,81,187,96,0,2,0,134,0,0,149,43,0,227,0,0,1
76356,10955,2020-11-18T16:16:58.1127365Z,2016,186,61,135,77,0,2,10,109,0,0,125,51,0,183,0,0,1
76356,10956,2020-11-18T16:16:58.1127365Z,2017,156,53,132,64,0,2,15,92,0,0,103,24,0,153,0,0,1
76356,10957,2020-11-18T16:16:58.1127365Z,2018,154,51,127,67,0,1,50,87,0,0,103,27,0,152,1,0,1
76356,10958,2020-11-18T16:16:58.1137369Z,2019,170,67,145,84,0,1,11,86,0,1,103,25,0,169,1,0,0
76356,10959,2020-11-18T16:16:58.1137369Z,2020,141,63,116,65,0,0,7,76,0,0,78,25,0,141,1,0,0
76356,25681,2021-06-24T05:35:08.6260012Z,2021,137,57,122,59,0,0,5,78,0,0,80,15,0,136,0,0,1
21006,2028,2020-11-18T16:15:58.9132588Z,2012,228,82,195,112,0,0,0,116,0,0,146,33,0,227,0,0,1
21006,2029,2020-11-18T16:15:58.9132588Z,2013,246,94,222,127,0,0,0,119,0,0,152,24,0,245,0,0,1
21006,2030,2020-11-18T16:15:58.9132588Z,2014,216,90,190,113,0,0,0,103,0,0,126,26,0,216,0,0,0
21006,2031,2020-11-18T16:15:58.9132588Z,2015,226,97,193,117,0,0,0,109,0,0,129,33,0,226,0,0,0
21006,2032,2020-11-18T16:15:58.9142597Z,2016,198,97,157,105,0,0,3,93,0,0,101,41,0,198,0,0,0
21006,2033,2020-11-18T16:15:58.9142597Z,2017,142,75,123,64,0,0,2,78,0,0,67,19,0,142,0,0,0
21006,2034,2020-11-18T16:15:58.9142597Z,2018,145,73,129,67,0,0,3,78,0,0,72,16,0,145,0,0,0
21006,2035,2020-11-18T16:15:58.9142597Z,2019,160,71,138,69,0,0,13,91,0,0,89,22,0,160,1,0,0
21006,2036,2020-11-18T16:15:58.9142597Z,2020,165,70,143,73,0,0,6,92,0,0,95,22,0,165,1,0,0
21006,25703,2021-06-24T05:35:08.6660317Z,2021,161,68,138,80,0,0,5,81,0,0,93,23,0,161,1,0,0
53256,25901,2021-06-24T05:35:12.8009958Z,2021,412,136,317,201,0,0,7,211,0,0,276,95,0,412,0,0,0
53256,7194,2020-11-18T16:16:32.0753737Z,2012,398,52,277,199,0,6,0,199,0,0,346,121,0,392,0,0,0
53256,7195,2020-11-18T16:16:32.0753737Z,2013,388,72,270,175,0,6,0,213,0,0,316,118,0,381,0,5,1
53256,7196,2020-11-18T16:16:32.0753737Z,2014,441,102,272,210,0,4,0,231,0,0,339,169,0,436,0,1,1
53256,7197,2020-11-18T16:16:32.0753737Z,2015,468,119,293,212,0,2,0,256,0,0,349,175,0,465,0,5,1
53256,7198,2020-11-18T16:16:32.0753737Z,2016,432,131,68,204,0,1,0,228,0,0,301,364,0,431,0,2,0
53256,7199,2020-11-18T16:16:32.0763746Z,2017,419,120,260,217,0,1,0,202,0,0,299,159,0,418,0,1,0
53256,7200,2020-11-18T16:16:32.0763746Z,2018,399,108,251,208,0,2,0,191,0,0,291,148,0,397,0,0,0
53256,7201,2020-11-18T16:16:32.481646Z,2019,458,133,319,227,0,3,0,231,0,0,325,139,1,454,0,2,0
53256,7202,2020-11-18T16:16:32.4826465Z,2020,451,132,320,231,0,1,0,220,0,0,319,131,0,449,0,0,1
66167,25983,2021-06-24T05:35:14.5042167Z,2021,236,73,230,115,0,3,0,121,0,0,163,6,0,233,0,0,0
66167,9159,2020-11-18T16:16:45.5023247Z,2012,450,115,442,243,0,2,0,207,0,0,335,8,0,448,0,0,0
66167,9160,2020-11-18T16:16:45.5023247Z,2013,382,92,376,195,0,2,0,187,0,0,290,6,0,380,0,1,0
66167,9161,2020-11-18T16:16:45.5023247Z,2014,415,99,407,211,0,4,0,204,0,0,316,8,0,411,0,0,0
66167,9162,2020-11-18T16:16:45.5033265Z,2015,359,94,349,180,0,1,0,179,0,0,265,10,0,358,0,1,0
66167,9163,2020-11-18T16:16:45.5033265Z,2016,250,64,248,129,0,1,16,121,0,0,186,2,0,249,0,1,0
66167,9164,2020-11-18T16:16:45.5033265Z,2017,233,66,228,118,0,1,24,115,0,0,167,5,1,231,0,0,0
66167,9165,2020-11-18T16:16:45.5043256Z,2018,253,72,219,120,0,2,11,133,0,0,181,34,1,250,0,0,0
66167,9166,2020-11-18T16:16:45.5043256Z,2019,271,84,263,139,0,2,0,132,0,0,187,8,1,267,0,0,1
66167,9167,2020-11-18T16:16:45.5053269Z,2020,269,80,265,138,0,3,0,131,0,0,189,4,1,265,0,0,0
30197,31756,2021-06-24T05:35:16.8268819Z,2021,198,54,186,109,0,0,0,89,0,0,144,12,0,198,0,0,0
30197,3250,2020-11-18T16:16:05.7217997Z,2012,175,48,147,84,0,2,0,91,0,0,127,28,0,173,0,0,0
30197,3251,2020-11-18T16:16:05.7217997Z,2013,171,46,151,79,0,0,0,92,0,0,125,20,0,171,0,4,0
30197,3252,2020-11-18T16:16:05.7217997Z,2014,196,56,145,89,0,0,0,107,0,0,140,51,0,196,0,3,0
30197,3253,2020-11-18T16:16:05.7217997Z,2015,275,69,238,132,0,1,0,143,0,0,206,37,0,274,0,5,0
30197,3254,2020-11-18T16:16:05.7228006Z,2016,265,68,67,125,0,0,1,140,0,0,197,198,0,265,0,1,0
30197,3255,2020-11-18T16:16:05.7228006Z,2017,237,77,218,118,0,0,1,119,0,0,160,19,0,237,0,0,0
30197,3256,2020-11-18T16:16:05.7228006Z,2018,215,56,200,102,0,0,10,113,0,0,159,15,2,213,0,0,0
30197,3257,2020-11-18T16:16:05.7228006Z,2019,233,63,227,116,0,0,0,117,0,0,170,6,0,233,0,0,0
30197,3258,2020-11-18T16:16:05.7228006Z,2020,208,53,202,107,0,0,1,101,0,0,155,6,0,208,0,0,0
11593,31594,2021-06-24T05:35:14.556254Z,2021,179,38,165,86,0,3,3,93,0,0,141,14,1,175,8,0,0
11593,459,2020-11-18T16:15:48.9956474Z,2012,243,9,202,118,0,3,0,125,0,0,234,41,0,238,0,0,2
11593,460,2020-11-18T16:15:48.9966478Z,2013,241,17,195,132,0,6,0,109,0,0,224,46,1,232,0,2,2
11593,461,2020-11-18T16:15:48.9966478Z,2014,223,25,184,129,0,6,0,94,0,0,198,39,1,214,0,2,2
11593,462,2020-11-18T16:15:48.9966478Z,2015,200,21,163,111,0,8,0,89,0,0,179,37,1,190,0,2,1
11593,463,2020-11-18T16:15:48.9966478Z,2016,173,29,126,96,0,7,0,77,0,0,144,47,1,165,0,1,0
11593,464,2020-11-18T16:15:48.9976487Z,2017,204,34,181,105,0,6,0,99,0,0,170,23,1,197,0,0,0
11593,465,2020-11-18T16:15:48.9976487Z,2018,169,32,148,88,0,3,19,81,0,0,137,21,1,164,8,1,1
11593,466,2020-11-18T16:15:48.9976487Z,2019,140,26,122,64,0,2,0,76,0,0,114,18,0,138,11,0,0
11593,467,2020-11-18T16:15:48.9976487Z,2020,159,34,141,75,0,4,0,84,0,0,125,18,1,154,13,0,0
61382,25943,2021-06-24T05:35:12.8450296Z,2021,544,179,472,260,0,65,0,284,0,0,365,72,0,475,1,1,4
61382,8144,2020-11-18T16:16:38.6127298Z,2012,462,1,375,255,0,63,0,207,0,0,461,87,9,388,0,0,2
61382,8145,2020-11-18T16:16:38.6137293Z,2013,486,3,396,274,0,56,0,212,0,0,483,90,8,420,0,0,2
61382,8146,2020-11-18T16:16:38.6137293Z,2014,459,24,372,241,0,42,0,218,0,0,435,87,3,412,0,0,2
61382,8147,2020-11-18T16:16:38.6137293Z,2015,443,36,361,228,0,41,0,215,0,0,407,82,1,400,0,1,1
61382,8148,2020-11-18T16:16:38.6147307Z,2016,593,91,455,307,0,74,0,286,0,0,502,138,0,517,0,0,2
61382,8149,2020-11-18T16:16:38.6147307Z,2017,574,112,484,287,0,62,0,287,0,0,462,90,0,512,0,0,0
61382,8150,2020-11-18T16:16:38.6147307Z,2018,605,119,502,320,0,72,0,285,0,0,486,103,0,531,0,2,2
61382,8151,2020-11-18T16:16:38.6157311Z,2019,561,146,476,286,0,57,0,275,0,0,415,85,0,502,0,2,2
61382,8152,2020-11-18T16:16:38.6157311Z,2020,570,187,353,284,0,78,10,286,0,0,383,217,0,488,0,1,4
62562,25962,2021-06-24T05:35:12.9020685Z,2021,200,68,197,96,0,8,0,104,0,0,132,3,0,192,0,0,0
62562,8580,2020-11-18T16:16:40.9562944Z,2012,330,81,322,168,0,3,0,162,0,0,249,8,0,327,0,0,0
62562,8581,2020-11-18T16:16:40.9572958Z,2013,322,85,289,164,0,8,0,158,0,0,237,33,0,314,0,0,0
62562,8582,2020-11-18T16:16:40.9572958Z,2014,288,80,264,142,0,6,0,146,0,0,208,24,0,282,0,0,0
62562,8583,2020-11-18T16:16:40.9572958Z,2015,333,102,325,154,0,9,0,179,0,0,231,8,0,324,0,2,0
62562,8584,2020-11-18T16:16:40.9582958Z,2016,199,64,190,86,0,5,0,113,0,0,135,9,0,194,0,0,0
62562,8585,2020-11-18T16:16:40.9582958Z,2017,231,89,221,99,0,7,2,132,0,0,142,10,0,224,0,0,0
62562,8586,2020-11-18T16:16:40.9582958Z,2018,202,67,195,96,0,8,2,106,0,0,135,7,0,194,0,0,0
62562,8587,2020-11-18T16:16:40.9582958Z,2019,223,90,217,106,0,7,8,117,0,0,133,6,0,216,0,0,0
62562,8588,2020-11-18T16:16:40.9592975Z,2020,204,78,198,93,0,12,5,111,0,0,126,6,0,192,0,0,0
70912,25662,2021-06-24T05:35:04.7332103Z,2021,176,79,154,77,0,1,0,99,0,0,97,22,0,175,1,0,0
70912,9972,2020-11-18T16:16:51.537351Z,2012,253,81,181,111,0,1,0,142,0,0,172,72,0,252,0,0,0
70912,9973,2020-11-18T16:16:51.537351Z,2013,236,79,154,92,0,0,0,144,0,0,157,82,0,236,0,0,0
70912,9974,2020-11-18T16:16:51.538351Z,2014,214,79,125,88,0,0,0,126,0,0,135,89,0,214,0,0,0
70912,9975,2020-11-18T16:16:51.538351Z,2015,217,70,142,96,0,2,0,121,0,0,147,75,0,215,0,1,0
70912,9976,2020-11-18T16:16:51.538351Z,2016,197,58,154,86,0,2,0,111,0,0,139,43,0,195,0,0,0
70912,9977,2020-11-18T16:16:51.538351Z,2017,198,73,142,83,0,2,0,115,0,0,125,56,0,196,0,0,0
70912,9978,2020-11-18T16:16:51.538351Z,2018,210,81,150,80,0,2,9,130,0,0,129,60,0,208,1,0,0
70912,9979,2020-11-18T16:16:51.5393514Z,2019,144,68,115,59,0,0,9,85,0,0,76,29,0,144,1,0,0
70912,9980,2020-11-18T16:16:51.5393514Z,2020,181,81,143,75,0,0,3,106,0,0,100,38,0,181,2,0,0
24786,25722,2021-06-24T05:35:08.6770389Z,2021,366,31,216,197,0,11,6,169,0,0,335,150,4,351,0,1,0
24786,2699,2020-11-18T16:16:02.5376737Z,2012,380,14,280,192,0,1,0,188,0,0,366,100,1,378,0,0,0
24786,2700,2020-11-18T16:16:02.538675Z,2013,341,10,226,185,0,0,0,156,0,0,331,115,1,340,0,0,0
24786,2701,2020-11-18T16:16:03.2561545Z,2014,362,5,207,195,0,0,0,167,0,0,357,155,0,362,0,0,0
24786,2702,2020-11-18T16:16:03.2561545Z,2015,407,7,207,227,0,1,0,180,0,0,400,200,2,404,0,0,0
24786,2703,2020-11-18T16:16:03.2561545Z,2016,391,10,186,217,0,1,4,174,0,0,381,205,2,388,0,0,0
24786,2704,2020-11-18T16:16:03.257155Z,2017,375,16,170,213,0,4,0,162,0,0,359,205,0,371,0,0,0
24786,2705,2020-11-18T16:16:03.257155Z,2018,365,19,171,211,0,4,5,154,0,0,346,194,4,357,1,0,0
24786,2706,2020-11-18T16:16:03.257155Z,2019,374,21,176,210,0,4,6,164,0,0,353,198,4,366,1,0,0
24786,2707,2020-11-18T16:16:03.257155Z,2020,381,28,207,214,0,8,8,167,0,0,353,174,4,369,0,1,0
23309,2537,2020-11-18T16:16:02.0713631Z,2012,492,57,378,241,0,0,0,251,0,0,435,114,0,492,0,0,0
23309,2538,2020-11-18T16:16:02.0713631Z,2013,508,102,392,252,0,3,0,256,0,0,406,116,0,505,0,3,0
23309,2539,2020-11-18T16:16:02.0713631Z,2014,498,125,372,249,0,6,0,249,0,0,373,126,0,492,0,4,0
23309,2540,2020-11-18T16:16:02.0723635Z,2015,446,130,332,222,0,6,0,224,0,0,316,114,0,440,0,4,0
23309,2541,2020-11-18T16:16:02.0723635Z,2016,358,118,233,172,0,7,2,186,0,0,240,125,0,351,0,5,0
23309,2542,2020-11-18T16:16:02.0723635Z,2017,351,122,286,161,0,4,4,190,0,0,229,65,0,347,0,1,0
23309,2543,2020-11-18T16:16:02.0723635Z,2018,388,126,313,181,0,6,4,207,0,0,262,75,0,382,0,1,0
23309,2544,2020-11-18T16:16:02.0723635Z,2019,325,112,259,146,0,6,7,179,0,1,213,66,0,319,0,0,0
23309,2545,2020-11-18T16:16:02.073364Z,2020,297,101,233,134,0,6,12,163,0,0,196,64,0,291,0,0,0
23309,31750,2021-06-24T05:35:15.4308807Z,2021,235,83,200,105,0,3,1,130,0,0,152,35,0,232,0,0,0
12005,31597,2021-06-24T05:35:14.5592555Z,2021,173,67,148,82,0,1,0,91,0,0,106,25,0,172,2,0,0
12005,544,2020-11-18T16:15:49.6710968Z,2012,170,36,145,88,0,8,0,82,0,0,134,25,0,162,0,0,0
12005,545,2020-11-18T16:15:49.672099Z,2013,161,40,143,79,0,6,0,82,0,0,121,18,0,155,0,0,0
12005,546,2020-11-18T16:15:49.672099Z,2014,137,31,116,71,0,5,0,66,0,0,106,21,0,132,0,0,0
12005,547,2020-11-18T16:15:49.6730995Z,2015,130,29,111,67,0,3,0,63,0,0,101,19,0,127,0,0,0
12005,548,2020-11-18T16:15:49.6730995Z,2016,135,37,105,70,0,2,0,65,0,0,98,30,0,133,0,1,0
12005,549,2020-11-18T16:15:49.6730995Z,2017,166,57,124,77,0,1,0,89,0,0,109,42,0,165,0,1,0
12005,550,2020-11-18T16:15:49.674099Z,2018,177,57,136,87,0,1,0,90,0,0,120,41,0,176,3,1,0
12005,551,2020-11-18T16:15:49.674099Z,2019,166,62,128,82,0,3,0,84,0,0,104,38,0,163,2,1,0
12005,552,2020-11-18T16:15:49.674099Z,2020,169,66,135,86,0,2,0,83,0,0,103,34,0,167,2,1,0
43257,25837,2021-06-24T05:35:10.9436636Z,2021,157,51,141,74,0,0,0,83,0,0,106,16,0,157,0,0,0
43257,5488,2020-11-18T16:16:19.7931821Z,2012,185,60,156,98,0,4,0,87,0,0,125,29,0,180,0,0,1
43257,5489,2020-11-18T16:16:19.7931821Z,2013,165,57,136,80,0,4,0,85,0,0,108,29,0,160,0,0,1
43257,5490,2020-11-18T16:16:19.7931821Z,2014,172,59,120,84,0,3,0,88,0,0,113,52,0,168,0,0,1
43257,5491,2020-11-18T16:16:19.7931821Z,2015,179,54,137,84,0,1,0,95,0,0,125,42,1,176,0,0,1
43257,5492,2020-11-18T16:16:19.7931821Z,2016,198,58,153,90,0,2,0,108,0,0,140,45,1,194,0,0,1
43257,5493,2020-11-18T16:16:19.7941835Z,2017,151,50,116,71,0,0,0,80,0,0,101,35,0,151,0,0,0
43257,5494,2020-11-18T16:16:19.7941835Z,2018,137,41,105,62,0,0,9,75,0,0,96,32,0,137,1,0,0
43257,5495,2020-11-18T16:16:19.7941835Z,2019,188,59,142,87,0,2,1,101,0,0,129,46,0,186,1,1,0
43257,5496,2020-11-18T16:16:19.7941835Z,2020,194,62,164,82,0,2,8,112,0,0,132,30,0,192,0,1,0
35048,31795,2021-06-24T05:35:16.8689121Z,2021,311,70,278,151,0,3,1,160,0,0,241,33,0,308,0,1,0
35048,4296,2020-11-18T16:16:11.4796411Z,2012,458,25,349,234,0,1,0,224,0,0,433,109,0,457,0,0,0
35048,4297,2020-11-18T16:16:11.4796411Z,2013,458,42,354,225,0,1,0,233,0,0,416,104,0,457,0,13,0
35048,4298,2020-11-18T16:16:11.4796411Z,2014,417,49,326,208,0,0,0,209,0,0,368,91,0,417,0,6,0
35048,4299,2020-11-18T16:16:11.480642Z,2015,375,43,283,175,0,0,0,200,0,0,332,92,0,375,0,8,0
35048,4300,2020-11-18T16:16:11.480642Z,2016,328,53,245,150,0,0,0,178,0,0,275,83,1,327,0,2,0
35048,4301,2020-11-18T16:16:12.1480841Z,2017,342,64,273,164,0,1,2,178,0,0,278,69,1,340,0,5,0
35048,4302,2020-11-18T16:16:12.1490841Z,2018,305,56,237,149,0,1,0,156,0,0,249,68,1,303,0,5,0
35048,4303,2020-11-18T16:16:12.1490841Z,2019,385,79,314,180,0,3,0,205,0,0,306,71,0,382,0,2,0
35048,4304,2020-11-18T16:16:12.1490841Z,2020,360,78,303,163,0,4,0,197,0,0,282,57,0,356,0,2,0
23598,25718,2021-06-24T05:35:08.6680327Z,2021,338,51,207,175,0,2,0,163,0,0,287,131,0,335,0,0,1
23598,2593,2020-11-18T16:16:02.1023831Z,2012,369,54,283,167,0,11,0,202,0,0,315,86,0,358,0,0,0
23598,2594,2020-11-18T16:16:02.103384Z,2013,342,68,252,177,0,8,0,165,0,0,274,90,0,334,0,1,0
23598,2595,2020-11-18T16:16:02.103384Z,2014,320,50,235,174,0,6,0,146,0,0,270,85,0,314,0,0,0
23598,2596,2020-11-18T16:16:02.103384Z,2015,332,43,231,194,0,2,0,138,0,0,289,101,0,330,0,0,0
23598,2597,2020-11-18T16:16:02.103384Z,2016,326,49,204,197,0,4,4,129,0,0,277,122,0,322,0,0,0
23598,2598,2020-11-18T16:16:02.1043845Z,2017,330,48,172,201,0,3,1,129,0,0,282,158,0,327,0,0,0
23598,2599,2020-11-18T16:16:02.1043845Z,2018,318,46,161,180,0,3,0,138,0,0,272,157,0,315,0,0,0
23598,2600,2020-11-18T16:16:02.1043845Z,2019,372,52,211,200,0,2,0,172,0,0,320,161,0,370,0,0,0
23598,2601,2020-11-18T16:16:02.4836376Z,2020,354,42,209,189,0,0,0,165,0,0,312,145,0,354,0,0,0
33043,25780,2021-06-24T05:35:10.8556013Z,2021,246,56,138,134,0,9,9,112,0,0,190,108,0,236,1,1,1
33043,4015,2020-11-18T16:16:10.2888457Z,2012,257,1,169,126,0,1,0,131,0,0,256,88,0,254,0,0,2
33043,4016,2020-11-18T16:16:10.2888457Z,2013,257,4,171,127,0,6,0,130,0,0,253,86,1,248,0,2,2
33043,4017,2020-11-18T16:16:10.2888457Z,2014,256,17,173,116,0,7,0,140,0,0,239,83,1,247,0,3,1
33043,4018,2020-11-18T16:16:10.289847Z,2015,238,15,151,118,0,3,0,120,0,0,223,87,1,234,0,2,0
33043,4019,2020-11-18T16:16:10.289847Z,2016,291,26,187,137,0,6,0,154,0,0,265,104,0,285,0,0,0
33043,4020,2020-11-18T16:16:10.289847Z,2017,284,33,212,141,0,5,2,143,0,0,251,72,0,279,0,0,0
33043,4021,2020-11-18T16:16:10.2908466Z,2018,263,32,202,126,0,8,0,137,0,0,231,61,0,255,0,0,0
33043,4022,2020-11-18T16:16:10.2908466Z,2019,239,37,187,117,0,7,3,122,0,0,202,52,0,232,0,1,0
33043,4023,2020-11-18T16:16:10.2908466Z,2020,252,49,196,138,0,6,0,114,0,0,203,56,0,246,1,1,0
69930,25993,2021-06-24T05:35:14.5122229Z,2021,801,202,606,415,0,23,0,386,0,0,599,195,1,775,3,2,2
69930,9383,2020-11-18T16:16:47.5126683Z,2012,622,2,449,317,0,20,0,305,0,0,620,173,1,601,0,0,0
69930,9384,2020-11-18T16:16:47.5126683Z,2013,627,3,425,320,0,16,0,307,0,0,624,202,2,609,0,0,0
69930,9385,2020-11-18T16:16:47.5136679Z,2014,751,62,549,401,0,24,0,350,0,0,689,202,1,725,0,0,1
69930,9386,2020-11-18T16:16:47.5136679Z,2015,832,74,626,454,0,24,0,378,0,0,758,206,1,806,0,1,1
69930,9387,2020-11-18T16:16:47.5136679Z,2016,912,142,450,504,0,22,6,408,0,0,770,462,3,886,0,0,1
69930,9388,2020-11-18T16:16:47.5146701Z,2017,889,132,584,492,0,16,3,397,0,0,757,305,2,870,0,0,1
69930,9389,2020-11-18T16:16:47.5146701Z,2018,1048,137,685,555,0,23,5,493,0,0,911,363,1,1023,2,1,1
69930,9390,2020-11-18T16:16:47.5146701Z,2019,860,117,611,458,0,24,2,402,0,0,743,249,1,833,2,0,2
69930,9391,2020-11-18T16:16:47.5146701Z,2020,814,175,552,427,0,26,3,387,0,0,639,262,1,785,5,1,2
58164,31931,2021-06-24T05:35:18.5301041Z,2021,583,135,438,292,0,4,4,291,0,0,448,145,0,576,6,1,3
58164,7825,2020-11-18T16:16:36.3522262Z,2012,760,131,608,356,0,19,0,404,0,0,629,152,1,740,0,0,0
58164,7826,2020-11-18T16:16:36.3532253Z,2013,811,156,639,385,0,17,0,426,0,0,655,172,1,793,0,8,0
58164,7827,2020-11-18T16:16:36.3532253Z,2014,765,159,579,346,0,13,0,419,0,0,606,186,1,751,0,4,0
58164,7828,2020-11-18T16:16:36.3532253Z,2015,795,160,576,370,0,15,0,425,0,0,635,219,0,780,0,3,0
58164,7829,2020-11-18T16:16:36.3532253Z,2016,748,143,251,348,0,10,10,400,0,0,605,497,0,737,0,3,1
58164,7830,2020-11-18T16:16:36.3532253Z,2017,580,123,428,270,0,7,0,310,0,0,457,152,0,572,0,5,1
58164,7831,2020-11-18T16:16:36.3542267Z,2018,610,129,429,294,0,4,0,316,0,0,481,181,0,605,12,3,1
58164,7832,2020-11-18T16:16:36.3542267Z,2019,654,150,470,311,1,4,5,343,0,0,504,184,0,649,10,1,1
58164,7833,2020-11-18T16:16:36.3542267Z,2020,649,146,468,317,0,6,2,332,0,0,503,181,0,643,7,1,0
34272,25787,2021-06-24T05:35:10.8696105Z,2021,610,137,534,297,0,7,22,313,0,0,473,76,1,601,2,0,1
34272,4176,2020-11-18T16:16:11.0373457Z,2012,516,85,427,274,0,5,0,242,0,0,431,89,0,511,0,0,0
34272,4177,2020-11-18T16:16:11.0373457Z,2013,480,74,395,244,0,11,0,236,0,0,406,85,1,468,0,1,0
34272,4178,2020-11-18T16:16:11.0373457Z,2014,507,84,406,248,0,10,0,259,0,0,423,101,3,493,0,4,1
34272,4179,2020-11-18T16:16:11.0373457Z,2015,510,85,417,242,0,7,0,268,0,0,425,93,0,503,0,1,0
34272,4180,2020-11-18T16:16:11.0373457Z,2016,493,87,398,244,0,11,0,249,0,0,406,95,0,482,0,3,0
34272,4181,2020-11-18T16:16:11.038347Z,2017,409,94,336,192,0,7,49,217,0,0,315,73,0,402,0,0,0
34272,4182,2020-11-18T16:16:11.038347Z,2018,509,91,416,253,0,12,0,256,0,0,418,93,0,497,4,0,0
34272,4183,2020-11-18T16:16:11.038347Z,2019,513,113,421,248,0,8,52,265,0,0,400,92,0,505,4,0,0
34272,4184,2020-11-18T16:16:11.038347Z,2020,567,126,468,268,0,10,16,299,0,0,441,99,0,557,4,0,0
25197,2835,2020-11-18T16:16:03.6844406Z,2012,115,26,96,52,0,1,0,63,0,0,89,19,0,114,0,0,0
25197,2836,2020-11-18T16:16:03.6844406Z,2013,134,30,112,75,0,0,0,59,0,0,104,22,0,134,0,0,0
25197,2837,2020-11-18T16:16:03.685441Z,2014,137,35,113,69,0,0,0,68,0,0,102,24,0,137,0,0,0
25197,2838,2020-11-18T16:16:03.685441Z,2015,135,41,111,70,0,0,0,65,0,0,94,24,0,135,0,0,0
25197,2839,2020-11-18T16:16:03.685441Z,2016,126,39,92,57,0,0,4,69,0,0,87,34,0,126,0,0,0
25197,2840,2020-11-18T16:16:03.6864419Z,2017,131,43,106,58,0,0,0,73,0,0,88,25,0,131,0,0,0
25197,2841,2020-11-18T16:16:03.6864419Z,2018,126,42,93,56,0,1,0,70,0,0,84,33,0,125,0,0,0
25197,2842,2020-11-18T16:16:03.6864419Z,2019,148,60,113,57,0,0,0,91,0,0,88,35,0,148,0,0,0
25197,2843,2020-11-18T16:16:03.6874419Z,2020,135,44,102,51,0,2,0,84,0,0,91,33,0,133,0,0,0
25197,31752,2021-06-24T05:35:15.434884Z,2021,132,46,104,50,0,3,0,82,0,0,86,28,0,129,0,0,0
64527,25976,2021-06-24T05:35:12.9270862Z,2021,123,39,109,63,0,6,0,60,0,0,84,14,0,117,0,0,0
64527,8964,2020-11-18T16:16:44.4526233Z,2012,291,98,270,156,0,16,0,135,0,0,193,21,0,275,0,0,0
64527,8965,2020-11-18T16:16:44.4526233Z,2013,269,89,253,141,0,18,0,128,0,0,180,16,0,251,0,1,0
64527,8966,2020-11-18T16:16:44.4526233Z,2014,259,86,240,134,0,22,0,125,0,0,173,19,0,237,0,0,0
64527,8967,2020-11-18T16:16:44.4536251Z,2015,220,61,207,118,0,19,0,102,0,0,159,13,0,199,0,0,2
64527,8968,2020-11-18T16:16:44.4536251Z,2016,208,59,170,118,0,13,0,90,0,0,149,38,0,193,0,0,2
64527,8969,2020-11-18T16:16:44.4536251Z,2017,182,60,169,105,0,9,0,77,0,0,122,13,0,171,0,0,2
64527,8970,2020-11-18T16:16:44.4536251Z,2018,163,49,155,90,0,7,0,73,0,0,114,8,0,155,0,0,1
64527,8971,2020-11-18T16:16:44.4536251Z,2019,180,62,173,93,0,9,0,87,0,0,118,7,0,167,0,0,4
64527,8972,2020-11-18T16:16:44.454626Z,2020,170,59,153,90,0,6,5,80,0,0,111,17,0,162,0,0,2
11239,31589,2021-06-24T05:35:14.5842741Z,2021,103,37,89,53,0,0,0,50,0,0,66,14,0,103,0,0,0
11239,324,2020-11-18T16:15:47.5756986Z,2012,162,36,119,84,0,0,0,78,0,0,126,43,0,162,0,0,0
11239,325,2020-11-18T16:15:47.5756986Z,2013,153,32,117,79,0,2,0,74,0,0,121,36,0,151,0,1,0
11239,326,2020-11-18T16:15:47.5766991Z,2014,139,31,94,66,0,0,0,73,0,0,108,45,0,139,0,0,0
11239,327,2020-11-18T16:15:47.5766991Z,2015,142,34,104,64,0,0,0,78,0,0,108,38,0,142,0,0,0
11239,328,2020-11-18T16:15:47.5766991Z,2016,136,35,110,61,0,0,0,75,0,0,101,26,0,136,0,0,0
11239,329,2020-11-18T16:15:47.5777Z,2017,134,34,105,59,0,0,0,75,0,0,100,29,0,134,0,0,0
11239,330,2020-11-18T16:15:47.5777Z,2018,119,28,97,51,0,0,0,68,0,0,91,22,0,119,0,0,0
11239,331,2020-11-18T16:15:47.5777Z,2019,107,37,84,51,0,0,0,56,0,0,70,23,0,107,0,0,0
11239,332,2020-11-18T16:15:47.5787004Z,2020,100,38,73,44,0,0,0,56,0,0,62,27,0,100,0,0,0
23119,2487,2020-11-18T16:16:01.438941Z,2012,408,53,344,177,0,3,0,231,0,0,355,64,0,405,0,0,0
23119,2488,2020-11-18T16:16:01.438941Z,2013,409,111,346,174,0,2,0,235,0,0,298,63,0,407,0,0,0
23119,2489,2020-11-18T16:16:01.438941Z,2014,341,127,292,148,0,3,0,193,0,0,214,49,0,338,0,0,0
23119,2490,2020-11-18T16:16:01.4399419Z,2015,254,97,219,113,0,1,0,141,0,0,157,35,0,253,0,2,0
23119,2491,2020-11-18T16:16:01.4399419Z,2016,186,96,160,94,0,0,1,92,0,0,90,26,0,186,0,0,0
23119,2492,2020-11-18T16:16:01.4399419Z,2017,305,166,255,141,0,4,0,164,0,0,139,50,0,301,0,2,0
23119,2493,2020-11-18T16:16:01.4399419Z,2018,336,168,275,157,0,5,1,179,0,0,168,61,0,331,0,2,0
23119,2494,2020-11-18T16:16:01.4409418Z,2019,364,205,305,157,0,2,2,207,0,0,159,59,0,362,0,0,0
23119,2495,2020-11-18T16:16:01.4409418Z,2020,268,157,235,132,0,2,0,136,0,0,111,33,0,266,0,0,0
23119,25715,2021-06-24T05:35:08.6690332Z,2021,206,131,176,95,0,1,0,111,0,0,75,30,1,204,0,0,0
18226,1522,2020-11-18T16:15:55.3598916Z,2012,381,52,294,196,0,16,0,185,0,0,329,87,0,365,0,0,0
18226,1523,2020-11-18T16:15:55.3598916Z,2013,351,68,283,191,0,16,0,160,0,0,283,68,0,335,0,4,0
18226,1524,2020-11-18T16:15:55.3608925Z,2014,321,80,264,165,0,13,0,156,0,0,241,57,0,308,0,4,0
18226,1525,2020-11-18T16:15:55.3608925Z,2015,340,85,269,175,0,11,0,165,0,0,255,71,0,329,0,4,0
18226,1526,2020-11-18T16:15:55.3608925Z,2016,320,105,253,151,0,8,0,169,0,0,215,67,0,312,0,3,0
18226,1527,2020-11-18T16:15:55.3608925Z,2017,325,99,266,160,0,7,0,165,0,0,226,59,0,317,0,3,1
18226,1528,2020-11-18T16:15:55.3608925Z,2018,396,112,328,187,0,10,2,209,0,0,284,68,0,386,3,0,0
18226,1529,2020-11-18T16:15:55.3618934Z,2019,373,100,306,181,0,7,1,192,0,0,273,67,0,366,2,0,0
18226,1530,2020-11-18T16:15:55.3618934Z,2020,391,107,298,195,0,9,0,196,0,0,284,93,0,382,0,0,0
18226,25615,2021-06-24T05:35:04.6471491Z,2021,405,110,350,201,0,7,0,204,0,0,295,55,0,398,0,0,0
50229,25872,2021-06-24T05:35:11.0507401Z,2021,250,53,221,122,0,4,1,128,0,0,197,29,0,245,0,0,1
50229,6154,2020-11-18T16:16:25.0877124Z,2012,219,18,147,114,0,1,0,105,0,0,201,72,0,218,0,0,0
50229,6155,2020-11-18T16:16:25.0877124Z,2013,223,22,177,111,0,0,0,112,0,0,201,46,0,223,0,0,0
50229,6156,2020-11-18T16:16:25.0877124Z,2014,176,21,154,81,0,0,0,95,0,0,155,22,0,176,0,0,0
50229,6157,2020-11-18T16:16:25.0887133Z,2015,137,18,122,50,0,0,0,87,0,0,119,15,0,137,0,0,0
50229,6158,2020-11-18T16:16:25.0887133Z,2016,199,38,151,83,0,2,0,116,0,0,161,48,0,197,0,2,0
50229,6159,2020-11-18T16:16:25.0887133Z,2017,240,49,201,109,0,0,0,131,0,0,191,39,0,240,0,2,0
50229,6160,2020-11-18T16:16:25.0887133Z,2018,275,50,233,123,0,0,9,152,0,0,225,42,0,275,4,2,0
50229,6161,2020-11-18T16:16:25.0897138Z,2019,384,77,318,195,0,3,42,189,0,0,307,66,0,380,2,0,1
50229,6162,2020-11-18T16:16:25.0897138Z,2020,345,65,292,190,0,3,18,155,0,0,280,53,0,341,0,0,1
52142,25891,2021-06-24T05:35:12.7849839Z,2021,253,84,215,133,0,2,0,120,0,0,169,38,0,250,1,0,1
52142,6721,2020-11-18T16:16:28.892249Z,2012,361,42,238,186,0,0,0,175,0,0,319,123,0,360,0,0,1
52142,6722,2020-11-18T16:16:28.892249Z,2013,352,56,221,192,0,2,0,160,0,0,296,131,0,349,0,0,1
52142,6723,2020-11-18T16:16:28.8932499Z,2014,344,63,231,192,0,1,0,152,0,0,281,113,0,342,0,0,1
52142,6724,2020-11-18T16:16:28.8932499Z,2015,330,53,228,180,0,6,0,150,0,0,277,102,0,324,0,0,0
52142,6725,2020-11-18T16:16:28.8932499Z,2016,321,52,226,167,0,7,0,154,0,0,269,95,0,314,0,1,0
52142,6726,2020-11-18T16:16:28.8942499Z,2017,294,73,209,140,0,6,0,154,0,0,221,85,0,288,0,1,0
52142,6727,2020-11-18T16:16:28.8942499Z,2018,299,91,211,150,0,2,0,149,0,0,208,88,0,297,1,0,0
52142,6728,2020-11-18T16:16:28.8942499Z,2019,300,88,223,153,0,2,1,147,0,0,212,77,0,297,1,0,1
52142,6729,2020-11-18T16:16:28.8942499Z,2020,308,90,240,160,0,2,0,148,0,0,218,68,0,305,2,0,1
43323,31841,2021-06-24T05:35:16.9279555Z,2021,327,111,291,154,0,8,1,173,0,0,216,36,0,316,0,0,3
43323,5533,2020-11-18T16:16:20.7167993Z,2012,421,118,358,212,0,0,0,209,0,0,303,63,0,421,0,0,0
43323,5534,2020-11-18T16:16:20.7167993Z,2013,456,120,391,236,0,3,0,220,0,0,336,65,0,453,0,4,0
43323,5535,2020-11-18T16:16:20.7167993Z,2014,463,122,340,246,0,2,0,217,0,0,341,123,0,461,0,3,0
43323,5536,2020-11-18T16:16:20.7167993Z,2015,412,118,349,224,0,1,0,188,0,0,294,63,0,411,0,8,0
43323,5537,2020-11-18T16:16:20.717802Z,2016,375,112,271,201,0,3,0,174,0,0,263,104,0,370,0,3,2
43323,5538,2020-11-18T16:16:20.717802Z,2017,375,116,316,188,0,3,0,187,0,0,259,59,0,369,0,2,3
43323,5539,2020-11-18T16:16:20.717802Z,2018,358,124,311,171,0,2,1,187,0,0,234,47,0,355,1,2,1
43323,5540,2020-11-18T16:16:20.717802Z,2019,364,145,320,177,0,8,5,187,0,0,219,44,0,355,1,0,1
43323,5541,2020-11-18T16:16:20.717802Z,2020,343,129,296,160,0,7,12,183,0,0,214,47,0,334,0,0,2
43307,31840,2021-06-24T05:35:16.9279555Z,2021,225,78,176,112,0,3,0,113,0,0,147,49,0,222,0,0,0
43307,5515,2020-11-18T16:16:20.7127971Z,2012,143,48,112,63,0,3,0,80,0,0,95,31,0,140,0,0,0
43307,5516,2020-11-18T16:16:20.7127971Z,2013,151,46,111,77,0,8,0,74,0,0,105,40,0,143,0,3,0
43307,5517,2020-11-18T16:16:20.713798Z,2014,157,48,124,79,0,8,0,78,0,0,109,33,0,149,0,4,0
43307,5518,2020-11-18T16:16:20.713798Z,2015,158,51,121,81,0,7,0,77,0,0,107,37,0,151,0,3,0
43307,5519,2020-11-18T16:16:20.713798Z,2016,142,45,101,79,0,5,0,63,0,0,97,41,0,137,0,1,0
43307,5520,2020-11-18T16:16:20.713798Z,2017,166,57,130,85,0,4,0,81,0,0,109,36,0,161,0,1,1
43307,5521,2020-11-18T16:16:20.714798Z,2018,157,41,116,82,0,6,0,75,0,0,116,41,0,151,0,0,0
43307,5522,2020-11-18T16:16:20.714798Z,2019,226,73,170,109,0,5,0,117,0,0,153,56,0,221,0,0,0
43307,5523,2020-11-18T16:16:20.714798Z,2020,216,73,161,105,0,5,1,111,0,0,143,55,0,211,0,0,0
69138,31994,2021-06-24T05:35:20.3183862Z,2021,230,64,196,113,0,8,0,117,0,0,166,34,0,222,0,0,0
69138,9341,2020-11-18T16:16:47.3895859Z,2012,168,42,126,77,0,1,0,91,0,0,126,42,0,167,0,0,0
69138,9342,2020-11-18T16:16:47.3895859Z,2013,158,38,130,67,0,1,0,91,0,0,120,28,0,157,0,0,0
69138,9343,2020-11-18T16:16:47.3895859Z,2014,145,35,118,67,0,0,0,78,0,0,110,27,0,145,0,0,0
69138,9344,2020-11-18T16:16:47.3895859Z,2015,211,51,165,98,0,2,0,113,0,0,160,46,0,209,0,0,0
69138,9345,2020-11-18T16:16:47.3905867Z,2016,158,39,74,72,0,2,0,86,0,0,119,84,0,156,0,0,0
69138,9346,2020-11-18T16:16:47.3905867Z,2017,212,54,163,102,0,2,0,110,0,0,158,49,0,210,0,0,0
69138,9347,2020-11-18T16:16:47.3905867Z,2018,232,74,191,117,0,2,0,115,0,0,158,41,0,229,0,1,1
69138,9348,2020-11-18T16:16:47.3905867Z,2019,228,76,197,120,0,6,0,108,0,0,152,31,0,222,0,0,0
69138,9349,2020-11-18T16:16:47.3915872Z,2020,224,67,182,112,0,6,0,112,0,0,157,42,0,218,0,0,0
54635,31912,2021-06-24T05:35:18.4840702Z,2021,503,125,415,254,0,3,2,249,0,0,378,88,0,494,1,0,6
54635,7408,2020-11-18T16:16:33.6904477Z,2012,448,110,340,225,0,10,0,223,0,0,338,108,1,437,0,0,0
54635,7409,2020-11-18T16:16:33.6904477Z,2013,415,99,319,221,0,11,0,194,0,0,316,96,1,403,0,6,0
54635,7410,2020-11-18T16:16:33.6904477Z,2014,412,101,286,223,0,17,0,189,0,0,311,126,1,394,0,6,0
54635,7411,2020-11-18T16:16:33.6914473Z,2015,470,128,335,241,0,16,0,229,0,0,342,135,1,452,0,1,1
54635,7412,2020-11-18T16:16:33.6914473Z,2016,434,116,336,228,0,12,0,206,0,0,318,98,1,421,0,0,0
54635,7413,2020-11-18T16:16:33.6914473Z,2017,424,117,316,229,0,11,0,195,0,0,307,108,0,412,0,0,1
54635,7414,2020-11-18T16:16:33.6914473Z,2018,533,139,446,294,0,12,1,239,0,3,394,87,0,520,3,0,1
54635,7415,2020-11-18T16:16:33.6924486Z,2019,589,165,483,307,0,11,0,282,0,2,424,106,0,577,4,0,1
54635,7416,2020-11-18T16:16:33.6924486Z,2020,553,141,471,279,0,6,9,274,0,0,412,82,0,543,3,0,4
70664,25657,2021-06-24T05:35:04.7021883Z,2021,326,116,278,164,0,2,0,162,0,0,210,48,0,323,0,0,1
70664,9831,2020-11-18T16:16:50.874908Z,2012,438,127,361,231,0,1,0,207,0,0,311,77,0,435,0,0,2
70664,9832,2020-11-18T16:16:50.874908Z,2013,401,140,318,208,0,2,0,193,0,0,261,83,0,397,0,1,2
70664,9833,2020-11-18T16:16:50.874908Z,2014,402,150,326,208,0,2,0,194,0,0,252,76,0,398,0,0,2
70664,9834,2020-11-18T16:16:50.874908Z,2015,376,145,298,197,0,2,0,179,0,0,231,78,0,373,0,1,1
70664,9835,2020-11-18T16:16:50.875908Z,2016,328,133,266,178,0,0,3,150,0,0,195,62,0,327,0,2,1
70664,9836,2020-11-18T16:16:50.875908Z,2017,314,121,240,163,0,0,5,151,0,0,193,74,1,312,0,1,1
70664,9837,2020-11-18T16:16:50.875908Z,2018,326,117,240,162,0,2,14,164,0,0,209,86,2,321,0,0,1
70664,9838,2020-11-18T16:16:50.8769098Z,2019,368,138,283,190,0,4,4,178,0,0,230,85,2,360,0,0,2
70664,9839,2020-11-18T16:16:50.8769098Z,2020,350,127,288,175,0,2,1,175,0,0,223,62,1,346,0,0,1
57828,31928,2021-06-24T05:35:18.5271013Z,2021,263,78,195,134,0,5,0,129,0,0,185,68,0,258,3,0,0
57828,7739,2020-11-18T16:16:35.9069277Z,2012,251,36,183,120,0,0,0,131,0,0,215,68,0,251,0,0,0
57828,7740,2020-11-18T16:16:35.9069277Z,2013,239,53,170,102,0,0,0,137,0,0,186,69,0,239,0,3,0
57828,7741,2020-11-18T16:16:35.9069277Z,2014,225,59,156,99,0,2,0,126,0,0,166,69,0,223,0,3,0
57828,7742,2020-11-18T16:16:35.907929Z,2015,246,64,175,117,0,2,0,129,0,0,182,71,0,244,0,2,0
57828,7743,2020-11-18T16:16:35.907929Z,2016,239,64,45,112,0,2,0,127,0,0,175,194,0,237,0,0,0
57828,7744,2020-11-18T16:16:35.907929Z,2017,240,64,157,107,0,3,0,133,0,0,176,83,0,237,0,0,0
57828,7745,2020-11-18T16:16:35.907929Z,2018,249,65,146,118,0,4,0,131,0,0,184,103,1,244,2,0,0
57828,7746,2020-11-18T16:16:35.907929Z,2019,277,74,178,138,0,2,4,139,0,1,203,99,1,274,3,0,0
57828,7747,2020-11-18T16:16:35.908929Z,2020,264,73,175,138,0,3,2,126,0,0,191,89,0,261,4,0,0
51177,31881,2021-06-24T05:35:18.4540496Z,2021,229,46,190,117,0,4,5,112,0,0,183,39,0,225,1,0,0
51177,6395,2020-11-18T16:16:26.2895159Z,2012,277,48,211,126,0,15,0,151,0,0,229,66,0,261,0,0,1
51177,6396,2020-11-18T16:16:26.2895159Z,2013,268,36,207,131,0,13,0,137,0,0,232,61,0,254,0,2,1
51177,6397,2020-11-18T16:16:26.2895159Z,2014,278,38,205,144,0,10,0,134,0,0,240,73,0,268,0,1,0
51177,6398,2020-11-18T16:16:26.2905168Z,2015,310,63,245,150,0,11,0,160,0,0,247,65,0,299,0,1,0
51177,6399,2020-11-18T16:16:26.2905168Z,2016,296,58,196,135,0,12,0,161,0,0,238,100,0,284,0,1,0
51177,6400,2020-11-18T16:16:26.2905168Z,2017,312,63,228,150,0,9,14,162,0,0,249,84,0,303,0,2,0
51177,6401,2020-11-18T16:16:27.0230025Z,2018,298,62,224,143,0,5,10,155,0,0,236,74,0,293,3,1,0
51177,6402,2020-11-18T16:16:27.0230025Z,2019,301,61,223,152,0,7,17,149,0,0,240,78,0,294,1,1,0
51177,6403,2020-11-18T16:16:27.0230025Z,2020,285,54,218,137,0,6,11,148,0,0,231,67,0,279,0,0,0
40295,31818,2021-06-24T05:35:16.9219494Z,2021,272,89,241,141,0,3,3,131,0,0,183,31,0,269,0,0,0
40295,4705,2020-11-18T16:16:15.3121955Z,2012,218,64,183,98,0,0,0,120,0,0,154,35,0,218,0,0,0
40295,4706,2020-11-18T16:16:15.3121955Z,2013,214,63,177,102,0,0,0,112,0,0,151,37,0,214,0,4,0
40295,4707,2020-11-18T16:16:15.3121955Z,2014,254,76,176,122,0,0,0,132,0,0,178,78,0,254,0,3,0
40295,4708,2020-11-18T16:16:15.3121955Z,2015,257,71,205,126,0,1,0,131,0,0,186,52,0,256,0,2,0
40295,4709,2020-11-18T16:16:15.3121955Z,2016,265,75,77,128,0,2,0,137,0,0,190,188,0,263,0,3,0
40295,4710,2020-11-18T16:16:15.3131968Z,2017,165,45,133,83,0,1,0,82,0,0,120,32,0,164,0,1,0
40295,4711,2020-11-18T16:16:15.3131968Z,2018,153,42,128,76,0,2,4,77,0,0,111,25,0,151,0,0,0
40295,4712,2020-11-18T16:16:15.3131968Z,2019,305,115,280,142,0,5,5,163,0,0,190,25,0,300,0,2,0
40295,4713,2020-11-18T16:16:15.3131968Z,2020,280,97,250,145,0,4,0,135,0,0,183,30,0,276,0,1,0
71753,10460,2020-11-18T16:16:54.7234727Z,2012,341,73,283,180,0,6,0,161,0,0,268,58,0,335,0,0,0
71753,10461,2020-11-18T16:16:54.7234727Z,2013,347,85,306,182,0,7,0,165,0,0,262,41,0,340,0,1,0
71753,10462,2020-11-18T16:16:54.7234727Z,2014,330,88,286,167,0,6,0,163,0,0,242,44,0,323,0,0,1
71753,10463,2020-11-18T16:16:54.7234727Z,2015,357,86,296,173,0,4,0,184,0,0,271,61,0,352,0,0,1
71753,10464,2020-11-18T16:16:54.7234727Z,2016,198,46,157,105,0,2,1,93,0,0,152,41,0,195,0,0,1
71753,10465,2020-11-18T16:16:54.7244727Z,2017,282,76,243,138,0,2,1,144,0,0,206,39,0,279,0,0,1
71753,10466,2020-11-18T16:16:54.7244727Z,2018,329,79,246,150,0,4,4,179,0,0,250,83,0,324,0,0,1
71753,10467,2020-11-18T16:16:54.7244727Z,2019,347,104,301,157,0,3,0,190,0,0,243,46,0,343,0,0,1
71753,10468,2020-11-18T16:16:54.7244727Z,2020,303,83,268,135,0,2,0,168,0,0,220,35,0,300,0,0,1
71753,25621,2021-06-24T05:35:04.6601577Z,2021,295,71,282,135,0,2,2,160,0,0,224,13,0,292,0,0,1
79038,11065,2020-11-18T16:16:58.5460256Z,2012,502,4,317,263,0,5,0,239,0,0,498,185,1,496,0,0,0
79038,11066,2020-11-18T16:16:58.5470274Z,2013,453,9,336,241,0,5,0,212,0,0,444,117,0,448,0,3,0
79038,11067,2020-11-18T16:16:58.5470274Z,2014,425,38,336,215,0,5,0,210,0,0,387,89,0,419,0,2,1
79038,11068,2020-11-18T16:16:58.5470274Z,2015,354,35,284,183,0,8,0,171,0,0,319,70,0,345,0,1,1
79038,11069,2020-11-18T16:16:58.5470274Z,2016,561,122,91,281,0,9,0,280,0,0,439,470,1,549,0,4,2
79038,11070,2020-11-18T16:16:58.5480274Z,2017,529,94,450,281,0,12,0,248,0,0,435,79,1,515,0,1,1
79038,11071,2020-11-18T16:16:58.5480274Z,2018,499,113,425,266,0,7,0,233,0,0,386,74,2,489,0,1,1
79038,11072,2020-11-18T16:16:58.5480274Z,2019,466,75,393,245,0,11,0,221,0,1,391,73,0,454,0,2,1
79038,11073,2020-11-18T16:16:58.5490278Z,2020,387,102,343,215,0,6,0,172,0,0,285,44,0,379,0,1,2
79038,31630,2021-06-24T05:35:14.6303071Z,2021,632,179,535,283,0,6,0,349,0,0,453,97,0,625,1,1,1
10744,198,2020-11-18T16:15:46.3909076Z,2012,300,106,258,154,0,2,0,146,0,0,194,42,0,298,0,0,0
10744,199,2020-11-18T16:15:46.3909076Z,2013,284,103,241,146,0,3,0,138,0,0,181,43,0,281,0,0,0
10744,200,2020-11-18T16:15:46.3919072Z,2014,283,105,234,139,0,2,0,144,0,0,178,49,0,281,0,0,0
10744,201,2020-11-18T16:15:46.8071848Z,2015,297,106,259,140,0,1,0,157,0,0,191,38,0,296,0,0,0
10744,202,2020-11-18T16:15:46.8071848Z,2016,294,109,230,138,0,3,0,156,0,0,185,64,0,291,0,0,0
10744,203,2020-11-18T16:15:46.8071848Z,2017,271,99,237,118,0,3,1,153,0,0,172,34,0,268,0,0,0
10744,204,2020-11-18T16:15:46.8071848Z,2018,290,83,237,119,0,3,0,171,0,0,207,53,0,286,0,0,1
10744,205,2020-11-18T16:15:46.8081857Z,2019,359,121,258,160,0,2,2,199,0,0,238,101,0,356,0,0,1
10744,206,2020-11-18T16:15:46.8081857Z,2020,350,121,311,160,0,0,0,190,0,0,229,39,0,349,0,0,1
10744,25584,2021-06-24T05:35:04.5951113Z,2021,343,108,310,155,0,1,0,188,0,0,235,33,0,342,0,0,0
41913,25827,2021-06-24T05:35:10.9196463Z,2021,58,16,52,30,0,1,0,28,0,0,42,6,0,57,0,0,0
41913,5068,2020-11-18T16:16:17.1103927Z,2012,109,30,99,59,0,2,0,50,0,0,79,10,0,107,0,0,0
41913,5069,2020-11-18T16:16:17.1113945Z,2013,103,33,93,52,0,1,0,51,0,0,70,10,0,102,0,0,0
41913,5070,2020-11-18T16:16:17.1113945Z,2014,94,32,79,50,0,2,0,44,0,0,62,15,0,92,0,0,0
41913,5071,2020-11-18T16:16:17.1113945Z,2015,92,34,81,50,0,1,0,42,0,0,58,11,0,91,0,0,0
41913,5072,2020-11-18T16:16:17.1113945Z,2016,94,35,69,50,0,0,0,44,0,0,59,25,0,94,0,0,0
41913,5073,2020-11-18T16:16:17.112394Z,2017,81,27,75,41,0,1,0,40,0,0,54,6,0,80,0,0,0
41913,5074,2020-11-18T16:16:17.112394Z,2018,83,22,78,47,0,3,0,36,0,0,61,5,0,80,0,0,0
41913,5075,2020-11-18T16:16:17.112394Z,2019,61,14,56,35,0,3,0,26,0,0,47,5,0,58,0,0,0
41913,5076,2020-11-18T16:16:17.112394Z,2020,63,15,60,35,0,2,0,28,0,0,48,3,0,61,0,0,0
30189,25754,2021-06-24T05:35:08.7130639Z,2021,177,67,157,73,0,6,2,104,0,0,110,20,0,171,0,0,0
30189,3241,2020-11-18T16:16:05.7187993Z,2012,216,46,194,106,0,2,0,110,0,0,170,22,0,214,0,0,0
30189,3242,2020-11-18T16:16:05.7187993Z,2013,205,47,170,104,0,5,0,101,0,0,158,35,0,200,0,2,0
30189,3243,2020-11-18T16:16:05.7187993Z,2014,217,42,184,110,0,7,0,107,0,0,175,33,0,210,0,2,0
30189,3244,2020-11-18T16:16:05.7197984Z,2015,213,44,184,111,0,8,0,102,0,0,169,29,0,205,0,3,0
30189,3245,2020-11-18T16:16:05.7197984Z,2016,191,45,95,99,0,9,1,92,0,0,146,96,0,182,0,6,0
30189,3246,2020-11-18T16:16:05.7197984Z,2017,162,56,144,81,0,4,1,81,0,0,106,18,0,158,0,1,0
30189,3247,2020-11-18T16:16:05.7208006Z,2018,156,49,136,79,0,4,0,77,0,0,107,20,0,152,0,1,0
30189,3248,2020-11-18T16:16:05.7208006Z,2019,174,80,156,79,0,4,3,95,0,0,94,18,0,170,0,2,0
30189,3249,2020-11-18T16:16:05.7208006Z,2020,174,71,147,72,0,6,0,102,0,0,103,27,0,167,0,1,1
23655,2605,2020-11-18T16:16:02.4986478Z,2012,254,94,216,130,0,0,0,124,0,0,160,38,0,254,0,0,0
23655,2606,2020-11-18T16:16:02.4986478Z,2013,281,112,236,147,0,3,0,134,0,0,169,45,0,278,0,1,0
23655,2607,2020-11-18T16:16:02.4996487Z,2014,294,104,258,156,0,5,0,138,0,0,190,36,0,288,0,1,1
23655,2608,2020-11-18T16:16:02.4996487Z,2015,297,100,225,151,0,4,0,146,0,0,197,72,0,293,0,3,0
23655,2609,2020-11-18T16:16:02.4996487Z,2016,247,93,206,130,0,4,35,117,0,0,154,41,0,243,0,1,0
23655,2610,2020-11-18T16:16:02.4996487Z,2017,202,74,159,109,0,2,0,93,0,0,128,43,0,200,0,0,0
23655,2611,2020-11-18T16:16:02.4996487Z,2018,239,75,170,128,0,3,1,111,0,0,164,69,0,236,0,0,0
23655,2612,2020-11-18T16:16:02.5006492Z,2019,225,65,187,113,0,4,2,112,0,0,160,38,0,221,0,1,0
23655,2613,2020-11-18T16:16:02.5006492Z,2020,163,51,133,78,0,6,2,85,0,0,112,30,0,157,0,0,0
23655,31720,2021-06-24T05:35:15.3818467Z,2021,165,50,134,84,0,2,0,81,0,0,115,31,0,163,0,0,0
27078,25732,2021-06-24T05:35:08.6850442Z,2021,182,57,148,95,0,2,13,87,0,0,125,34,0,178,0,0,2
27078,3011,2020-11-18T16:16:04.7101255Z,2012,358,90,266,184,0,3,0,174,0,0,268,92,0,355,0,0,0
27078,3012,2020-11-18T16:16:04.711126Z,2013,358,116,265,171,0,1,0,187,0,0,242,93,0,355,0,10,2
27078,3013,2020-11-18T16:16:04.711126Z,2014,355,119,262,171,0,0,0,184,0,0,236,93,0,355,0,0,0
27078,3014,2020-11-18T16:16:04.711126Z,2015,341,113,251,153,0,0,0,188,0,0,228,90,0,341,0,0,0
27078,3015,2020-11-18T16:16:04.711126Z,2016,312,116,236,133,0,0,13,179,0,0,196,76,0,312,0,0,0
27078,3016,2020-11-18T16:16:04.711126Z,2017,261,100,180,113,0,2,4,148,0,0,161,81,0,259,0,0,0
27078,3017,2020-11-18T16:16:04.7121291Z,2018,221,84,169,89,0,0,20,132,0,0,137,52,0,221,0,0,0
27078,3018,2020-11-18T16:16:04.7121291Z,2019,212,71,153,106,0,3,9,106,0,2,141,59,0,209,0,0,0
27078,3019,2020-11-18T16:16:04.7121291Z,2020,194,69,150,108,0,2,27,86,0,0,125,44,0,192,0,0,0
46821,25855,2021-06-24T05:35:10.975687Z,2021,524,164,422,262,0,20,1,262,0,0,360,102,0,501,0,6,3
46821,5937,2020-11-18T16:16:23.5156625Z,2012,650,0,341,341,0,8,0,309,0,0,650,309,0,641,0,0,1
46821,5938,2020-11-18T16:16:23.5156625Z,2013,635,5,443,346,0,8,0,289,0,0,630,192,0,626,0,2,1
46821,5939,2020-11-18T16:16:23.5166634Z,2014,600,30,424,321,0,4,0,279,0,0,570,176,0,596,0,0,0
46821,5940,2020-11-18T16:16:23.5166634Z,2015,548,22,386,297,0,9,0,251,0,0,526,162,0,538,0,0,1
46821,5941,2020-11-18T16:16:23.5166634Z,2016,502,54,113,273,0,8,1,229,0,0,448,389,0,494,0,0,0
46821,5942,2020-11-18T16:16:23.5166634Z,2017,569,76,376,306,0,10,0,263,0,0,493,193,0,559,0,0,0
46821,5943,2020-11-18T16:16:23.5166634Z,2018,595,109,430,314,0,17,4,281,0,0,486,165,1,576,0,2,1
46821,5944,2020-11-18T16:16:23.5166634Z,2019,483,112,362,248,0,12,1,235,0,0,371,121,0,469,0,3,2
46821,5945,2020-11-18T16:16:23.5176639Z,2020,467,143,358,262,0,14,2,205,0,0,324,109,0,449,0,4,4
57331,31926,2021-06-24T05:35:19.7229595Z,2021,200,62,144,109,0,1,0,91,0,0,138,56,0,199,1,0,0
57331,7703,2020-11-18T16:16:35.9019245Z,2012,290,101,229,117,0,1,0,173,0,0,189,61,0,289,0,0,0
57331,7704,2020-11-18T16:16:35.9029254Z,2013,306,100,238,133,0,7,0,173,0,0,206,68,0,299,0,1,0
57331,7705,2020-11-18T16:16:35.9029254Z,2014,300,97,215,140,0,2,0,160,0,0,203,85,0,298,0,3,0
57331,7706,2020-11-18T16:16:35.9029254Z,2015,317,95,237,151,0,3,0,166,0,0,222,80,0,314,0,0,0
57331,7707,2020-11-18T16:16:35.9029254Z,2016,311,99,214,155,0,4,1,156,0,0,212,97,0,307,0,0,0
57331,7708,2020-11-18T16:16:35.9029254Z,2017,274,81,210,139,0,1,2,135,0,0,193,64,0,273,0,0,0
57331,7709,2020-11-18T16:16:35.9029254Z,2018,259,75,182,142,0,1,1,117,0,0,184,77,0,257,5,0,1
57331,7710,2020-11-18T16:16:35.9039254Z,2019,287,94,192,156,0,1,1,131,0,0,193,95,0,285,2,1,1
57331,7711,2020-11-18T16:16:35.9039254Z,2020,281,88,183,146,0,3,5,135,0,0,193,98,0,277,1,1,1
62901,31968,2021-06-24T05:35:20.2763552Z,2021,909,286,743,447,0,7,1,462,0,0,623,166,0,901,0,1,1
62901,8732,2020-11-18T16:16:42.8335469Z,2012,608,102,515,302,0,2,0,306,0,0,506,93,0,606,0,0,0
62901,8733,2020-11-18T16:16:42.8335469Z,2013,572,131,462,278,0,1,0,294,0,0,441,110,0,571,0,0,0
62901,8734,2020-11-18T16:16:42.8335469Z,2014,610,159,506,289,0,3,0,321,0,0,451,104,1,606,0,1,0
62901,8735,2020-11-18T16:16:42.8345465Z,2015,691,189,554,320,0,5,0,371,0,0,502,137,0,686,0,2,0
62901,8736,2020-11-18T16:16:42.8345465Z,2016,778,235,635,366,0,7,0,412,0,0,543,143,1,769,0,3,1
62901,8737,2020-11-18T16:16:42.8345465Z,2017,738,230,600,339,0,6,0,399,0,0,508,138,0,732,0,1,0
62901,8738,2020-11-18T16:16:42.8355483Z,2018,867,240,677,401,0,6,6,466,0,0,627,190,0,861,0,0,0
62901,8739,2020-11-18T16:16:42.8355483Z,2019,930,261,705,453,0,6,8,477,0,0,669,225,0,923,0,0,1
62901,8740,2020-11-18T16:16:42.8355483Z,2020,900,270,681,441,0,4,8,459,0,0,630,219,0,895,0,0,1
70458,25650,2021-06-24T05:35:04.6951839Z,2021,336,155,278,145,0,0,3,191,0,0,181,58,0,336,0,0,0
70458,9683,2020-11-18T16:16:49.729142Z,2012,478,198,317,210,0,9,0,268,0,0,280,161,0,466,0,0,3
70458,9684,2020-11-18T16:16:49.7301424Z,2013,461,188,283,194,0,5,0,267,0,0,273,178,0,456,0,2,0
70458,9685,2020-11-18T16:16:49.7301424Z,2014,466,193,287,197,0,4,0,269,0,0,273,179,0,462,0,3,0
70458,9686,2020-11-18T16:16:49.7301424Z,2015,415,162,267,175,0,5,0,240,0,0,253,148,0,410,0,3,0
70458,9687,2020-11-18T16:16:49.7301424Z,2016,301,118,222,134,0,6,0,167,0,0,183,79,0,295,0,2,0
70458,9688,2020-11-18T16:16:49.7311438Z,2017,297,139,229,125,0,3,0,172,0,0,158,68,1,293,0,6,0
70458,9689,2020-11-18T16:16:49.7311438Z,2018,388,152,280,166,0,8,0,222,0,0,236,108,0,380,1,3,0
70458,9690,2020-11-18T16:16:49.7311438Z,2019,365,169,258,180,0,4,0,185,0,0,196,107,0,361,1,3,0
70458,9691,2020-11-18T16:16:49.7311438Z,2020,335,151,253,153,0,2,0,182,0,0,184,82,0,333,0,0,0
20479,1762,2020-11-18T16:15:57.4102561Z,2012,141,37,101,64,0,0,0,77,0,0,104,40,1,140,0,0,0
20479,1763,2020-11-18T16:15:57.4112557Z,2013,151,41,119,65,0,0,0,86,0,0,110,32,1,150,0,0,0
20479,1764,2020-11-18T16:15:57.4112557Z,2014,135,39,100,56,0,0,0,79,0,0,96,35,0,135,0,0,0
20479,1765,2020-11-18T16:15:57.4112557Z,2015,130,32,103,57,0,0,0,73,0,0,98,27,0,130,0,1,0
20479,1766,2020-11-18T16:15:57.4122588Z,2016,92,15,68,41,0,0,0,51,0,0,77,24,0,92,0,0,0
20479,1767,2020-11-18T16:15:57.4122588Z,2017,96,19,64,41,0,0,0,55,0,0,77,32,0,96,0,0,0
20479,1768,2020-11-18T16:15:57.4122588Z,2018,127,19,86,56,0,0,0,71,0,0,108,41,0,127,2,0,0
20479,1769,2020-11-18T16:15:57.4122588Z,2019,151,30,92,70,0,1,0,81,0,0,121,59,0,150,0,0,0
20479,1770,2020-11-18T16:15:57.4122588Z,2020,137,29,95,65,0,0,0,72,0,0,108,42,0,137,0,0,0
20479,31694,2021-06-24T05:35:15.3067917Z,2021,158,32,120,75,0,0,0,83,0,0,126,38,0,158,0,0,0
13359,1000,2020-11-18T16:15:52.0516821Z,2017,324,80,262,138,0,2,0,186,0,0,244,62,0,322,0,2,0
13359,1001,2020-11-18T16:15:52.4729642Z,2018,326,80,257,154,0,3,1,172,0,0,246,69,0,323,0,1,0
13359,1002,2020-11-18T16:15:52.4739647Z,2019,282,75,225,136,0,3,3,146,0,0,207,57,0,279,0,0,0
13359,1003,2020-11-18T16:15:52.4739647Z,2020,275,71,205,139,0,2,2,136,0,0,204,70,0,273,0,0,0
13359,31870,2021-06-24T05:35:18.4350357Z,2021,282,64,249,145,0,6,1,137,0,0,218,33,0,276,0,0,0
13359,995,2020-11-18T16:15:52.0496804Z,2012,423,78,314,200,0,1,0,223,0,0,345,109,0,422,0,0,0
13359,996,2020-11-18T16:15:52.0496804Z,2013,390,80,285,185,0,0,0,205,0,0,310,105,0,390,0,4,0
13359,997,2020-11-18T16:15:52.0496804Z,2014,372,85,271,170,0,0,0,202,0,0,287,101,0,372,0,2,0
13359,998,2020-11-18T16:15:52.0506817Z,2015,371,82,257,152,0,2,0,219,0,0,289,114,0,369,0,2,0
13359,999,2020-11-18T16:15:52.0506817Z,2016,358,80,213,148,0,1,3,210,0,0,278,145,0,357,0,3,0
64279,31976,2021-06-24T05:35:20.2833609Z,2021,281,189,246,112,0,19,0,169,0,0,92,35,1,260,1,2,1
64279,8933,2020-11-18T16:16:44.4456188Z,2012,154,74,98,70,0,5,0,84,0,0,80,56,0,147,0,0,2
64279,8934,2020-11-18T16:16:44.4466193Z,2013,147,83,93,64,0,3,0,83,0,0,64,54,2,140,0,3,2
64279,8935,2020-11-18T16:16:44.4466193Z,2014,144,87,81,62,0,2,0,82,0,0,57,63,2,138,0,2,2
64279,8936,2020-11-18T16:16:44.4466193Z,2015,143,73,87,66,0,6,0,77,0,0,70,56,1,134,0,2,2
64279,8937,2020-11-18T16:16:44.4466193Z,2016,154,88,105,70,0,9,0,84,0,0,66,49,1,144,0,0,0
64279,8938,2020-11-18T16:16:44.4466193Z,2017,177,106,145,79,0,9,0,98,0,0,71,32,0,168,0,0,0
64279,8939,2020-11-18T16:16:44.4476202Z,2018,168,100,139,75,0,9,0,93,0,0,68,29,0,159,0,0,0
64279,8940,2020-11-18T16:16:44.4476202Z,2019,249,169,218,97,0,18,3,152,0,0,80,31,1,230,1,1,0
64279,8941,2020-11-18T16:16:44.4476202Z,2020,280,192,257,112,0,18,4,168,0,0,88,23,1,261,1,2,0
77461,10983,2020-11-18T16:16:58.1347507Z,2015,415,85,256,214,0,7,0,201,0,0,330,159,0,408,0,3,0
77461,10984,2020-11-18T16:16:58.1347507Z,2016,365,86,239,181,0,4,6,184,0,0,279,126,0,361,0,2,0
77461,10985,2020-11-18T16:16:58.1347507Z,2017,537,146,408,285,0,5,2,252,0,0,391,129,0,532,0,1,0
77461,10986,2020-11-18T16:16:58.1347507Z,2018,628,146,444,346,0,3,18,282,0,0,482,184,0,625,0,0,0
77461,10987,2020-11-18T16:16:58.1357516Z,2019,777,217,570,423,0,9,6,354,0,0,560,207,1,767,1,0,0
77461,10988,2020-11-18T16:16:58.1357516Z,2020,762,207,559,419,0,9,0,343,0,0,555,203,1,752,2,0,0
77461,31683,2021-06-24T05:35:15.2877788Z,2021,723,202,570,388,0,5,5,335,0,0,521,153,0,718,3,0,0
28456,3143,2020-11-18T16:16:05.3365435Z,2014,253,65,181,127,0,1,0,126,0,0,188,72,0,252,0,2,0
28456,3144,2020-11-18T16:16:05.3365435Z,2015,294,72,202,145,0,0,0,149,0,0,222,92,0,294,0,1,0
28456,3145,2020-11-18T16:16:05.3365435Z,2016,355,106,242,155,0,3,0,200,0,0,249,113,1,351,0,1,0
28456,3146,2020-11-18T16:16:05.3365435Z,2017,357,99,256,161,0,2,0,196,0,0,258,101,1,354,0,1,0
28456,3147,2020-11-18T16:16:05.3375444Z,2018,329,83,235,152,0,4,0,177,0,0,246,94,0,324,1,0,1
28456,3148,2020-11-18T16:16:05.3375444Z,2019,494,127,378,253,0,3,0,241,0,0,367,116,0,490,1,0,1
28456,3149,2020-11-18T16:16:05.3375444Z,2020,494,118,359,241,0,2,0,253,0,0,376,135,0,491,0,0,1
28456,31740,2021-06-24T05:35:15.4078658Z,2021,460,109,365,216,0,2,0,244,0,0,351,95,0,458,2,0,0
34462,31791,2021-06-24T05:35:16.8679116Z,2021,285,71,230,154,0,4,7,131,0,0,214,55,0,281,0,0,0
34462,4221,2020-11-18T16:16:11.4376126Z,2012,446,29,332,216,0,11,0,230,0,0,417,114,1,432,0,0,2
34462,4222,2020-11-18T16:16:11.4386144Z,2013,428,44,334,210,0,11,0,218,0,0,384,94,0,417,0,4,0
34462,4223,2020-11-18T16:16:11.4386144Z,2014,404,56,326,205,0,14,0,199,0,0,348,78,0,390,0,7,0
34462,4224,2020-11-18T16:16:11.4386144Z,2015,368,65,297,190,0,9,0,178,0,0,303,71,0,359,0,3,0
34462,4225,2020-11-18T16:16:11.4386144Z,2016,353,72,232,165,0,8,1,188,0,0,281,121,0,345,0,2,0
34462,4226,2020-11-18T16:16:11.4396144Z,2017,327,82,258,151,0,5,1,176,0,0,245,69,0,321,0,2,1
34462,4227,2020-11-18T16:16:11.4396144Z,2018,319,76,259,145,0,4,2,174,0,0,243,60,1,314,1,3,0
34462,4228,2020-11-18T16:16:11.4396144Z,2019,309,77,246,145,0,3,9,164,0,0,232,63,0,305,1,2,1
34462,4229,2020-11-18T16:16:11.4396144Z,2020,277,75,220,145,0,5,4,132,0,0,202,57,0,272,0,2,0
54429,31909,2021-06-24T05:35:18.4820697Z,2021,107,27,95,61,0,0,0,46,0,0,80,12,0,105,1,0,2
54429,7359,2020-11-18T16:16:33.2441509Z,2012,264,27,227,125,0,0,0,139,0,0,237,37,0,262,0,0,2
54429,7360,2020-11-18T16:16:33.2451517Z,2013,229,43,202,121,0,1,0,108,0,0,186,27,0,227,0,0,1
54429,7361,2020-11-18T16:16:33.2451517Z,2014,248,49,212,139,0,0,0,109,0,0,199,36,0,247,0,1,1
54429,7362,2020-11-18T16:16:33.2451517Z,2015,222,55,190,120,0,0,0,102,0,0,167,32,0,220,0,2,2
54429,7363,2020-11-18T16:16:33.2451517Z,2016,184,50,153,94,0,0,0,90,0,0,134,31,0,183,0,0,1
54429,7364,2020-11-18T16:16:33.2461531Z,2017,220,62,188,124,0,0,2,96,0,0,158,32,0,220,0,1,0
54429,7365,2020-11-18T16:16:33.2461531Z,2018,235,68,201,133,0,2,8,102,0,0,167,34,0,232,0,0,1
54429,7366,2020-11-18T16:16:33.2471531Z,2019,142,42,124,84,0,0,2,58,0,0,100,18,0,141,0,0,1
54429,7367,2020-11-18T16:16:33.2471531Z,2020,140,47,123,82,0,0,12,58,0,0,93,17,0,138,0,0,2
15750,1244,2020-11-18T16:15:53.6087218Z,2012,426,64,348,212,0,11,0,214,0,0,362,78,0,414,0,0,1
15750,1245,2020-11-18T16:15:53.6087218Z,2013,387,85,292,202,0,9,0,185,0,0,302,95,0,378,0,5,0
15750,1246,2020-11-18T16:15:53.6087218Z,2014,343,100,254,171,0,11,0,172,0,0,243,89,0,332,0,4,0
15750,1247,2020-11-18T16:15:53.6097222Z,2015,332,98,264,159,0,10,0,173,0,0,234,68,0,322,0,3,0
15750,1248,2020-11-18T16:15:53.6097222Z,2016,302,90,210,146,0,11,1,156,0,0,212,92,0,291,0,3,0
15750,1249,2020-11-18T16:15:53.6097222Z,2017,225,69,191,105,0,14,1,120,0,0,156,34,0,211,0,6,0
15750,1250,2020-11-18T16:15:53.6097222Z,2018,539,173,425,268,0,11,0,271,0,0,366,114,0,528,3,3,0
15750,1251,2020-11-18T16:15:53.6097222Z,2019,432,157,347,212,0,9,0,220,0,1,275,85,0,423,1,0,0
15750,1252,2020-11-18T16:15:53.6097222Z,2020,404,142,323,198,0,8,0,206,0,0,262,81,0,394,0,2,2
15750,31813,2021-06-24T05:35:16.9029369Z,2021,365,131,285,180,0,6,0,185,0,0,234,80,0,359,0,2,0
70755,31660,2021-06-24T05:35:15.2437472Z,2021,517,150,481,266,0,5,58,251,0,0,367,36,2,509,0,0,1
70755,9871,2020-11-18T16:16:50.8879161Z,2012,495,134,411,247,0,1,0,248,0,0,361,84,3,490,0,0,1
70755,9872,2020-11-18T16:16:50.8879161Z,2013,473,139,347,243,0,2,0,230,0,0,334,126,3,468,0,0,0
70755,9873,2020-11-18T16:16:50.8879161Z,2014,481,147,326,235,0,4,0,246,0,0,334,155,1,476,0,1,0
70755,9874,2020-11-18T16:16:50.8879161Z,2015,450,133,335,226,0,6,0,224,0,0,317,115,0,444,0,0,0
70755,9875,2020-11-18T16:16:50.8879161Z,2016,382,122,77,191,0,5,0,191,0,0,260,305,0,377,0,0,0
70755,9876,2020-11-18T16:16:50.8879161Z,2017,357,116,310,177,0,5,35,180,0,0,241,47,0,352,0,0,0
70755,9877,2020-11-18T16:16:50.8889178Z,2018,449,131,394,220,0,7,62,229,0,0,318,55,2,439,0,0,1
70755,9878,2020-11-18T16:16:50.8889178Z,2019,590,216,490,306,2,4,84,284,0,0,374,100,2,584,0,0,0
70755,9879,2020-11-18T16:16:50.8889178Z,2020,568,191,488,297,0,7,63,271,0,0,377,80,1,560,0,0,0
54452,31910,2021-06-24T05:35:18.4830702Z,2021,397,133,320,211,0,1,9,186,0,0,264,77,0,396,7,1,0
54452,7372,2020-11-18T16:16:33.2441509Z,2017,397,106,305,198,0,3,0,199,0,0,291,92,0,394,0,2,0
54452,7373,2020-11-18T16:16:33.2441509Z,2018,424,117,319,227,0,2,27,197,0,0,307,105,0,422,8,2,0
54452,7374,2020-11-18T16:16:33.2441509Z,2019,429,149,320,225,0,1,7,204,0,0,280,109,0,427,8,1,1
54452,7375,2020-11-18T16:16:33.2451517Z,2020,408,135,301,220,0,0,7,188,0,0,273,107,0,408,8,1,0
34363,25789,2021-06-24T05:35:10.8696105Z,2021,405,135,326,229,0,3,1,176,0,0,270,79,0,402,1,0,0
34363,4212,2020-11-18T16:16:11.4406157Z,2012,421,8,321,227,0,0,0,194,0,0,413,100,0,421,0,0,0
34363,4213,2020-11-18T16:16:11.4406157Z,2013,389,25,297,218,0,1,0,171,0,0,364,92,0,388,0,4,0
34363,4214,2020-11-18T16:16:11.4406157Z,2014,402,47,323,220,0,2,0,182,0,0,355,79,0,400,0,3,0
34363,4215,2020-11-18T16:16:11.4406157Z,2015,413,49,337,229,0,2,0,184,0,0,364,76,0,411,0,2,0
34363,4216,2020-11-18T16:16:11.4416162Z,2016,366,69,303,198,0,3,0,168,0,0,297,63,0,363,0,1,0
34363,4217,2020-11-18T16:16:11.4416162Z,2017,550,121,446,270,0,8,0,280,0,0,429,104,0,542,0,1,0
34363,4218,2020-11-18T16:16:11.4416162Z,2018,512,110,425,264,0,6,10,248,0,0,402,87,0,506,1,0,0
34363,4219,2020-11-18T16:16:11.4416162Z,2019,443,89,357,242,0,5,0,201,0,0,354,86,0,438,1,0,0
34363,4220,2020-11-18T16:16:11.4416162Z,2020,416,127,350,225,0,3,0,191,0,0,289,66,0,413,1,0,0
40667,31822,2021-06-24T05:35:16.9259537Z,2021,347,129,324,169,0,9,0,178,0,0,218,23,0,338,0,1,0
40667,4834,2020-11-18T16:16:15.7815083Z,2012,453,51,377,224,0,19,0,229,0,0,402,76,0,434,0,0,0
40667,4835,2020-11-18T16:16:15.7815083Z,2013,433,74,357,198,0,17,0,235,0,0,359,76,0,416,0,12,0
40667,4836,2020-11-18T16:16:15.7815083Z,2014,420,87,340,202,0,16,0,218,0,0,333,80,0,404,0,4,0
40667,4837,2020-11-18T16:16:15.7825092Z,2015,399,80,304,181,0,16,0,218,0,0,319,95,0,383,0,4,0
40667,4838,2020-11-18T16:16:15.7825092Z,2016,418,112,325,206,0,14,0,212,0,0,306,93,0,404,0,2,0
40667,4839,2020-11-18T16:16:15.7825092Z,2017,464,145,392,231,0,12,0,233,0,0,319,72,1,451,0,1,0
40667,4840,2020-11-18T16:16:15.7825092Z,2018,466,155,402,225,0,8,1,241,0,0,311,64,1,457,1,1,0
40667,4841,2020-11-18T16:16:15.7825092Z,2019,412,153,363,191,0,21,1,221,0,0,259,49,0,391,0,1,0
40667,4842,2020-11-18T16:16:15.7835101Z,2020,351,133,297,167,0,15,1,184,0,0,218,54,0,336,0,1,0
52621,31898,2021-06-24T05:35:18.474064Z,2021,245,73,228,115,0,3,0,130,0,0,172,17,0,242,0,0,0
52621,6926,2020-11-18T16:16:30.8745716Z,2012,334,52,285,168,0,3,0,166,0,0,282,49,2,329,0,0,0
52621,6927,2020-11-18T16:16:30.8745716Z,2013,310,76,273,169,0,4,0,141,0,0,234,37,2,304,0,1,0
52621,6928,2020-11-18T16:16:30.8755725Z,2014,270,87,242,146,0,5,0,124,0,0,183,28,2,263,0,1,0
52621,6929,2020-11-18T16:16:30.8755725Z,2015,222,62,202,111,0,4,0,111,0,0,160,20,0,218,0,1,0
52621,6930,2020-11-18T16:16:30.8755725Z,2016,226,73,170,117,0,6,1,109,0,0,153,56,0,220,0,1,0
52621,6931,2020-11-18T16:16:30.8765729Z,2017,203,70,172,105,0,2,0,98,0,0,133,31,1,200,0,1,0
52621,6932,2020-11-18T16:16:30.8765729Z,2018,224,82,193,113,0,2,4,111,0,0,142,31,1,219,1,1,2
52621,6933,2020-11-18T16:16:30.8765729Z,2019,297,88,274,148,0,1,1,149,0,0,209,23,1,294,1,1,1
52621,6934,2020-11-18T16:16:30.8775743Z,2020,294,77,274,148,0,0,4,146,0,0,217,20,0,294,1,1,0
71076,10038,2020-11-18T16:16:52.5800475Z,2012,500,205,383,192,0,11,0,308,0,0,295,117,1,488,0,0,0
71076,10039,2020-11-18T16:16:52.5800475Z,2013,462,201,363,177,0,11,0,285,0,0,261,99,1,450,0,16,0
71076,10040,2020-11-18T16:16:52.5800475Z,2014,481,231,320,190,0,12,0,291,0,0,250,161,1,468,0,7,0
71076,10041,2020-11-18T16:16:52.5810484Z,2015,418,214,327,171,0,8,0,247,0,0,204,91,0,410,0,4,0
71076,10042,2020-11-18T16:16:52.5810484Z,2016,393,224,231,166,0,5,1,227,0,0,169,162,0,388,0,3,0
71076,10043,2020-11-18T16:16:52.5810484Z,2017,393,231,340,170,0,9,7,223,0,0,162,53,0,384,0,3,0
71076,10044,2020-11-18T16:16:52.582048Z,2018,315,198,285,132,0,6,1,183,0,0,117,30,0,309,0,1,0
71076,10045,2020-11-18T16:16:52.582048Z,2019,460,268,407,193,0,9,0,267,0,0,192,53,0,451,0,1,0
71076,10046,2020-11-18T16:16:52.582048Z,2020,421,242,355,182,0,9,0,239,0,0,179,66,0,412,0,1,0
71076,31619,2021-06-24T05:35:14.6182989Z,2021,350,198,309,144,0,10,0,206,0,0,152,41,0,340,0,1,0
12377,31634,2021-06-24T05:35:14.633309Z,2021,596,144,486,294,0,2,0,302,0,0,452,110,0,594,14,1,0
12377,709,2020-11-18T16:15:50.8959099Z,2012,716,0,548,370,0,1,0,346,0,0,716,168,0,715,0,0,0
12377,710,2020-11-18T16:15:50.8959099Z,2013,660,4,508,335,0,0,0,325,0,0,656,152,0,660,0,2,0
12377,711,2020-11-18T16:15:50.8959099Z,2014,638,35,485,342,0,0,0,296,0,0,603,153,0,638,0,2,0
12377,712,2020-11-18T16:15:50.8959099Z,2015,654,30,486,347,0,1,0,307,0,0,624,168,0,653,0,4,0
12377,713,2020-11-18T16:15:50.8959099Z,2016,830,131,550,412,0,0,1,418,0,0,699,280,0,830,0,2,0
12377,714,2020-11-18T16:15:50.8969107Z,2017,782,133,593,391,0,1,1,391,0,0,649,189,0,781,0,2,0
12377,715,2020-11-18T16:15:50.8969107Z,2018,738,104,540,374,0,0,4,364,0,0,634,198,0,738,15,3,0
12377,716,2020-11-18T16:15:50.8969107Z,2019,636,96,462,318,0,0,3,318,0,0,540,174,0,636,18,4,0
12377,717,2020-11-18T16:15:50.8969107Z,2020,600,131,431,309,0,0,0,291,0,0,469,169,1,599,23,1,0
32763,25779,2021-06-24T05:35:10.8495961Z,2021,138,33,108,80,0,4,0,58,0,0,105,30,0,134,0,0,0
32763,3990,2020-11-18T16:16:09.9035881Z,2012,169,39,147,90,0,7,0,79,0,0,130,22,0,162,0,0,0
32763,3991,2020-11-18T16:16:09.9045903Z,2013,137,30,115,73,0,12,0,64,0,0,107,22,0,125,0,5,0
32763,3992,2020-11-18T16:16:09.9045903Z,2014,129,35,113,62,0,11,0,67,0,0,94,16,0,118,0,4,0
32763,3993,2020-11-18T16:16:09.9045903Z,2015,111,37,97,53,0,3,0,58,0,0,74,14,0,107,0,0,1
32763,3994,2020-11-18T16:16:09.9045903Z,2016,165,51,143,79,0,4,12,86,0,0,114,22,0,159,0,0,2
32763,3995,2020-11-18T16:16:09.9055903Z,2017,190,61,160,89,0,4,1,101,0,0,129,30,0,186,0,0,0
32763,3996,2020-11-18T16:16:09.9055903Z,2018,203,58,167,101,0,6,8,102,0,0,145,36,0,197,0,0,0
32763,3997,2020-11-18T16:16:09.9055903Z,2019,175,51,125,96,0,6,0,79,0,1,124,50,0,169,0,0,0
32763,3998,2020-11-18T16:16:09.9065903Z,2020,136,36,96,77,0,3,0,59,0,0,100,40,0,133,0,0,0
17889,1486,2020-11-18T16:15:54.7724994Z,2012,344,78,261,160,0,7,0,184,0,0,266,83,0,337,0,0,0
17889,1487,2020-11-18T16:15:54.7724994Z,2013,327,84,253,148,0,5,0,179,0,0,243,74,3,319,0,6,0
17889,1488,2020-11-18T16:15:54.7724994Z,2014,277,76,214,120,0,5,0,157,0,0,201,63,0,272,0,5,0
17889,1489,2020-11-18T16:15:54.7724994Z,2015,235,59,174,106,0,2,0,129,0,0,176,61,0,233,0,6,0
17889,1490,2020-11-18T16:15:54.7734994Z,2016,243,63,190,109,0,4,0,134,0,0,180,53,0,239,0,5,0
17889,1491,2020-11-18T16:15:54.7734994Z,2017,187,54,143,81,0,0,0,106,0,0,133,44,0,187,0,0,0
17889,1492,2020-11-18T16:15:54.7734994Z,2018,175,46,131,82,0,0,26,93,0,0,129,44,0,175,0,0,0
17889,1493,2020-11-18T16:15:54.7734994Z,2019,200,70,154,97,0,2,0,103,0,0,130,46,0,198,0,0,0
17889,1494,2020-11-18T16:15:54.7734994Z,2020,210,67,153,96,0,1,0,114,0,0,143,57,1,206,0,0,2
17889,25613,2021-06-24T05:35:04.6321381Z,2021,194,59,167,93,0,1,0,101,0,0,135,27,0,193,0,0,0
52225,25892,2021-06-24T05:35:12.7829829Z,2021,233,85,219,103,0,5,0,130,0,0,148,14,0,228,0,0,0
52225,6753,2020-11-18T16:16:28.9002543Z,2012,309,91,284,135,0,6,0,174,0,0,218,25,0,303,0,0,0
52225,6754,2020-11-18T16:16:28.9002543Z,2013,390,130,366,173,0,5,0,217,0,0,260,24,0,385,0,2,0
52225,6755,2020-11-18T16:16:28.9002543Z,2014,367,130,339,167,0,12,0,200,0,0,237,28,0,355,0,2,0
52225,6756,2020-11-18T16:16:28.9012543Z,2015,344,128,324,161,0,11,0,183,0,0,216,20,0,333,0,3,0
52225,6757,2020-11-18T16:16:28.9012543Z,2016,334,125,308,160,0,8,1,174,0,0,209,26,0,326,0,3,0
52225,6758,2020-11-18T16:16:28.9012543Z,2017,266,107,252,117,0,7,1,149,0,0,159,14,0,259,0,3,0
52225,6759,2020-11-18T16:16:28.9022552Z,2018,286,110,277,125,0,9,0,161,0,0,176,9,0,277,1,1,0
52225,6760,2020-11-18T16:16:28.9022552Z,2019,301,123,290,140,0,5,0,161,0,0,178,11,0,296,1,0,0
52225,6761,2020-11-18T16:16:28.9022552Z,2020,286,122,278,130,0,6,8,156,0,0,164,8,1,279,0,0,0
40915,25821,2021-06-24T05:35:10.913642Z,2021,265,110,238,135,0,5,0,130,0,0,155,27,0,260,0,0,0
40915,4880,2020-11-18T16:16:15.8065257Z,2012,226,80,193,98,0,3,0,128,0,0,146,33,0,223,0,0,0
40915,4881,2020-11-18T16:16:15.8065257Z,2013,194,73,161,84,0,1,0,110,0,0,121,33,0,193,0,1,0
40915,4882,2020-11-18T16:16:15.8075266Z,2014,187,72,159,83,0,5,0,104,0,0,115,28,0,182,0,2,0
40915,4883,2020-11-18T16:16:15.8075266Z,2015,218,89,183,102,0,6,0,116,0,0,129,35,0,212,0,2,0
40915,4884,2020-11-18T16:16:15.8075266Z,2016,255,108,215,119,0,8,21,136,0,0,147,40,0,247,0,1,0
40915,4885,2020-11-18T16:16:15.8075266Z,2017,232,102,201,110,0,12,0,122,0,0,130,31,0,220,0,2,0
40915,4886,2020-11-18T16:16:15.8075266Z,2018,257,104,216,126,0,14,3,131,0,0,153,41,0,243,0,0,0
40915,4887,2020-11-18T16:16:15.8085266Z,2019,275,114,241,154,0,12,0,121,0,0,161,34,0,263,0,0,0
40915,4888,2020-11-18T16:16:15.8085266Z,2020,287,119,253,159,0,8,0,128,0,0,168,34,0,279,0,0,0
56424,31921,2021-06-24T05:35:18.4930778Z,2021,344,101,308,193,0,5,0,151,0,0,243,36,0,339,3,1,0
56424,7595,2020-11-18T16:16:34.5590279Z,2012,607,82,510,303,0,0,0,304,0,0,525,97,0,607,0,0,0
56424,7596,2020-11-18T16:16:34.5590279Z,2013,597,111,516,305,0,1,0,292,0,0,486,81,0,596,0,4,0
56424,7597,2020-11-18T16:16:34.5600275Z,2014,580,114,498,280,0,1,0,300,0,0,466,82,0,579,0,3,0
56424,7598,2020-11-18T16:16:34.5600275Z,2015,500,98,430,238,0,4,0,262,0,0,402,70,0,496,0,2,0
56424,7599,2020-11-18T16:16:34.5600275Z,2016,488,109,113,237,0,5,1,251,0,0,379,375,0,483,0,3,0
56424,7600,2020-11-18T16:16:34.5600275Z,2017,407,115,306,196,0,6,0,211,0,0,292,101,0,401,0,1,0
56424,7601,2020-11-18T16:16:35.0583608Z,2018,332,80,262,150,0,4,0,182,0,0,252,70,0,328,3,0,0
56424,7602,2020-11-18T16:16:35.0593613Z,2019,359,98,310,182,0,3,0,177,0,0,261,49,0,356,5,1,0
56424,7603,2020-11-18T16:16:35.0593613Z,2020,355,114,317,188,0,3,2,167,0,0,241,38,0,352,5,2,0
60228,25937,2021-06-24T05:35:12.8340193Z,2021,229,64,200,121,0,0,0,108,0,0,165,29,0,229,0,0,0
60228,7942,2020-11-18T16:16:37.0927204Z,2012,137,32,111,59,0,0,0,78,0,0,105,26,0,137,0,0,0
60228,7943,2020-11-18T16:16:37.0927204Z,2013,138,31,108,59,0,0,0,79,0,0,107,30,0,138,0,0,0
60228,7944,2020-11-18T16:16:37.0927204Z,2014,134,37,110,56,0,1,0,78,0,0,97,24,0,133,0,0,0
60228,7945,2020-11-18T16:16:37.0937204Z,2015,222,72,194,98,0,1,0,124,0,0,150,28,0,221,0,0,0
60228,7946,2020-11-18T16:16:37.0937204Z,2016,233,73,186,104,0,0,1,129,0,0,160,47,0,233,0,0,0
60228,7947,2020-11-18T16:16:37.0937204Z,2017,228,78,191,107,0,1,4,121,0,0,150,37,0,227,0,0,0
60228,7948,2020-11-18T16:16:37.0937204Z,2018,222,73,200,95,0,2,6,127,0,0,149,22,0,219,0,0,1
60228,7949,2020-11-18T16:16:37.0947209Z,2019,198,63,164,107,2,0,6,91,0,0,135,34,0,197,0,1,1
60228,7950,2020-11-18T16:16:37.0947209Z,2020,249,76,212,140,0,1,0,109,0,0,173,37,0,247,0,1,1
65078,31980,2021-06-24T05:35:20.2813594Z,2021,332,95,311,162,0,4,0,170,0,0,237,21,0,328,0,0,0
65078,9023,2020-11-18T16:16:44.8829134Z,2012,488,124,396,220,0,9,0,268,0,0,364,92,0,477,0,0,2
65078,9024,2020-11-18T16:16:44.8839116Z,2013,470,129,391,213,0,12,0,257,0,0,341,79,0,457,0,0,1
65078,9025,2020-11-18T16:16:44.8839116Z,2014,435,127,363,198,0,12,0,237,0,0,308,72,0,423,0,1,0
65078,9026,2020-11-18T16:16:44.8839116Z,2015,408,110,350,189,0,4,0,219,0,0,298,58,0,404,0,1,0
65078,9027,2020-11-18T16:16:44.8839116Z,2016,372,103,291,177,0,4,0,195,0,0,269,81,0,368,0,1,0
65078,9028,2020-11-18T16:16:44.8839116Z,2017,335,99,285,168,0,3,0,167,0,0,236,50,0,332,0,2,0
65078,9029,2020-11-18T16:16:44.8849125Z,2018,348,97,297,156,1,4,1,192,0,0,251,51,0,344,0,1,0
65078,9030,2020-11-18T16:16:44.8849125Z,2019,375,118,344,165,0,4,0,210,0,0,257,31,0,371,0,1,0
65078,9031,2020-11-18T16:16:44.8849125Z,2020,345,104,320,161,0,5,0,184,0,0,241,25,0,337,0,1,3
70508,31653,2021-06-24T05:35:14.676341Z,2021,492,169,386,245,0,10,1,247,0,0,323,106,0,482,2,3,0
70508,9723,2020-11-18T16:16:50.4686362Z,2012,625,115,358,327,0,10,0,298,0,0,510,267,7,604,0,0,4
70508,9724,2020-11-18T16:16:50.4686362Z,2013,590,162,370,295,0,9,0,295,0,0,428,220,3,570,0,3,8
70508,9725,2020-11-18T16:16:50.4696362Z,2014,605,142,363,299,0,12,0,306,0,0,463,242,1,587,0,1,5
70508,9726,2020-11-18T16:16:50.4696362Z,2015,601,134,349,301,0,13,0,300,0,0,467,252,1,583,0,2,4
70508,9727,2020-11-18T16:16:50.4696362Z,2016,595,154,356,301,0,5,0,294,0,0,441,239,1,589,0,0,0
70508,9728,2020-11-18T16:16:50.4696362Z,2017,534,154,332,279,0,4,3,255,0,0,380,202,1,529,0,1,0
70508,9729,2020-11-18T16:16:50.4696362Z,2018,603,176,420,313,0,4,25,290,0,4,427,183,0,599,2,2,0
70508,9730,2020-11-18T16:16:50.4706375Z,2019,573,182,381,291,0,6,17,282,0,0,391,192,0,567,2,4,0
70508,9731,2020-11-18T16:16:50.4706375Z,2020,541,178,370,283,0,9,2,258,0,0,363,171,0,532,4,4,0
69112,25992,2021-06-24T05:35:14.5102223Z,2021,497,176,442,227,0,4,0,270,0,0,321,55,0,493,0,0,0
69112,9332,2020-11-18T16:16:47.3825805Z,2012,383,136,354,174,0,7,0,209,0,0,247,29,1,375,0,0,0
69112,9333,2020-11-18T16:16:47.3825805Z,2013,395,147,354,180,0,6,0,215,0,0,248,41,0,388,0,1,1
69112,9334,2020-11-18T16:16:47.3835823Z,2014,382,125,357,173,0,5,0,209,0,0,257,25,0,376,0,1,1
69112,9335,2020-11-18T16:16:47.3835823Z,2015,361,140,339,162,0,4,0,199,0,0,221,22,0,355,0,0,2
69112,9336,2020-11-18T16:16:47.3835823Z,2016,333,125,265,152,0,3,0,181,0,0,208,68,0,329,0,0,1
69112,9337,2020-11-18T16:16:47.3835823Z,2017,322,123,291,146,0,4,0,176,0,0,199,31,0,317,0,0,1
69112,9338,2020-11-18T16:16:47.3845823Z,2018,309,101,278,130,0,2,6,179,0,0,208,31,0,306,0,0,1
69112,9339,2020-11-18T16:16:47.3845823Z,2019,338,124,310,149,0,1,6,189,0,0,214,28,0,337,0,0,0
69112,9340,2020-11-18T16:16:47.3845823Z,2020,406,145,367,177,0,3,4,229,0,0,261,39,0,401,0,0,2
12096,31599,2021-06-24T05:35:14.5582554Z,2021,239,113,211,122,0,9,0,117,0,0,126,28,0,230,0,0,0
12096,597,2020-11-18T16:15:49.6941131Z,2012,380,39,353,178,0,3,0,202,0,0,341,27,15,362,0,0,0
12096,598,2020-11-18T16:15:49.6941131Z,2013,351,76,323,161,0,4,0,190,0,0,275,28,9,338,0,4,0
12096,599,2020-11-18T16:15:49.6941131Z,2014,267,76,244,126,0,2,0,141,0,0,191,23,3,262,0,2,0
12096,600,2020-11-18T16:15:49.6951127Z,2015,405,105,365,184,0,8,0,221,0,0,300,40,2,394,0,4,1
12096,601,2020-11-18T16:15:50.2194601Z,2016,403,117,280,192,0,5,5,211,0,0,286,123,1,396,0,2,1
12096,602,2020-11-18T16:15:50.2194601Z,2017,355,130,329,149,0,5,3,206,0,0,225,26,1,349,0,3,0
12096,603,2020-11-18T16:15:50.2204606Z,2018,301,95,276,129,1,3,17,172,0,0,206,25,1,297,0,2,0
12096,604,2020-11-18T16:15:50.2204606Z,2019,266,105,246,132,0,4,3,134,0,0,161,20,0,262,0,0,0
12096,605,2020-11-18T16:15:50.2204606Z,2020,254,113,230,127,0,5,0,127,0,0,141,24,0,249,0,0,0
20784,1924,2020-11-18T16:15:58.4929785Z,2012,248,101,214,123,0,2,0,125,0,0,147,34,0,246,0,0,0
20784,1925,2020-11-18T16:15:58.4939798Z,2013,227,90,200,113,0,1,0,114,0,0,137,27,0,226,0,3,0
20784,1926,2020-11-18T16:15:58.4939798Z,2014,199,86,182,101,0,1,0,98,0,0,113,17,0,198,0,1,0
20784,1927,2020-11-18T16:15:58.4939798Z,2015,160,68,147,89,0,2,0,71,0,0,92,13,0,158,0,0,0
20784,1928,2020-11-18T16:15:58.4939798Z,2016,137,52,115,82,0,0,0,55,0,0,85,22,1,136,0,0,0
20784,1929,2020-11-18T16:15:58.4939798Z,2017,197,80,170,107,0,0,0,90,0,0,117,27,0,197,0,0,0
20784,1930,2020-11-18T16:15:58.4949798Z,2018,118,43,104,63,0,0,27,55,0,0,75,14,0,118,0,0,0
20784,1931,2020-11-18T16:15:58.4949798Z,2019,120,41,108,62,0,0,21,58,0,0,79,12,0,120,0,0,0
20784,1932,2020-11-18T16:15:58.4949798Z,2020,121,42,107,60,0,1,3,61,0,0,79,14,0,120,0,0,0
20784,25699,2021-06-24T05:35:08.6580246Z,2021,137,43,114,61,0,1,5,76,0,0,94,23,0,136,0,0,0
21550,2230,2020-11-18T16:16:00.0230003Z,2012,312,26,240,160,0,0,0,152,0,0,286,72,0,311,0,0,1
21550,2231,2020-11-18T16:16:00.0240017Z,2013,406,65,313,207,0,1,0,199,0,0,341,93,0,404,0,1,1
21550,2232,2020-11-18T16:16:00.0240017Z,2014,409,76,295,223,0,2,0,186,0,0,333,114,0,407,0,1,0
21550,2233,2020-11-18T16:16:00.0240017Z,2015,515,136,394,269,0,1,0,246,0,0,379,121,0,514,0,3,0
21550,2234,2020-11-18T16:16:00.0250021Z,2016,522,160,263,275,0,1,5,247,0,0,362,259,0,521,0,4,0
21550,2235,2020-11-18T16:16:00.0250021Z,2017,422,139,311,202,0,3,0,220,0,0,283,111,0,419,0,3,0
21550,2236,2020-11-18T16:16:00.0250021Z,2018,447,123,312,200,0,3,7,247,0,0,324,135,0,444,1,1,0
21550,2237,2020-11-18T16:16:00.0260039Z,2019,456,139,291,216,0,2,11,240,0,0,317,165,0,454,1,1,0
21550,2238,2020-11-18T16:16:00.0260039Z,2020,457,124,269,226,0,0,8,231,0,0,333,188,0,457,1,1,0
21550,25709,2021-06-24T05:35:08.6650294Z,2021,456,120,321,231,0,1,10,225,0,0,336,135,0,455,1,1,0
60335,25938,2021-06-24T05:35:12.8320178Z,2021,307,104,261,151,0,2,3,156,0,0,203,46,0,305,0,0,0
60335,7990,2020-11-18T16:16:37.1257414Z,2012,393,66,320,204,0,3,0,189,0,0,327,73,0,390,0,0,0
60335,7991,2020-11-18T16:16:37.1267427Z,2013,429,97,367,208,0,3,0,221,0,0,332,62,0,425,0,0,1
60335,7992,2020-11-18T16:16:37.1267427Z,2014,436,118,366,207,0,3,0,229,0,0,318,70,0,432,0,0,1
60335,7993,2020-11-18T16:16:37.1267427Z,2015,448,117,393,218,0,2,0,230,0,0,331,55,0,446,0,0,0
60335,7994,2020-11-18T16:16:37.1267427Z,2016,433,126,360,205,0,1,1,228,0,0,307,73,0,432,0,0,0
60335,7995,2020-11-18T16:16:37.1267427Z,2017,321,96,281,139,0,1,3,182,0,0,225,40,0,320,0,0,0
60335,7996,2020-11-18T16:16:37.1277436Z,2018,305,92,260,129,0,2,9,176,0,0,213,45,0,303,0,0,0
60335,7997,2020-11-18T16:16:37.1277436Z,2019,356,117,306,152,0,1,11,204,0,0,239,50,0,355,0,0,0
60335,7998,2020-11-18T16:16:37.1277436Z,2020,337,110,297,155,0,0,0,182,0,0,227,40,0,337,0,0,0
31252,31767,2021-06-24T05:35:16.8388914Z,2021,271,35,252,126,0,0,0,145,0,0,236,19,5,263,0,1,3
31252,3602,2020-11-18T16:16:08.0313385Z,2012,215,34,195,106,0,7,0,109,0,0,181,20,1,207,0,0,0
31252,3603,2020-11-18T16:16:08.0323399Z,2013,222,40,165,109,0,1,0,113,0,0,182,57,1,220,0,0,0
31252,3604,2020-11-18T16:16:08.0323399Z,2014,214,37,171,100,0,0,0,114,0,0,177,43,0,214,0,0,0
31252,3605,2020-11-18T16:16:08.0323399Z,2015,206,35,179,101,0,0,0,105,0,0,171,27,1,205,0,0,0
31252,3606,2020-11-18T16:16:08.0323399Z,2016,182,29,155,91,0,0,0,91,0,0,153,27,0,182,0,0,0
31252,3607,2020-11-18T16:16:08.0323399Z,2017,90,13,79,45,0,1,0,45,0,0,77,11,1,88,0,0,0
31252,3608,2020-11-18T16:16:08.0323399Z,2018,105,16,95,50,0,1,0,55,0,0,89,10,1,101,0,0,2
31252,3609,2020-11-18T16:16:08.0333394Z,2019,269,33,242,137,0,2,0,132,0,0,236,27,4,261,0,1,2
31252,3610,2020-11-18T16:16:08.0333394Z,2020,270,27,256,125,0,1,0,145,0,0,243,14,3,264,0,0,2
10355,25580,2021-06-24T05:35:04.5921094Z,2021,231,100,220,101,0,4,0,130,0,0,131,11,1,226,1,1,0
10355,83,2020-11-18T16:15:45.5153234Z,2012,316,148,280,135,0,12,0,181,0,0,168,36,0,304,0,0,0
10355,84,2020-11-18T16:15:45.5153234Z,2013,304,163,218,130,0,9,0,174,0,0,141,86,0,294,0,1,1
10355,85,2020-11-18T16:15:45.5153234Z,2014,263,134,235,118,0,7,0,145,0,0,129,28,0,255,0,0,1
10355,86,2020-11-18T16:15:45.5153234Z,2015,274,143,272,128,0,5,0,146,0,0,131,2,0,269,0,0,0
10355,87,2020-11-18T16:15:45.5163243Z,2016,286,147,277,133,0,5,0,153,0,0,139,9,0,281,0,0,0
10355,88,2020-11-18T16:15:45.5163243Z,2017,260,130,253,118,0,4,0,142,0,0,130,7,0,256,0,1,0
10355,89,2020-11-18T16:15:45.5163243Z,2018,213,92,205,94,0,4,2,119,0,0,121,8,0,208,0,1,1
10355,90,2020-11-18T16:15:45.5163243Z,2019,265,124,258,128,0,7,2,137,0,0,141,7,0,258,0,1,0
10355,91,2020-11-18T16:15:45.5173247Z,2020,265,102,249,129,0,6,1,136,0,0,163,16,0,259,0,1,0
35972,25804,2021-06-24T05:35:10.8956305Z,2021,414,94,332,202,0,4,1,212,0,0,320,82,1,409,0,3,0
35972,4497,2020-11-18T16:16:12.5913773Z,2012,241,48,167,120,0,3,0,121,0,0,193,74,0,238,0,0,0
35972,4498,2020-11-18T16:16:12.5913773Z,2013,227,47,131,111,0,8,0,116,0,0,180,96,0,218,0,3,1
35972,4499,2020-11-18T16:16:12.5913773Z,2014,225,51,150,105,0,8,0,120,0,0,174,75,0,216,0,4,1
35972,4500,2020-11-18T16:16:12.5923787Z,2015,314,73,218,141,0,6,0,173,0,0,241,96,3,303,0,10,2
35972,4501,2020-11-18T16:16:13.1797708Z,2016,289,64,187,144,0,5,7,145,0,0,225,102,3,280,0,8,1
35972,4502,2020-11-18T16:16:13.1807708Z,2017,366,87,281,185,0,7,0,181,0,0,279,85,3,356,0,6,0
35972,4503,2020-11-18T16:16:13.1807708Z,2018,337,69,239,168,0,4,28,169,0,0,268,98,2,331,0,4,0
35972,4504,2020-11-18T16:16:13.1807708Z,2019,523,121,378,245,0,9,10,278,0,1,402,145,3,511,0,2,0
35972,4505,2020-11-18T16:16:13.1807708Z,2020,477,110,375,222,0,8,1,255,0,0,367,102,2,467,0,2,0
34777,31792,2021-06-24T05:35:16.866912Z,2021,161,49,155,74,0,0,2,87,0,0,112,6,0,161,0,0,0
34777,4239,2020-11-18T16:16:11.4736371Z,2012,482,55,378,246,0,3,0,236,0,0,427,104,0,479,0,0,0
34777,4240,2020-11-18T16:16:11.4736371Z,2013,420,85,336,213,0,4,0,207,0,0,335,84,0,416,0,3,0
34777,4241,2020-11-18T16:16:11.4746376Z,2014,388,97,318,184,0,2,0,204,0,0,291,70,0,386,0,2,0
34777,4242,2020-11-18T16:16:11.4746376Z,2015,307,79,267,141,0,0,0,166,0,0,228,40,0,307,0,0,0
34777,4243,2020-11-18T16:16:11.4746376Z,2016,219,64,187,99,0,1,0,120,0,0,155,32,0,218,0,0,0
34777,4244,2020-11-18T16:16:11.4746376Z,2017,162,38,133,80,0,1,1,82,0,0,124,29,0,161,0,0,0
34777,4245,2020-11-18T16:16:11.4746376Z,2018,242,65,196,125,0,1,0,117,0,0,177,46,0,241,0,1,0
34777,4246,2020-11-18T16:16:11.4756394Z,2019,267,93,254,130,0,2,0,137,0,0,174,13,0,265,0,0,0
34777,4247,2020-11-18T16:16:11.4756394Z,2020,213,74,202,104,0,1,2,109,0,0,139,11,0,209,0,0,3
15446,1219,2020-11-18T16:15:53.5987165Z,2012,511,65,393,252,0,32,0,259,0,0,446,118,2,477,0,0,0
15446,1220,2020-11-18T16:15:53.5987165Z,2013,516,106,400,272,0,19,0,244,0,0,410,116,1,496,0,4,0
15446,1221,2020-11-18T16:15:53.5987165Z,2014,502,121,388,271,0,15,0,231,0,0,381,114,1,486,0,2,0
15446,1222,2020-11-18T16:15:53.5987165Z,2015,423,107,336,211,0,10,0,212,0,0,316,87,0,413,0,1,0
15446,1223,2020-11-18T16:15:53.5997165Z,2016,384,120,301,191,0,8,0,193,0,0,264,83,0,376,0,1,0
15446,1224,2020-11-18T16:15:53.5997165Z,2017,311,101,255,132,0,12,1,179,0,0,210,56,0,299,0,5,0
15446,1225,2020-11-18T16:15:53.5997165Z,2018,627,208,492,292,0,19,24,335,0,0,419,135,0,608,4,7,0
15446,1226,2020-11-18T16:15:53.5997165Z,2019,787,265,617,364,1,31,1,423,0,3,522,170,0,756,4,4,0
15446,1227,2020-11-18T16:15:53.5997165Z,2020,694,235,548,330,0,33,2,364,0,0,459,146,2,659,5,2,0
15446,31812,2021-06-24T05:35:16.9019364Z,2021,585,186,497,264,0,25,0,321,0,0,399,88,1,559,3,4,0
31070,25764,2021-06-24T05:35:08.7360802Z,2021,267,74,231,126,0,2,0,141,0,0,193,36,0,265,2,0,0
31070,3535,2020-11-18T16:16:07.6170614Z,2012,266,52,221,128,0,3,0,138,0,0,214,45,0,263,0,0,0
31070,3536,2020-11-18T16:16:07.6180631Z,2013,255,65,226,121,0,3,0,134,0,0,190,29,0,252,0,3,0
31070,3537,2020-11-18T16:16:07.6180631Z,2014,231,60,205,113,0,1,0,118,0,0,171,26,0,230,0,1,0
31070,3538,2020-11-18T16:16:07.6180631Z,2015,240,59,214,113,0,1,0,127,0,0,181,26,0,239,0,1,0
31070,3539,2020-11-18T16:16:07.6190627Z,2016,203,43,159,99,0,0,0,104,0,0,160,44,3,200,0,1,0
31070,3540,2020-11-18T16:16:07.6190627Z,2017,225,57,204,111,0,0,0,114,0,0,168,21,1,224,0,0,0
31070,3541,2020-11-18T16:16:07.6190627Z,2018,298,77,271,137,0,0,0,161,0,0,221,27,0,298,1,0,0
31070,3542,2020-11-18T16:16:07.6190627Z,2019,303,89,270,150,0,1,1,153,0,0,214,33,1,301,1,0,0
31070,3543,2020-11-18T16:16:07.6200631Z,2020,294,89,263,138,0,2,0,156,0,0,205,31,1,291,2,0,0
22582,2465,2020-11-18T16:16:01.4339379Z,2012,601,1,435,313,0,5,0,288,0,0,600,166,0,595,0,0,1
22582,2466,2020-11-18T16:16:01.4339379Z,2013,559,2,409,285,0,5,0,274,0,0,557,150,0,554,0,1,0
22582,2467,2020-11-18T16:16:01.4339379Z,2014,544,27,406,278,0,4,0,266,0,0,517,138,0,540,0,1,0
22582,2468,2020-11-18T16:16:01.4339379Z,2015,521,27,411,259,0,2,0,262,0,0,494,110,0,518,0,1,1
22582,2469,2020-11-18T16:16:01.4349379Z,2016,746,110,549,392,0,10,7,354,0,0,636,197,0,736,0,2,0
22582,2470,2020-11-18T16:16:01.4349379Z,2017,704,118,538,363,0,11,4,341,0,0,586,166,0,693,0,3,0
22582,2471,2020-11-18T16:16:01.4349379Z,2018,631,102,465,327,0,12,23,304,0,0,529,166,0,619,0,2,0
22582,2472,2020-11-18T16:16:01.4349379Z,2019,554,97,437,276,1,11,15,278,0,0,457,117,0,543,0,2,0
22582,2473,2020-11-18T16:16:01.4359383Z,2020,475,125,369,242,0,7,8,233,0,0,350,106,0,468,0,1,0
22582,25748,2021-06-24T05:35:08.7040576Z,2021,468,150,383,235,0,8,17,233,0,0,318,85,0,460,0,1,0
70482,31652,2021-06-24T05:35:14.676341Z,2021,217,59,164,125,0,0,0,92,0,0,158,53,1,216,1,0,0
70482,9705,2020-11-18T16:16:50.4576282Z,2012,299,110,227,134,0,4,0,165,0,0,189,72,0,295,0,0,0
70482,9706,2020-11-18T16:16:50.4586291Z,2013,312,115,218,153,0,9,0,159,0,0,197,94,0,303,0,0,0
70482,9707,2020-11-18T16:16:50.4586291Z,2014,293,100,208,152,0,5,0,141,0,0,193,85,0,288,0,1,0
70482,9708,2020-11-18T16:16:50.4586291Z,2015,306,100,214,155,0,4,0,151,0,0,206,92,0,302,0,2,0
70482,9709,2020-11-18T16:16:50.4586291Z,2016,252,81,161,129,0,4,0,123,0,0,171,91,0,248,0,1,0
70482,9710,2020-11-18T16:16:50.4586291Z,2017,253,70,169,135,0,3,1,118,0,0,183,84,1,249,0,1,0
70482,9711,2020-11-18T16:16:50.4596304Z,2018,215,58,139,119,0,1,4,96,0,0,157,76,0,213,1,0,1
70482,9712,2020-11-18T16:16:50.4596304Z,2019,298,100,197,167,0,1,0,131,0,0,198,101,0,297,1,0,0
70482,9713,2020-11-18T16:16:50.4596304Z,2020,264,82,184,144,0,0,0,120,0,0,182,80,1,263,1,0,0
34785,25791,2021-06-24T05:35:10.8696105Z,2021,607,124,468,322,0,12,0,285,0,0,483,139,0,595,1,1,0
34785,4248,2020-11-18T16:16:11.4696345Z,2012,643,1,428,342,0,2,0,301,0,0,642,215,0,641,0,0,0
34785,4249,2020-11-18T16:16:11.4696345Z,2013,539,0,329,296,0,2,0,243,0,0,539,210,0,537,0,1,0
34785,4250,2020-11-18T16:16:11.4706353Z,2014,584,19,371,306,0,2,0,278,0,0,565,213,0,582,0,2,0
34785,4251,2020-11-18T16:16:11.4706353Z,2015,549,23,353,257,0,3,0,292,0,0,526,196,0,541,0,1,5
34785,4252,2020-11-18T16:16:11.4706353Z,2016,522,48,351,250,0,6,0,272,0,0,474,171,0,510,0,0,6
34785,4253,2020-11-18T16:16:11.4706353Z,2017,633,70,440,310,0,14,0,323,0,0,563,193,0,612,0,0,7
34785,4254,2020-11-18T16:16:11.4716371Z,2018,615,72,417,295,0,13,0,320,0,0,543,198,1,599,0,0,2
34785,4255,2020-11-18T16:16:11.4716371Z,2019,582,79,391,297,0,16,0,285,0,0,503,191,0,566,0,1,0
34785,4256,2020-11-18T16:16:11.4716371Z,2020,588,110,396,320,0,12,0,268,0,0,478,192,0,576,0,1,0
20396,1716,2020-11-18T16:15:57.3942454Z,2012,450,125,319,201,0,4,0,249,0,0,325,131,3,443,0,0,0
20396,1717,2020-11-18T16:15:57.3942454Z,2013,454,131,308,223,0,9,0,231,0,0,323,146,2,443,0,4,0
20396,1718,2020-11-18T16:15:57.3942454Z,2014,458,135,317,235,0,6,0,223,0,0,323,141,4,448,0,2,0
20396,1719,2020-11-18T16:15:57.395245Z,2015,458,128,326,231,0,6,0,227,0,0,330,132,3,449,0,2,0
20396,1720,2020-11-18T16:15:57.395245Z,2016,366,112,257,178,0,7,0,188,0,0,254,109,2,357,0,3,0
20396,1721,2020-11-18T16:15:57.395245Z,2017,340,106,234,162,0,9,0,178,0,0,234,106,3,328,0,3,0
20396,1722,2020-11-18T16:15:57.395245Z,2018,396,111,271,185,0,10,0,211,0,0,285,125,2,384,1,0,0
20396,1723,2020-11-18T16:15:57.3962463Z,2019,434,133,292,224,0,11,1,210,0,0,301,142,5,417,0,0,1
20396,1724,2020-11-18T16:15:57.3962463Z,2020,497,140,324,249,0,11,0,248,0,0,357,173,3,483,0,0,0
20396,25691,2021-06-24T05:35:08.6390117Z,2021,520,149,411,253,0,7,0,267,0,0,371,109,1,510,0,0,2
30874,31763,2021-06-24T05:35:16.8348886Z,2021,238,45,201,110,0,0,0,128,0,0,193,37,0,238,0,0,0
30874,3480,2020-11-18T16:16:07.027667Z,2012,221,57,172,110,0,1,0,111,0,0,164,49,0,220,0,0,0
30874,3481,2020-11-18T16:16:07.0286679Z,2013,208,60,165,103,0,0,0,105,0,0,148,43,0,208,0,0,0
30874,3482,2020-11-18T16:16:07.0286679Z,2014,205,51,162,102,0,1,0,103,0,0,154,43,0,203,0,0,1
30874,3483,2020-11-18T16:16:07.0286679Z,2015,241,65,194,115,0,2,0,126,0,0,176,47,0,237,0,0,2
30874,3484,2020-11-18T16:16:07.0286679Z,2016,170,55,113,70,0,0,0,100,0,0,115,57,0,169,0,0,1
30874,3485,2020-11-18T16:16:07.0286679Z,2017,180,55,146,77,0,1,0,103,0,0,125,34,0,178,0,0,1
30874,3486,2020-11-18T16:16:07.0296683Z,2018,227,68,184,101,0,0,0,126,0,0,159,43,0,226,0,0,1
30874,3487,2020-11-18T16:16:07.0296683Z,2019,236,56,189,116,0,0,0,120,0,0,180,47,0,235,0,0,1
30874,3488,2020-11-18T16:16:07.0296683Z,2020,234,46,187,121,0,0,0,113,0,0,188,47,0,233,0,0,1
40378,25817,2021-06-24T05:35:10.9076382Z,2021,254,89,218,124,0,3,3,130,0,0,165,36,3,248,0,0,0
40378,4740,2020-11-18T16:16:15.3262044Z,2012,270,33,223,119,0,4,0,151,0,0,237,47,0,264,0,0,2
40378,4741,2020-11-18T16:16:15.3272053Z,2013,253,44,220,113,0,1,0,140,0,0,209,33,0,252,0,3,0
40378,4742,2020-11-18T16:16:15.3272053Z,2014,180,42,169,80,0,2,0,100,0,0,138,11,0,178,0,0,0
40378,4743,2020-11-18T16:16:15.3272053Z,2015,249,64,239,108,0,0,0,141,0,0,185,10,0,248,0,1,1
40378,4744,2020-11-18T16:16:15.3272053Z,2016,227,71,154,103,0,1,18,124,0,0,156,73,0,225,0,0,1
40378,4745,2020-11-18T16:16:15.3272053Z,2017,201,65,189,89,0,0,11,112,0,0,136,12,0,201,0,0,0
40378,4746,2020-11-18T16:16:15.3282053Z,2018,242,77,230,110,0,3,3,132,0,0,165,12,0,239,2,1,0
40378,4747,2020-11-18T16:16:15.3282053Z,2019,327,127,309,154,0,5,0,173,0,0,200,18,0,322,0,0,0
40378,4748,2020-11-18T16:16:15.3282053Z,2020,318,121,308,149,0,5,0,169,0,0,197,10,0,313,0,0,0
50294,25873,2021-06-24T05:35:11.0557439Z,2021,503,79,397,246,0,4,0,257,0,0,424,106,0,499,9,2,0
50294,6186,2020-11-18T16:16:25.1057249Z,2012,620,1,336,312,0,13,0,308,0,0,619,284,0,607,0,0,0
50294,6187,2020-11-18T16:16:25.1057249Z,2013,569,1,420,298,0,4,0,271,0,0,568,149,0,565,0,4,0
50294,6188,2020-11-18T16:16:25.1057249Z,2014,556,22,432,296,0,2,0,260,0,0,534,124,0,554,0,1,0
50294,6189,2020-11-18T16:16:25.1057249Z,2015,536,16,426,296,0,0,0,240,0,0,520,110,0,536,0,1,0
50294,6190,2020-11-18T16:16:25.1067258Z,2016,718,57,328,380,0,2,2,338,0,0,661,390,0,716,0,2,0
50294,6191,2020-11-18T16:16:25.1067258Z,2017,693,60,582,366,0,1,1,327,0,0,633,111,0,690,0,1,2
50294,6192,2020-11-18T16:16:25.1067258Z,2018,618,68,496,310,0,1,2,308,0,0,550,122,0,616,17,1,1
50294,6193,2020-11-18T16:16:25.1067258Z,2019,566,57,455,296,0,2,1,270,0,0,509,111,0,564,21,1,0
50294,6194,2020-11-18T16:16:25.1067258Z,2020,531,82,420,256,0,2,1,275,0,0,449,111,0,529,21,2,0
32573,31778,2021-06-24T05:35:16.8549029Z,2021,143,41,126,66,0,3,0,77,0,0,102,17,0,140,0,0,0
32573,3921,2020-11-18T16:16:09.8825747Z,2012,219,66,178,112,0,1,0,107,0,0,153,41,0,218,0,0,0
32573,3922,2020-11-18T16:16:09.8825747Z,2013,184,62,155,86,0,2,0,98,0,0,122,29,0,182,0,1,0
32573,3923,2020-11-18T16:16:09.8835761Z,2014,148,50,121,67,0,4,0,81,0,0,98,27,0,144,0,2,0
32573,3924,2020-11-18T16:16:09.8835761Z,2015,144,48,126,62,0,4,0,82,0,0,96,18,1,139,0,1,0
32573,3925,2020-11-18T16:16:09.8835761Z,2016,95,42,77,39,0,2,0,56,0,0,53,18,1,92,0,1,0
32573,3926,2020-11-18T16:16:09.8845765Z,2017,114,49,100,49,0,5,0,65,0,0,65,14,1,108,0,2,0
32573,3927,2020-11-18T16:16:09.8845765Z,2018,123,46,116,46,0,2,5,77,0,0,77,7,1,120,1,1,0
32573,3928,2020-11-18T16:16:09.885577Z,2019,190,56,175,81,0,2,2,109,0,0,134,15,1,187,1,0,0
32573,3929,2020-11-18T16:16:09.885577Z,2020,167,54,151,74,0,2,0,93,0,0,113,16,0,165,0,0,0
69054,31993,2021-06-24T05:35:20.3193867Z,2021,518,221,438,208,0,1,14,310,0,0,297,80,0,515,0,0,2
69054,9312,2020-11-18T16:16:47.3805796Z,2012,522,128,364,275,0,1,0,247,0,0,394,158,11,508,0,0,2
69054,9313,2020-11-18T16:16:47.3815801Z,2013,473,133,362,245,0,1,0,228,0,0,340,111,7,463,0,1,2
69054,9314,2020-11-18T16:16:47.3815801Z,2014,440,112,320,233,0,1,0,207,0,0,328,120,6,429,0,5,4
69054,9315,2020-11-18T16:16:47.3815801Z,2015,432,99,278,216,0,6,0,216,0,0,333,154,5,417,0,5,4
69054,9316,2020-11-18T16:16:47.3815801Z,2016,370,103,251,180,0,3,0,190,0,0,267,119,1,362,0,3,4
69054,9317,2020-11-18T16:16:47.3825805Z,2017,373,119,281,181,0,4,0,192,0,0,254,92,0,365,0,4,4
69054,9318,2020-11-18T16:16:47.3825805Z,2018,229,76,162,104,0,2,0,125,0,0,153,67,0,227,0,0,0
69054,9319,2020-11-18T16:16:47.3825805Z,2019,485,214,401,208,0,10,14,277,0,0,271,84,0,473,0,0,2
69054,9320,2020-11-18T16:16:47.3825805Z,2020,546,245,459,228,0,2,8,318,0,0,301,87,0,542,0,0,2
56226,25919,2021-06-24T05:35:12.8110034Z,2021,612,194,500,268,0,7,0,344,0,0,418,112,0,605,10,1,0
56226,7586,2020-11-18T16:16:34.5610297Z,2012,682,0,484,325,0,2,0,357,0,0,682,198,0,679,0,0,1
56226,7587,2020-11-18T16:16:34.5610297Z,2013,751,1,540,361,0,2,0,390,0,0,750,211,0,748,0,4,1
56226,7588,2020-11-18T16:16:34.5620302Z,2014,729,51,513,357,0,2,0,372,0,0,678,216,0,726,0,3,1
56226,7589,2020-11-18T16:16:34.5620302Z,2015,669,44,474,318,0,5,0,351,0,0,625,195,0,664,0,5,0
56226,7590,2020-11-18T16:16:34.5620302Z,2016,581,108,260,284,0,2,1,297,0,0,473,321,0,579,0,3,0
56226,7591,2020-11-18T16:16:34.5630315Z,2017,523,127,396,246,0,4,1,277,0,0,396,127,0,519,0,1,0
56226,7592,2020-11-18T16:16:34.5630315Z,2018,624,151,454,277,0,4,36,347,0,0,473,170,0,620,0,0,0
56226,7593,2020-11-18T16:16:34.5630315Z,2019,624,140,473,269,0,3,2,355,0,0,484,151,0,621,4,1,0
56226,7594,2020-11-18T16:16:34.564031Z,2020,607,185,486,285,0,4,10,322,0,0,422,121,0,603,12,1,0
20800,1939,2020-11-18T16:15:58.4959816Z,2012,456,0,328,252,0,6,0,204,0,0,456,128,0,450,0,0,0
20800,1940,2020-11-18T16:15:58.4969821Z,2013,368,9,278,195,0,7,0,173,0,0,359,90,0,360,0,2,1
20800,1941,2020-11-18T16:15:58.4969821Z,2014,370,40,291,180,0,10,0,190,0,0,330,79,0,360,0,0,0
20800,1942,2020-11-18T16:15:58.4969821Z,2015,362,37,286,168,0,13,0,194,0,0,325,76,0,349,0,1,0
20800,1943,2020-11-18T16:15:58.4969821Z,2016,366,75,302,164,0,11,2,202,0,0,291,64,0,355,0,1,0
20800,1944,2020-11-18T16:15:58.4969821Z,2017,547,148,465,269,0,13,3,278,0,0,399,82,0,534,0,2,0
20800,1945,2020-11-18T16:15:58.4979816Z,2018,491,142,403,261,0,11,1,230,0,0,349,88,0,480,0,0,0
20800,1946,2020-11-18T16:15:58.4979816Z,2019,453,141,369,244,0,12,3,209,0,0,312,84,0,441,0,0,0
20800,1947,2020-11-18T16:15:58.4979816Z,2020,499,197,401,262,0,14,0,237,0,0,302,98,1,482,0,1,2
20800,31701,2021-06-24T05:35:15.3328099Z,2021,497,229,398,252,0,9,1,245,0,0,268,99,1,485,1,1,2
42176,25829,2021-06-24T05:35:10.9246502Z,2021,372,140,328,199,0,6,0,173,0,0,232,44,0,365,0,1,1
42176,5157,2020-11-18T16:16:17.8178626Z,2012,339,33,289,185,0,3,0,154,0,0,306,50,0,336,0,0,0
42176,5158,2020-11-18T16:16:17.8178626Z,2013,210,30,171,117,0,4,0,93,0,0,180,39,0,206,0,2,0
42176,5159,2020-11-18T16:16:17.8188639Z,2014,273,56,238,144,0,7,0,129,0,0,217,35,0,266,0,7,0
42176,5160,2020-11-18T16:16:17.8188639Z,2015,226,50,193,112,0,7,0,114,0,0,176,33,0,219,0,4,0
42176,5161,2020-11-18T16:16:17.8188639Z,2016,155,50,154,71,0,2,1,84,0,0,105,1,0,153,0,0,0
42176,5162,2020-11-18T16:16:17.8198644Z,2017,147,43,134,69,0,1,1,78,0,0,104,13,0,146,0,1,0
42176,5163,2020-11-18T16:16:17.8198644Z,2018,359,118,335,191,0,6,1,168,0,0,241,24,0,353,0,1,0
42176,5164,2020-11-18T16:16:17.8198644Z,2019,399,152,357,205,0,9,0,194,0,0,247,42,0,390,0,0,0
42176,5165,2020-11-18T16:16:17.8198644Z,2020,379,145,345,204,0,7,0,175,0,0,234,34,0,370,0,1,2
40121,25814,2021-06-24T05:35:10.9076382Z,2021,140,37,120,61,0,2,0,79,0,0,103,20,0,138,1,0,0
40121,4628,2020-11-18T16:16:14.3955832Z,2012,169,55,131,77,0,0,0,92,0,0,114,38,0,169,0,0,0
40121,4629,2020-11-18T16:16:14.3965832Z,2013,185,57,131,87,0,1,0,98,0,0,128,54,0,184,0,1,0
40121,4630,2020-11-18T16:16:14.3965832Z,2014,164,55,128,74,0,0,0,90,0,0,109,36,0,164,0,1,0
40121,4631,2020-11-18T16:16:14.3965832Z,2015,162,56,131,75,0,0,0,87,0,0,106,31,0,162,0,0,0
40121,4632,2020-11-18T16:16:14.3965832Z,2016,157,49,42,80,0,0,0,77,0,0,108,115,1,156,0,1,0
40121,4633,2020-11-18T16:16:14.3975845Z,2017,169,52,132,79,0,2,0,90,0,0,117,37,0,167,0,1,0
40121,4634,2020-11-18T16:16:14.3975845Z,2018,146,45,107,65,0,5,0,81,0,0,101,39,0,141,1,0,0
40121,4635,2020-11-18T16:16:14.3975845Z,2019,104,30,80,46,0,3,0,58,0,2,74,24,0,101,1,0,0
40121,4636,2020-11-18T16:16:14.3975845Z,2020,116,33,92,45,0,3,0,71,0,0,83,24,0,113,1,0,0
24752,25721,2021-06-24T05:35:08.6710337Z,2021,215,60,183,98,0,6,0,117,0,0,155,32,0,209,2,0,0
24752,2674,2020-11-18T16:16:02.5306697Z,2012,316,38,236,146,0,6,0,170,0,0,278,80,0,309,0,0,1
24752,2675,2020-11-18T16:16:02.5306697Z,2013,353,51,288,183,0,18,0,170,0,0,302,65,0,334,0,1,1
24752,2676,2020-11-18T16:16:02.5316714Z,2014,355,66,282,177,0,28,0,178,0,0,289,73,0,327,0,0,0
24752,2677,2020-11-18T16:16:02.5316714Z,2015,380,82,317,192,0,25,0,188,0,0,298,63,0,355,0,1,0
24752,2678,2020-11-18T16:16:02.5316714Z,2016,339,80,270,161,0,10,0,178,0,0,259,69,0,329,0,1,0
24752,2679,2020-11-18T16:16:02.5316714Z,2017,342,86,264,162,0,7,1,180,0,0,256,78,0,335,0,2,0
24752,2680,2020-11-18T16:16:02.5316714Z,2018,292,73,219,144,0,4,8,148,0,1,219,73,0,286,0,2,2
24752,2681,2020-11-18T16:16:02.532671Z,2019,224,63,168,107,0,4,21,117,0,0,161,56,0,219,0,0,1
24752,2682,2020-11-18T16:16:02.532671Z,2020,208,62,154,102,0,2,8,106,0,0,146,54,0,206,1,0,0
61671,31955,2021-06-24T05:35:20.2403298Z,2021,186,31,122,133,0,5,0,53,0,0,155,64,0,180,1,0,1
61671,8363,2020-11-18T16:16:39.7925168Z,2012,227,11,133,177,0,12,0,50,0,0,216,94,0,214,0,0,1
61671,8364,2020-11-18T16:16:39.7935177Z,2013,208,15,115,160,0,10,0,48,0,0,193,93,0,198,0,0,0
61671,8365,2020-11-18T16:16:39.7935177Z,2014,200,19,105,156,0,9,0,44,0,0,181,95,0,191,0,0,0
61671,8366,2020-11-18T16:16:39.7935177Z,2015,223,20,124,177,0,12,0,46,0,0,203,99,0,210,0,0,1
61671,8367,2020-11-18T16:16:39.7935177Z,2016,221,23,131,167,0,13,2,54,0,0,198,90,0,207,0,0,1
61671,8368,2020-11-18T16:16:39.7945181Z,2017,210,27,130,167,0,12,0,43,0,0,183,80,0,197,0,0,1
61671,8369,2020-11-18T16:16:39.7945181Z,2018,212,25,136,168,0,8,0,44,0,0,187,76,0,203,0,0,1
61671,8370,2020-11-18T16:16:39.7945181Z,2019,193,25,125,152,0,3,0,41,0,0,168,68,0,189,0,0,1
61671,8371,2020-11-18T16:16:39.7945181Z,2020,188,28,105,141,0,3,0,47,0,0,160,83,0,184,1,0,1
71399,10216,2020-11-18T16:16:53.7128026Z,2012,288,85,262,136,0,8,0,152,0,0,203,26,0,280,0,0,0
71399,10217,2020-11-18T16:16:53.7138026Z,2013,312,96,232,150,0,6,0,162,0,0,216,80,0,306,0,3,0
71399,10218,2020-11-18T16:16:53.7138026Z,2014,336,99,282,163,0,4,0,173,0,0,237,54,0,332,0,1,0
71399,10219,2020-11-18T16:16:53.7138026Z,2015,350,113,299,163,0,4,0,187,0,0,237,51,0,346,0,1,0
71399,10220,2020-11-18T16:16:53.714804Z,2016,348,109,274,172,0,8,0,176,0,0,239,74,0,340,0,2,0
71399,10221,2020-11-18T16:16:53.714804Z,2017,348,124,301,171,0,9,0,177,0,0,224,47,0,339,0,2,0
71399,10222,2020-11-18T16:16:53.714804Z,2018,375,122,324,176,0,8,0,199,0,0,253,51,0,367,0,1,0
71399,10223,2020-11-18T16:16:53.7158062Z,2019,332,118,286,155,0,7,15,177,0,0,214,46,0,325,0,1,0
71399,10224,2020-11-18T16:16:53.7158062Z,2020,313,114,260,144,0,6,16,169,0,0,199,53,0,307,0,1,0
71399,25669,2021-06-24T05:35:04.7392146Z,2021,266,97,237,123,0,4,19,143,0,0,169,29,0,262,0,0,0
58131,25929,2021-06-24T05:35:12.8280154Z,2021,239,96,205,119,0,2,0,120,0,0,143,34,1,235,0,1,1
58131,7816,2020-11-18T16:16:36.3492236Z,2012,421,133,360,196,0,2,0,225,0,0,288,61,0,419,0,0,0
58131,7817,2020-11-18T16:16:36.3492236Z,2013,392,124,336,189,0,1,0,203,0,0,268,56,0,391,0,0,0
58131,7818,2020-11-18T16:16:36.3502236Z,2014,382,120,292,188,0,0,0,194,0,0,262,90,0,382,0,1,0
58131,7819,2020-11-18T16:16:36.3502236Z,2015,366,111,274,179,0,0,0,187,0,0,255,92,0,366,0,3,0
58131,7820,2020-11-18T16:16:36.3502236Z,2016,363,114,67,177,0,9,0,186,0,0,249,296,0,354,0,3,0
58131,7821,2020-11-18T16:16:36.3502236Z,2017,316,112,221,161,0,9,0,155,0,0,204,95,0,307,0,2,0
58131,7822,2020-11-18T16:16:36.3502236Z,2018,267,100,196,121,0,8,0,146,0,0,167,71,0,259,2,2,0
58131,7823,2020-11-18T16:16:36.3502236Z,2019,244,105,196,114,0,3,0,130,0,0,139,48,0,240,0,1,1
58131,7824,2020-11-18T16:16:36.351224Z,2020,218,95,183,107,0,2,0,111,0,0,123,35,0,215,0,1,1
24661,25720,2021-06-24T05:35:08.6720342Z,2021,221,76,188,97,0,0,1,124,0,0,145,33,0,221,0,1,0
24661,2638,2020-11-18T16:16:02.5116567Z,2012,282,74,235,124,0,2,0,158,0,0,208,47,0,280,0,0,0
24661,2639,2020-11-18T16:16:02.5116567Z,2013,274,84,226,130,0,1,0,144,0,0,190,48,0,273,0,4,0
24661,2640,2020-11-18T16:16:02.5116567Z,2014,231,81,194,113,0,3,0,118,0,0,150,37,0,228,0,3,0
24661,2641,2020-11-18T16:16:02.5126576Z,2015,200,75,175,85,0,3,0,115,0,0,125,25,0,197,0,3,0
24661,2642,2020-11-18T16:16:02.5126576Z,2016,154,65,129,72,0,3,8,82,0,0,89,25,0,151,0,1,0
24661,2643,2020-11-18T16:16:02.5126576Z,2017,100,55,87,43,0,2,0,57,0,0,45,13,0,98,0,2,0
24661,2644,2020-11-18T16:16:02.5126576Z,2018,217,75,186,92,0,5,0,125,0,0,142,31,1,211,0,2,0
24661,2645,2020-11-18T16:16:02.5126576Z,2019,248,87,215,122,0,0,0,126,0,0,161,33,0,248,0,2,0
24661,2646,2020-11-18T16:16:02.5136581Z,2020,241,95,216,102,0,1,1,139,0,0,146,25,2,237,0,1,1
70680,25658,2021-06-24T05:35:04.7342113Z,2021,116,41,91,54,0,1,2,62,0,0,75,25,0,115,2,0,0
70680,9849,2020-11-18T16:16:50.8789098Z,2012,358,90,283,182,0,1,0,176,0,0,268,75,0,357,0,0,0
70680,9850,2020-11-18T16:16:50.8789098Z,2013,353,104,278,172,0,0,0,181,0,0,249,75,0,353,0,0,0
70680,9851,2020-11-18T16:16:50.8789098Z,2014,333,94,240,174,0,0,0,159,0,0,239,93,0,333,0,0,0
70680,9852,2020-11-18T16:16:50.8799112Z,2015,309,85,243,163,0,0,0,146,0,0,224,66,0,309,0,0,0
70680,9853,2020-11-18T16:16:50.8799112Z,2016,258,77,180,115,0,2,0,143,0,0,181,78,0,256,0,1,0
70680,9854,2020-11-18T16:16:50.8799112Z,2017,197,72,145,90,0,0,0,107,0,0,125,52,0,197,0,0,0
70680,9855,2020-11-18T16:16:50.8799112Z,2018,188,63,143,94,0,0,33,94,0,0,125,45,0,188,5,0,0
70680,9856,2020-11-18T16:16:50.8799112Z,2019,163,62,124,80,0,0,1,83,0,0,101,39,0,163,6,0,0
70680,9857,2020-11-18T16:16:50.8809116Z,2020,150,50,112,71,0,1,3,79,0,0,100,38,0,149,5,0,0
20719,1888,2020-11-18T16:15:57.8815698Z,2012,227,47,135,108,0,7,0,119,0,0,180,92,0,220,0,0,0
20719,1889,2020-11-18T16:15:57.8815698Z,2013,244,56,132,121,0,7,0,123,0,0,188,112,0,236,0,12,1
20719,1890,2020-11-18T16:15:57.8815698Z,2014,221,60,119,103,0,0,0,118,0,0,161,102,0,221,0,4,0
20719,1891,2020-11-18T16:15:57.8825716Z,2015,239,65,117,121,0,3,0,118,0,0,174,122,0,236,0,11,0
20719,1892,2020-11-18T16:15:57.8825716Z,2016,229,68,80,122,0,7,8,107,0,0,161,149,0,222,0,13,0
20719,1893,2020-11-18T16:15:57.8825716Z,2017,234,60,143,118,0,7,11,116,0,0,174,91,0,227,0,16,0
20719,1894,2020-11-18T16:15:57.8825716Z,2018,215,44,112,102,0,6,14,113,0,0,171,103,0,209,1,8,0
20719,1895,2020-11-18T16:15:57.8825716Z,2019,215,46,136,102,0,1,5,113,0,0,169,79,0,214,1,4,0
20719,1896,2020-11-18T16:15:57.8835739Z,2020,213,46,128,101,0,2,8,112,0,0,167,85,0,211,0,3,0
20719,25697,2021-06-24T05:35:08.6580246Z,2021,204,41,136,91,0,1,10,113,0,0,163,68,0,203,0,3,0
71548,10321,2020-11-18T16:16:54.3131991Z,2012,253,97,229,112,0,4,0,141,0,0,156,24,0,249,0,0,0
71548,10322,2020-11-18T16:16:54.3131991Z,2013,228,91,177,104,0,5,0,124,0,0,137,51,0,223,0,8,0
71548,10323,2020-11-18T16:16:54.3142Z,2014,230,93,196,107,0,4,0,123,0,0,137,34,0,226,0,2,0
71548,10324,2020-11-18T16:16:54.3142Z,2015,220,96,172,109,0,6,0,111,0,0,124,48,0,214,0,0,0
71548,10325,2020-11-18T16:16:54.3142Z,2016,209,85,137,98,0,5,10,111,0,0,124,72,1,203,0,1,0
71548,10326,2020-11-18T16:16:54.3142Z,2017,197,81,174,99,0,4,5,98,0,0,116,23,1,192,0,2,0
71548,10327,2020-11-18T16:16:54.3142Z,2018,174,60,160,84,4,6,3,90,0,0,114,14,0,168,0,1,0
71548,10328,2020-11-18T16:16:54.3142Z,2019,151,53,113,79,4,4,1,72,0,0,98,38,0,147,0,1,0
71548,10329,2020-11-18T16:16:54.3152004Z,2020,157,54,139,86,0,4,0,71,0,0,103,18,0,153,0,1,0
71548,31674,2021-06-24T05:35:15.2777716Z,2021,146,51,136,76,0,2,0,70,0,0,95,10,0,144,0,0,0
57000,25921,2021-06-24T05:35:12.8140045Z,2021,313,102,253,155,0,0,4,158,0,0,211,60,0,313,7,2,0
57000,7631,2020-11-18T16:16:35.0783742Z,2012,481,39,350,249,0,5,0,232,0,0,442,131,0,476,0,0,0
57000,7632,2020-11-18T16:16:35.0793746Z,2013,412,61,319,213,0,6,0,199,0,0,351,93,0,406,0,2,0
57000,7633,2020-11-18T16:16:35.0793746Z,2014,386,73,290,186,0,6,0,200,0,0,313,96,0,380,0,3,0
57000,7634,2020-11-18T16:16:35.0793746Z,2015,374,89,294,172,0,6,0,202,0,0,285,80,0,368,0,2,0
57000,7635,2020-11-18T16:16:35.080376Z,2016,377,112,298,157,0,4,2,220,0,0,265,79,0,373,0,1,0
57000,7636,2020-11-18T16:16:35.080376Z,2017,419,117,317,191,0,0,3,228,0,0,302,102,0,419,0,0,0
57000,7637,2020-11-18T16:16:35.080376Z,2018,412,116,320,196,0,2,6,216,0,0,296,92,0,410,8,2,0
57000,7638,2020-11-18T16:16:35.0813764Z,2019,421,129,320,194,0,1,0,227,0,0,292,101,0,420,12,1,0
57000,7639,2020-11-18T16:16:35.0813764Z,2020,376,131,281,172,0,0,2,204,0,0,245,95,0,376,10,2,0
71373,10198,2020-11-18T16:16:53.2905217Z,2012,565,117,493,282,0,19,0,283,0,0,448,72,0,546,0,0,0
71373,10199,2020-11-18T16:16:53.2905217Z,2013,488,135,427,220,0,14,0,268,0,0,353,61,0,472,0,3,2
71373,10200,2020-11-18T16:16:53.2905217Z,2014,413,125,362,184,0,10,0,229,0,0,288,51,0,403,0,3,0
71373,10201,2020-11-18T16:16:53.7067982Z,2015,341,104,301,164,0,8,0,177,0,0,237,40,0,332,0,1,1
71373,10202,2020-11-18T16:16:53.7067982Z,2016,304,110,268,148,0,3,1,156,0,0,194,36,0,301,0,0,0
71373,10203,2020-11-18T16:16:53.7067982Z,2017,317,109,271,143,0,4,4,174,0,0,208,46,0,313,0,0,0
71373,10204,2020-11-18T16:16:53.7067982Z,2018,335,122,286,152,1,5,3,183,0,0,213,49,0,330,0,0,0
71373,10205,2020-11-18T16:16:53.7077996Z,2019,291,123,248,141,0,3,2,150,0,0,168,43,0,288,0,0,0
71373,10206,2020-11-18T16:16:53.7077996Z,2020,250,94,222,129,0,4,5,121,0,0,156,28,0,246,0,0,0
71373,25668,2021-06-24T05:35:04.7342113Z,2021,231,94,211,125,0,3,0,106,0,0,137,20,0,228,0,1,0
52894,31745,2021-06-24T05:35:15.4138701Z,2021,163,46,144,83,0,1,9,80,0,0,117,19,0,162,0,0,0
52894,7050,2020-11-18T16:16:31.316868Z,2012,211,41,162,115,0,2,0,96,0,0,170,49,0,209,0,0,0
52894,7051,2020-11-18T16:16:31.316868Z,2013,207,53,161,106,0,7,0,101,0,0,154,46,0,200,0,0,0
52894,7052,2020-11-18T16:16:31.316868Z,2014,201,57,149,110,0,6,0,91,0,0,144,52,0,195,0,0,0
52894,7053,2020-11-18T16:16:31.316868Z,2015,215,60,164,110,0,7,0,105,0,0,155,51,0,208,0,2,0
52894,7054,2020-11-18T16:16:31.3178684Z,2016,146,48,108,73,0,3,4,73,0,0,98,38,0,143,0,1,0
52894,7055,2020-11-18T16:16:31.3178684Z,2017,140,54,113,67,0,1,8,73,0,0,86,27,0,139,0,1,0
52894,7056,2020-11-18T16:16:31.3178684Z,2018,137,44,116,68,0,0,0,69,0,0,93,21,0,137,2,1,0
52894,7057,2020-11-18T16:16:31.3178684Z,2019,202,68,175,95,0,0,3,107,0,0,134,27,0,202,0,2,0
52894,7058,2020-11-18T16:16:31.3178684Z,2020,178,53,144,89,0,0,5,89,0,0,125,34,0,178,0,1,0
18267,1557,2020-11-18T16:15:55.3688983Z,2012,288,72,263,137,0,3,0,151,0,0,216,25,0,285,0,0,0
18267,1558,2020-11-18T16:15:55.3698992Z,2013,332,95,298,155,0,6,0,177,0,0,237,34,0,325,0,3,1
18267,1559,2020-11-18T16:15:55.3708996Z,2014,390,104,338,194,0,6,0,196,0,0,286,52,0,383,0,2,1
18267,1560,2020-11-18T16:15:55.3708996Z,2015,443,107,403,217,0,9,0,226,0,0,336,40,0,434,0,1,0
18267,1561,2020-11-18T16:15:55.3708996Z,2016,413,109,364,196,0,9,9,217,0,0,304,49,0,404,0,0,0
18267,1562,2020-11-18T16:15:55.3719005Z,2017,446,120,388,224,0,2,15,222,0,0,326,58,0,444,0,0,0
18267,1563,2020-11-18T16:15:55.3719005Z,2018,484,116,417,254,0,4,20,230,0,0,368,67,0,480,0,0,0
18267,1564,2020-11-18T16:15:55.3719005Z,2019,589,176,521,315,0,8,44,274,0,1,413,68,0,581,0,1,0
18267,1565,2020-11-18T16:15:55.3719005Z,2020,545,169,487,274,0,6,0,271,0,0,376,58,0,539,0,0,0
18267,31618,2021-06-24T05:35:14.6162971Z,2021,527,175,450,278,0,3,15,249,0,0,352,77,1,523,0,0,0
43018,25836,2021-06-24T05:35:10.9426635Z,2021,234,87,218,117,0,10,0,117,0,0,147,16,0,224,0,0,0
43018,5418,2020-11-18T16:16:19.7741692Z,2012,384,151,323,177,0,6,0,207,0,0,233,61,7,370,0,0,1
43018,5419,2020-11-18T16:16:19.7751696Z,2013,364,136,289,165,0,2,0,199,0,0,228,75,7,355,0,9,0
43018,5420,2020-11-18T16:16:19.7751696Z,2014,320,129,267,148,0,0,0,172,0,0,191,53,8,312,0,13,0
43018,5421,2020-11-18T16:16:19.7751696Z,2015,245,109,196,117,0,0,0,128,0,0,136,49,4,241,0,7,0
43018,5422,2020-11-18T16:16:19.7751696Z,2016,258,121,149,110,0,1,0,148,0,0,137,109,3,254,0,4,0
43018,5423,2020-11-18T16:16:19.7751696Z,2017,202,87,166,92,0,0,2,110,0,0,115,36,3,199,0,1,0
43018,5424,2020-11-18T16:16:19.7761705Z,2018,166,73,145,77,0,0,1,89,0,0,93,21,3,163,0,0,0
43018,5425,2020-11-18T16:16:19.7761705Z,2019,278,132,256,141,0,1,6,137,0,0,146,22,2,275,0,1,0
43018,5426,2020-11-18T16:16:19.7761705Z,2020,278,122,254,138,0,5,4,140,0,0,156,24,1,272,0,0,0
50500,25875,2021-06-24T05:35:11.0577449Z,2021,300,126,257,142,0,9,0,158,0,0,174,43,0,291,3,0,0
50500,6222,2020-11-18T16:16:25.5009896Z,2012,337,94,274,171,0,7,0,166,0,0,243,63,8,322,0,0,0
50500,6223,2020-11-18T16:16:25.5009896Z,2013,326,99,243,164,0,9,0,162,0,0,227,83,7,310,0,3,0
50500,6224,2020-11-18T16:16:25.5009896Z,2014,352,106,304,184,0,15,0,168,0,0,246,48,3,334,0,3,0
50500,6225,2020-11-18T16:16:25.5009896Z,2015,330,101,273,161,0,14,0,169,0,0,229,57,0,316,0,5,0
50500,6226,2020-11-18T16:16:25.5019896Z,2016,342,111,293,175,0,9,0,167,0,0,231,49,0,333,0,1,0
50500,6227,2020-11-18T16:16:25.5019896Z,2017,362,117,306,188,0,8,0,174,0,0,245,56,0,354,0,1,0
50500,6228,2020-11-18T16:16:25.5019896Z,2018,353,105,289,177,0,7,0,176,0,0,248,64,0,346,1,1,0
50500,6229,2020-11-18T16:16:25.5019896Z,2019,411,159,329,196,0,6,17,215,0,0,252,82,0,405,3,1,0
50500,6230,2020-11-18T16:16:25.5019896Z,2020,355,147,292,167,0,5,0,188,0,0,208,63,0,350,3,0,0
71522,10303,2020-11-18T16:16:54.3081964Z,2012,369,101,340,189,0,9,0,180,0,0,268,29,0,360,0,0,0
71522,10304,2020-11-18T16:16:54.3081964Z,2013,343,104,305,165,0,11,0,178,0,0,239,38,0,332,0,3,0
71522,10305,2020-11-18T16:16:54.3091973Z,2014,325,99,297,157,0,8,0,168,0,0,226,28,0,317,0,3,0
71522,10306,2020-11-18T16:16:54.3091973Z,2015,300,98,261,136,0,5,0,164,0,0,202,39,0,295,0,1,0
71522,10307,2020-11-18T16:16:54.3091973Z,2016,223,66,157,108,0,6,1,115,0,0,157,66,0,217,0,1,0
71522,10308,2020-11-18T16:16:54.3091973Z,2017,189,66,175,92,0,4,0,97,0,0,123,14,0,185,0,0,0
71522,10309,2020-11-18T16:16:54.3091973Z,2018,174,64,154,84,0,2,14,90,0,0,110,20,0,172,0,0,0
71522,10310,2020-11-18T16:16:54.3101973Z,2019,157,69,139,73,0,4,4,84,0,0,88,18,0,153,0,0,0
71522,10311,2020-11-18T16:16:54.3101973Z,2020,188,73,167,84,0,5,0,104,0,0,115,21,0,183,0,0,0
71522,31673,2021-06-24T05:35:15.2767711Z,2021,201,62,185,87,0,3,0,114,0,0,139,16,0,198,0,0,0
50757,31879,2021-06-24T05:35:18.4530482Z,2021,253,85,194,118,0,1,15,135,0,0,168,59,0,252,1,1,0
50757,6326,2020-11-18T16:16:26.270503Z,2012,334,62,266,164,0,2,0,170,0,0,272,68,0,332,0,0,0
50757,6327,2020-11-18T16:16:26.2715034Z,2013,380,74,307,182,0,2,0,198,0,0,306,73,0,378,0,8,0
50757,6328,2020-11-18T16:16:26.2715034Z,2014,404,85,307,193,0,6,0,211,0,0,319,97,0,398,0,9,0
50757,6329,2020-11-18T16:16:26.2715034Z,2015,395,84,311,188,0,4,0,207,0,0,311,84,0,391,0,7,0
50757,6330,2020-11-18T16:16:26.2725052Z,2016,367,82,228,181,0,4,0,186,0,0,285,139,0,363,0,7,0
50757,6331,2020-11-18T16:16:26.2725052Z,2017,491,126,360,237,0,3,0,254,0,0,365,131,0,487,0,8,1
50757,6332,2020-11-18T16:16:26.2725052Z,2018,446,121,317,210,0,2,0,236,0,0,325,129,0,444,2,6,0
50757,6333,2020-11-18T16:16:26.2725052Z,2019,450,142,340,206,0,1,0,244,0,1,308,110,0,449,1,8,0
50757,6334,2020-11-18T16:16:26.2735052Z,2020,437,141,329,204,0,3,56,233,0,0,296,108,0,434,1,4,0
14357,1053,2020-11-18T16:15:52.4999821Z,2012,444,0,343,252,0,12,0,192,0,0,444,101,1,431,0,0,0
14357,1054,2020-11-18T16:15:52.4999821Z,2013,496,3,383,250,0,17,0,246,0,0,493,113,0,479,0,1,0
14357,1055,2020-11-18T16:15:52.5009821Z,2014,508,26,398,260,0,10,0,248,0,0,482,110,0,498,0,0,0
14357,1056,2020-11-18T16:15:52.5009821Z,2015,498,16,374,249,0,5,0,249,0,0,482,124,0,493,0,1,0
14357,1057,2020-11-18T16:15:52.5009821Z,2016,568,63,402,285,0,8,0,283,0,0,505,166,0,560,0,1,0
14357,1058,2020-11-18T16:15:52.5009821Z,2017,520,63,358,279,0,6,0,241,0,0,457,162,0,514,0,0,0
14357,1059,2020-11-18T16:15:52.5019829Z,2018,478,52,340,263,0,6,0,215,0,0,426,138,0,472,8,0,0
14357,1060,2020-11-18T16:15:52.5019829Z,2019,449,57,301,235,0,3,0,214,0,1,392,148,0,446,12,0,0
14357,1061,2020-11-18T16:15:52.5019829Z,2020,472,85,334,236,0,6,0,236,0,0,387,138,0,466,15,0,0
14357,25638,2021-06-24T05:35:04.6941826Z,2021,513,109,401,235,0,5,0,278,0,0,404,112,0,508,13,0,0
71092,10056,2020-11-18T16:16:52.582048Z,2012,660,0,451,339,0,22,0,321,0,0,660,209,1,637,0,0,0
71092,10057,2020-11-18T16:16:52.582048Z,2013,653,8,473,329,0,10,0,324,0,0,645,180,1,639,0,2,3
71092,10058,2020-11-18T16:16:52.582048Z,2014,697,70,521,373,0,9,0,324,0,0,627,176,2,682,0,2,4
71092,10059,2020-11-18T16:16:52.582048Z,2015,743,71,536,404,0,8,0,339,0,0,672,207,1,730,0,4,4
71092,10060,2020-11-18T16:16:52.5830484Z,2016,757,115,364,433,0,10,0,324,0,0,642,393,0,746,0,7,1
71092,10061,2020-11-18T16:16:52.5830484Z,2017,742,114,544,402,0,15,3,340,0,0,628,198,0,727,0,4,0
71092,10062,2020-11-18T16:16:52.5830484Z,2018,882,168,650,448,0,5,21,434,0,0,714,232,0,877,0,0,0
71092,10063,2020-11-18T16:16:52.5830484Z,2019,846,169,666,420,0,8,35,426,0,0,677,180,0,834,0,1,4
71092,10064,2020-11-18T16:16:52.5840493Z,2020,810,240,654,413,0,6,20,397,0,0,570,156,0,799,1,0,5
71092,31620,2021-06-24T05:35:14.619299Z,2021,749,224,567,397,0,7,28,352,0,0,525,182,1,739,0,2,2
34207,25786,2021-06-24T05:35:10.8596037Z,2021,179,56,159,92,0,4,0,87,0,0,123,20,1,174,0,1,0
34207,4146,2020-11-18T16:16:11.0233363Z,2012,411,59,359,183,0,25,0,228,0,0,352,52,2,384,0,0,0
34207,4147,2020-11-18T16:16:11.0243372Z,2013,433,84,399,193,0,23,0,240,0,0,349,34,1,408,0,2,1
34207,4148,2020-11-18T16:16:11.0243372Z,2014,409,95,376,187,0,24,0,222,0,0,314,33,0,385,0,1,0
34207,4149,2020-11-18T16:16:11.0243372Z,2015,376,84,339,180,0,24,0,196,0,0,292,37,1,351,0,0,0
34207,4150,2020-11-18T16:16:11.0243372Z,2016,292,80,212,139,0,16,3,153,0,0,212,80,1,275,0,1,0
34207,4151,2020-11-18T16:16:11.0243372Z,2017,289,80,272,134,0,20,2,155,0,0,209,17,1,268,0,2,0
34207,4152,2020-11-18T16:16:11.025339Z,2018,255,72,232,125,0,10,1,130,0,0,183,23,1,244,0,2,0
34207,4153,2020-11-18T16:16:11.025339Z,2019,245,84,228,127,0,7,0,118,0,0,161,17,0,238,0,0,0
34207,4154,2020-11-18T16:16:11.025339Z,2020,210,74,195,111,0,7,0,99,0,0,136,15,1,201,0,0,1
60343,31940,2021-06-24T05:35:18.5371085Z,2021,648,230,583,307,0,24,0,341,0,0,418,65,2,618,1,4,4
60343,7999,2020-11-18T16:16:37.1227396Z,2012,548,193,408,247,0,26,0,301,0,0,355,140,1,521,0,0,0
60343,8000,2020-11-18T16:16:37.1227396Z,2013,540,217,359,239,0,23,0,301,0,0,323,181,0,517,0,2,0
60343,8001,2020-11-18T16:16:37.5150021Z,2014,508,215,417,219,0,17,0,289,0,0,293,91,0,491,0,4,0
60343,8002,2020-11-18T16:16:37.516003Z,2015,510,193,442,220,0,20,0,290,0,0,317,68,0,490,0,10,0
60343,8003,2020-11-18T16:16:37.516003Z,2016,447,174,304,196,0,17,1,251,0,0,273,143,0,430,0,6,0
60343,8004,2020-11-18T16:16:37.516003Z,2017,599,208,430,282,0,15,0,317,0,0,391,169,0,583,0,5,1
60343,8005,2020-11-18T16:16:37.516003Z,2018,606,210,517,291,0,18,5,315,0,2,396,89,0,588,1,4,0
60343,8006,2020-11-18T16:16:37.5170034Z,2019,647,272,559,307,0,18,5,340,0,2,375,88,1,626,1,3,2
60343,8007,2020-11-18T16:16:37.5170034Z,2020,658,263,574,305,0,22,2,353,0,0,395,84,0,636,1,5,0
13318,31868,2021-06-24T05:35:18.4340348Z,2021,158,47,129,76,0,2,0,82,0,0,111,29,0,156,0,0,0
13318,959,2020-11-18T16:15:52.0416755Z,2012,293,23,230,133,0,0,0,160,0,0,270,63,0,293,0,0,0
13318,960,2020-11-18T16:15:52.0416755Z,2013,309,38,246,143,0,1,0,166,0,0,271,63,0,308,0,1,0
13318,961,2020-11-18T16:15:52.0416755Z,2014,237,44,186,107,0,1,0,130,0,0,193,51,0,236,0,0,0
13318,962,2020-11-18T16:15:52.0426786Z,2015,198,29,157,91,0,1,0,107,0,0,169,41,0,197,0,3,0
13318,963,2020-11-18T16:15:52.0426786Z,2016,156,29,128,75,0,3,0,81,0,0,127,28,0,153,0,4,0
13318,964,2020-11-18T16:15:52.0426786Z,2017,188,36,147,99,0,1,0,89,0,0,152,41,0,187,0,5,0
13318,965,2020-11-18T16:15:52.0426786Z,2018,191,35,144,95,0,1,9,96,0,0,156,47,0,190,0,3,0
13318,966,2020-11-18T16:15:52.0426786Z,2019,146,35,112,70,0,0,0,76,0,0,111,34,0,146,0,1,0
13318,967,2020-11-18T16:15:52.0436768Z,2020,151,47,114,73,0,0,0,78,0,0,104,37,0,151,0,2,0
18242,1540,2020-11-18T16:15:55.3638956Z,2012,587,1,388,267,0,0,0,320,0,0,586,199,1,586,0,0,0
18242,1541,2020-11-18T16:15:55.3638956Z,2013,617,3,394,303,0,0,0,314,0,0,614,223,1,616,0,5,0
18242,1542,2020-11-18T16:15:55.3648965Z,2014,651,30,450,330,0,1,0,321,0,0,621,201,0,650,0,4,0
18242,1543,2020-11-18T16:15:55.3648965Z,2015,604,30,400,324,0,2,0,280,0,0,574,204,0,602,0,2,0
18242,1544,2020-11-18T16:15:55.3648965Z,2016,723,110,489,386,0,3,2,337,0,0,613,234,0,719,0,1,1
18242,1545,2020-11-18T16:15:55.3658969Z,2017,620,95,423,321,0,1,0,299,0,0,525,197,0,619,0,1,0
18242,1546,2020-11-18T16:15:55.3658969Z,2018,505,83,336,253,0,0,5,252,0,0,422,169,0,505,6,2,0
18242,1547,2020-11-18T16:15:55.3658969Z,2019,434,76,308,237,0,0,7,197,0,0,358,126,0,434,6,1,0
18242,1548,2020-11-18T16:15:55.3668974Z,2020,441,80,327,240,0,1,0,201,0,0,361,114,0,440,9,0,0
18242,31641,2021-06-24T05:35:14.6553244Z,2021,396,88,300,208,0,0,3,188,0,0,308,96,0,396,8,0,0
57919,31929,2021-06-24T05:35:18.5281014Z,2021,731,186,616,376,0,7,0,355,0,0,545,115,0,724,1,2,0
57919,7766,2020-11-18T16:16:35.9129317Z,2012,779,1,568,392,0,6,0,387,0,0,778,211,0,772,0,0,1
57919,7767,2020-11-18T16:16:35.9129317Z,2013,727,3,548,410,0,12,0,317,0,0,724,179,0,713,0,6,2
57919,7768,2020-11-18T16:16:35.9139321Z,2014,685,23,510,369,0,12,0,316,0,0,662,175,0,671,0,6,2
57919,7769,2020-11-18T16:16:35.9139321Z,2015,666,41,509,373,0,11,0,293,0,0,625,157,0,654,0,7,1
57919,7770,2020-11-18T16:16:35.9139321Z,2016,656,77,258,344,0,6,0,312,0,0,579,398,0,649,0,0,1
57919,7771,2020-11-18T16:16:35.9139321Z,2017,676,97,522,364,0,2,0,312,0,0,579,154,0,672,0,0,2
57919,7772,2020-11-18T16:16:35.9149326Z,2018,700,114,530,340,0,4,1,360,0,0,586,170,0,694,0,1,2
57919,7773,2020-11-18T16:16:35.9149326Z,2019,743,133,583,376,0,4,1,367,0,0,610,160,0,738,0,2,1
57919,7774,2020-11-18T16:16:35.9149326Z,2020,740,194,595,369,0,5,19,371,0,0,546,145,0,734,0,2,1
75812,10879,2020-11-18T16:16:57.4222757Z,2012,201,1,151,108,0,2,0,93,0,0,200,50,0,199,0,0,0
75812,10880,2020-11-18T16:16:57.4232766Z,2013,344,6,245,184,0,3,0,160,0,0,338,99,0,341,0,0,0
75812,10881,2020-11-18T16:16:57.4232766Z,2014,398,44,311,217,0,6,0,181,0,0,354,87,1,390,0,0,1
75812,10882,2020-11-18T16:16:57.4232766Z,2015,392,45,317,189,0,10,0,203,0,0,347,75,1,381,0,0,0
75812,10883,2020-11-18T16:16:57.4232766Z,2016,398,81,65,204,0,10,0,194,0,0,317,333,0,388,0,0,0
75812,10884,2020-11-18T16:16:57.4242766Z,2017,376,79,305,185,0,8,0,191,0,0,297,71,0,368,0,0,0
75812,10885,2020-11-18T16:16:57.4242766Z,2018,404,76,317,204,0,9,0,200,0,0,328,87,0,395,2,0,0
75812,10886,2020-11-18T16:16:57.4242766Z,2019,365,87,300,176,0,8,1,189,0,0,278,65,0,357,0,0,0
75812,10887,2020-11-18T16:16:57.4242766Z,2020,349,101,295,175,0,7,0,174,0,0,248,54,0,342,0,0,0
75812,31999,2021-06-24T05:35:20.3213881Z,2021,374,124,333,206,0,6,0,168,0,0,250,41,0,367,0,0,1
54502,25909,2021-06-24T05:35:12.8029968Z,2021,274,85,225,159,0,0,0,115,0,0,189,49,0,274,0,0,0
54502,7381,2020-11-18T16:16:33.2501548Z,2012,428,121,352,215,0,4,0,213,0,0,307,76,1,423,0,0,0
54502,7382,2020-11-18T16:16:33.2511557Z,2013,426,116,340,207,0,2,0,219,0,0,310,86,0,424,0,3,0
54502,7383,2020-11-18T16:16:33.2511557Z,2014,419,113,284,206,0,1,0,213,0,0,306,135,0,418,0,3,0
54502,7384,2020-11-18T16:16:33.2511557Z,2015,380,104,298,177,0,0,0,203,0,0,276,82,0,380,0,2,0
54502,7385,2020-11-18T16:16:33.2511557Z,2016,357,119,271,168,0,1,2,189,0,0,238,86,0,356,0,1,0
54502,7386,2020-11-18T16:16:33.2521562Z,2017,311,113,257,157,0,0,0,154,0,0,198,54,0,311,0,1,0
54502,7387,2020-11-18T16:16:33.2521562Z,2018,314,114,254,160,0,0,0,154,0,0,200,60,0,313,1,1,1
54502,7388,2020-11-18T16:16:33.2521562Z,2019,264,96,219,141,0,0,0,123,0,0,168,45,0,264,1,0,0
54502,7389,2020-11-18T16:16:33.2521562Z,2020,280,96,227,158,0,0,19,122,0,0,184,53,0,280,1,0,0
34348,25788,2021-06-24T05:35:10.8676099Z,2021,344,98,298,159,0,6,0,185,0,0,246,46,0,338,0,0,0
34348,4194,2020-11-18T16:16:11.0373457Z,2012,536,57,332,270,0,5,0,266,0,0,479,204,2,529,0,0,0
34348,4195,2020-11-18T16:16:11.0373457Z,2013,516,77,318,260,0,6,0,256,0,0,439,198,1,508,0,5,1
34348,4196,2020-11-18T16:16:11.0373457Z,2014,462,83,320,226,0,7,0,236,0,0,379,142,0,453,0,0,2
34348,4197,2020-11-18T16:16:11.038347Z,2015,497,91,354,249,0,5,0,248,0,0,406,143,0,491,0,3,1
34348,4198,2020-11-18T16:16:11.038347Z,2016,449,92,293,230,0,8,1,219,0,0,357,156,0,441,0,1,0
34348,4199,2020-11-18T16:16:11.038347Z,2017,401,88,294,182,0,7,0,219,0,0,313,107,0,391,0,2,3
34348,4200,2020-11-18T16:16:11.038347Z,2018,379,86,286,177,0,4,1,202,0,0,293,93,0,374,0,0,1
34348,4201,2020-11-18T16:16:11.4306082Z,2019,344,100,273,175,0,6,5,169,0,0,244,71,0,336,0,1,2
34348,4202,2020-11-18T16:16:11.4306082Z,2020,368,100,296,178,0,9,3,190,0,0,268,72,0,359,0,0,0
54619,25910,2021-06-24T05:35:12.8039982Z,2021,731,166,575,380,0,8,2,351,0,0,565,156,6,716,15,3,1
54619,7399,2020-11-18T16:16:33.2521562Z,2012,761,1,542,374,0,2,0,387,0,0,760,219,0,759,0,0,0
54619,7400,2020-11-18T16:16:33.2521562Z,2013,598,1,428,283,0,2,0,315,0,0,597,170,0,596,0,3,0
54619,7401,2020-11-18T16:16:33.6884459Z,2014,712,32,532,342,0,3,0,370,0,0,680,180,0,709,0,0,0
54619,7402,2020-11-18T16:16:33.6884459Z,2015,742,46,557,366,0,0,0,376,0,0,696,185,0,742,0,5,0
54619,7403,2020-11-18T16:16:33.6894464Z,2016,680,89,278,337,0,3,0,343,0,0,591,402,0,677,0,2,0
54619,7404,2020-11-18T16:16:33.6894464Z,2017,765,106,582,385,0,4,5,380,0,0,659,183,1,760,0,2,0
54619,7405,2020-11-18T16:16:33.6894464Z,2018,574,83,389,289,0,4,4,285,0,0,491,185,6,564,3,1,0
54619,7406,2020-11-18T16:16:33.6894464Z,2019,712,106,503,363,0,5,0,349,0,0,606,209,8,698,16,1,1
54619,7407,2020-11-18T16:16:33.6894464Z,2020,711,152,517,372,0,6,0,339,0,0,559,194,6,698,19,2,1
11940,25595,2021-06-24T05:35:04.6071203Z,2021,215,95,198,96,0,4,0,119,0,0,120,17,0,210,0,1,1
11940,529,2020-11-18T16:15:49.6660942Z,2012,230,57,178,132,0,7,0,98,0,0,173,52,0,223,0,0,0
11940,530,2020-11-18T16:15:49.6660942Z,2013,234,66,196,116,0,7,0,118,0,0,168,38,0,227,0,7,0
11940,531,2020-11-18T16:15:49.6670955Z,2014,209,53,140,107,0,10,0,102,0,0,156,69,0,199,0,8,0
11940,532,2020-11-18T16:15:49.6670955Z,2015,220,62,176,110,0,10,0,110,0,0,158,44,0,210,0,3,0
11940,533,2020-11-18T16:15:49.6670955Z,2016,260,75,173,128,0,9,1,132,0,0,185,87,0,251,0,4,0
11940,534,2020-11-18T16:15:49.6670955Z,2017,334,104,289,160,0,7,1,174,0,0,230,45,0,327,0,1,0
11940,535,2020-11-18T16:15:49.6670955Z,2018,388,140,316,181,0,9,2,207,0,0,248,72,0,379,0,1,0
11940,536,2020-11-18T16:15:49.6680964Z,2019,259,98,211,119,0,6,0,140,0,0,161,48,0,252,0,1,1
11940,537,2020-11-18T16:15:49.6680964Z,2020,246,100,213,112,0,6,0,134,0,0,146,33,0,239,0,2,1
25031,2789,2020-11-18T16:16:03.2851741Z,2012,383,30,282,197,0,1,0,186,0,0,353,101,0,382,0,0,0
25031,2790,2020-11-18T16:16:03.2851741Z,2013,400,55,290,196,0,1,0,204,0,0,345,110,0,399,0,8,0
25031,2791,2020-11-18T16:16:03.2851741Z,2014,391,77,278,191,0,0,0,200,0,0,314,113,0,391,0,4,0
25031,2792,2020-11-18T16:16:03.286175Z,2015,388,95,287,186,0,1,0,202,0,0,293,101,0,387,0,1,0
25031,2793,2020-11-18T16:16:03.286175Z,2016,357,109,132,160,0,1,0,197,0,0,248,225,0,356,0,3,0
25031,2794,2020-11-18T16:16:03.286175Z,2017,320,96,261,136,0,0,3,184,0,0,224,59,0,320,0,2,0
25031,2795,2020-11-18T16:16:03.286175Z,2018,270,75,221,112,0,0,1,158,0,0,195,49,0,270,0,1,0
25031,2796,2020-11-18T16:16:03.286175Z,2019,295,95,233,131,0,0,4,164,0,0,200,62,0,295,0,3,0
25031,2797,2020-11-18T16:16:03.287175Z,2020,257,89,204,119,0,2,2,138,0,0,168,53,0,255,0,2,0
25031,31751,2021-06-24T05:35:15.434884Z,2021,223,85,191,106,0,0,1,117,0,0,138,32,0,223,0,2,0
70532,31654,2021-06-24T05:35:14.677341Z,2021,213,84,168,94,0,1,1,119,0,0,129,45,0,212,0,0,0
70532,9747,2020-11-18T16:16:50.4746402Z,2012,261,95,194,114,0,8,0,147,0,0,166,67,1,251,0,0,1
70532,9748,2020-11-18T16:16:50.4756411Z,2013,263,120,189,119,0,7,0,144,0,0,143,74,2,253,0,1,1
70532,9749,2020-11-18T16:16:50.4756411Z,2014,218,87,158,101,0,4,0,117,0,0,131,60,0,213,0,1,1
70532,9750,2020-11-18T16:16:50.4756411Z,2015,223,92,134,108,0,3,0,115,0,0,131,89,0,220,0,0,0
70532,9751,2020-11-18T16:16:50.4756411Z,2016,171,70,82,71,0,3,1,100,0,0,101,89,0,168,0,0,0
70532,9752,2020-11-18T16:16:50.4756411Z,2017,176,76,132,75,0,4,1,101,0,0,100,44,0,172,0,0,0
70532,9753,2020-11-18T16:16:50.476642Z,2018,249,108,180,113,0,5,14,136,0,0,141,69,0,244,0,0,0
70532,9754,2020-11-18T16:16:50.476642Z,2019,251,124,202,114,0,4,7,137,0,0,127,49,0,247,0,0,0
70532,9755,2020-11-18T16:16:50.476642Z,2020,232,106,180,109,0,2,1,123,0,0,126,52,0,230,0,0,0
14779,1092,2020-11-18T16:15:52.5079865Z,2012,376,108,350,172,0,16,0,204,0,0,268,26,1,358,0,0,1
14779,1093,2020-11-18T16:15:52.5089878Z,2013,345,111,312,156,0,9,0,189,0,0,234,33,1,334,0,1,1
14779,1094,2020-11-18T16:15:52.5089878Z,2014,294,104,261,129,0,3,0,165,0,0,190,33,1,288,0,1,2
14779,1095,2020-11-18T16:15:52.5089878Z,2015,261,85,240,117,0,13,0,144,0,0,176,21,0,248,0,6,0
14779,1096,2020-11-18T16:15:52.5089878Z,2016,323,110,294,152,0,17,2,171,0,0,213,29,0,305,0,0,1
14779,1097,2020-11-18T16:15:52.5089878Z,2017,253,94,233,123,0,14,2,130,0,0,159,20,0,238,0,0,1
14779,1098,2020-11-18T16:15:52.5089878Z,2018,204,84,195,103,0,7,0,101,0,0,120,9,0,196,0,0,1
14779,1099,2020-11-18T16:15:52.5099878Z,2019,256,110,237,123,0,6,1,133,0,0,146,19,0,250,0,0,0
14779,1100,2020-11-18T16:15:52.5099878Z,2020,256,113,220,129,0,5,0,127,0,0,143,36,0,251,0,0,0
14779,25603,2021-06-24T05:35:04.620129Z,2021,218,95,213,99,0,8,5,119,0,0,123,5,0,210,0,4,0
17319,1324,2020-11-18T16:15:54.3051879Z,2012,672,3,491,340,0,12,0,332,0,0,669,181,1,659,0,0,0
17319,1325,2020-11-18T16:15:54.3051879Z,2013,619,5,455,321,0,23,0,298,0,0,614,164,4,592,0,3,0
17319,1326,2020-11-18T16:15:54.3061884Z,2014,590,30,441,310,0,20,0,280,0,0,560,149,3,566,0,0,1
17319,1327,2020-11-18T16:15:54.3061884Z,2015,597,39,450,323,0,14,0,274,0,0,558,147,2,581,0,0,0
17319,1328,2020-11-18T16:15:54.3061884Z,2016,499,72,249,275,0,3,0,224,0,0,427,250,0,496,0,1,0
17319,1329,2020-11-18T16:15:54.3061884Z,2017,554,90,440,287,0,12,1,267,0,0,464,114,0,542,0,2,0
17319,1330,2020-11-18T16:15:54.3061884Z,2018,618,115,483,316,0,14,19,302,0,0,503,135,0,604,3,2,0
17319,1331,2020-11-18T16:15:54.3071884Z,2019,579,116,463,286,0,3,1,293,0,0,463,116,0,576,6,1,0
17319,1332,2020-11-18T16:15:54.3071884Z,2020,562,145,450,289,0,6,0,273,0,0,417,112,0,556,6,4,0
17319,25606,2021-06-24T05:35:04.616127Z,2021,543,160,457,270,0,6,0,273,0,0,383,86,0,537,4,3,0
30734,25759,2021-06-24T05:35:08.7280749Z,2021,317,77,202,135,0,3,0,182,0,0,240,115,0,312,0,0,2
30734,3428,2020-11-18T16:16:07.0096554Z,2012,187,44,159,103,0,0,0,84,0,0,143,28,1,186,0,0,0
30734,3429,2020-11-18T16:16:07.0096554Z,2013,198,50,172,105,0,0,0,93,0,0,148,26,0,198,0,1,0
30734,3430,2020-11-18T16:16:07.0106572Z,2014,209,59,181,111,0,0,0,98,0,0,150,28,0,209,0,0,0
30734,3431,2020-11-18T16:16:07.0106572Z,2015,207,72,169,110,0,0,0,97,0,0,135,38,1,206,0,3,0
30734,3432,2020-11-18T16:16:07.0106572Z,2016,242,74,170,117,0,0,12,125,0,0,168,72,1,241,0,3,0
30734,3433,2020-11-18T16:16:07.0106572Z,2017,259,89,178,126,0,2,2,133,0,0,170,81,1,256,0,3,0
30734,3434,2020-11-18T16:16:07.0106572Z,2018,263,77,180,128,0,0,0,135,0,0,186,83,1,262,0,0,0
30734,3435,2020-11-18T16:16:07.0116567Z,2019,262,66,183,127,0,0,0,135,0,0,196,79,0,261,0,0,1
30734,3436,2020-11-18T16:16:07.0116567Z,2020,289,72,180,129,0,2,0,160,0,0,217,109,0,286,0,0,1
12930,31603,2021-06-24T05:35:14.5742683Z,2021,367,155,294,184,0,1,0,183,0,0,212,73,0,366,6,1,0
12930,914,2020-11-18T16:15:52.0266657Z,2012,489,1,412,248,0,1,0,241,0,0,488,77,0,488,0,0,0
12930,915,2020-11-18T16:15:52.0276665Z,2013,555,4,445,284,0,1,0,271,0,0,551,110,0,554,0,1,0
12930,916,2020-11-18T16:15:52.0276665Z,2014,548,53,442,280,0,3,0,268,0,0,495,106,0,545,0,0,0
12930,917,2020-11-18T16:15:52.0276665Z,2015,451,44,362,229,0,5,0,222,0,0,407,89,0,446,0,1,0
12930,918,2020-11-18T16:15:52.0276665Z,2016,345,71,59,181,0,6,0,164,0,0,274,286,0,339,0,1,0
12930,919,2020-11-18T16:15:52.0286679Z,2017,382,114,313,194,0,2,1,188,0,0,268,69,0,380,0,2,0
12930,920,2020-11-18T16:15:52.0286679Z,2018,383,119,306,185,0,0,3,198,0,0,264,77,0,383,8,1,0
12930,921,2020-11-18T16:15:52.0286679Z,2019,363,113,284,172,0,1,0,191,0,0,250,79,0,362,7,0,0
12930,922,2020-11-18T16:15:52.0296674Z,2020,305,114,246,144,0,2,0,161,0,0,191,59,0,303,7,0,0
62893,25966,2021-06-24T05:35:12.9010676Z,2021,414,112,305,236,0,10,1,178,0,0,302,109,0,404,0,0,0
62893,8723,2020-11-18T16:16:42.8315456Z,2012,282,71,212,121,0,4,0,161,0,0,211,70,1,276,0,0,1
62893,8724,2020-11-18T16:16:42.8315456Z,2013,170,50,126,74,0,4,0,96,0,0,120,44,0,165,0,0,1
62893,8725,2020-11-18T16:16:42.8325456Z,2014,253,97,178,113,0,1,0,140,0,0,156,75,0,251,0,0,1
62893,8726,2020-11-18T16:16:42.8325456Z,2015,332,124,319,157,0,1,0,175,0,0,208,13,0,331,0,0,0
62893,8727,2020-11-18T16:16:42.8325456Z,2016,328,111,227,157,0,1,0,171,0,0,217,101,0,327,0,0,0
62893,8728,2020-11-18T16:16:42.8335469Z,2017,350,138,324,165,0,0,2,185,0,0,212,26,0,350,0,0,0
62893,8729,2020-11-18T16:16:42.8335469Z,2018,399,123,342,186,0,18,0,213,0,0,276,57,0,381,0,0,0
62893,8730,2020-11-18T16:16:42.8335469Z,2019,343,97,251,175,0,13,0,168,0,0,246,92,0,330,0,0,0
62893,8731,2020-11-18T16:16:42.8345465Z,2020,350,91,263,199,0,10,0,151,0,0,259,87,0,340,0,0,0
61408,25944,2021-06-24T05:35:12.8450296Z,2021,287,73,275,144,0,5,0,143,0,0,214,12,0,282,0,0,0
61408,8162,2020-11-18T16:16:38.6137293Z,2012,328,86,312,154,0,10,0,174,0,0,242,16,0,317,0,0,1
61408,8163,2020-11-18T16:16:38.6137293Z,2013,329,89,303,142,0,10,0,187,0,0,240,26,0,318,0,0,1
61408,8164,2020-11-18T16:16:38.6137293Z,2014,321,83,259,151,0,8,0,170,0,0,238,62,0,312,0,1,1
61408,8165,2020-11-18T16:16:38.6147307Z,2015,367,92,354,183,0,7,0,184,0,0,275,13,0,358,0,3,2
61408,8166,2020-11-18T16:16:38.6147307Z,2016,194,46,186,99,0,2,0,95,0,0,148,8,0,192,0,1,0
61408,8167,2020-11-18T16:16:38.6147307Z,2017,279,73,269,137,0,2,0,142,0,0,206,10,0,277,0,1,0
61408,8168,2020-11-18T16:16:38.6157311Z,2018,395,106,371,198,0,2,0,197,0,0,289,24,0,393,0,0,0
61408,8169,2020-11-18T16:16:38.6157311Z,2019,339,95,320,179,0,6,0,160,0,0,244,19,0,333,0,0,0
61408,8170,2020-11-18T16:16:38.6157311Z,2020,309,90,286,164,0,2,2,145,0,0,219,23,0,307,0,0,0
52258,31894,2021-06-24T05:35:18.4670592Z,2021,377,97,318,185,0,0,0,192,0,0,280,59,1,374,0,0,2
52258,6765,2020-11-18T16:16:28.9382797Z,2012,353,108,299,177,0,9,0,176,0,0,245,54,0,344,0,0,0
52258,6766,2020-11-18T16:16:28.9382797Z,2013,352,111,298,178,0,7,0,174,0,0,241,54,1,344,0,1,0
52258,6767,2020-11-18T16:16:28.9392797Z,2014,342,126,279,162,0,7,0,180,0,0,216,63,1,333,0,1,1
52258,6768,2020-11-18T16:16:28.9392797Z,2015,338,126,277,149,0,10,0,189,0,0,212,61,1,327,0,0,0
52258,6769,2020-11-18T16:16:28.9392797Z,2016,357,125,95,174,0,6,0,183,0,0,232,262,1,350,0,0,0
52258,6770,2020-11-18T16:16:28.9392797Z,2017,303,108,250,146,0,3,2,157,0,0,195,53,2,297,0,0,1
52258,6771,2020-11-18T16:16:28.9402797Z,2018,346,111,276,175,0,5,2,171,0,0,235,70,2,338,0,0,1
52258,6772,2020-11-18T16:16:28.9402797Z,2019,360,115,307,171,0,2,3,189,0,0,245,53,1,357,0,0,0
52258,6773,2020-11-18T16:16:28.9402797Z,2020,362,107,314,170,0,1,6,192,0,0,255,48,1,359,0,0,1
42804,31835,2021-06-24T05:35:16.964981Z,2021,194,69,154,87,0,3,2,107,0,0,125,40,0,191,0,1,0
42804,5348,2020-11-18T16:16:19.3398791Z,2012,315,98,258,149,0,6,0,166,0,0,217,57,1,308,0,0,0
42804,5349,2020-11-18T16:16:19.3398791Z,2013,343,101,287,160,0,6,0,183,0,0,242,56,0,334,0,12,3
42804,5350,2020-11-18T16:16:19.3398791Z,2014,331,98,272,151,0,3,0,180,0,0,233,59,0,321,0,10,7
42804,5351,2020-11-18T16:16:19.3398791Z,2015,299,80,247,134,0,5,0,165,0,0,219,52,0,288,0,7,6
42804,5352,2020-11-18T16:16:19.3398791Z,2016,290,91,225,130,0,4,3,160,0,0,199,65,0,282,0,4,4
42804,5353,2020-11-18T16:16:19.3408804Z,2017,280,91,220,129,0,2,1,151,0,0,189,60,0,275,0,6,3
42804,5354,2020-11-18T16:16:19.3408804Z,2018,289,78,245,134,0,2,11,155,0,0,211,44,0,283,2,2,4
42804,5355,2020-11-18T16:16:19.3408804Z,2019,257,88,211,138,1,3,1,119,0,0,169,46,0,252,1,1,2
42804,5356,2020-11-18T16:16:19.3408804Z,2020,227,74,182,120,0,2,2,107,0,0,153,45,0,225,0,1,0
75804,10870,2020-11-18T16:16:57.4162712Z,2012,506,91,340,251,0,2,0,255,0,0,415,166,1,503,0,0,0
75804,10871,2020-11-18T16:16:57.4162712Z,2013,505,145,355,259,0,3,0,246,0,0,360,150,0,502,0,0,0
75804,10872,2020-11-18T16:16:57.4162712Z,2014,496,172,391,243,0,3,0,253,0,0,324,105,0,492,0,0,1
75804,10873,2020-11-18T16:16:57.4162712Z,2015,478,181,383,233,0,4,0,245,0,0,297,95,0,473,0,0,1
75804,10874,2020-11-18T16:16:57.4162712Z,2016,479,195,285,234,0,4,3,245,0,0,284,194,0,473,0,1,2
75804,10875,2020-11-18T16:16:57.4172721Z,2017,455,195,343,215,0,6,1,240,0,0,260,112,0,448,0,0,1
75804,10876,2020-11-18T16:16:57.4172721Z,2018,461,163,361,220,0,3,0,241,0,0,298,100,0,457,9,0,1
75804,10877,2020-11-18T16:16:57.4172721Z,2019,433,163,375,227,0,8,0,206,0,0,270,58,0,423,5,2,2
75804,10878,2020-11-18T16:16:57.4172721Z,2020,405,183,344,197,0,4,0,208,0,0,222,61,0,400,3,0,1
75804,25997,2021-06-24T05:35:14.5152248Z,2021,377,164,328,174,0,9,0,203,0,0,213,49,0,367,4,0,1
35881,31803,2021-06-24T05:35:16.8779192Z,2021,341,71,312,165,0,4,0,176,0,0,270,29,0,337,0,0,0
35881,4452,2020-11-18T16:16:12.5843738Z,2012,476,0,390,251,0,20,0,225,0,0,476,86,3,453,0,0,0
35881,4453,2020-11-18T16:16:12.5853751Z,2013,449,0,365,232,0,14,0,217,0,0,449,84,2,432,0,2,1
35881,4454,2020-11-18T16:16:12.5853751Z,2014,387,14,292,198,0,16,0,189,0,0,373,95,0,371,0,1,0
35881,4455,2020-11-18T16:16:12.5853751Z,2015,344,15,277,180,0,7,0,164,0,0,329,67,0,337,0,1,0
35881,4456,2020-11-18T16:16:12.5863742Z,2016,242,20,166,132,0,2,0,110,0,0,222,76,0,240,0,0,0
35881,4457,2020-11-18T16:16:12.5863742Z,2017,496,53,402,233,0,10,1,263,0,0,443,94,0,486,0,1,0
35881,4458,2020-11-18T16:16:12.5863742Z,2018,484,38,387,239,0,12,0,245,0,0,446,97,0,471,0,0,1
35881,4459,2020-11-18T16:16:12.5873746Z,2019,423,36,357,223,0,12,0,200,0,0,387,66,0,411,0,0,0
35881,4460,2020-11-18T16:16:12.5873746Z,2020,347,47,299,181,0,8,0,166,0,0,300,48,0,339,0,0,0
61390,31945,2021-06-24T05:35:18.54011Z,2021,192,28,104,108,0,6,0,84,0,0,164,88,2,184,0,0,0
61390,8153,2020-11-18T16:16:38.6117285Z,2012,175,0,66,106,0,12,0,69,0,0,175,109,2,161,0,0,0
61390,8154,2020-11-18T16:16:38.6117285Z,2013,202,4,86,118,0,9,0,84,0,0,198,116,1,192,0,0,0
61390,8155,2020-11-18T16:16:38.6127298Z,2014,205,14,79,115,0,4,0,90,0,0,191,126,1,200,0,0,0
61390,8156,2020-11-18T16:16:38.6127298Z,2015,210,12,85,111,0,7,0,99,0,0,198,125,0,203,0,0,0
61390,8157,2020-11-18T16:16:38.6127298Z,2016,200,26,51,119,0,6,0,81,0,0,174,149,0,194,0,0,0
61390,8158,2020-11-18T16:16:38.6137293Z,2017,213,26,97,126,0,7,0,87,0,0,187,116,0,206,0,0,0
61390,8159,2020-11-18T16:16:38.6137293Z,2018,228,23,100,129,0,7,0,99,0,0,205,128,0,221,0,0,0
61390,8160,2020-11-18T16:16:38.6137293Z,2019,201,23,87,110,0,5,0,91,0,0,178,114,0,196,0,0,0
61390,8161,2020-11-18T16:16:38.6137293Z,2020,203,28,85,109,0,4,0,94,0,0,175,118,1,198,0,1,0
40204,31817,2021-06-24T05:35:16.9199493Z,2021,546,85,411,266,0,3,0,280,0,0,461,135,0,543,5,3,0
40204,4661,2020-11-18T16:16:14.4085917Z,2012,421,126,352,210,0,0,0,211,0,0,295,69,0,421,0,0,0
40204,4662,2020-11-18T16:16:14.4095921Z,2013,368,106,294,180,0,0,0,188,0,0,262,74,0,368,0,2,0
40204,4663,2020-11-18T16:16:14.4095921Z,2014,320,91,257,161,0,2,0,159,0,0,229,63,1,317,0,4,0
40204,4664,2020-11-18T16:16:14.4095921Z,2015,293,90,244,151,0,0,0,142,0,0,203,49,0,292,0,6,1
40204,4665,2020-11-18T16:16:14.410593Z,2016,251,73,197,127,0,0,0,124,0,0,178,54,0,250,0,2,1
40204,4666,2020-11-18T16:16:14.410593Z,2017,250,67,204,127,0,2,1,123,0,0,183,46,0,247,0,3,1
40204,4667,2020-11-18T16:16:14.410593Z,2018,601,121,433,292,0,0,18,309,0,0,480,168,0,601,5,3,0
40204,4668,2020-11-18T16:16:14.410593Z,2019,562,123,401,278,0,2,4,284,0,2,439,161,0,560,6,2,0
40204,4669,2020-11-18T16:16:14.4115934Z,2020,541,104,395,270,0,7,2,271,0,0,437,146,0,534,5,3,0
70177,31645,2021-06-24T05:35:14.6833454Z,2021,305,112,261,151,0,3,0,154,0,0,193,44,0,302,0,0,0
70177,9506,2020-11-18T16:16:49.3218724Z,2012,345,102,252,165,0,4,0,180,0,0,243,93,6,335,0,0,0
70177,9507,2020-11-18T16:16:49.3218724Z,2013,301,92,218,148,0,4,0,153,0,0,209,83,5,292,0,1,0
70177,9508,2020-11-18T16:16:49.3218724Z,2014,314,88,222,157,0,2,0,157,0,0,226,92,6,306,0,1,0
70177,9509,2020-11-18T16:16:49.3218724Z,2015,248,75,175,123,0,3,0,125,0,0,173,73,3,242,0,1,0
70177,9510,2020-11-18T16:16:49.3228723Z,2016,239,87,182,124,0,3,0,115,0,0,152,57,2,234,0,1,0
70177,9511,2020-11-18T16:16:49.3228723Z,2017,217,84,184,114,0,2,1,103,0,0,133,33,1,214,0,1,0
70177,9512,2020-11-18T16:16:49.3228723Z,2018,312,119,236,151,0,2,0,161,0,0,193,76,3,307,0,3,0
70177,9513,2020-11-18T16:16:49.3228723Z,2019,390,157,248,210,0,9,0,180,0,0,233,142,3,378,0,3,0
70177,9514,2020-11-18T16:16:49.3238728Z,2020,346,134,286,170,0,4,0,176,0,0,212,60,3,339,0,3,0
33704,31786,2021-06-24T05:35:16.8629087Z,2021,349,27,190,183,0,7,0,166,0,0,322,159,0,341,13,0,1
33704,4112,2020-11-18T16:16:11.0163328Z,2012,385,9,139,190,0,5,0,195,0,0,376,246,1,377,0,0,2
33704,4113,2020-11-18T16:16:11.0163328Z,2013,397,20,163,191,0,4,0,206,0,0,377,234,1,391,0,2,1
33704,4114,2020-11-18T16:16:11.0173328Z,2014,388,25,170,189,0,6,0,199,0,0,363,218,0,382,0,0,0
33704,4115,2020-11-18T16:16:11.0173328Z,2015,372,24,150,196,0,6,0,176,0,0,348,222,0,366,0,0,0
33704,4116,2020-11-18T16:16:11.0173328Z,2016,310,21,118,180,0,5,0,130,0,0,289,192,0,305,0,0,0
33704,4117,2020-11-18T16:16:11.0173328Z,2017,375,46,202,200,0,8,0,175,0,0,329,173,0,366,0,0,1
33704,4118,2020-11-18T16:16:11.0173328Z,2018,361,31,180,201,0,10,0,160,0,0,330,181,0,350,10,0,1
33704,4119,2020-11-18T16:16:11.0183337Z,2019,367,30,187,199,0,10,0,168,0,0,337,180,0,355,13,0,2
33704,4120,2020-11-18T16:16:11.0183337Z,2020,359,26,176,194,0,7,0,165,0,0,333,183,1,350,15,0,1
62547,25961,2021-06-24T05:35:12.9020685Z,2021,334,128,278,156,0,28,5,178,0,0,206,56,1,304,0,1,1
62547,8562,2020-11-18T16:16:40.8892499Z,2012,190,0,127,105,0,21,0,85,0,0,190,63,0,168,0,0,1
62547,8563,2020-11-18T16:16:40.8902507Z,2013,126,2,111,50,0,11,0,76,0,0,124,15,0,114,0,0,1
62547,8564,2020-11-18T16:16:40.8902507Z,2014,136,23,123,62,0,14,0,74,0,0,113,13,0,121,0,0,1
62547,8565,2020-11-18T16:16:40.8912521Z,2015,212,32,189,102,0,11,0,110,0,0,180,23,0,201,0,0,0
62547,8566,2020-11-18T16:16:40.8912521Z,2016,466,131,366,219,0,25,3,247,0,0,335,100,1,440,0,0,0
62547,8567,2020-11-18T16:16:40.8912521Z,2017,363,90,326,169,0,21,0,194,0,0,273,37,1,341,0,1,0
62547,8568,2020-11-18T16:16:40.8922516Z,2018,390,97,334,183,0,23,0,207,0,0,293,56,1,366,0,1,0
62547,8569,2020-11-18T16:16:40.8922516Z,2019,399,103,348,189,0,25,3,210,0,0,296,51,2,372,0,0,0
62547,8570,2020-11-18T16:16:40.8922516Z,2020,365,128,321,183,0,36,2,182,0,0,237,44,1,327,0,1,1
75879,10914,2020-11-18T16:16:58.101728Z,2012,306,121,169,158,0,30,0,148,0,0,185,137,2,272,0,0,2
75879,10915,2020-11-18T16:16:58.101728Z,2013,305,130,175,156,0,27,0,149,0,0,175,130,1,277,0,1,0
75879,10916,2020-11-18T16:16:58.1027293Z,2014,329,137,175,161,0,25,0,168,0,0,192,154,1,303,0,1,0
75879,10917,2020-11-18T16:16:58.1027293Z,2015,333,128,173,165,0,18,0,168,0,0,205,160,0,312,0,2,3
75879,10918,2020-11-18T16:16:58.1027293Z,2016,373,133,170,190,0,18,0,183,0,0,240,203,0,352,0,1,3
75879,10919,2020-11-18T16:16:58.1027293Z,2017,367,128,190,197,0,15,0,170,0,0,239,177,0,348,0,1,4
75879,10920,2020-11-18T16:16:58.1027293Z,2018,369,113,213,196,0,19,0,173,0,0,256,156,0,348,1,0,2
75879,10921,2020-11-18T16:16:58.1027293Z,2019,395,135,230,209,0,25,1,186,0,0,260,165,2,368,1,1,0
75879,10922,2020-11-18T16:16:58.1037298Z,2020,368,129,209,190,0,25,0,178,0,0,239,159,2,341,1,1,0
75879,25999,2021-06-24T05:35:14.5192277Z,2021,384,133,259,195,0,26,0,189,0,0,251,125,2,355,2,1,1
10827,219,2020-11-18T16:15:46.8151906Z,2012,550,14,415,284,0,3,0,266,0,0,536,135,0,547,0,0,0
10827,220,2020-11-18T16:15:46.8151906Z,2013,536,22,389,278,0,1,0,258,0,0,514,147,0,534,0,5,1
10827,221,2020-11-18T16:15:46.8151906Z,2014,557,72,422,284,0,3,0,273,0,0,485,135,0,553,0,5,1
10827,222,2020-11-18T16:15:46.8151906Z,2015,600,96,456,293,0,8,0,307,0,0,504,144,0,591,0,3,1
10827,223,2020-11-18T16:15:46.8151906Z,2016,563,149,409,271,0,6,0,292,0,0,414,154,0,557,0,0,0
10827,224,2020-11-18T16:15:46.8161911Z,2017,522,127,398,261,0,5,0,261,0,0,395,124,0,517,0,0,0
10827,225,2020-11-18T16:15:46.8161911Z,2018,608,155,451,307,0,11,10,301,0,0,453,157,0,597,0,0,0
10827,226,2020-11-18T16:15:46.8161911Z,2019,577,148,450,285,0,13,0,292,0,0,429,127,0,563,0,1,1
10827,227,2020-11-18T16:15:46.8171915Z,2020,548,178,441,284,0,11,0,264,0,0,370,107,0,536,0,2,1
10827,31586,2021-06-24T05:35:14.5282344Z,2021,545,196,447,273,0,13,0,272,0,0,349,98,0,531,0,5,1
75267,10757,2020-11-18T16:16:56.8959232Z,2012,679,3,478,348,0,22,0,331,0,0,676,201,0,657,0,0,0
75267,10758,2020-11-18T16:16:56.8959232Z,2013,699,5,508,374,0,23,0,325,0,0,694,191,0,676,0,1,0
75267,10759,2020-11-18T16:16:56.8959232Z,2014,612,27,447,315,0,16,0,297,0,0,585,165,8,588,0,4,0
75267,10760,2020-11-18T16:16:56.8959232Z,2015,589,32,422,321,0,16,0,268,0,0,557,167,1,572,0,3,0
75267,10761,2020-11-18T16:16:56.8969245Z,2016,683,96,283,354,0,12,1,329,0,0,587,400,1,670,0,3,0
75267,10762,2020-11-18T16:16:56.8969245Z,2017,704,126,498,379,0,6,3,325,0,0,578,206,1,697,0,2,0
75267,10763,2020-11-18T16:16:56.8969245Z,2018,692,107,499,374,0,6,0,318,0,0,585,193,1,685,0,2,0
75267,10764,2020-11-18T16:16:56.8969245Z,2019,652,115,485,339,0,5,1,313,0,0,537,167,0,647,0,0,0
75267,10765,2020-11-18T16:16:56.8969245Z,2020,572,129,442,297,0,8,0,275,0,0,443,130,0,564,0,0,0
75267,25627,2021-06-24T05:35:04.6661625Z,2021,499,123,418,256,0,7,1,243,0,0,376,81,0,492,0,0,0
62554,31963,2021-06-24T05:35:20.263347Z,2021,263,100,254,133,0,5,0,130,0,0,163,9,0,258,1,0,0
62554,8571,2020-11-18T16:16:40.8902507Z,2012,272,42,246,142,0,8,0,130,0,0,230,26,0,263,0,0,1
62554,8572,2020-11-18T16:16:40.8902507Z,2013,243,55,208,138,0,3,0,105,0,0,188,35,0,239,0,1,1
62554,8573,2020-11-18T16:16:40.8912521Z,2014,238,50,207,128,0,4,0,110,0,0,188,31,1,233,0,0,0
62554,8574,2020-11-18T16:16:40.8912521Z,2015,271,63,253,138,0,8,0,133,0,0,208,18,1,262,0,0,0
62554,8575,2020-11-18T16:16:40.8912521Z,2016,143,38,132,72,0,3,0,71,0,0,105,11,0,140,0,0,0
62554,8576,2020-11-18T16:16:40.8922516Z,2017,229,68,213,112,0,2,0,117,0,0,161,16,1,226,0,1,0
62554,8577,2020-11-18T16:16:40.8922516Z,2018,241,61,218,128,0,3,0,113,0,0,180,23,0,238,0,0,0
62554,8578,2020-11-18T16:16:40.8922516Z,2019,307,103,287,163,0,5,0,144,0,0,204,20,0,302,0,0,0
62554,8579,2020-11-18T16:16:40.8932525Z,2020,280,99,261,144,0,4,0,136,0,0,181,19,0,276,1,0,0
70060,25641,2021-06-24T05:35:04.6911806Z,2021,336,169,298,155,0,8,2,181,0,0,167,38,0,327,1,1,1
70060,9429,2020-11-18T16:16:48.5033292Z,2012,500,88,388,215,0,7,0,285,0,0,412,112,2,487,0,0,4
70060,9430,2020-11-18T16:16:48.5043301Z,2013,431,138,355,200,0,7,0,231,0,0,293,76,2,416,0,0,6
70060,9431,2020-11-18T16:16:48.5043301Z,2014,417,176,344,182,0,8,0,235,0,0,241,73,2,402,0,0,5
70060,9432,2020-11-18T16:16:48.5043301Z,2015,411,161,340,178,0,6,0,233,0,0,250,71,0,402,0,3,3
70060,9433,2020-11-18T16:16:48.5043301Z,2016,466,193,370,208,0,12,4,258,0,0,273,96,1,451,0,3,2
70060,9434,2020-11-18T16:16:48.5043301Z,2017,402,163,338,192,0,9,1,210,0,0,239,64,0,393,0,0,0
70060,9435,2020-11-18T16:16:48.505331Z,2018,391,155,339,200,0,3,10,191,0,0,236,52,0,388,0,0,0
70060,9436,2020-11-18T16:16:48.505331Z,2019,314,149,272,145,0,6,3,169,0,0,165,42,0,307,0,0,1
70060,9437,2020-11-18T16:16:48.505331Z,2020,325,163,286,150,0,8,3,175,0,0,162,39,0,316,0,1,1
55731,31916,2021-06-24T05:35:18.4860717Z,2021,194,49,166,102,0,5,0,92,0,0,145,28,0,189,2,0,0
55731,7505,2020-11-18T16:16:34.5180003Z,2012,346,95,267,170,0,9,0,176,0,0,251,79,0,337,0,0,0
55731,7506,2020-11-18T16:16:34.5180003Z,2013,296,83,226,148,0,11,0,148,0,0,213,70,0,285,0,1,0
55731,7507,2020-11-18T16:16:34.5180003Z,2014,289,80,225,139,0,8,0,150,0,0,209,64,0,281,0,0,0
55731,7508,2020-11-18T16:16:34.5190012Z,2015,267,80,220,131,0,11,0,136,0,0,187,47,0,255,0,3,1
55731,7509,2020-11-18T16:16:34.5190012Z,2016,228,65,190,117,0,10,3,111,0,0,163,38,0,216,0,2,2
55731,7510,2020-11-18T16:16:34.5190012Z,2017,225,73,183,117,0,8,0,108,0,0,152,42,0,217,0,0,0
55731,7511,2020-11-18T16:16:34.5200016Z,2018,290,84,210,151,0,12,18,139,0,0,206,80,0,278,2,0,0
55731,7512,2020-11-18T16:16:34.5200016Z,2019,221,68,194,114,0,4,10,107,0,0,153,27,0,217,2,0,0
55731,7513,2020-11-18T16:16:34.5200016Z,2020,218,68,185,108,0,6,2,110,0,0,150,33,0,212,2,0,0
57562,25925,2021-06-24T05:35:12.8220107Z,2021,264,84,213,128,0,6,0,136,0,0,180,51,0,257,3,0,1
57562,7712,2020-11-18T16:16:35.9019245Z,2012,500,66,378,241,0,10,0,259,0,0,434,122,0,490,0,0,0
57562,7713,2020-11-18T16:16:35.9019245Z,2013,497,102,378,232,0,9,0,265,0,0,395,119,0,488,0,2,0
57562,7714,2020-11-18T16:16:35.9019245Z,2014,491,118,364,234,0,14,0,257,0,0,373,127,0,477,0,2,0
57562,7715,2020-11-18T16:16:35.9019245Z,2015,464,118,353,203,0,11,0,261,0,0,346,111,0,453,0,1,0
57562,7716,2020-11-18T16:16:35.9029254Z,2016,285,82,124,124,0,6,0,161,0,0,203,161,0,279,0,0,0
57562,7717,2020-11-18T16:16:35.9029254Z,2017,512,135,366,232,0,4,0,280,0,0,377,146,0,506,0,3,2
57562,7718,2020-11-18T16:16:35.9029254Z,2018,495,141,359,232,0,5,14,263,0,0,354,136,2,487,1,6,1
57562,7719,2020-11-18T16:16:35.9029254Z,2019,354,110,287,170,0,8,2,184,0,0,244,67,2,343,3,1,1
57562,7720,2020-11-18T16:16:35.9029254Z,2020,346,116,279,154,0,6,2,192,0,0,230,67,0,339,5,0,1
52274,25893,2021-06-24T05:35:12.7899877Z,2021,430,132,324,209,0,4,1,221,0,0,298,106,0,426,1,1,0
52274,6780,2020-11-18T16:16:28.9082619Z,2012,455,0,343,230,0,0,0,225,0,0,455,112,0,454,0,0,1
52274,6781,2020-11-18T16:16:28.9092601Z,2013,429,0,329,206,0,2,0,223,0,0,429,100,0,426,0,1,1
52274,6782,2020-11-18T16:16:28.9092601Z,2014,439,36,344,183,0,7,0,256,0,0,403,95,0,432,0,0,0
52274,6783,2020-11-18T16:16:28.9092601Z,2015,427,41,319,200,0,7,0,227,0,0,386,108,0,420,0,1,0
52274,6784,2020-11-18T16:16:28.9102601Z,2016,450,81,323,218,0,11,2,232,0,0,369,127,0,439,0,2,0
52274,6785,2020-11-18T16:16:28.9102601Z,2017,434,64,347,224,0,8,0,210,0,0,370,87,0,426,0,1,0
52274,6786,2020-11-18T16:16:28.9102601Z,2018,384,59,281,185,0,6,0,199,0,0,325,103,0,378,10,0,0
52274,6787,2020-11-18T16:16:28.911261Z,2019,441,91,331,212,0,8,0,229,0,0,350,110,0,433,7,1,0
52274,6788,2020-11-18T16:16:28.911261Z,2020,453,124,340,223,0,4,1,230,0,0,329,113,0,449,4,1,0
47647,31861,2021-06-24T05:35:18.4270305Z,2021,578,128,396,295,0,12,0,283,0,0,450,182,0,566,10,4,0
47647,6032,2020-11-18T16:16:23.97597Z,2012,742,1,476,388,0,16,0,354,0,0,741,266,0,726,0,0,0
47647,6033,2020-11-18T16:16:23.9769709Z,2013,779,1,507,421,0,9,0,358,0,0,778,272,0,769,0,0,1
47647,6034,2020-11-18T16:16:23.9769709Z,2014,704,27,458,376,0,8,0,328,0,0,677,246,0,694,0,4,2
47647,6035,2020-11-18T16:16:23.9769709Z,2015,670,30,464,347,0,10,0,323,0,0,640,206,0,660,0,3,0
47647,6036,2020-11-18T16:16:23.9769709Z,2016,369,22,163,192,0,4,0,177,0,0,347,206,0,365,0,2,0
47647,6037,2020-11-18T16:16:23.9769709Z,2017,693,93,482,381,0,11,0,312,0,0,600,211,1,681,0,3,0
47647,6038,2020-11-18T16:16:23.9769709Z,2018,715,104,509,380,0,10,18,335,0,0,611,206,0,705,14,2,0
47647,6039,2020-11-18T16:16:23.9779713Z,2019,616,97,455,326,0,8,0,290,0,0,519,161,0,607,19,2,1
47647,6040,2020-11-18T16:16:23.9779713Z,2020,577,125,424,312,0,13,1,265,0,0,452,153,0,564,16,3,0
68510,25989,2021-06-24T05:35:14.5112224Z,2021,353,132,304,167,0,4,0,186,0,0,221,49,0,349,0,0,0
68510,9267,2020-11-18T16:16:46.70713Z,2012,563,188,437,273,0,3,0,290,0,0,375,126,9,548,0,0,3
68510,9268,2020-11-18T16:16:46.70813Z,2013,530,193,355,265,0,0,0,265,0,0,337,175,2,526,0,0,2
68510,9269,2020-11-18T16:16:46.70813Z,2014,515,186,408,258,0,1,0,257,0,0,329,107,1,513,0,0,0
68510,9270,2020-11-18T16:16:46.70813Z,2015,568,185,474,289,0,3,0,279,0,0,383,94,1,564,0,2,0
68510,9271,2020-11-18T16:16:46.70813Z,2016,507,160,417,267,0,0,16,240,0,0,347,90,1,506,0,3,0
68510,9272,2020-11-18T16:16:46.7091313Z,2017,531,198,452,262,0,0,54,269,0,0,333,79,3,528,0,1,0
68510,9273,2020-11-18T16:16:46.7091313Z,2018,474,140,396,233,0,2,36,241,0,0,334,78,2,470,0,1,0
68510,9274,2020-11-18T16:16:46.7091313Z,2019,393,141,321,194,0,1,22,199,0,0,252,72,1,391,0,1,0
68510,9275,2020-11-18T16:16:46.7101318Z,2020,372,143,303,185,0,2,26,187,0,0,229,69,0,369,0,0,1
21758,2281,2020-11-18T16:16:00.0400128Z,2012,486,6,395,248,0,1,0,238,0,0,480,91,0,484,0,0,1
21758,2282,2020-11-18T16:16:00.0400128Z,2013,469,12,401,236,0,2,0,233,0,0,457,68,0,465,0,1,2
21758,2283,2020-11-18T16:16:00.0400128Z,2014,476,44,395,247,0,4,0,229,0,0,432,81,0,470,0,1,2
21758,2284,2020-11-18T16:16:00.0410128Z,2015,406,40,339,207,0,5,0,199,0,0,366,67,0,400,0,1,1
21758,2285,2020-11-18T16:16:00.0410128Z,2016,399,77,313,202,0,4,1,197,0,0,322,86,0,395,0,0,0
21758,2286,2020-11-18T16:16:00.0410128Z,2017,475,122,387,231,0,2,4,244,0,0,353,88,0,473,0,2,0
21758,2287,2020-11-18T16:16:00.0420146Z,2018,488,93,377,240,0,1,3,248,0,0,395,111,0,487,3,2,0
21758,2288,2020-11-18T16:16:00.0420146Z,2019,397,90,312,189,0,0,1,208,0,0,307,85,0,397,0,1,0
21758,2289,2020-11-18T16:16:00.0420146Z,2020,370,123,280,182,0,1,2,188,0,0,247,90,0,369,0,1,0
21758,31712,2021-06-24T05:35:15.3698376Z,2021,381,122,313,185,0,1,2,196,0,0,259,68,0,380,0,2,0
12278,25631,2021-06-24T05:35:04.6841758Z,2021,264,77,228,127,0,3,5,137,0,0,187,36,2,259,0,0,0
12278,678,2020-11-18T16:15:50.2444765Z,2012,391,88,265,181,0,1,0,210,0,0,303,126,0,390,0,0,0
12278,679,2020-11-18T16:15:50.2454773Z,2013,377,86,222,182,0,2,0,195,0,0,291,155,0,375,0,1,0
12278,680,2020-11-18T16:15:50.2454773Z,2014,377,79,236,187,0,3,0,190,0,0,298,141,0,374,0,1,0
12278,681,2020-11-18T16:15:50.2454773Z,2015,384,76,238,194,0,1,0,190,0,0,308,146,0,383,0,0,0
12278,682,2020-11-18T16:15:50.2454773Z,2016,329,70,126,158,0,3,0,171,0,0,259,203,0,326,0,0,0
12278,683,2020-11-18T16:15:50.2454773Z,2017,308,71,202,144,0,2,0,164,0,0,237,106,0,306,0,0,0
12278,684,2020-11-18T16:15:50.2464773Z,2018,309,68,202,140,0,2,1,169,0,0,241,107,0,307,0,0,0
12278,685,2020-11-18T16:15:50.2464773Z,2019,318,98,229,143,0,1,13,175,0,2,220,89,0,317,0,0,0
12278,686,2020-11-18T16:15:50.2464773Z,2020,306,87,229,146,0,3,6,160,0,0,219,77,2,301,0,0,0
33563,25783,2021-06-24T05:35:10.8596037Z,2021,348,81,266,186,0,4,0,162,0,0,267,82,2,340,0,0,2
33563,4085,2020-11-18T16:16:10.3088595Z,2012,351,75,267,155,0,13,0,196,0,0,276,84,4,334,0,0,0
33563,4086,2020-11-18T16:16:10.3088595Z,2013,296,59,218,133,0,3,0,163,0,0,237,78,5,288,0,3,0
33563,4087,2020-11-18T16:16:10.3088595Z,2014,269,56,204,128,0,4,0,141,0,0,213,65,7,258,0,0,0
33563,4088,2020-11-18T16:16:10.3098604Z,2015,278,59,198,138,0,6,0,140,0,0,219,80,7,264,0,1,1
33563,4089,2020-11-18T16:16:10.3098604Z,2016,272,55,172,137,0,3,2,135,0,0,217,100,6,262,0,2,1
33563,4090,2020-11-18T16:16:10.3098604Z,2017,271,56,201,129,0,1,0,142,0,0,215,70,5,265,0,1,0
33563,4091,2020-11-18T16:16:10.3108608Z,2018,287,65,216,147,0,2,0,140,0,0,222,71,4,280,0,1,1
33563,4092,2020-11-18T16:16:10.3108608Z,2019,348,105,257,175,0,1,0,173,0,0,243,91,5,341,0,3,1
33563,4093,2020-11-18T16:16:10.3108608Z,2020,348,90,249,176,0,6,0,172,0,0,258,99,3,338,0,2,1
62539,31962,2021-06-24T05:35:20.2523393Z,2021,208,105,191,89,0,10,0,119,0,0,103,17,0,198,0,0,0
62539,8553,2020-11-18T16:16:40.8862485Z,2012,286,111,245,129,0,13,0,157,0,0,175,41,1,272,0,0,0
62539,8554,2020-11-18T16:16:40.8862485Z,2013,240,96,216,112,0,7,0,128,0,0,144,24,1,232,0,0,0
62539,8555,2020-11-18T16:16:40.887249Z,2014,292,102,259,137,0,13,0,155,0,0,190,33,1,277,0,0,1
62539,8556,2020-11-18T16:16:40.887249Z,2015,296,103,261,134,0,13,0,162,0,0,193,35,0,282,0,0,1
62539,8557,2020-11-18T16:16:40.887249Z,2016,270,90,229,128,0,16,0,142,0,0,180,41,0,253,0,0,1
62539,8558,2020-11-18T16:16:40.887249Z,2017,232,89,195,106,0,15,0,126,0,0,143,37,0,217,0,0,0
62539,8559,2020-11-18T16:16:40.888249Z,2018,249,98,203,102,0,12,0,147,0,0,151,46,0,237,0,0,0
62539,8560,2020-11-18T16:16:40.888249Z,2019,247,123,213,104,0,10,2,143,0,0,124,34,0,237,0,0,0
62539,8561,2020-11-18T16:16:40.888249Z,2020,220,108,191,92,0,8,0,128,0,0,112,29,0,212,0,0,0
10710,176,2020-11-18T16:15:46.3869045Z,2012,502,180,391,246,0,5,0,256,0,0,322,111,0,497,0,0,0
10710,177,2020-11-18T16:15:46.3869045Z,2013,482,179,360,231,0,5,0,251,0,0,303,122,0,477,0,0,0
10710,178,2020-11-18T16:15:46.3879045Z,2014,494,205,363,234,0,5,0,260,0,0,289,131,0,489,0,0,0
10710,179,2020-11-18T16:15:46.3879045Z,2015,443,169,319,218,0,7,0,225,0,0,274,124,0,436,0,1,0
10710,180,2020-11-18T16:15:46.3879045Z,2016,388,152,196,174,0,2,0,214,0,0,236,192,0,385,0,2,1
10710,181,2020-11-18T16:15:46.3879045Z,2017,429,177,363,188,0,4,0,241,0,0,252,66,0,424,0,1,1
10710,182,2020-11-18T16:15:46.3879045Z,2018,448,144,327,212,0,7,0,236,0,0,304,121,0,440,0,1,1
10710,183,2020-11-18T16:15:46.3879045Z,2019,380,144,302,178,0,5,0,202,0,0,236,78,0,375,0,0,0
10710,184,2020-11-18T16:15:46.388905Z,2020,334,125,268,150,0,4,0,184,0,0,209,66,0,330,0,0,0
10710,31585,2021-06-24T05:35:14.5272334Z,2021,322,130,277,136,0,1,0,186,0,0,192,45,0,321,0,0,0
16220,1287,2020-11-18T16:15:53.6127249Z,2014,472,112,333,211,0,0,0,261,0,0,360,139,0,472,0,0,0
16220,1288,2020-11-18T16:15:53.6127249Z,2015,547,121,434,270,0,0,0,277,0,0,426,113,2,545,0,0,0
16220,1289,2020-11-18T16:15:53.6137254Z,2016,507,113,317,250,0,3,4,257,0,0,394,190,1,503,0,4,0
16220,1290,2020-11-18T16:15:53.6137254Z,2017,372,98,306,182,0,3,0,190,0,0,274,66,0,369,0,1,0
16220,1291,2020-11-18T16:15:53.6137254Z,2018,353,71,270,182,0,2,33,171,0,0,282,83,1,350,0,1,0
16220,1292,2020-11-18T16:15:53.6137254Z,2019,334,79,264,172,0,1,6,162,0,0,255,70,0,333,1,1,0
16220,1293,2020-11-18T16:15:53.6137254Z,2020,318,78,250,157,0,1,7,161,0,0,240,68,0,316,1,0,1
16220,31872,2021-06-24T05:35:18.4400387Z,2021,257,59,210,131,0,1,0,126,0,0,198,47,0,254,1,0,2
60038,25936,2021-06-24T05:35:12.8330183Z,2021,94,10,45,89,0,2,0,5,0,0,84,49,1,91,0,0,0
60038,7924,2020-11-18T16:16:37.0907191Z,2012,124,8,57,118,0,0,0,6,0,0,116,67,0,124,0,0,0
60038,7925,2020-11-18T16:16:37.0917218Z,2013,126,11,57,120,0,1,0,6,0,0,115,69,0,125,0,0,0
60038,7926,2020-11-18T16:16:37.0917218Z,2014,111,11,52,105,0,1,0,6,0,0,100,59,1,109,0,1,0
60038,7927,2020-11-18T16:16:37.0917218Z,2015,113,13,45,105,0,3,0,8,0,0,100,68,0,110,0,1,0
60038,7928,2020-11-18T16:16:37.0917218Z,2016,109,14,45,100,0,5,0,9,0,0,95,64,0,104,0,0,0
60038,7929,2020-11-18T16:16:37.0917218Z,2017,113,14,50,105,0,6,0,8,0,0,99,63,1,106,0,0,0
60038,7930,2020-11-18T16:16:37.0927204Z,2018,110,10,47,100,0,6,0,10,0,0,100,63,1,103,0,0,0
60038,7931,2020-11-18T16:16:37.0927204Z,2019,106,14,42,96,0,3,1,10,0,0,92,64,2,101,0,0,0
60038,7932,2020-11-18T16:16:37.0927204Z,2020,106,11,50,99,0,4,0,7,0,0,95,56,1,101,0,0,0
55475,31915,2021-06-24T05:35:18.4860717Z,2021,215,74,190,96,0,1,5,119,0,0,141,25,1,212,2,0,1
55475,7487,2020-11-18T16:16:33.7164638Z,2012,389,98,358,172,0,5,0,217,0,0,291,31,8,375,0,0,1
55475,7488,2020-11-18T16:16:33.7164638Z,2013,401,117,357,185,0,4,0,216,0,0,284,44,7,390,0,3,0
55475,7489,2020-11-18T16:16:33.7164638Z,2014,412,127,371,189,0,4,0,223,0,0,285,41,5,403,0,3,0
55475,7490,2020-11-18T16:16:33.7174651Z,2015,432,137,389,203,0,6,0,229,0,0,295,43,8,417,0,2,1
55475,7491,2020-11-18T16:16:33.7174651Z,2016,441,133,192,208,0,7,4,233,0,0,308,249,6,428,0,1,0
55475,7492,2020-11-18T16:16:33.7174651Z,2017,338,93,279,153,0,7,2,185,0,0,245,59,1,330,0,1,0
55475,7493,2020-11-18T16:16:33.7174651Z,2018,326,92,234,147,0,9,4,179,0,0,234,92,0,316,2,0,1
55475,7494,2020-11-18T16:16:33.7174651Z,2019,349,121,308,169,0,5,12,180,0,0,228,41,0,342,2,1,2
55475,7495,2020-11-18T16:16:33.7184673Z,2020,295,110,253,128,0,4,28,167,0,0,185,42,0,289,2,1,2
52704,25898,2021-06-24T05:35:12.7939906Z,2021,160,52,142,79,0,0,18,81,0,0,108,18,0,160,0,0,0
52704,6954,2020-11-18T16:16:30.8825774Z,2012,220,69,180,97,0,0,0,123,0,0,151,40,0,220,0,0,0
52704,6955,2020-11-18T16:16:30.8825774Z,2013,230,73,187,102,0,1,0,128,0,0,157,43,0,229,0,2,0
52704,6956,2020-11-18T16:16:30.8825774Z,2014,198,67,162,95,0,0,0,103,0,0,131,36,0,198,0,0,0
52704,6957,2020-11-18T16:16:30.8835787Z,2015,237,87,197,108,0,0,0,129,0,0,150,40,0,237,0,0,0
52704,6958,2020-11-18T16:16:30.8835787Z,2016,260,100,221,112,0,2,0,148,0,0,160,39,0,258,0,0,0
52704,6959,2020-11-18T16:16:30.8835787Z,2017,232,83,196,111,0,1,0,121,0,0,149,36,0,231,0,0,0
52704,6960,2020-11-18T16:16:30.8845796Z,2018,213,73,172,109,0,1,33,104,0,0,140,41,0,212,1,0,0
52704,6961,2020-11-18T16:16:30.8845796Z,2019,198,68,174,96,0,1,29,102,0,0,130,24,0,197,0,0,0
52704,6962,2020-11-18T16:16:30.8845796Z,2020,200,65,171,90,0,1,38,110,0,0,135,29,0,199,0,0,0
11908,25594,2021-06-24T05:35:04.604118Z,2021,220,42,203,105,0,4,0,115,0,0,178,17,0,216,0,1,0
11908,501,2020-11-18T16:15:49.6590888Z,2012,199,48,175,86,0,7,0,113,0,0,151,24,1,191,0,0,0
11908,502,2020-11-18T16:15:49.6590888Z,2013,178,38,144,77,0,9,0,101,0,0,140,34,0,169,0,0,0
11908,503,2020-11-18T16:15:49.6590888Z,2014,204,51,145,90,0,7,0,114,0,0,153,59,0,197,0,1,0
11908,504,2020-11-18T16:15:49.6590888Z,2015,203,50,169,95,0,4,0,108,0,0,153,34,0,199,0,0,0
11908,505,2020-11-18T16:15:49.6600897Z,2016,178,42,125,82,0,1,0,96,0,0,136,53,0,177,0,0,0
11908,506,2020-11-18T16:15:49.6600897Z,2017,255,57,224,111,0,4,1,144,0,0,198,31,0,251,0,2,0
11908,507,2020-11-18T16:15:49.6600897Z,2018,235,48,194,104,0,7,0,131,0,0,187,41,0,228,4,2,0
11908,508,2020-11-18T16:15:49.6600897Z,2019,200,44,172,91,0,4,0,109,0,0,156,28,0,196,0,1,0
11908,509,2020-11-18T16:15:49.6610915Z,2020,197,40,175,90,0,4,0,107,0,0,157,22,0,193,0,1,0
70292,31648,2021-06-24T05:35:14.6673348Z,2021,312,103,271,155,0,6,0,157,0,0,209,41,0,305,0,0,1
70292,9597,2020-11-18T16:16:49.2248075Z,2012,322,105,294,174,0,3,0,148,0,0,217,28,0,318,0,0,1
70292,9598,2020-11-18T16:16:49.2258079Z,2013,315,108,284,183,0,3,0,132,0,0,207,31,0,311,0,2,1
70292,9599,2020-11-18T16:16:49.2258079Z,2014,336,120,307,196,0,3,0,140,0,0,216,29,0,333,0,0,0
70292,9600,2020-11-18T16:16:49.2258079Z,2015,330,118,314,180,0,2,0,150,0,0,212,16,0,328,0,0,0
70292,9601,2020-11-18T16:16:49.7041255Z,2016,308,112,268,155,0,1,0,153,0,0,196,40,0,307,0,0,0
70292,9602,2020-11-18T16:16:49.7041255Z,2017,313,135,285,148,0,1,0,165,0,0,178,28,0,311,0,0,1
70292,9603,2020-11-18T16:16:49.7041255Z,2018,296,110,252,142,0,4,0,154,0,0,186,44,0,291,1,0,1
70292,9604,2020-11-18T16:16:49.7041255Z,2019,297,112,269,148,0,4,6,149,0,0,185,28,0,292,1,0,1
70292,9605,2020-11-18T16:16:49.7051255Z,2020,263,96,241,132,0,5,4,131,0,0,167,22,0,257,0,0,1
10314,25579,2021-06-24T05:35:04.5921094Z,2021,175,62,143,84,0,2,0,91,0,0,113,32,0,173,0,0,0
10314,58,2020-11-18T16:15:45.5283319Z,2012,343,118,259,151,0,13,0,192,0,0,225,84,0,330,0,0,0
10314,59,2020-11-18T16:15:45.5293314Z,2013,315,115,237,138,0,13,0,177,0,0,200,78,0,302,0,3,0
10314,60,2020-11-18T16:15:45.5293314Z,2014,279,109,194,124,0,5,0,155,0,0,170,85,0,274,0,1,0
10314,61,2020-11-18T16:15:45.5293314Z,2015,285,111,215,129,0,4,0,156,0,0,174,70,0,281,0,1,0
10314,62,2020-11-18T16:15:45.5303319Z,2016,250,104,97,110,0,5,2,140,0,0,146,153,0,245,0,0,0
10314,63,2020-11-18T16:15:45.5303319Z,2017,257,98,200,114,0,4,2,143,0,0,159,57,0,252,0,0,1
10314,64,2020-11-18T16:15:45.5303319Z,2018,225,87,171,106,0,3,10,119,0,0,138,54,0,222,0,0,0
10314,65,2020-11-18T16:15:45.5303319Z,2019,192,87,152,95,0,1,0,97,0,0,105,40,0,191,0,0,0
10314,66,2020-11-18T16:15:45.5303319Z,2020,194,76,160,89,0,6,0,105,0,0,118,34,0,188,0,0,0
61416,31946,2021-06-24T05:35:18.5421123Z,2021,642,189,412,283,0,12,0,359,0,0,453,230,2,627,0,0,1
61416,8171,2020-11-18T16:16:38.6127298Z,2012,565,117,225,277,0,20,0,288,0,0,448,340,0,545,0,0,0
61416,8172,2020-11-18T16:16:38.6137293Z,2013,601,137,280,294,0,29,0,307,0,0,464,321,0,572,0,1,0
61416,8173,2020-11-18T16:16:38.6137293Z,2014,653,158,299,307,0,24,0,346,0,0,495,354,0,629,0,2,0
61416,8174,2020-11-18T16:16:38.6137293Z,2015,691,163,325,320,0,23,0,371,0,0,528,366,1,667,0,3,0
61416,8175,2020-11-18T16:16:38.6147307Z,2016,702,184,321,325,0,20,1,377,0,0,518,381,1,681,0,1,0
61416,8176,2020-11-18T16:16:38.6147307Z,2017,665,192,343,314,0,18,1,351,0,0,473,322,2,644,0,1,1
61416,8177,2020-11-18T16:16:38.6147307Z,2018,581,135,281,277,0,16,4,304,0,0,446,300,0,563,2,1,2
61416,8178,2020-11-18T16:16:38.6157311Z,2019,633,171,349,281,0,17,0,352,0,0,462,284,1,614,2,1,1
61416,8179,2020-11-18T16:16:38.6157311Z,2020,669,180,355,301,0,19,1,368,0,0,489,314,2,645,0,1,3
43224,31838,2021-06-24T05:35:16.964981Z,2021,439,186,352,193,0,10,0,246,0,0,253,87,0,428,1,2,1
43224,5473,2020-11-18T16:16:19.7941835Z,2012,560,71,423,268,0,2,0,292,0,0,489,137,0,558,0,0,0
43224,5474,2020-11-18T16:16:19.7941835Z,2013,494,102,374,245,0,3,0,249,0,0,392,120,0,490,0,3,1
43224,5475,2020-11-18T16:16:19.7941835Z,2014,447,108,343,217,0,2,0,230,0,0,339,104,0,445,0,2,0
43224,5476,2020-11-18T16:16:19.7941835Z,2015,422,114,338,192,0,4,0,230,0,0,308,84,0,418,0,3,0
43224,5477,2020-11-18T16:16:19.7941835Z,2016,319,106,232,147,0,2,4,172,0,0,213,87,1,316,0,2,0
43224,5478,2020-11-18T16:16:19.795183Z,2017,354,116,286,169,0,3,1,185,0,0,238,68,1,350,0,3,0
43224,5479,2020-11-18T16:16:19.795183Z,2018,436,160,339,201,0,5,5,235,0,0,276,97,0,431,1,3,0
43224,5480,2020-11-18T16:16:19.795183Z,2019,653,264,540,296,0,18,0,357,0,0,389,113,0,635,0,5,0
43224,5481,2020-11-18T16:16:19.795183Z,2020,511,225,436,222,0,14,0,289,0,0,286,75,0,496,1,4,1
23515,2562,2020-11-18T16:16:02.0923764Z,2012,256,91,233,115,0,0,0,141,0,0,165,23,0,256,0,0,0
23515,2563,2020-11-18T16:16:02.0933773Z,2013,215,91,188,90,0,1,0,125,0,0,124,27,0,214,0,0,0
23515,2564,2020-11-18T16:16:02.0933773Z,2014,215,96,169,91,0,0,0,124,0,0,119,46,0,215,0,0,0
23515,2565,2020-11-18T16:16:02.0933773Z,2015,245,106,214,111,0,1,0,134,0,0,139,31,0,244,0,0,0
23515,2566,2020-11-18T16:16:02.0933773Z,2016,199,90,105,93,0,1,4,106,0,0,109,94,0,198,0,0,0
23515,2567,2020-11-18T16:16:02.0933773Z,2017,172,78,152,79,0,1,1,93,0,0,94,20,0,171,0,0,0
23515,2568,2020-11-18T16:16:02.0943782Z,2018,216,96,187,92,0,1,5,124,0,0,120,29,0,215,0,0,0
23515,2569,2020-11-18T16:16:02.0943782Z,2019,204,98,173,87,0,1,0,117,0,0,106,31,0,203,0,0,0
23515,2570,2020-11-18T16:16:02.0943782Z,2020,204,95,171,84,0,3,3,120,0,0,109,33,0,201,0,0,0
23515,25717,2021-06-24T05:35:08.6710337Z,2021,177,86,150,64,0,1,0,113,0,0,91,27,0,176,0,0,0
45641,25848,2021-06-24T05:35:10.9686813Z,2021,76,22,64,40,0,0,0,36,0,0,54,12,0,76,0,0,0
45641,5812,2020-11-18T16:16:22.5680311Z,2012,117,29,91,49,0,3,0,68,0,0,88,26,0,114,0,0,0
45641,5813,2020-11-18T16:16:22.5690306Z,2013,115,30,92,55,0,3,0,60,0,0,85,23,0,112,0,1,0
45641,5814,2020-11-18T16:16:22.5690306Z,2014,114,32,89,51,0,1,0,63,0,0,82,25,0,113,0,1,0
45641,5815,2020-11-18T16:16:22.5690306Z,2015,118,30,83,60,0,0,0,58,0,0,88,35,0,118,0,0,0
45641,5816,2020-11-18T16:16:22.5690306Z,2016,137,36,91,70,0,1,0,67,0,0,101,46,0,136,0,1,0
45641,5817,2020-11-18T16:16:22.5700311Z,2017,128,31,109,64,0,0,0,64,0,0,97,19,0,128,0,0,0
45641,5818,2020-11-18T16:16:22.5700311Z,2018,124,35,104,63,0,0,0,61,0,0,89,20,0,121,0,0,3
45641,5819,2020-11-18T16:16:22.5700311Z,2019,92,32,79,42,0,0,0,50,0,0,60,13,0,92,0,0,0
45641,5820,2020-11-18T16:16:22.5710324Z,2020,91,32,73,47,0,1,0,44,0,0,59,18,0,90,0,0,0
61424,25945,2021-06-24T05:35:12.8450296Z,2021,169,169,116,70,0,6,18,99,0,0,0,53,0,163,0,0,0
61424,8180,2020-11-18T16:16:38.6417494Z,2012,196,118,139,81,0,6,0,115,0,0,78,57,0,190,0,0,0
61424,8181,2020-11-18T16:16:38.6417494Z,2013,200,138,144,77,0,9,0,123,0,0,62,56,0,191,0,0,0
61424,8182,2020-11-18T16:16:38.6427485Z,2014,221,172,150,80,0,11,0,141,0,0,49,71,0,210,0,0,0
61424,8183,2020-11-18T16:16:38.6427485Z,2015,242,192,170,95,0,9,0,147,0,0,50,72,0,233,0,0,0
61424,8184,2020-11-18T16:16:38.6427485Z,2016,238,220,153,101,0,5,4,137,0,0,18,85,0,233,0,0,0
61424,8185,2020-11-18T16:16:38.6427485Z,2017,233,216,154,100,0,7,5,133,0,0,17,79,0,226,0,0,0
61424,8186,2020-11-18T16:16:38.6437498Z,2018,234,190,156,101,0,7,14,133,0,0,44,78,0,227,0,0,0
61424,8187,2020-11-18T16:16:38.6437498Z,2019,196,182,124,84,0,7,15,112,0,0,14,72,0,189,0,0,0
61424,8188,2020-11-18T16:16:38.6437498Z,2020,185,183,125,77,0,7,20,108,0,0,2,60,0,178,0,0,0
30916,25762,2021-06-24T05:35:08.7360802Z,2021,286,86,236,154,0,2,2,132,0,0,200,50,1,283,2,0,0
30916,3489,2020-11-18T16:16:07.0606897Z,2012,320,88,242,144,0,3,0,176,0,0,232,78,1,316,0,0,0
30916,3490,2020-11-18T16:16:07.0616906Z,2013,330,83,254,157,0,3,0,173,0,0,247,76,2,325,0,6,0
30916,3491,2020-11-18T16:16:07.0616906Z,2014,355,104,278,180,0,5,0,175,0,0,251,77,2,347,0,2,1
30916,3492,2020-11-18T16:16:07.0616906Z,2015,324,104,240,163,0,3,0,161,0,0,220,84,2,318,0,1,1
30916,3493,2020-11-18T16:16:07.0626906Z,2016,354,100,250,180,0,2,0,174,0,0,254,104,0,351,0,0,1
30916,3494,2020-11-18T16:16:07.0626906Z,2017,333,100,255,181,0,0,1,152,0,0,233,78,0,332,0,0,1
30916,3495,2020-11-18T16:16:07.0626906Z,2018,294,72,219,172,0,0,0,122,0,0,222,75,1,293,3,0,0
30916,3496,2020-11-18T16:16:07.0626906Z,2019,274,85,209,149,1,0,7,125,0,0,189,65,0,274,2,0,0
30916,3497,2020-11-18T16:16:07.0626906Z,2020,286,81,212,154,0,1,0,132,0,0,205,74,0,285,2,0,0
71779,10478,2020-11-18T16:16:54.732478Z,2012,579,0,400,306,0,1,0,273,0,0,579,179,0,578,0,0,0
71779,10479,2020-11-18T16:16:54.732478Z,2013,589,3,399,310,0,5,0,279,0,0,586,190,0,584,0,0,0
71779,10480,2020-11-18T16:16:54.732478Z,2014,599,32,413,330,0,9,0,269,0,0,567,186,0,589,0,1,1
71779,10481,2020-11-18T16:16:54.732478Z,2015,603,31,425,335,0,12,0,268,0,0,572,178,1,589,0,0,1
71779,10482,2020-11-18T16:16:54.732478Z,2016,555,62,258,307,0,7,0,248,0,0,493,297,1,546,0,0,1
71779,10483,2020-11-18T16:16:54.7334784Z,2017,512,61,379,275,0,6,0,237,0,0,451,133,0,506,0,0,0
71779,10484,2020-11-18T16:16:54.7334784Z,2018,619,89,444,323,0,4,0,296,0,0,530,175,0,615,3,0,0
71779,10485,2020-11-18T16:16:54.7334784Z,2019,620,100,464,323,0,1,1,297,0,1,520,156,0,619,3,0,0
71779,10486,2020-11-18T16:16:54.7334784Z,2020,615,128,474,313,0,1,1,302,0,0,487,141,0,614,3,0,0
71779,25622,2021-06-24T05:35:04.6601577Z,2021,376,71,310,228,0,2,0,148,0,0,305,66,0,373,1,0,1
61432,31947,2021-06-24T05:35:18.5421123Z,2021,233,80,215,114,0,35,0,119,0,0,153,18,0,196,4,1,2
61432,8189,2020-11-18T16:16:38.6437498Z,2012,264,37,212,118,0,38,0,146,0,0,227,52,0,224,0,0,2
61432,8190,2020-11-18T16:16:38.6437498Z,2013,252,59,213,103,0,45,0,149,0,0,193,39,1,205,0,0,1
61432,8191,2020-11-18T16:16:38.6437498Z,2014,227,71,185,92,0,43,0,135,0,0,156,42,1,183,0,0,0
61432,8192,2020-11-18T16:16:38.6447512Z,2015,211,57,179,91,0,36,0,120,0,0,154,32,0,174,0,0,1
61432,8193,2020-11-18T16:16:38.6447512Z,2016,282,97,231,122,0,46,0,160,0,0,185,51,0,231,0,1,5
61432,8194,2020-11-18T16:16:38.6447512Z,2017,271,90,227,125,0,39,0,146,0,0,181,44,0,228,0,0,4
61432,8195,2020-11-18T16:16:38.6447512Z,2018,331,93,287,173,0,42,0,158,0,0,238,44,0,287,7,1,2
61432,8196,2020-11-18T16:16:38.6447512Z,2019,306,98,272,168,0,58,0,138,0,0,208,34,0,246,7,1,2
61432,8197,2020-11-18T16:16:38.6457512Z,2020,289,93,265,150,0,46,0,139,0,0,196,24,0,241,5,1,2
52761,25742,2021-06-24T05:35:08.6920486Z,2021,105,23,77,54,0,0,0,51,0,0,82,28,0,103,0,1,2
52761,6980,2020-11-18T16:16:30.8955859Z,2012,45,9,40,19,0,1,0,26,0,0,36,5,0,43,0,0,1
52761,6981,2020-11-18T16:16:30.8955859Z,2013,66,11,51,33,0,1,0,33,0,0,55,15,1,64,0,0,0
52761,6982,2020-11-18T16:16:30.8965868Z,2014,51,11,43,26,0,0,0,25,0,0,40,8,1,50,0,2,0
52761,6983,2020-11-18T16:16:30.8965868Z,2015,79,16,71,38,0,2,0,41,0,0,63,8,0,77,0,4,0
52761,6984,2020-11-18T16:16:30.8965868Z,2016,95,20,77,43,0,0,0,52,0,0,75,18,0,93,0,3,2
52761,6985,2020-11-18T16:16:30.8975872Z,2017,104,24,84,45,0,0,0,59,0,0,80,20,0,104,0,4,0
52761,6986,2020-11-18T16:16:30.8975872Z,2018,132,23,110,57,0,0,0,75,0,0,109,22,0,131,1,3,1
52761,6987,2020-11-18T16:16:30.8975872Z,2019,123,23,96,60,0,0,2,63,0,0,100,27,0,122,0,4,1
52761,6988,2020-11-18T16:16:30.898589Z,2020,105,20,77,47,0,0,5,58,0,0,85,28,0,104,2,1,1
43406,31842,2021-06-24T05:35:16.9679829Z,2021,264,91,214,107,0,2,0,157,0,0,173,50,0,261,1,2,1
43406,5557,2020-11-18T16:16:20.7298087Z,2012,300,37,246,135,0,3,0,165,0,0,263,54,0,297,0,0,0
43406,5558,2020-11-18T16:16:20.7298087Z,2013,312,49,265,144,0,4,0,168,0,0,263,47,0,308,0,3,0
43406,5559,2020-11-18T16:16:20.7298087Z,2014,338,71,274,159,0,5,0,179,0,0,267,64,0,333,0,0,0
43406,5560,2020-11-18T16:16:20.7298087Z,2015,323,59,271,156,0,4,0,167,0,0,264,52,0,319,0,0,0
43406,5561,2020-11-18T16:16:20.7308096Z,2016,335,89,259,172,0,1,1,163,0,0,246,76,0,334,0,0,0
43406,5562,2020-11-18T16:16:20.7308096Z,2017,342,89,269,166,0,1,0,176,0,0,253,73,0,341,0,0,0
43406,5563,2020-11-18T16:16:20.7308096Z,2018,348,89,279,168,0,1,0,180,0,0,259,69,0,347,0,0,0
43406,5564,2020-11-18T16:16:20.7308096Z,2019,320,89,258,136,0,0,0,184,0,0,231,62,0,320,0,0,0
43406,5565,2020-11-18T16:16:20.7308096Z,2020,311,91,256,140,0,1,0,171,0,0,220,55,0,310,1,1,0
64998,31979,2021-06-24T05:35:20.2833609Z,2021,130,108,65,50,0,1,0,80,0,0,22,65,0,125,0,0,4
64998,9005,2020-11-18T16:16:44.8759058Z,2012,139,68,76,67,0,1,0,72,0,0,71,63,0,135,0,0,3
64998,9006,2020-11-18T16:16:44.8759058Z,2013,127,74,77,58,0,1,0,69,0,0,53,50,0,123,0,0,3
64998,9007,2020-11-18T16:16:44.8759058Z,2014,139,96,77,64,0,1,0,75,0,0,43,62,0,135,0,1,3
64998,9008,2020-11-18T16:16:44.8759058Z,2015,136,94,58,64,0,1,0,72,0,0,42,78,0,131,0,0,4
64998,9009,2020-11-18T16:16:44.8759058Z,2016,147,108,60,66,0,1,0,81,0,0,39,87,0,142,0,0,4
64998,9010,2020-11-18T16:16:44.8769067Z,2017,138,104,59,61,0,1,0,77,0,0,34,79,0,134,0,0,3
64998,9011,2020-11-18T16:16:44.8769067Z,2018,134,97,62,57,3,1,0,77,0,1,37,72,0,130,0,0,3
64998,9012,2020-11-18T16:16:44.8769067Z,2019,126,107,59,49,3,1,1,77,0,0,19,67,0,122,0,0,3
64998,9013,2020-11-18T16:16:44.8769067Z,2020,131,113,65,51,0,1,1,80,0,0,18,66,0,127,0,0,3
53660,31906,2021-06-24T05:35:18.4830702Z,2021,130,29,113,65,0,5,13,65,0,0,101,17,0,125,0,0,0
53660,7295,2020-11-18T16:16:32.5206719Z,2012,110,31,105,54,0,0,0,56,0,0,79,5,0,110,0,0,0
53660,7296,2020-11-18T16:16:32.5206719Z,2013,110,25,108,56,0,1,0,54,0,0,85,2,0,109,0,1,0
53660,7297,2020-11-18T16:16:32.5206719Z,2014,114,26,111,59,0,2,0,55,0,0,88,3,0,112,0,0,0
53660,7298,2020-11-18T16:16:32.5216723Z,2015,100,24,85,48,0,2,0,52,0,0,76,15,0,98,0,0,0
53660,7299,2020-11-18T16:16:32.5216723Z,2016,90,19,79,43,0,3,8,47,0,0,71,11,0,87,0,0,0
53660,7300,2020-11-18T16:16:32.5216723Z,2017,82,23,81,41,0,2,10,41,0,0,59,1,0,80,0,0,0
53660,7301,2020-11-18T16:16:33.2221367Z,2018,76,19,73,37,0,1,13,39,0,0,57,3,0,75,0,0,0
53660,7302,2020-11-18T16:16:33.2221367Z,2019,112,31,108,50,0,1,15,62,0,0,81,4,0,111,0,0,0
53660,7303,2020-11-18T16:16:33.2221367Z,2020,120,36,114,53,0,1,14,67,0,0,84,6,0,119,0,0,0
17764,1441,2020-11-18T16:15:54.7604914Z,2012,367,66,250,184,0,3,0,183,0,0,301,117,0,364,0,0,0
17764,1442,2020-11-18T16:15:54.7604914Z,2013,363,91,261,179,0,2,0,184,0,0,272,102,0,361,0,0,0
17764,1443,2020-11-18T16:15:54.7604914Z,2014,318,88,233,157,0,2,0,161,0,0,230,85,0,316,0,0,0
17764,1444,2020-11-18T16:15:54.7614928Z,2015,483,150,376,239,0,6,0,244,0,0,333,107,0,477,0,0,0
17764,1445,2020-11-18T16:15:54.7614928Z,2016,426,130,306,213,0,11,0,213,0,0,296,120,0,415,0,0,0
17764,1446,2020-11-18T16:15:54.7614928Z,2017,412,121,317,207,0,7,1,205,0,0,291,95,0,405,0,1,0
17764,1447,2020-11-18T16:15:54.7614928Z,2018,375,125,313,190,0,7,0,185,0,0,250,62,0,368,0,0,0
17764,1448,2020-11-18T16:15:54.7614928Z,2019,353,132,294,172,0,6,0,181,0,0,221,59,0,347,0,2,0
17764,1449,2020-11-18T16:15:54.7614928Z,2020,345,132,286,162,0,8,0,183,0,0,213,59,0,337,0,0,0
17764,31613,2021-06-24T05:35:14.6112937Z,2021,300,117,260,151,0,8,0,149,0,0,183,40,0,292,1,1,0
35493,31797,2021-06-24T05:35:16.8699139Z,2021,389,122,318,176,0,3,2,213,0,0,267,71,0,385,3,2,1
35493,4338,2020-11-18T16:16:12.1650969Z,2012,567,66,378,285,0,10,0,282,0,0,501,189,2,555,0,0,0
35493,4339,2020-11-18T16:16:12.1650969Z,2013,528,120,368,261,0,11,0,267,0,0,408,160,0,517,0,3,0
35493,4340,2020-11-18T16:16:12.1650969Z,2014,564,148,417,275,0,8,0,289,0,0,416,147,1,554,0,1,1
35493,4341,2020-11-18T16:16:12.1660965Z,2015,528,149,391,266,0,6,0,262,0,0,379,137,2,519,0,1,1
35493,4342,2020-11-18T16:16:12.1660965Z,2016,440,126,222,222,0,4,0,218,0,0,314,218,4,431,0,2,1
35493,4343,2020-11-18T16:16:12.1660965Z,2017,401,95,327,196,0,5,2,205,0,0,306,74,2,394,0,1,0
35493,4344,2020-11-18T16:16:12.1670973Z,2018,340,84,276,172,0,4,0,168,0,0,256,64,0,336,2,0,0
35493,4345,2020-11-18T16:16:12.1670973Z,2019,278,85,236,126,0,2,1,152,0,0,193,42,0,276,5,0,0
35493,4346,2020-11-18T16:16:12.1670973Z,2020,351,116,287,160,0,4,0,191,0,0,235,64,0,346,6,1,1
45682,31850,2021-06-24T05:35:16.9799924Z,2021,713,231,582,349,0,6,0,364,0,0,482,131,0,707,4,1,0
45682,5821,2020-11-18T16:16:22.5710324Z,2012,710,0,519,366,0,4,0,344,0,0,710,191,0,705,0,0,1
45682,5822,2020-11-18T16:16:22.5720324Z,2013,672,4,495,367,0,8,0,305,0,0,668,177,0,663,0,4,1
45682,5823,2020-11-18T16:16:22.5720324Z,2014,736,56,534,388,0,6,0,348,0,0,680,202,0,728,0,3,2
45682,5824,2020-11-18T16:16:22.5720324Z,2015,743,64,566,356,0,5,0,387,0,0,679,177,0,736,0,5,2
45682,5825,2020-11-18T16:16:22.5720324Z,2016,737,136,478,349,0,6,0,388,0,0,601,259,1,727,0,3,3
45682,5826,2020-11-18T16:16:22.5730333Z,2017,768,152,583,367,0,8,0,401,0,0,616,185,2,756,0,7,2
45682,5827,2020-11-18T16:16:22.5730333Z,2018,840,191,618,409,0,14,0,431,0,2,649,222,3,823,3,8,0
45682,5828,2020-11-18T16:16:22.5730333Z,2019,770,194,591,388,0,8,0,382,0,3,576,179,0,762,4,4,0
45682,5829,2020-11-18T16:16:22.5740333Z,2020,724,241,568,364,0,9,0,360,0,0,483,156,0,715,5,3,0
32227,31772,2021-06-24T05:35:16.8448953Z,2021,403,96,335,193,0,7,0,210,0,0,307,68,0,396,0,0,0
32227,3789,2020-11-18T16:16:08.7348078Z,2012,533,44,398,287,0,8,0,246,0,0,489,135,7,518,0,0,0
32227,3790,2020-11-18T16:16:08.7348078Z,2013,581,77,426,303,0,7,0,278,0,0,504,155,5,569,0,3,0
32227,3791,2020-11-18T16:16:08.7348078Z,2014,532,84,402,290,0,3,0,242,0,0,448,130,0,529,0,2,0
32227,3792,2020-11-18T16:16:08.7348078Z,2015,547,90,399,277,0,8,0,270,0,0,457,148,0,538,0,2,1
32227,3793,2020-11-18T16:16:08.7358082Z,2016,512,94,378,257,0,9,0,255,0,0,418,134,0,502,0,2,1
32227,3794,2020-11-18T16:16:08.7358082Z,2017,517,96,413,265,0,7,1,252,0,0,421,104,1,508,0,1,1
32227,3795,2020-11-18T16:16:08.7358082Z,2018,522,94,408,265,0,5,1,257,0,0,428,114,1,516,4,0,0
32227,3796,2020-11-18T16:16:08.7358082Z,2019,422,108,347,204,0,2,0,218,0,0,314,75,2,418,2,0,0
32227,3797,2020-11-18T16:16:08.7358082Z,2020,397,100,328,187,0,5,0,210,0,0,297,69,1,391,1,0,0
54247,31908,2021-06-24T05:35:18.4820697Z,2021,173,71,163,85,0,4,0,88,0,0,102,10,0,169,0,0,0
54247,7341,2020-11-18T16:16:33.2411482Z,2012,325,119,259,139,0,8,0,186,0,0,206,66,0,317,0,0,0
54247,7342,2020-11-18T16:16:33.2421495Z,2013,327,129,246,157,0,5,0,170,0,0,198,81,0,320,0,0,2
54247,7343,2020-11-18T16:16:33.2421495Z,2014,303,122,231,141,0,9,0,162,0,0,181,72,0,294,0,0,0
54247,7344,2020-11-18T16:16:33.2421495Z,2015,304,121,254,136,0,6,0,168,0,0,183,50,0,298,0,1,0
54247,7345,2020-11-18T16:16:33.2431504Z,2016,246,101,214,115,0,6,1,131,0,0,145,32,0,240,0,0,0
54247,7346,2020-11-18T16:16:33.2431504Z,2017,229,94,207,107,0,3,0,122,0,0,135,22,0,226,0,0,0
54247,7347,2020-11-18T16:16:33.2431504Z,2018,200,83,179,91,0,2,1,109,0,0,117,21,0,198,0,0,0
54247,7348,2020-11-18T16:16:33.2441509Z,2019,224,104,197,107,0,2,5,117,0,0,120,27,0,222,0,0,0
54247,7349,2020-11-18T16:16:33.2441509Z,2020,242,100,216,115,0,4,6,127,0,0,142,26,0,238,0,0,0
35360,25795,2021-06-24T05:35:10.8756152Z,2021,320,77,272,154,0,2,0,166,0,0,243,48,1,317,2,0,0
35360,4329,2020-11-18T16:16:12.1610929Z,2012,318,74,198,175,0,2,0,143,0,0,244,120,0,316,0,0,0
35360,4330,2020-11-18T16:16:12.1610929Z,2013,320,75,212,178,0,2,0,142,0,0,245,108,0,318,0,1,0
35360,4331,2020-11-18T16:16:12.1620938Z,2014,296,71,177,159,0,2,0,137,0,0,225,119,0,294,0,1,0
35360,4332,2020-11-18T16:16:12.1620938Z,2015,326,64,225,176,0,4,0,150,0,0,262,101,0,321,0,3,1
35360,4333,2020-11-18T16:16:12.1620938Z,2016,295,70,205,153,0,2,0,142,0,0,225,90,0,293,0,2,0
35360,4334,2020-11-18T16:16:12.163096Z,2017,244,66,180,119,0,2,0,125,0,0,178,64,0,242,0,3,0
35360,4335,2020-11-18T16:16:12.163096Z,2018,309,60,239,153,0,5,4,156,0,0,249,70,0,304,1,3,0
35360,4336,2020-11-18T16:16:12.163096Z,2019,340,94,254,162,0,5,0,178,0,0,246,86,0,335,1,1,0
35360,4337,2020-11-18T16:16:12.1640947Z,2020,303,79,217,138,0,1,0,165,0,0,224,86,0,302,2,1,0
58511,25934,2021-06-24T05:35:12.8320178Z,2021,119,51,106,57,0,2,1,62,0,0,68,13,1,116,1,0,0
58511,7906,2020-11-18T16:16:37.0797111Z,2012,510,1,384,266,0,2,0,244,0,0,509,126,0,508,0,0,0
58511,7907,2020-11-18T16:16:37.0797111Z,2013,419,6,362,228,0,1,0,191,0,0,413,57,0,417,0,1,1
58511,7908,2020-11-18T16:16:37.0797111Z,2014,348,35,299,183,0,1,0,165,0,0,313,49,0,345,0,1,2
58511,7909,2020-11-18T16:16:37.0807111Z,2015,352,44,315,196,0,4,0,156,0,0,308,37,1,346,0,1,1
58511,7910,2020-11-18T16:16:37.0807111Z,2016,195,38,66,107,0,2,0,88,0,0,157,129,1,192,0,0,0
58511,7911,2020-11-18T16:16:37.0807111Z,2017,338,70,306,168,0,0,1,170,0,0,268,32,1,337,0,0,0
58511,7912,2020-11-18T16:16:37.0817124Z,2018,275,64,249,126,0,5,2,149,0,0,211,26,0,270,0,0,0
58511,7913,2020-11-18T16:16:37.0817124Z,2019,207,51,183,108,0,3,2,99,0,0,156,24,0,204,1,1,0
58511,7914,2020-11-18T16:16:37.0817124Z,2020,161,56,145,83,0,2,6,78,0,0,105,16,0,159,1,1,0
71894,10534,2020-11-18T16:16:55.4279428Z,2012,854,0,375,445,0,0,0,409,0,0,854,479,0,854,0,0,0
71894,10535,2020-11-18T16:16:55.4279428Z,2013,760,3,369,389,0,0,0,371,0,0,757,391,0,760,0,0,0
71894,10536,2020-11-18T16:16:55.4279428Z,2014,746,47,592,379,0,1,0,367,0,0,699,154,2,743,0,0,0
71894,10537,2020-11-18T16:16:55.4289441Z,2015,807,27,641,415,0,9,0,392,0,0,780,166,2,796,0,1,0
71894,10538,2020-11-18T16:16:55.4289441Z,2016,827,64,445,443,0,11,1,384,0,0,763,382,1,815,0,1,0
71894,10539,2020-11-18T16:16:55.4289441Z,2017,680,67,562,370,0,6,1,310,0,0,613,118,1,673,0,0,0
71894,10540,2020-11-18T16:16:55.4289441Z,2018,814,98,657,431,0,13,5,383,0,2,716,157,0,801,0,0,0
71894,10541,2020-11-18T16:16:55.4299437Z,2019,740,105,598,375,0,12,3,365,0,1,635,142,0,727,0,1,1
71894,10542,2020-11-18T16:16:55.4299437Z,2020,739,149,603,397,0,6,0,342,0,0,590,136,0,733,0,0,0
71894,25624,2021-06-24T05:35:04.66116Z,2021,732,140,620,399,0,11,0,333,0,0,592,112,0,721,0,2,0
56093,31919,2021-06-24T05:35:18.4910759Z,2021,320,110,269,154,0,0,2,166,0,0,210,51,2,318,0,0,0
56093,7559,2020-11-18T16:16:34.5390141Z,2012,514,142,395,229,0,9,0,285,0,0,372,119,0,505,0,0,0
56093,7560,2020-11-18T16:16:34.5390141Z,2013,537,161,424,243,0,7,0,294,0,0,376,113,0,530,0,4,0
56093,7561,2020-11-18T16:16:34.540015Z,2014,532,164,427,245,0,3,0,287,0,0,368,105,0,529,0,1,0
56093,7562,2020-11-18T16:16:34.540015Z,2015,514,152,419,238,0,1,0,276,0,0,362,95,0,513,0,1,0
56093,7563,2020-11-18T16:16:34.540015Z,2016,458,138,384,206,0,1,2,252,0,0,320,74,0,457,0,0,0
56093,7564,2020-11-18T16:16:34.540015Z,2017,354,122,288,165,0,3,0,189,0,0,232,66,0,351,0,2,0
56093,7565,2020-11-18T16:16:34.540015Z,2018,332,112,270,147,0,3,1,185,0,2,220,62,0,329,1,3,0
56093,7566,2020-11-18T16:16:34.5410155Z,2019,527,196,406,265,0,2,22,262,0,0,331,121,0,525,2,4,0
56093,7567,2020-11-18T16:16:34.5410155Z,2020,456,173,376,212,0,1,9,244,0,0,283,80,0,455,0,2,0
58305,31934,2021-06-24T05:35:18.5311046Z,2021,417,138,340,172,0,3,7,245,0,0,279,77,0,414,6,1,0
58305,7879,2020-11-18T16:16:36.3662343Z,2012,552,3,394,317,0,7,0,235,0,0,549,158,0,545,0,0,0
58305,7880,2020-11-18T16:16:36.3672352Z,2013,552,25,407,293,0,7,0,259,0,0,527,145,0,545,0,4,0
58305,7881,2020-11-18T16:16:36.3672352Z,2014,619,78,482,314,0,3,0,305,0,0,541,137,0,616,0,2,0
58305,7882,2020-11-18T16:16:36.3672352Z,2015,553,62,423,287,0,7,0,266,0,0,491,130,0,546,0,4,0
58305,7883,2020-11-18T16:16:36.3672352Z,2016,482,102,284,246,0,4,3,236,0,0,380,198,0,478,0,1,0
58305,7884,2020-11-18T16:16:36.3672352Z,2017,496,120,400,225,0,4,0,271,0,0,376,96,0,492,0,2,0
58305,7885,2020-11-18T16:16:36.3672352Z,2018,559,141,437,248,0,6,0,311,0,0,418,122,0,553,5,2,0
58305,7886,2020-11-18T16:16:36.3682356Z,2019,386,125,329,135,0,4,4,251,0,0,261,57,0,382,4,0,0
58305,7887,2020-11-18T16:16:36.3682356Z,2020,415,147,353,162,0,5,7,253,0,0,268,62,0,410,10,0,0
43315,25839,2021-06-24T05:35:10.9456646Z,2021,595,175,443,316,0,9,1,279,0,0,420,152,0,586,1,1,0
43315,5524,2020-11-18T16:16:20.714798Z,2012,723,1,487,392,0,11,0,331,0,0,722,236,0,712,0,0,0
43315,5525,2020-11-18T16:16:20.714798Z,2013,722,5,479,398,0,11,0,324,0,0,717,243,0,711,0,1,0
43315,5526,2020-11-18T16:16:20.7157989Z,2014,699,55,505,365,0,6,0,334,0,0,644,194,0,693,0,3,0
43315,5527,2020-11-18T16:16:20.7157989Z,2015,690,47,491,351,0,3,0,339,0,0,643,199,0,687,0,1,0
43315,5528,2020-11-18T16:16:20.7157989Z,2016,661,88,29,338,0,2,0,323,0,0,573,632,0,659,0,2,0
43315,5529,2020-11-18T16:16:20.7157989Z,2017,646,93,377,338,0,5,0,308,0,0,553,269,0,641,0,2,0
43315,5530,2020-11-18T16:16:20.7167993Z,2018,673,112,478,360,0,6,7,313,0,0,561,195,0,667,0,1,0
43315,5531,2020-11-18T16:16:20.7167993Z,2019,655,129,450,348,0,5,1,307,0,0,526,205,0,650,1,1,0
43315,5532,2020-11-18T16:16:20.7167993Z,2020,630,162,448,336,0,8,0,294,0,0,468,182,0,622,1,1,0
11528,25592,2021-06-24T05:35:04.600116Z,2021,392,145,361,193,0,2,0,199,0,0,247,31,0,390,0,0,0
11528,447,2020-11-18T16:15:48.8385427Z,2012,327,0,279,185,0,19,0,142,0,0,327,48,0,308,0,0,0
11528,448,2020-11-18T16:15:48.8385427Z,2013,282,2,239,151,0,10,0,131,0,0,280,43,0,272,0,0,0
11528,449,2020-11-18T16:15:48.8385427Z,2014,293,41,240,153,0,6,0,140,0,0,252,53,0,287,0,0,0
11528,450,2020-11-18T16:15:48.8385427Z,2015,497,74,423,247,0,1,0,250,0,0,423,74,0,496,0,3,0
11528,451,2020-11-18T16:15:48.8395431Z,2016,464,98,36,241,0,1,1,223,0,0,366,428,0,462,0,5,1
11528,452,2020-11-18T16:15:48.8395431Z,2017,394,95,333,192,0,2,0,202,0,0,299,61,0,392,0,0,0
11528,453,2020-11-18T16:15:48.8395431Z,2018,438,133,366,217,0,0,23,221,0,0,305,72,0,438,0,0,0
11528,454,2020-11-18T16:15:48.8395431Z,2019,417,122,360,207,0,1,1,210,0,0,295,57,0,416,0,0,0
11528,455,2020-11-18T16:15:48.8395431Z,2020,387,138,341,196,0,1,0,191,0,0,249,46,0,386,0,0,0
60905,31942,2021-06-24T05:35:18.5391104Z,2021,355,112,296,188,0,13,0,167,0,0,243,59,1,341,0,0,0
60905,8074,2020-11-18T16:16:37.5420198Z,2012,575,0,329,299,0,1,0,276,0,0,575,246,6,568,0,0,0
60905,8075,2020-11-18T16:16:37.5420198Z,2013,412,2,250,206,0,5,0,206,0,0,410,162,2,405,0,0,0
60905,8076,2020-11-18T16:16:37.5420198Z,2014,507,36,333,249,0,5,0,258,0,0,471,174,2,500,0,0,0
60905,8077,2020-11-18T16:16:37.5430207Z,2015,500,56,393,230,0,7,0,270,0,0,444,107,3,490,0,0,0
60905,8078,2020-11-18T16:16:37.5430207Z,2016,469,104,285,217,0,11,3,252,0,0,365,184,2,456,0,1,0
60905,8079,2020-11-18T16:16:37.5430207Z,2017,521,124,387,264,0,11,3,257,0,0,397,134,3,507,0,1,0
60905,8080,2020-11-18T16:16:37.5430207Z,2018,706,148,519,367,0,26,5,339,0,0,558,187,3,676,0,2,1
60905,8081,2020-11-18T16:16:37.5430207Z,2019,649,133,499,341,0,19,3,308,0,0,516,150,3,626,0,0,1
60905,8082,2020-11-18T16:16:37.544022Z,2020,584,167,458,301,0,14,0,283,0,0,417,126,2,568,0,0,0
52365,25894,2021-06-24T05:35:12.7859848Z,2021,231,97,211,95,0,2,0,136,0,0,134,20,0,227,1,0,2
52365,6816,2020-11-18T16:16:30.1540908Z,2012,331,117,283,155,0,0,0,176,0,0,214,48,0,330,0,0,1
52365,6817,2020-11-18T16:16:30.1540908Z,2013,301,104,259,150,0,1,0,151,0,0,197,42,0,299,0,0,1
52365,6818,2020-11-18T16:16:30.1540908Z,2014,302,109,233,154,0,2,0,148,0,0,193,69,0,299,0,0,1
52365,6819,2020-11-18T16:16:30.1540908Z,2015,299,107,259,148,0,1,0,151,0,0,192,40,0,297,0,0,1
52365,6820,2020-11-18T16:16:30.1540908Z,2016,288,112,259,133,0,3,1,155,0,0,176,29,0,284,0,0,1
52365,6821,2020-11-18T16:16:30.1550908Z,2017,231,90,220,102,0,2,0,129,0,0,141,11,0,229,0,0,0
52365,6822,2020-11-18T16:16:30.1550908Z,2018,231,90,214,96,0,4,0,135,0,0,141,17,0,227,1,0,0
52365,6823,2020-11-18T16:16:30.1550908Z,2019,274,108,253,121,0,7,0,153,0,0,166,21,0,267,1,1,0
52365,6824,2020-11-18T16:16:30.1550908Z,2020,306,126,284,122,0,7,14,184,0,0,180,22,0,298,1,0,1
70094,25642,2021-06-24T05:35:04.6951839Z,2021,92,92,75,37,0,0,4,55,0,0,0,17,1,90,0,0,1
70094,9450,2020-11-18T16:16:48.5163376Z,2012,72,43,52,27,0,1,0,45,0,0,29,20,0,71,0,0,0
70094,9451,2020-11-18T16:16:48.5163376Z,2013,63,46,41,24,0,0,0,39,0,0,17,22,0,63,0,0,0
70094,9452,2020-11-18T16:16:48.5173385Z,2014,70,57,50,23,0,0,0,47,0,0,13,20,1,69,0,0,0
70094,9453,2020-11-18T16:16:48.5173385Z,2015,65,50,49,19,0,1,0,46,0,0,15,16,1,63,0,0,0
70094,9454,2020-11-18T16:16:48.5173385Z,2016,71,62,53,25,0,1,2,46,0,0,9,18,1,69,0,0,0
70094,9455,2020-11-18T16:16:48.5173385Z,2017,86,73,72,42,0,1,3,44,0,0,13,14,0,85,0,0,0
70094,9456,2020-11-18T16:16:48.5173385Z,2018,91,74,74,46,0,1,4,45,0,0,17,17,1,88,0,0,1
70094,9457,2020-11-18T16:16:48.5183399Z,2019,87,79,75,40,0,1,6,47,0,0,8,12,1,84,0,0,1
70094,9458,2020-11-18T16:16:48.5183399Z,2020,86,86,73,37,0,1,3,49,0,0,0,13,2,82,0,0,1
53579,31905,2021-06-24T05:35:18.4800674Z,2021,108,31,92,50,0,3,0,58,0,0,77,16,0,105,0,0,0
53579,7267,2020-11-18T16:16:32.5136679Z,2012,196,68,157,86,0,14,0,110,0,0,128,39,0,182,0,0,0
53579,7268,2020-11-18T16:16:32.5136679Z,2013,176,67,151,76,0,10,0,100,0,0,109,25,0,166,0,8,0
53579,7269,2020-11-18T16:16:32.5146683Z,2014,145,44,119,62,0,6,0,83,0,0,101,26,0,139,0,2,0
53579,7270,2020-11-18T16:16:32.5146683Z,2015,135,36,114,63,0,7,0,72,0,0,99,21,0,128,0,3,0
53579,7271,2020-11-18T16:16:32.5146683Z,2016,145,44,118,69,0,6,5,76,0,0,101,27,0,139,0,2,0
53579,7272,2020-11-18T16:16:32.5156683Z,2017,239,87,207,111,0,12,4,128,0,0,152,32,0,227,0,0,0
53579,7273,2020-11-18T16:16:32.5156683Z,2018,141,55,127,70,0,10,2,71,0,0,86,14,0,131,2,0,0
53579,7274,2020-11-18T16:16:32.5156683Z,2019,146,55,127,65,0,5,0,81,0,0,91,19,0,141,0,0,0
53579,7275,2020-11-18T16:16:32.5166696Z,2020,146,51,132,67,0,4,1,79,0,0,95,14,0,142,0,0,0
17384,1360,2020-11-18T16:15:54.3151942Z,2012,732,2,531,347,0,37,0,385,0,0,730,201,0,695,0,0,0
17384,1361,2020-11-18T16:15:54.3151942Z,2013,659,7,454,331,0,31,0,328,0,0,652,205,0,628,0,7,0
17384,1362,2020-11-18T16:15:54.3161946Z,2014,667,46,482,344,0,30,0,323,0,0,621,185,0,637,0,3,0
17384,1363,2020-11-18T16:15:54.3161946Z,2015,688,54,496,350,0,28,0,338,0,0,634,192,0,660,0,9,0
17384,1364,2020-11-18T16:15:54.3161946Z,2016,643,108,452,343,0,18,0,300,0,0,535,191,0,625,0,5,0
17384,1365,2020-11-18T16:15:54.3161946Z,2017,613,90,444,305,0,16,1,308,0,0,523,169,0,597,0,3,0
17384,1366,2020-11-18T16:15:54.3161946Z,2018,782,116,567,376,0,16,0,406,0,0,666,215,0,766,0,2,0
17384,1367,2020-11-18T16:15:54.3171951Z,2019,747,126,518,349,0,10,0,398,0,0,621,229,0,737,0,2,0
17384,1368,2020-11-18T16:15:54.3171951Z,2020,746,177,525,362,0,11,0,384,0,0,569,221,0,735,0,0,0
17384,25608,2021-06-24T05:35:04.6241323Z,2021,699,170,514,348,0,16,0,351,0,0,529,185,0,683,1,0,0
11756,31595,2021-06-24T05:35:14.556254Z,2021,543,187,449,280,0,8,2,263,0,0,356,94,0,534,0,0,1
11756,486,2020-11-18T16:15:48.3402084Z,2012,393,122,317,172,0,11,0,221,0,0,271,76,0,382,0,0,0
11756,487,2020-11-18T16:15:48.3402084Z,2013,385,120,293,168,0,14,0,217,0,0,265,92,0,371,0,4,0
11756,488,2020-11-18T16:15:48.3402084Z,2014,396,137,272,184,0,9,0,212,0,0,259,124,0,385,0,3,2
11756,489,2020-11-18T16:15:48.3412093Z,2015,414,154,316,208,0,9,0,206,0,0,260,98,0,405,0,5,0
11756,490,2020-11-18T16:15:48.3412093Z,2016,423,157,193,211,0,11,4,212,0,0,266,230,0,411,0,3,1
11756,491,2020-11-18T16:15:48.3412093Z,2017,399,155,274,199,0,9,4,200,0,0,244,125,0,390,0,5,0
11756,492,2020-11-18T16:15:48.3412093Z,2018,581,190,371,288,0,16,4,293,0,0,391,210,0,565,0,4,0
11756,493,2020-11-18T16:15:48.3412093Z,2019,580,196,463,309,0,10,2,271,0,2,384,117,0,570,2,2,0
11756,494,2020-11-18T16:15:48.3422102Z,2020,601,217,503,318,0,12,4,283,0,0,384,98,0,589,0,1,0
33340,31784,2021-06-24T05:35:16.8619086Z,2021,355,52,298,199,0,9,0,156,0,0,303,57,1,345,0,0,0
33340,4076,2020-11-18T16:16:10.3078595Z,2012,620,0,476,327,0,35,0,293,0,0,620,144,1,584,0,0,0
33340,4077,2020-11-18T16:16:10.3078595Z,2013,580,1,440,303,0,29,0,277,0,0,579,140,0,549,0,1,2
33340,4078,2020-11-18T16:16:10.3078595Z,2014,559,14,427,307,0,28,0,252,0,0,545,132,0,529,0,0,2
33340,4079,2020-11-18T16:16:10.3088595Z,2015,655,37,525,366,0,27,0,289,0,0,618,130,0,626,0,1,2
33340,4080,2020-11-18T16:16:10.3088595Z,2016,576,61,469,328,0,24,0,248,0,0,515,107,0,552,0,1,0
33340,4081,2020-11-18T16:16:10.3088595Z,2017,512,55,425,301,0,20,3,211,0,0,457,87,1,491,0,0,0
33340,4082,2020-11-18T16:16:10.3098604Z,2018,495,53,389,272,0,20,0,223,0,0,442,106,0,475,0,0,0
33340,4083,2020-11-18T16:16:10.3098604Z,2019,384,43,294,215,0,13,6,169,0,0,341,90,1,370,0,0,0
33340,4084,2020-11-18T16:16:10.3098604Z,2020,388,59,304,214,0,11,26,174,0,0,329,84,1,376,0,0,0
51698,31887,2021-06-24T05:35:18.4590525Z,2021,445,127,351,236,0,10,0,209,0,0,318,94,0,434,1,0,1
51698,6559,2020-11-18T16:16:27.8025199Z,2012,628,0,464,321,0,8,0,307,0,0,628,164,0,620,0,0,0
51698,6560,2020-11-18T16:16:27.8025199Z,2013,593,0,428,314,0,12,0,279,0,0,593,165,0,580,0,0,1
51698,6561,2020-11-18T16:16:27.8035204Z,2014,576,38,394,322,0,7,0,254,0,0,538,182,0,568,0,1,1
51698,6562,2020-11-18T16:16:27.8035204Z,2015,609,51,420,324,0,5,0,285,0,0,558,189,2,600,0,1,2
51698,6563,2020-11-18T16:16:27.8035204Z,2016,606,89,119,303,0,7,1,303,0,0,517,487,2,595,0,0,2
51698,6564,2020-11-18T16:16:27.8035204Z,2017,610,82,460,321,0,1,0,289,0,0,528,150,0,609,0,0,0
51698,6565,2020-11-18T16:16:27.8035204Z,2018,575,96,428,316,0,4,14,259,0,0,479,147,0,571,0,2,0
51698,6566,2020-11-18T16:16:27.8045212Z,2019,569,98,421,326,0,2,1,243,0,0,471,148,0,567,0,5,0
51698,6567,2020-11-18T16:16:27.8045212Z,2020,497,137,366,286,0,1,0,211,0,0,360,131,0,495,0,4,1
63081,25971,2021-06-24T05:35:12.9080728Z,2021,346,129,330,163,0,3,0,183,0,0,217,16,0,341,0,0,2
63081,8854,2020-11-18T16:16:43.9142637Z,2012,315,108,293,158,0,1,0,157,0,0,207,22,0,314,0,0,0
63081,8855,2020-11-18T16:16:43.9152641Z,2013,297,106,237,160,0,1,0,137,0,0,191,60,0,296,0,2,0
63081,8856,2020-11-18T16:16:43.9152641Z,2014,268,102,233,135,0,2,0,133,0,0,166,35,0,266,0,1,0
63081,8857,2020-11-18T16:16:43.9152641Z,2015,340,128,326,159,0,3,0,181,0,0,212,14,0,337,0,1,0
63081,8858,2020-11-18T16:16:43.9152641Z,2016,340,118,321,165,0,2,0,175,0,0,222,19,0,338,0,1,0
63081,8859,2020-11-18T16:16:43.916265Z,2017,337,124,319,166,0,2,0,171,0,0,213,18,0,334,0,2,1
63081,8860,2020-11-18T16:16:43.916265Z,2018,332,98,317,168,0,2,0,164,0,0,234,15,0,329,0,0,1
63081,8861,2020-11-18T16:16:43.916265Z,2019,349,122,322,168,0,3,1,181,0,2,227,27,0,345,0,0,1
63081,8862,2020-11-18T16:16:43.916265Z,2020,335,109,322,166,0,3,0,169,0,0,226,13,0,329,0,0,3
71498,10280,2020-11-18T16:16:53.7318159Z,2012,301,114,276,150,0,1,0,151,0,0,187,25,2,292,0,0,6
71498,10281,2020-11-18T16:16:53.7328168Z,2013,279,106,220,150,0,1,0,129,0,0,173,59,1,275,0,0,2
71498,10282,2020-11-18T16:16:53.7328168Z,2014,253,102,223,134,0,2,0,119,0,0,151,30,1,249,0,1,1
71498,10283,2020-11-18T16:16:53.7328168Z,2015,236,96,204,120,0,4,0,116,0,0,140,32,0,231,0,0,1
71498,10284,2020-11-18T16:16:53.7328168Z,2016,205,90,185,101,0,1,0,104,0,0,115,20,0,203,0,0,1
71498,10285,2020-11-18T16:16:53.7328168Z,2017,504,213,449,233,0,13,3,271,0,0,291,55,1,488,0,1,2
71498,10286,2020-11-18T16:16:53.7338168Z,2018,411,162,370,187,0,12,3,224,0,0,249,41,1,397,0,2,1
71498,10287,2020-11-18T16:16:53.7338168Z,2019,286,117,263,129,0,6,1,157,0,0,169,23,0,279,0,2,1
71498,10288,2020-11-18T16:16:53.7338168Z,2020,262,124,246,122,0,1,0,140,0,0,138,16,0,260,0,0,1
71498,31672,2021-06-24T05:35:15.2757702Z,2021,250,113,234,107,0,1,0,143,0,0,137,16,0,248,0,1,1
11387,25589,2021-06-24T05:35:04.5921094Z,2021,517,181,421,241,0,9,1,276,0,0,336,96,0,505,0,1,3
11387,370,2020-11-18T16:15:47.5917098Z,2012,290,86,232,161,0,8,0,129,0,0,204,58,0,282,0,0,0
11387,371,2020-11-18T16:15:47.5917098Z,2013,307,99,250,153,0,3,0,154,0,0,208,57,0,304,0,2,0
11387,372,2020-11-18T16:15:47.5917098Z,2014,276,94,227,129,0,1,0,147,0,0,182,49,0,275,0,1,0
11387,373,2020-11-18T16:15:47.5917098Z,2015,311,116,253,151,0,3,0,160,0,0,195,58,0,308,0,2,0
11387,374,2020-11-18T16:15:47.5927093Z,2016,481,155,72,226,0,5,1,255,0,0,326,409,1,475,0,2,0
11387,375,2020-11-18T16:15:47.5927093Z,2017,438,145,320,207,0,4,0,231,0,0,293,118,0,434,0,0,0
11387,376,2020-11-18T16:15:47.5927093Z,2018,413,138,290,185,0,2,0,228,0,0,275,123,0,411,1,0,0
11387,377,2020-11-18T16:15:47.5927093Z,2019,556,196,435,259,0,9,1,297,0,0,360,121,0,545,1,1,2
11387,378,2020-11-18T16:15:47.5927093Z,2020,568,182,428,268,0,8,1,300,0,0,386,140,0,558,0,1,2
61457,31948,2021-06-24T05:35:18.5431128Z,2021,155,61,146,68,0,5,0,87,0,0,94,9,0,149,1,0,1
61457,8207,2020-11-18T16:16:39.0510221Z,2012,217,64,198,112,0,18,0,105,0,0,153,19,0,199,0,0,0
61457,8208,2020-11-18T16:16:39.0510221Z,2013,195,67,154,106,0,19,0,89,0,0,128,41,1,175,0,2,0
61457,8209,2020-11-18T16:16:39.0520235Z,2014,197,69,184,112,0,15,0,85,0,0,128,13,2,180,0,1,0
61457,8210,2020-11-18T16:16:39.0520235Z,2015,284,91,270,143,0,27,0,141,0,0,193,14,0,256,0,1,1
61457,8211,2020-11-18T16:16:39.0520235Z,2016,175,56,162,80,0,11,0,95,0,0,119,13,0,164,0,0,0
61457,8212,2020-11-18T16:16:39.053023Z,2017,149,49,133,66,0,10,0,83,0,0,100,16,0,139,0,0,0
61457,8213,2020-11-18T16:16:39.053023Z,2018,169,65,151,72,0,7,1,97,0,0,104,18,0,160,4,0,2
61457,8214,2020-11-18T16:16:39.053023Z,2019,200,81,171,82,1,7,1,118,0,0,119,29,0,192,1,0,1
61457,8215,2020-11-18T16:16:39.0540235Z,2020,173,63,158,84,0,5,0,89,0,0,110,15,0,167,1,0,1
17111,1297,2020-11-18T16:15:53.6207321Z,2012,243,44,197,123,0,2,0,120,0,0,199,46,0,241,0,0,0
17111,1298,2020-11-18T16:15:53.6217325Z,2013,182,39,128,84,0,5,0,98,0,0,143,54,0,176,0,4,1
17111,1299,2020-11-18T16:15:53.6217325Z,2014,268,80,211,124,0,6,0,144,0,0,188,57,1,260,0,1,1
17111,1300,2020-11-18T16:15:53.6217325Z,2015,197,75,160,91,0,4,0,106,0,0,122,37,0,192,0,1,1
17111,1301,2020-11-18T16:15:54.2941799Z,2016,213,90,76,104,0,11,1,109,0,0,123,137,0,202,0,0,0
17111,1302,2020-11-18T16:15:54.2951813Z,2017,225,94,187,113,0,9,0,112,0,0,131,38,0,214,0,2,2
17111,1303,2020-11-18T16:15:54.2951813Z,2018,317,107,246,164,0,11,2,153,0,0,210,71,0,305,0,2,1
17111,1304,2020-11-18T16:15:54.2951813Z,2019,420,180,348,198,0,15,2,222,0,0,240,72,0,405,0,3,0
17111,1305,2020-11-18T16:15:54.2951813Z,2020,355,171,312,167,0,11,0,188,0,0,184,43,0,343,0,1,1
17111,31607,2021-06-24T05:35:14.5842741Z,2021,305,137,249,159,0,10,0,146,0,0,168,56,0,293,0,0,2
25783,2902,2020-11-18T16:16:04.2678296Z,2012,268,50,204,131,0,0,0,137,0,0,218,64,0,267,0,0,1
25783,2903,2020-11-18T16:16:04.2688305Z,2013,263,67,201,128,0,0,0,135,0,0,196,62,0,262,0,0,1
25783,2904,2020-11-18T16:16:04.2688305Z,2014,232,70,187,116,0,2,0,116,0,0,162,45,0,230,0,3,0
25783,2905,2020-11-18T16:16:04.2688305Z,2015,280,118,252,129,0,2,0,151,0,0,162,28,0,277,0,1,1
25783,2906,2020-11-18T16:16:04.2688305Z,2016,303,122,220,145,0,3,6,158,0,0,181,83,0,299,0,0,1
25783,2907,2020-11-18T16:16:04.2698328Z,2017,319,124,288,156,0,3,14,163,0,0,195,31,0,315,0,0,1
25783,2908,2020-11-18T16:16:04.2698328Z,2018,321,133,267,147,0,2,15,174,0,0,188,54,0,318,0,0,1
25783,2909,2020-11-18T16:16:04.2698328Z,2019,348,158,289,170,0,3,30,178,0,0,190,59,0,344,0,0,1
25783,2910,2020-11-18T16:16:04.2698328Z,2020,291,122,244,133,0,2,11,158,0,0,169,47,0,289,0,0,0
25783,31728,2021-06-24T05:35:15.3858491Z,2021,239,103,198,117,0,1,2,122,0,0,136,41,0,238,0,0,0
26005,2927,2020-11-18T16:16:04.2758363Z,2012,344,40,280,180,0,1,0,164,0,0,304,64,0,343,0,0,0
26005,2928,2020-11-18T16:16:04.2758363Z,2013,308,60,240,155,0,1,0,153,0,0,248,68,0,307,0,2,0
26005,2929,2020-11-18T16:16:04.2758363Z,2014,291,64,231,142,0,1,0,149,0,0,227,60,0,290,0,2,0
26005,2930,2020-11-18T16:16:04.2768368Z,2015,311,74,246,155,0,0,0,156,0,0,237,65,0,311,0,1,0
26005,2931,2020-11-18T16:16:04.2768368Z,2016,310,95,122,144,0,1,13,166,0,0,215,188,0,309,0,1,0
26005,2932,2020-11-18T16:16:04.2768368Z,2017,281,88,224,133,0,1,7,148,0,0,193,57,0,280,0,3,0
26005,2933,2020-11-18T16:16:04.2768368Z,2018,243,79,198,120,0,2,2,123,0,0,164,45,0,241,0,2,0
26005,2934,2020-11-18T16:16:04.2778363Z,2019,241,80,194,119,0,2,3,122,0,0,161,47,0,239,0,1,0
26005,2935,2020-11-18T16:16:04.2778363Z,2020,230,79,183,116,0,2,1,114,0,0,151,47,0,228,0,1,0
26005,31729,2021-06-24T05:35:15.3948562Z,2021,202,70,169,102,0,4,0,100,0,0,132,33,0,198,1,0,0
26021,2945,2020-11-18T16:16:04.2898452Z,2012,683,1,483,365,0,5,0,318,0,0,682,200,24,654,0,0,0
26021,2946,2020-11-18T16:16:04.2898452Z,2013,651,2,471,348,0,3,0,303,0,0,649,180,14,634,0,4,0
26021,2947,2020-11-18T16:16:04.2898452Z,2014,632,29,455,322,0,2,0,310,0,0,603,177,9,621,0,4,0
26021,2948,2020-11-18T16:16:04.2908457Z,2015,518,29,349,259,0,0,0,259,0,0,489,169,1,517,0,2,0
26021,2949,2020-11-18T16:16:04.2908457Z,2016,563,67,112,272,0,0,1,291,0,0,496,451,0,563,0,2,0
26021,2950,2020-11-18T16:16:04.2908457Z,2017,588,78,386,285,0,1,0,303,0,0,510,202,0,587,0,3,0
26021,2951,2020-11-18T16:16:04.2908457Z,2018,567,68,363,264,0,3,0,303,0,0,499,204,1,563,4,1,0
26021,2952,2020-11-18T16:16:04.2918493Z,2019,514,75,333,244,1,2,0,270,0,0,439,181,1,511,5,2,0
26021,2953,2020-11-18T16:16:04.2918493Z,2020,540,111,374,268,0,3,2,272,0,0,429,166,1,536,6,1,0
26021,31730,2021-06-24T05:35:15.3978581Z,2021,570,112,435,279,0,3,0,291,0,0,458,135,2,565,7,1,0
34264,31788,2021-06-24T05:35:16.8649092Z,2021,254,69,214,109,0,3,0,145,0,0,185,40,1,250,0,0,0
34264,4167,2020-11-18T16:16:11.0303403Z,2012,166,0,129,92,0,0,0,74,0,0,166,37,0,166,0,0,0
34264,4168,2020-11-18T16:16:11.0313417Z,2013,285,29,223,148,0,1,0,137,0,0,256,62,0,284,0,3,0
34264,4169,2020-11-18T16:16:11.0313417Z,2014,243,38,189,114,0,0,0,129,0,0,205,54,0,243,0,0,0
34264,4170,2020-11-18T16:16:11.0313417Z,2015,214,32,172,100,0,0,0,114,0,0,182,42,0,214,0,0,0
34264,4171,2020-11-18T16:16:11.0313417Z,2016,222,44,146,102,0,0,0,120,0,0,178,76,0,222,0,1,0
34264,4172,2020-11-18T16:16:11.0313417Z,2017,175,42,146,83,0,0,0,92,0,0,133,29,0,175,0,0,0
34264,4173,2020-11-18T16:16:11.0313417Z,2018,189,39,156,86,0,1,0,103,0,0,150,33,1,187,0,1,0
34264,4174,2020-11-18T16:16:11.0323426Z,2019,182,42,148,80,0,0,1,102,0,0,140,34,0,182,0,0,0
34264,4175,2020-11-18T16:16:11.0323426Z,2020,223,58,189,101,0,0,1,122,0,0,165,34,1,222,0,0,0
46995,25856,2021-06-24T05:35:10.9736851Z,2021,418,130,337,212,0,15,2,206,0,0,288,81,0,403,3,0,0
46995,5955,2020-11-18T16:16:23.5276705Z,2012,585,0,442,288,0,7,0,297,0,0,585,143,0,577,0,0,1
46995,5956,2020-11-18T16:16:23.5276705Z,2013,539,1,399,280,0,7,0,259,0,0,538,140,0,532,0,4,0
46995,5957,2020-11-18T16:16:23.5276705Z,2014,495,38,357,250,0,7,0,245,0,0,457,138,0,488,0,4,0
46995,5958,2020-11-18T16:16:23.5276705Z,2015,483,13,339,249,0,4,0,234,0,0,470,144,0,479,0,2,0
46995,5959,2020-11-18T16:16:23.5276705Z,2016,468,34,293,224,0,0,0,244,0,0,434,175,0,468,0,2,0
46995,5960,2020-11-18T16:16:23.5276705Z,2017,467,61,359,232,0,2,1,235,0,0,406,108,0,465,0,2,0
46995,5961,2020-11-18T16:16:23.5286723Z,2018,462,78,355,227,0,8,6,235,0,0,384,107,0,454,2,1,0
46995,5962,2020-11-18T16:16:23.5286723Z,2019,440,89,344,235,0,3,0,205,0,0,351,96,0,437,3,0,0
46995,5963,2020-11-18T16:16:23.5286723Z,2020,429,114,344,232,0,8,15,197,0,0,315,85,0,421,4,0,0
51763,31888,2021-06-24T05:35:18.4590525Z,2021,214,78,184,102,0,5,12,112,0,0,136,30,0,209,0,0,0
51763,6577,2020-11-18T16:16:27.8135266Z,2012,264,23,211,130,0,1,0,134,0,0,241,53,0,263,0,0,0
51763,6578,2020-11-18T16:16:27.8135266Z,2013,256,34,206,122,0,1,0,134,0,0,222,50,0,255,0,1,0
51763,6579,2020-11-18T16:16:27.8145279Z,2014,240,44,187,109,0,2,0,131,0,0,196,53,0,238,0,1,0
51763,6580,2020-11-18T16:16:27.8145279Z,2015,209,39,160,93,0,4,0,116,0,0,170,49,0,205,0,2,0
51763,6581,2020-11-18T16:16:27.8145279Z,2016,180,52,132,83,0,2,0,97,0,0,128,48,0,178,0,2,0
51763,6582,2020-11-18T16:16:27.8145279Z,2017,197,50,165,90,0,7,0,107,0,0,147,32,0,190,0,4,0
51763,6583,2020-11-18T16:16:27.8145279Z,2018,195,53,154,86,0,4,13,109,0,0,142,41,0,191,0,0,0
51763,6584,2020-11-18T16:16:27.8155288Z,2019,225,58,181,104,0,7,35,121,0,0,167,44,0,218,0,0,0
51763,6585,2020-11-18T16:16:27.8155288Z,2020,223,71,177,102,0,8,16,121,0,0,152,46,0,215,0,0,0
11395,31591,2021-06-24T05:35:14.5542521Z,2021,335,98,294,175,0,13,0,160,0,0,237,41,0,322,0,2,0
11395,379,2020-11-18T16:15:47.5937098Z,2012,299,65,244,158,0,2,0,141,0,0,234,55,1,295,0,0,1
11395,380,2020-11-18T16:15:47.5937098Z,2013,313,73,261,157,0,4,0,156,0,0,240,52,0,309,0,5,0
11395,381,2020-11-18T16:15:47.5937098Z,2014,326,71,258,157,0,5,0,169,0,0,255,68,0,321,0,3,0
11395,382,2020-11-18T16:15:47.5937098Z,2015,316,70,258,149,0,4,0,167,0,0,246,58,0,312,0,2,0
11395,383,2020-11-18T16:15:47.5937098Z,2016,308,76,256,144,0,3,1,164,0,0,232,52,0,305,0,2,0
11395,384,2020-11-18T16:15:47.5937098Z,2017,298,76,256,135,0,4,0,163,0,0,222,42,0,294,0,0,0
11395,385,2020-11-18T16:15:47.5947107Z,2018,255,53,215,113,0,7,0,142,0,0,202,40,0,248,0,2,0
11395,386,2020-11-18T16:15:47.5947107Z,2019,379,110,317,185,0,13,0,194,0,0,269,62,0,366,0,1,0
11395,387,2020-11-18T16:15:47.5947107Z,2020,333,97,283,176,0,10,0,157,0,0,236,50,0,323,0,0,0
13425,1016,2020-11-18T16:15:52.4849722Z,2012,545,6,364,283,0,4,0,262,0,0,539,181,0,541,0,0,0
13425,1017,2020-11-18T16:15:52.4849722Z,2013,503,12,346,253,0,4,0,250,0,0,491,157,1,497,0,0,1
13425,1018,2020-11-18T16:15:52.4849722Z,2014,549,21,386,286,0,2,0,263,0,0,528,163,0,545,0,3,2
13425,1019,2020-11-18T16:15:52.485974Z,2015,573,25,392,312,0,3,0,261,0,0,548,181,0,570,0,3,0
13425,1020,2020-11-18T16:15:52.485974Z,2016,585,55,109,317,0,2,0,268,0,0,530,476,0,583,0,0,0
13425,1021,2020-11-18T16:15:52.485974Z,2017,820,111,632,425,0,3,0,395,0,0,709,188,0,817,0,1,0
13425,1022,2020-11-18T16:15:52.485974Z,2018,764,83,560,384,0,2,5,380,0,0,681,204,0,762,7,0,0
13425,1023,2020-11-18T16:15:52.485974Z,2019,646,75,500,323,0,2,5,323,0,0,571,146,0,644,8,1,0
13425,1024,2020-11-18T16:15:52.485974Z,2020,561,84,420,275,0,1,5,286,0,0,477,141,0,559,9,1,1
13425,31871,2021-06-24T05:35:18.4370381Z,2021,495,66,393,255,0,1,0,240,0,0,429,102,0,494,5,0,0
20834,1964,2020-11-18T16:15:58.5029852Z,2012,285,97,176,150,0,6,0,135,0,0,188,109,0,279,0,0,0
20834,1965,2020-11-18T16:15:58.5029852Z,2013,255,88,204,128,0,5,0,127,0,0,167,51,0,250,0,2,0
20834,1966,2020-11-18T16:15:58.5029852Z,2014,243,77,187,122,0,5,0,121,0,0,166,56,1,237,0,1,0
20834,1967,2020-11-18T16:15:58.5039874Z,2015,254,79,225,130,0,3,0,124,0,0,175,29,0,251,0,0,0
20834,1968,2020-11-18T16:15:58.5039874Z,2016,213,74,30,102,0,4,1,111,0,0,139,183,0,208,0,1,1
20834,1969,2020-11-18T16:15:58.5039874Z,2017,198,74,168,95,0,3,5,103,0,0,124,30,0,194,0,0,1
20834,1970,2020-11-18T16:15:58.5039874Z,2018,282,102,240,144,0,2,4,138,0,0,180,42,0,280,1,1,0
20834,1971,2020-11-18T16:15:58.5039874Z,2019,350,135,311,164,0,11,0,186,0,0,215,39,0,339,2,1,0
20834,1972,2020-11-18T16:15:58.5049865Z,2020,320,118,291,153,0,11,4,167,0,0,202,29,0,309,2,0,0
20834,31702,2021-06-24T05:35:15.3318094Z,2021,249,88,201,123,0,11,3,126,0,0,161,48,0,238,2,0,0
22327,2412,2020-11-18T16:16:01.4179277Z,2012,387,125,324,175,0,15,0,212,0,0,262,63,0,372,0,0,0
22327,2413,2020-11-18T16:16:01.4179277Z,2013,439,142,299,202,0,12,0,237,0,0,297,140,0,427,0,5,0
22327,2414,2020-11-18T16:16:01.4189282Z,2014,459,156,302,213,0,10,0,246,0,0,303,157,0,449,0,2,0
22327,2415,2020-11-18T16:16:01.4189282Z,2015,459,142,314,224,0,9,0,235,0,0,317,145,0,450,0,3,0
22327,2416,2020-11-18T16:16:01.4189282Z,2016,465,137,295,224,0,12,0,241,0,0,328,170,0,453,0,2,0
22327,2417,2020-11-18T16:16:01.4189282Z,2017,458,156,351,208,0,6,0,250,0,0,302,107,0,452,0,0,0
22327,2418,2020-11-18T16:16:01.4199286Z,2018,482,153,348,222,0,3,2,260,0,0,329,134,0,479,0,0,0
22327,2419,2020-11-18T16:16:01.4199286Z,2019,563,168,459,286,0,4,2,277,0,0,395,104,0,559,0,0,0
22327,2420,2020-11-18T16:16:01.4199286Z,2020,539,152,428,274,0,3,0,265,0,0,387,111,0,536,0,0,0
22327,31748,2021-06-24T05:35:15.4318816Z,2021,499,124,418,263,0,3,0,236,0,0,375,81,1,495,0,0,0
30924,31764,2021-06-24T05:35:16.8348886Z,2021,225,60,161,120,0,1,2,105,0,0,165,64,0,224,0,0,0
30924,3498,2020-11-18T16:16:07.0626906Z,2012,287,62,179,145,0,0,0,142,0,0,225,108,1,286,0,0,0
30924,3499,2020-11-18T16:16:07.0626906Z,2013,242,55,150,122,0,0,0,120,0,0,187,92,3,239,0,1,0
30924,3500,2020-11-18T16:16:07.0626906Z,2014,230,61,115,104,0,0,0,126,0,0,169,115,5,224,0,0,1
30924,3501,2020-11-18T16:16:07.6040529Z,2015,218,57,166,100,0,0,0,118,0,0,161,52,0,217,0,3,1
30924,3502,2020-11-18T16:16:07.6040529Z,2016,198,52,147,88,0,0,0,110,0,0,146,51,0,197,0,2,1
30924,3503,2020-11-18T16:16:07.6040529Z,2017,174,50,142,81,0,0,0,93,0,0,124,32,0,173,0,0,1
30924,3504,2020-11-18T16:16:07.6040529Z,2018,159,41,133,78,0,1,2,81,0,0,118,26,0,158,0,0,0
30924,3505,2020-11-18T16:16:07.6050547Z,2019,214,54,156,108,0,1,1,106,0,0,160,58,0,213,0,0,0
30924,3506,2020-11-18T16:16:07.6050547Z,2020,213,58,158,107,0,1,0,106,0,0,155,55,0,210,0,0,2
40477,25818,2021-06-24T05:35:10.9076382Z,2021,245,83,196,120,0,3,0,125,0,0,162,49,1,238,0,0,3
40477,4782,2020-11-18T16:16:15.3392129Z,2012,296,90,246,135,0,2,0,161,0,0,206,50,0,294,0,0,0
40477,4783,2020-11-18T16:16:15.3392129Z,2013,297,79,249,147,0,9,0,150,0,0,218,48,0,288,0,3,0
40477,4784,2020-11-18T16:16:15.3392129Z,2014,250,74,203,117,0,7,0,133,0,0,176,47,0,243,0,5,0
40477,4785,2020-11-18T16:16:15.3392129Z,2015,234,61,194,113,0,6,0,121,0,0,173,40,0,228,0,4,0
40477,4786,2020-11-18T16:16:15.3402138Z,2016,251,80,196,113,0,6,4,138,0,0,171,55,0,245,0,4,0
40477,4787,2020-11-18T16:16:15.3402138Z,2017,266,91,235,120,0,5,0,146,0,0,175,31,0,261,0,3,0
40477,4788,2020-11-18T16:16:15.3402138Z,2018,206,56,183,101,0,4,5,105,0,1,150,23,0,202,1,1,0
40477,4789,2020-11-18T16:16:15.3412156Z,2019,311,99,281,168,0,4,2,143,0,0,212,30,1,306,1,0,0
40477,4790,2020-11-18T16:16:15.3412156Z,2020,298,98,273,150,0,5,0,148,0,0,200,25,1,292,0,0,0
41541,25824,2021-06-24T05:35:10.9146439Z,2021,381,165,317,184,0,0,0,197,0,0,216,64,0,381,1,0,0
41541,4995,2020-11-18T16:16:16.6731036Z,2012,414,47,323,188,0,4,0,226,0,0,367,91,0,410,0,0,0
41541,4996,2020-11-18T16:16:16.6731036Z,2013,475,113,393,208,0,1,0,267,0,0,362,82,0,474,0,1,0
41541,4997,2020-11-18T16:16:16.6731036Z,2014,429,144,349,196,0,1,0,233,0,0,285,80,0,427,0,3,1
41541,4998,2020-11-18T16:16:16.674104Z,2015,367,113,286,161,0,1,0,206,0,0,254,81,0,366,0,2,0
41541,4999,2020-11-18T16:16:16.674104Z,2016,492,182,390,212,0,2,2,280,0,0,310,102,2,487,0,7,1
41541,5000,2020-11-18T16:16:16.674104Z,2017,423,162,323,196,0,2,0,227,0,0,261,100,1,420,0,1,0
41541,5001,2020-11-18T16:16:17.0803729Z,2018,466,174,383,223,0,4,5,243,0,0,292,83,0,462,4,1,0
41541,5002,2020-11-18T16:16:17.0803729Z,2019,443,158,365,218,0,2,0,225,0,0,285,78,0,440,3,2,1
41541,5003,2020-11-18T16:16:17.0803729Z,2020,416,169,337,202,0,2,0,214,0,0,247,79,0,414,2,0,0
42242,31831,2021-06-24T05:35:16.9559743Z,2021,246,74,214,127,0,1,2,119,0,0,172,32,0,244,0,0,1
42242,5173,2020-11-18T16:16:17.8278702Z,2012,392,111,286,190,0,17,0,202,0,0,281,106,0,375,0,0,0
42242,5174,2020-11-18T16:16:17.8278702Z,2013,387,91,280,187,0,18,0,200,0,0,296,107,0,368,0,0,1
42242,5175,2020-11-18T16:16:17.8278702Z,2014,386,101,293,191,0,15,0,195,0,0,285,93,0,370,0,0,1
42242,5176,2020-11-18T16:16:17.8278702Z,2015,411,101,328,198,0,13,0,213,0,0,310,83,0,398,0,1,0
42242,5177,2020-11-18T16:16:17.8278702Z,2016,375,91,152,185,0,11,6,190,0,0,284,223,0,364,0,0,0
42242,5178,2020-11-18T16:16:17.8288702Z,2017,296,73,232,142,0,8,5,154,0,0,223,64,0,288,0,0,0
42242,5179,2020-11-18T16:16:17.8288702Z,2018,263,64,212,140,1,7,4,123,0,0,199,51,2,253,0,2,1
42242,5180,2020-11-18T16:16:17.8288702Z,2019,273,96,242,134,1,6,7,139,0,0,177,31,2,265,0,1,0
42242,5181,2020-11-18T16:16:17.8288702Z,2020,258,90,218,122,0,1,3,136,0,0,168,40,1,255,0,0,1
50773,25878,2021-06-24T05:35:12.7709738Z,2021,102,26,81,41,0,3,2,61,0,0,76,21,0,99,2,0,0
50773,6342,2020-11-18T16:16:26.2755065Z,2012,123,28,102,58,0,3,0,65,0,0,95,21,0,120,0,0,0
50773,6343,2020-11-18T16:16:26.2755065Z,2013,126,32,105,55,0,2,0,71,0,0,94,21,0,124,0,0,0
50773,6344,2020-11-18T16:16:26.2765074Z,2014,136,34,114,58,0,1,0,78,0,0,102,22,0,135,0,0,0
50773,6345,2020-11-18T16:16:26.2765074Z,2015,139,34,115,71,0,6,0,68,0,0,105,24,0,133,0,3,0
50773,6346,2020-11-18T16:16:26.2765074Z,2016,154,43,122,79,0,3,0,75,0,0,111,32,0,151,0,2,0
50773,6347,2020-11-18T16:16:26.2765074Z,2017,123,33,107,59,0,8,0,64,0,0,90,16,0,115,0,1,0
50773,6348,2020-11-18T16:16:26.2765074Z,2018,125,30,108,59,0,10,8,66,0,0,95,17,0,115,3,0,0
50773,6349,2020-11-18T16:16:26.2775088Z,2019,166,50,138,81,0,7,2,85,0,0,116,28,0,159,5,0,0
50773,6350,2020-11-18T16:16:26.2775088Z,2020,137,37,106,61,0,6,13,76,0,0,100,31,0,131,4,0,0
53512,25903,2021-06-24T05:35:12.8019954Z,2021,177,55,144,82,0,2,4,95,0,0,122,33,0,175,0,1,0
53512,7258,2020-11-18T16:16:32.5126661Z,2012,264,85,210,129,0,3,0,135,0,0,179,54,0,261,0,0,0
53512,7259,2020-11-18T16:16:32.5126661Z,2013,263,89,204,129,0,2,0,134,0,0,174,59,0,261,0,3,0
53512,7260,2020-11-18T16:16:32.5126661Z,2014,240,85,190,115,0,1,0,125,0,0,155,50,0,239,0,0,0
53512,7261,2020-11-18T16:16:32.5136679Z,2015,237,75,186,124,0,0,0,113,0,0,162,51,0,237,0,1,0
53512,7262,2020-11-18T16:16:32.5136679Z,2016,233,78,141,116,0,2,0,117,0,0,155,92,0,231,0,1,0
53512,7263,2020-11-18T16:16:32.5136679Z,2017,185,67,145,93,0,4,7,92,0,0,118,40,0,181,0,4,0
53512,7264,2020-11-18T16:16:32.5146683Z,2018,240,87,204,118,0,4,7,122,0,2,153,36,0,236,3,2,0
53512,7265,2020-11-18T16:16:32.5146683Z,2019,235,86,195,117,0,0,0,118,0,1,149,40,0,235,2,3,0
53512,7266,2020-11-18T16:16:32.5146683Z,2020,231,86,191,111,0,0,9,120,0,0,145,40,0,231,2,2,0
61689,25954,2021-06-24T05:35:12.874048Z,2021,350,120,313,188,0,18,2,162,0,0,230,37,1,329,1,0,2
61689,8372,2020-11-18T16:16:39.7955186Z,2012,380,132,319,190,0,22,0,190,0,0,248,61,0,355,0,0,3
61689,8373,2020-11-18T16:16:39.7955186Z,2013,369,141,314,177,0,32,0,192,0,0,228,55,0,334,0,3,3
61689,8374,2020-11-18T16:16:39.7955186Z,2014,382,129,324,189,0,30,0,193,0,0,253,58,1,348,0,1,3
61689,8375,2020-11-18T16:16:39.7965203Z,2015,381,145,322,200,0,24,0,181,0,0,236,59,0,354,0,1,3
61689,8376,2020-11-18T16:16:39.7965203Z,2016,368,135,306,206,0,18,2,162,0,0,233,62,1,347,0,1,2
61689,8377,2020-11-18T16:16:39.7965203Z,2017,324,125,280,176,0,13,3,148,0,0,199,44,1,309,0,1,1
61689,8378,2020-11-18T16:16:39.7965203Z,2018,308,109,270,165,0,20,2,143,0,0,199,38,0,285,2,1,3
61689,8379,2020-11-18T16:16:39.7975203Z,2019,374,125,323,194,0,22,6,180,0,0,249,51,1,350,2,2,1
61689,8380,2020-11-18T16:16:39.7975203Z,2020,360,113,313,185,0,20,5,175,0,0,247,47,1,337,2,1,2
62810,25965,2021-06-24T05:35:12.90407Z,2021,178,60,163,93,0,20,0,85,0,0,118,15,0,158,0,0,0
62810,8682,2020-11-18T16:16:42.1881175Z,2012,213,51,202,96,0,37,0,117,0,0,162,11,14,161,0,0,1
62810,8683,2020-11-18T16:16:42.1891175Z,2013,239,63,215,122,0,41,0,117,0,0,176,24,10,188,0,5,0
62810,8684,2020-11-18T16:16:42.1891175Z,2014,238,58,184,127,0,25,0,111,0,0,180,54,8,205,0,2,0
62810,8685,2020-11-18T16:16:42.1891175Z,2015,256,79,242,129,0,32,0,127,0,0,177,14,5,219,0,1,0
62810,8686,2020-11-18T16:16:42.1891175Z,2016,244,81,224,122,0,21,0,122,0,0,163,20,6,217,0,1,0
62810,8687,2020-11-18T16:16:42.1891175Z,2017,235,75,203,128,0,14,0,107,0,0,160,32,3,218,0,2,0
62810,8688,2020-11-18T16:16:42.1901184Z,2018,223,72,196,120,0,19,0,103,0,0,151,27,3,200,0,1,1
62810,8689,2020-11-18T16:16:42.1901184Z,2019,227,84,201,119,0,18,0,108,0,0,143,26,3,206,0,1,0
62810,8690,2020-11-18T16:16:42.1901184Z,2020,228,76,203,122,0,27,0,106,0,0,152,25,1,200,0,1,0
75820,10888,2020-11-18T16:16:57.4212752Z,2012,253,67,226,113,0,12,0,140,0,0,186,27,0,232,0,0,9
75820,10889,2020-11-18T16:16:57.4212752Z,2013,228,55,210,99,0,12,0,129,0,0,173,18,1,212,0,2,3
75820,10890,2020-11-18T16:16:57.4222757Z,2014,194,44,177,92,0,10,0,102,0,0,150,17,1,183,0,0,0
75820,10891,2020-11-18T16:16:57.4222757Z,2015,173,52,156,76,0,6,0,97,0,0,121,17,0,166,0,1,1
75820,10892,2020-11-18T16:16:57.4222757Z,2016,149,54,24,60,0,3,0,89,0,0,95,125,0,146,0,0,0
75820,10893,2020-11-18T16:16:57.4232766Z,2017,150,64,136,61,0,5,1,89,0,0,86,14,0,144,0,2,1
75820,10894,2020-11-18T16:16:57.4232766Z,2018,96,43,91,36,0,1,7,60,0,0,53,5,0,95,0,1,0
75820,10895,2020-11-18T16:16:57.4232766Z,2019,259,90,234,142,0,5,6,117,0,0,169,25,0,254,1,0,0
75820,10896,2020-11-18T16:16:57.4232766Z,2020,262,75,219,141,0,4,0,121,0,0,187,43,0,258,1,0,0
75820,25998,2021-06-24T05:35:14.5162253Z,2021,256,81,214,132,0,6,0,124,0,0,175,42,0,250,1,0,0
48264,31865,2021-06-24T05:35:18.4320343Z,2021,683,234,503,335,0,10,0,348,0,0,449,180,1,672,0,2,0
48264,6104,2020-11-18T16:16:25.0696999Z,2012,821,0,545,414,0,23,0,407,0,0,821,276,0,798,0,0,0
48264,6105,2020-11-18T16:16:25.0696999Z,2013,774,0,535,394,0,13,0,380,0,0,774,239,0,761,0,2,0
48264,6106,2020-11-18T16:16:25.0696999Z,2014,544,9,391,279,0,0,0,265,0,0,535,153,0,544,0,3,0
48264,6107,2020-11-18T16:16:25.0707008Z,2015,711,54,517,387,0,4,0,324,0,0,657,194,0,707,0,4,0
48264,6108,2020-11-18T16:16:25.0707008Z,2016,466,60,47,244,0,4,0,222,0,0,406,419,0,462,0,4,0
48264,6109,2020-11-18T16:16:25.0707008Z,2017,647,125,279,328,0,7,0,319,0,0,522,368,1,639,0,2,0
48264,6110,2020-11-18T16:16:25.0707008Z,2018,719,171,453,359,0,9,1,360,0,0,548,266,2,706,0,2,2
48264,6111,2020-11-18T16:16:25.0707008Z,2019,690,179,463,350,0,10,1,340,0,0,511,227,3,676,0,2,1
48264,6112,2020-11-18T16:16:25.0717017Z,2020,649,229,477,310,0,6,1,339,0,0,420,172,2,640,0,2,1
70581,25655,2021-06-24T05:35:04.7041893Z,2021,405,125,347,198,0,22,2,207,0,0,280,58,0,382,0,1,1
70581,9792,2020-11-18T16:16:50.4836456Z,2012,500,55,375,256,0,13,0,244,0,0,445,125,1,486,0,0,0
70581,9793,2020-11-18T16:16:50.4846473Z,2013,505,83,368,251,0,10,0,254,0,0,422,137,1,493,0,0,1
70581,9794,2020-11-18T16:16:50.4846473Z,2014,464,91,337,244,0,10,0,220,0,0,373,127,2,450,0,1,2
70581,9795,2020-11-18T16:16:50.4846473Z,2015,471,97,348,242,0,15,0,229,0,0,374,123,1,454,0,0,1
70581,9796,2020-11-18T16:16:50.4846473Z,2016,359,83,238,179,0,15,2,180,0,0,276,121,0,344,0,0,0
70581,9797,2020-11-18T16:16:50.4846473Z,2017,329,71,239,167,0,16,0,162,0,0,258,90,0,313,0,0,0
70581,9798,2020-11-18T16:16:50.4856478Z,2018,297,57,203,162,0,13,4,135,0,0,240,94,0,284,1,0,0
70581,9799,2020-11-18T16:16:50.4856478Z,2019,438,114,328,205,0,13,4,233,0,1,324,110,0,424,0,0,1
70581,9800,2020-11-18T16:16:50.4856478Z,2020,397,125,308,191,0,20,0,206,0,0,272,89,0,376,0,0,1
20909,1980,2020-11-18T16:15:58.5099896Z,2012,368,42,304,190,0,9,0,178,0,0,326,64,1,358,0,0,0
20909,1981,2020-11-18T16:15:58.5099896Z,2013,350,74,299,177,0,9,0,173,0,0,276,51,0,341,0,1,0
20909,1982,2020-11-18T16:15:58.5099896Z,2014,343,88,288,182,0,10,0,161,0,0,255,55,0,333,0,1,0
20909,1983,2020-11-18T16:15:58.510991Z,2015,311,89,269,155,0,9,0,156,0,0,222,42,0,302,0,1,0
20909,1984,2020-11-18T16:15:58.510991Z,2016,271,87,168,142,0,6,1,129,0,0,184,103,0,265,0,1,0
20909,1985,2020-11-18T16:15:58.510991Z,2017,258,92,209,142,0,4,1,116,0,0,166,49,0,254,0,1,0
20909,1986,2020-11-18T16:15:58.510991Z,2018,339,136,272,165,0,4,3,174,0,0,203,67,0,334,0,1,1
20909,1987,2020-11-18T16:15:58.510991Z,2019,329,137,272,163,0,2,0,166,0,0,192,57,0,327,0,1,0
20909,1988,2020-11-18T16:15:58.5119919Z,2020,347,149,289,165,0,3,3,182,0,0,198,58,0,342,0,2,2
20909,25701,2021-06-24T05:35:08.6630284Z,2021,377,155,297,167,0,7,0,210,0,0,222,80,1,369,1,1,0
63099,31973,2021-06-24T05:35:20.2783575Z,2021,141,55,117,74,0,1,0,67,0,0,86,24,0,139,0,0,1
63099,8863,2020-11-18T16:16:43.9192672Z,2012,284,105,282,139,0,4,0,145,0,0,179,2,1,279,0,0,0
63099,8864,2020-11-18T16:16:43.9192672Z,2013,255,93,249,120,0,3,0,135,0,0,162,6,1,251,0,0,0
63099,8865,2020-11-18T16:16:43.9192672Z,2014,240,102,238,125,0,3,0,115,0,0,138,2,0,236,0,0,1
63099,8866,2020-11-18T16:16:43.9192672Z,2015,316,145,314,167,0,5,0,149,0,0,171,2,0,309,0,0,2
63099,8867,2020-11-18T16:16:43.9202681Z,2016,314,137,306,154,0,4,2,160,0,0,177,8,0,308,0,1,2
63099,8868,2020-11-18T16:16:43.9202681Z,2017,304,123,300,141,0,5,2,163,0,0,181,4,0,297,0,1,2
63099,8869,2020-11-18T16:16:43.9202681Z,2018,267,107,261,126,0,1,1,141,0,0,160,6,0,262,0,1,4
63099,8870,2020-11-18T16:16:43.9202681Z,2019,214,90,200,113,0,0,5,101,0,0,124,14,0,212,0,0,2
63099,8871,2020-11-18T16:16:43.9202681Z,2020,180,74,178,90,0,3,5,90,0,0,106,2,0,175,0,0,2
71134,10080,2020-11-18T16:16:52.5960564Z,2012,422,138,326,206,0,3,0,216,0,0,284,96,0,418,0,0,1
71134,10081,2020-11-18T16:16:52.5960564Z,2013,384,139,325,186,0,6,0,198,0,0,245,59,0,378,0,4,0
71134,10082,2020-11-18T16:16:52.5960564Z,2014,349,122,298,170,0,4,0,179,0,0,227,51,0,344,0,1,1
71134,10083,2020-11-18T16:16:52.5960564Z,2015,329,120,243,157,0,2,0,172,0,0,209,86,0,327,0,0,0
71134,10084,2020-11-18T16:16:52.5960564Z,2016,311,121,189,150,0,2,1,161,0,0,190,122,0,309,0,0,0
71134,10085,2020-11-18T16:16:52.5970587Z,2017,293,114,261,137,0,3,1,156,0,0,179,32,0,290,0,1,0
71134,10086,2020-11-18T16:16:52.5970587Z,2018,243,88,221,119,0,1,1,124,0,0,155,22,0,242,0,0,0
71134,10087,2020-11-18T16:16:52.5970587Z,2019,251,110,219,123,0,2,1,128,0,0,141,32,0,249,0,0,0
71134,10088,2020-11-18T16:16:52.5970587Z,2020,244,116,189,118,0,1,0,126,0,0,128,55,0,243,0,0,0
71134,25619,2021-06-24T05:35:04.6471491Z,2021,241,111,196,119,0,1,0,122,0,0,130,45,0,240,0,0,0
31583,25769,2021-06-24T05:35:08.7420849Z,2021,226,57,200,102,0,0,0,124,0,0,169,26,0,223,0,0,3
31583,3716,2020-11-18T16:16:08.7137935Z,2012,142,21,133,72,0,1,0,70,0,0,121,9,0,141,0,0,0
31583,3717,2020-11-18T16:16:08.7137935Z,2013,140,25,133,77,0,1,0,63,0,0,115,7,0,139,0,0,0
31583,3718,2020-11-18T16:16:08.7137935Z,2014,127,29,104,67,0,0,0,60,0,0,98,23,0,127,0,0,0
31583,3719,2020-11-18T16:16:08.714794Z,2015,67,17,56,35,0,1,0,32,0,0,50,11,0,66,0,0,0
31583,3720,2020-11-18T16:16:08.714794Z,2016,108,22,80,49,0,1,2,59,0,0,86,28,0,107,0,0,0
31583,3721,2020-11-18T16:16:08.714794Z,2017,112,31,95,46,0,2,0,66,0,0,81,17,0,110,0,0,0
31583,3722,2020-11-18T16:16:08.714794Z,2018,222,57,181,101,0,1,0,121,0,0,165,41,0,221,0,0,0
31583,3723,2020-11-18T16:16:08.714794Z,2019,242,67,209,110,0,1,0,132,0,0,175,33,1,239,0,0,1
31583,3724,2020-11-18T16:16:08.7157944Z,2020,216,58,175,106,0,1,0,110,0,0,158,41,0,212,0,0,3
35071,25794,2021-06-24T05:35:10.8766157Z,2021,370,87,314,179,0,6,2,191,0,0,283,56,0,364,0,0,0
35071,4305,2020-11-18T16:16:12.1570903Z,2012,360,74,226,162,0,3,0,198,0,0,286,134,2,354,0,0,1
35071,4306,2020-11-18T16:16:12.1570903Z,2013,353,69,191,159,0,6,0,194,0,0,284,162,2,345,0,4,0
35071,4307,2020-11-18T16:16:12.1580907Z,2014,367,84,214,171,0,4,0,196,0,0,283,153,0,361,0,0,2
35071,4308,2020-11-18T16:16:12.1580907Z,2015,351,69,237,180,0,7,0,171,0,0,282,114,1,341,0,1,2
35071,4309,2020-11-18T16:16:12.1580907Z,2016,354,75,229,191,0,9,0,163,0,0,279,125,1,343,0,0,1
35071,4310,2020-11-18T16:16:12.1590916Z,2017,304,76,222,156,0,7,4,148,0,0,228,82,1,296,0,0,0
35071,4311,2020-11-18T16:16:12.1590916Z,2018,298,73,215,146,0,8,2,152,0,0,225,83,0,290,0,0,0
35071,4312,2020-11-18T16:16:12.1590916Z,2019,366,89,267,183,0,12,2,183,0,0,277,99,0,354,0,0,0
35071,4313,2020-11-18T16:16:12.160092Z,2020,367,85,275,177,0,12,0,190,0,0,282,92,0,355,0,0,0
66209,31985,2021-06-24T05:35:20.2913666Z,2021,427,99,357,236,0,10,2,191,0,0,328,70,1,416,1,0,0
66209,9168,2020-11-18T16:16:45.5053269Z,2012,546,0,338,284,0,10,0,262,0,0,546,208,1,535,0,0,0
66209,9169,2020-11-18T16:16:45.5063278Z,2013,507,1,310,259,0,8,0,248,0,0,506,197,1,498,0,0,0
66209,9170,2020-11-18T16:16:45.5063278Z,2014,490,35,328,246,0,8,0,244,0,0,455,162,1,481,0,1,0
66209,9171,2020-11-18T16:16:45.5063278Z,2015,587,50,429,289,0,11,0,298,0,0,537,158,0,576,0,2,0
66209,9172,2020-11-18T16:16:45.5063278Z,2016,491,71,347,238,0,11,1,253,0,0,420,144,1,478,0,2,1
66209,9173,2020-11-18T16:16:45.5073287Z,2017,487,86,361,228,0,16,2,259,0,0,401,126,0,469,0,3,2
66209,9174,2020-11-18T16:16:45.5073287Z,2018,583,109,425,276,0,19,3,307,0,0,474,158,0,562,0,2,2
66209,9175,2020-11-18T16:16:45.5073287Z,2019,510,96,387,255,0,12,1,255,0,0,414,123,0,498,0,0,0
66209,9176,2020-11-18T16:16:45.5073287Z,2020,504,119,378,258,0,13,3,246,0,0,385,126,1,489,0,0,1
66233,31986,2021-06-24T05:35:20.3103809Z,2021,351,107,324,174,0,6,0,177,0,0,244,27,0,343,0,0,2
66233,9186,2020-11-18T16:16:45.5083292Z,2012,372,124,282,161,0,0,0,211,0,0,248,90,5,365,0,0,2
66233,9187,2020-11-18T16:16:45.5093301Z,2013,413,137,314,178,0,1,0,235,0,0,276,99,4,406,0,3,2
66233,9188,2020-11-18T16:16:45.5093301Z,2014,424,146,332,175,0,1,0,249,0,0,278,92,4,418,0,2,1
66233,9189,2020-11-18T16:16:45.5093301Z,2015,398,137,334,174,0,3,0,224,0,0,261,64,1,392,0,3,2
66233,9190,2020-11-18T16:16:45.510331Z,2016,353,125,251,164,0,0,1,189,0,0,228,102,0,352,0,1,1
66233,9191,2020-11-18T16:16:45.510331Z,2017,287,106,251,133,0,1,0,154,0,0,181,36,0,286,0,0,0
66233,9192,2020-11-18T16:16:45.510331Z,2018,301,105,262,145,0,6,0,156,0,0,196,39,0,295,1,0,0
66233,9193,2020-11-18T16:16:45.510331Z,2019,316,107,277,147,0,7,0,169,0,0,209,39,0,309,1,0,0
66233,9194,2020-11-18T16:16:45.510331Z,2020,345,106,313,177,0,7,0,168,0,0,239,32,0,336,0,0,2
46813,31856,2021-06-24T05:35:18.4200243Z,2021,201,94,187,84,0,3,0,117,0,0,107,14,0,198,0,0,0
46813,5928,2020-11-18T16:16:23.5376777Z,2012,281,132,235,134,0,4,0,147,0,0,149,46,0,277,0,0,0
46813,5929,2020-11-18T16:16:23.5386786Z,2013,255,123,223,119,0,7,0,136,0,0,132,32,0,248,0,2,0
46813,5930,2020-11-18T16:16:23.5386786Z,2014,208,115,187,99,0,7,0,109,0,0,93,21,0,201,0,1,0
46813,5931,2020-11-18T16:16:23.5386786Z,2015,189,97,158,94,0,3,0,95,0,0,92,31,0,186,0,0,0
46813,5932,2020-11-18T16:16:23.5386786Z,2016,151,92,133,67,0,1,0,84,0,0,59,18,0,150,0,0,0
46813,5933,2020-11-18T16:16:23.5396786Z,2017,160,83,146,71,0,0,0,89,0,0,77,14,0,160,0,0,0
46813,5934,2020-11-18T16:16:23.5396786Z,2018,253,108,224,122,0,7,3,131,0,0,145,29,0,246,0,1,0
46813,5935,2020-11-18T16:16:23.5396786Z,2019,241,105,218,113,0,4,0,128,0,0,136,23,0,237,0,2,0
46813,5936,2020-11-18T16:16:23.5396786Z,2020,233,108,209,100,0,6,0,133,0,0,125,24,0,227,0,0,0
58180,31932,2021-06-24T05:35:18.5301041Z,2021,592,102,418,325,0,2,0,267,0,0,490,174,0,590,0,0,0
58180,7843,2020-11-18T16:16:36.3522262Z,2012,910,3,625,457,0,10,0,453,0,0,907,285,0,900,0,0,0
58180,7844,2020-11-18T16:16:36.3522262Z,2013,890,5,570,455,0,6,0,435,0,0,885,320,0,884,0,8,0
58180,7845,2020-11-18T16:16:36.3522262Z,2014,905,53,582,476,0,3,0,429,0,0,852,323,0,901,0,1,1
58180,7846,2020-11-18T16:16:36.3532253Z,2015,897,37,533,480,0,2,0,417,0,0,860,364,0,894,0,2,1
58180,7847,2020-11-18T16:16:36.3532253Z,2016,905,97,591,467,0,3,13,438,0,0,808,314,0,901,0,1,1
58180,7848,2020-11-18T16:16:36.3532253Z,2017,886,110,557,458,0,3,7,428,0,0,776,329,0,882,0,0,1
58180,7849,2020-11-18T16:16:36.3532253Z,2018,772,100,504,397,0,1,12,375,0,0,672,268,0,770,0,0,1
58180,7850,2020-11-18T16:16:36.3532253Z,2019,709,82,449,387,0,2,33,322,0,0,627,260,1,706,0,2,0
58180,7851,2020-11-18T16:16:36.3542267Z,2020,650,104,421,362,0,3,25,288,0,0,546,229,2,645,0,1,0
50781,31880,2021-06-24T05:35:18.4520477Z,2021,127,40,109,53,0,1,28,74,0,0,87,18,0,126,2,2,0
50781,6351,2020-11-18T16:16:26.2855132Z,2012,104,39,84,51,0,0,0,53,0,0,65,20,0,104,0,0,0
50781,6352,2020-11-18T16:16:26.2855132Z,2013,121,51,95,54,0,1,0,67,0,0,70,26,0,120,0,0,0
50781,6353,2020-11-18T16:16:26.2855132Z,2014,119,51,93,53,0,0,0,66,0,0,68,26,0,119,0,2,0
50781,6354,2020-11-18T16:16:26.2865137Z,2015,145,59,115,59,0,0,0,86,0,0,86,30,0,145,0,4,0
50781,6355,2020-11-18T16:16:26.2865137Z,2016,163,61,100,69,0,0,30,94,0,0,102,63,0,163,0,3,0
50781,6356,2020-11-18T16:16:26.2865137Z,2017,139,52,113,56,0,0,20,83,0,0,87,26,0,139,0,0,0
50781,6357,2020-11-18T16:16:26.2875137Z,2018,143,49,102,58,0,1,23,85,0,1,94,41,0,142,2,0,0
50781,6358,2020-11-18T16:16:26.2875137Z,2019,154,46,123,66,0,1,40,88,0,0,108,31,0,153,2,2,0
50781,6359,2020-11-18T16:16:26.2875137Z,2020,159,39,132,71,0,1,46,88,0,0,120,27,0,157,2,2,1
42267,31832,2021-06-24T05:35:16.9589767Z,2021,443,171,418,224,0,15,0,219,0,0,272,25,0,428,1,0,0
42267,5191,2020-11-18T16:16:17.8328729Z,2012,308,29,268,162,0,4,0,146,0,0,279,40,0,304,0,0,0
42267,5192,2020-11-18T16:16:17.8328729Z,2013,265,39,226,138,0,5,0,127,0,0,226,39,0,260,0,2,0
42267,5193,2020-11-18T16:16:17.8328729Z,2014,247,65,216,124,0,8,0,123,0,0,182,31,1,238,0,1,0
42267,5194,2020-11-18T16:16:17.8328729Z,2015,238,62,220,111,0,6,0,127,0,0,176,18,0,232,0,1,0
42267,5195,2020-11-18T16:16:17.8328729Z,2016,236,81,142,112,0,7,0,124,0,0,155,94,0,229,0,1,0
42267,5196,2020-11-18T16:16:17.8338729Z,2017,218,71,196,114,0,8,0,104,0,0,147,22,0,210,0,2,0
42267,5197,2020-11-18T16:16:17.8338729Z,2018,235,74,205,115,0,9,0,120,0,0,161,30,0,226,1,0,0
42267,5198,2020-11-18T16:16:17.8338729Z,2019,546,204,494,256,0,15,0,290,0,0,342,52,0,531,2,1,0
42267,5199,2020-11-18T16:16:17.8338729Z,2020,501,206,472,245,0,17,0,256,0,0,295,29,0,483,2,1,1
62604,31964,2021-06-24T05:35:20.2773566Z,2021,302,108,299,148,0,6,0,154,0,0,194,3,0,296,0,0,0
62604,8603,2020-11-18T16:16:42.1651019Z,2012,359,111,270,167,0,4,0,192,0,0,248,89,0,355,0,0,0
62604,8604,2020-11-18T16:16:42.1651019Z,2013,312,104,274,141,0,3,0,171,0,0,208,38,0,309,0,3,0
62604,8605,2020-11-18T16:16:42.1651019Z,2014,260,93,195,122,0,3,0,138,0,0,167,65,0,257,0,3,0
62604,8606,2020-11-18T16:16:42.1651019Z,2015,270,101,172,127,0,3,0,143,0,0,169,98,0,267,0,3,0
62604,8607,2020-11-18T16:16:42.1651019Z,2016,305,113,238,150,0,3,1,155,0,0,192,67,0,301,0,1,1
62604,8608,2020-11-18T16:16:42.1661028Z,2017,372,129,362,179,0,3,0,193,0,0,243,10,3,365,0,4,1
62604,8609,2020-11-18T16:16:42.1661028Z,2018,408,128,352,204,0,6,0,204,0,0,280,56,4,397,1,4,1
62604,8610,2020-11-18T16:16:42.1661028Z,2019,412,128,403,220,0,5,3,192,0,0,284,9,4,401,1,3,2
62604,8611,2020-11-18T16:16:42.1661028Z,2020,392,121,383,205,0,4,1,187,0,0,271,9,4,383,1,3,1
63107,25972,2021-06-24T05:35:12.9090733Z,2021,298,106,286,145,0,27,4,153,0,0,192,12,0,270,0,0,1
63107,8872,2020-11-18T16:16:43.9272726Z,2012,347,92,333,173,0,18,0,174,0,0,255,14,0,329,0,0,0
63107,8873,2020-11-18T16:16:43.9272726Z,2013,336,97,322,177,0,19,0,159,0,0,239,14,0,317,0,0,0
63107,8874,2020-11-18T16:16:43.9272726Z,2014,310,107,295,163,0,20,0,147,0,0,203,15,0,290,0,0,0
63107,8875,2020-11-18T16:16:43.928273Z,2015,307,106,294,158,0,16,0,149,0,0,201,13,0,290,0,0,1
63107,8876,2020-11-18T16:16:43.928273Z,2016,185,61,173,99,0,15,4,86,0,0,124,12,0,170,0,0,0
63107,8877,2020-11-18T16:16:43.928273Z,2017,226,75,213,119,0,35,7,107,0,0,151,13,0,190,0,0,1
63107,8878,2020-11-18T16:16:43.928273Z,2018,204,74,195,108,0,29,4,96,0,0,130,9,0,173,0,0,2
63107,8879,2020-11-18T16:16:43.928273Z,2019,356,138,338,178,0,39,5,178,0,0,218,18,0,316,0,0,1
63107,8880,2020-11-18T16:16:43.9292739Z,2020,333,110,311,163,0,45,6,170,0,0,223,22,0,287,0,0,1
70870,31662,2021-06-24T05:35:15.2447481Z,2021,485,172,441,246,0,6,8,239,0,0,313,44,0,479,0,0,0
70870,9945,2020-11-18T16:16:51.525343Z,2012,507,77,383,232,0,1,0,275,0,0,430,124,0,506,0,0,0
70870,9946,2020-11-18T16:16:51.525343Z,2013,491,111,379,222,0,2,0,269,0,0,380,112,0,489,0,2,0
70870,9947,2020-11-18T16:16:51.525343Z,2014,453,122,343,208,0,3,0,245,0,0,331,110,0,450,0,0,0
70870,9948,2020-11-18T16:16:51.5263434Z,2015,429,117,327,191,0,2,0,238,0,0,312,102,0,427,0,0,0
70870,9949,2020-11-18T16:16:51.5263434Z,2016,605,167,354,307,0,3,3,298,0,0,438,251,0,602,0,2,0
70870,9950,2020-11-18T16:16:51.5263434Z,2017,418,111,316,214,0,1,1,204,0,0,307,102,0,417,0,1,0
70870,9951,2020-11-18T16:16:51.5273439Z,2018,423,119,325,222,0,2,1,201,0,0,304,98,0,421,0,0,0
70870,9952,2020-11-18T16:16:51.5273439Z,2019,583,194,488,296,0,4,23,287,0,0,389,95,0,579,0,0,0
70870,9953,2020-11-18T16:16:51.5273439Z,2020,521,172,448,262,0,4,14,259,0,0,349,73,0,517,0,0,0
21832,2300,2020-11-18T16:16:00.4312731Z,2012,162,14,101,78,0,1,0,84,0,0,148,61,0,161,0,0,0
21832,2301,2020-11-18T16:16:01.0026522Z,2013,169,13,112,84,0,1,0,85,0,0,156,57,0,168,0,1,0
21832,2302,2020-11-18T16:16:01.0036527Z,2014,149,10,90,77,0,2,0,72,0,0,139,59,0,147,0,2,0
21832,2303,2020-11-18T16:16:01.0036527Z,2015,128,12,80,64,0,2,0,64,0,0,116,48,0,126,0,1,0
21832,2304,2020-11-18T16:16:01.0036527Z,2017,65,13,35,0,0,2,0,65,0,0,52,30,0,63,0,0,0
21832,2305,2020-11-18T16:16:01.0046536Z,2018,95,15,56,0,0,1,0,95,0,0,80,39,0,94,0,0,0
21832,2306,2020-11-18T16:16:01.0046536Z,2019,84,15,47,2,0,0,0,82,0,0,69,37,0,84,0,0,0
21832,2307,2020-11-18T16:16:01.0046536Z,2020,97,20,56,1,0,0,1,96,0,0,77,41,0,97,1,0,0
21832,25711,2021-06-24T05:35:08.6670309Z,2021,94,23,66,1,0,0,1,93,0,0,71,28,0,94,1,0,0
63024,31971,2021-06-24T05:35:20.2783575Z,2021,298,121,257,151,0,2,11,147,0,0,177,41,1,294,0,0,1
63024,8814,2020-11-18T16:16:43.9022565Z,2012,337,42,283,169,0,6,0,168,0,0,295,54,0,327,0,0,4
63024,8815,2020-11-18T16:16:43.9022565Z,2013,334,65,304,182,0,10,0,152,0,0,269,30,0,321,0,0,3
63024,8816,2020-11-18T16:16:43.9022565Z,2014,310,75,286,171,0,8,0,139,0,0,235,24,0,299,0,0,3
63024,8817,2020-11-18T16:16:43.9022565Z,2015,311,71,287,175,0,9,0,136,0,0,240,24,0,301,0,0,1
63024,8818,2020-11-18T16:16:43.9022565Z,2016,143,38,133,71,0,3,0,72,0,0,105,10,0,140,0,0,0
63024,8819,2020-11-18T16:16:43.9032565Z,2017,239,75,227,126,0,3,0,113,0,0,164,12,0,236,0,0,0
63024,8820,2020-11-18T16:16:43.9032565Z,2018,230,74,218,115,0,6,1,115,0,0,156,12,0,224,0,0,0
63024,8821,2020-11-18T16:16:43.9032565Z,2019,246,109,201,126,0,2,18,120,0,0,137,45,0,243,0,0,1
63024,8822,2020-11-18T16:16:43.9032565Z,2020,261,107,216,128,0,2,23,133,0,0,154,45,0,258,0,0,1
66498,31988,2021-06-24T05:35:20.3163843Z,2021,290,81,261,149,0,4,0,141,0,0,209,29,0,283,0,1,3
66498,9228,2020-11-18T16:16:46.6961224Z,2012,455,63,393,236,0,18,0,219,0,0,392,62,0,436,0,0,1
66498,9229,2020-11-18T16:16:46.6961224Z,2013,449,91,388,228,0,17,0,221,0,0,358,61,0,432,0,0,0
66498,9230,2020-11-18T16:16:46.6961224Z,2014,406,106,374,216,0,3,0,190,0,0,300,32,0,403,0,0,0
66498,9231,2020-11-18T16:16:46.6971228Z,2015,403,105,353,213,0,1,0,190,0,0,298,50,0,402,0,0,0
66498,9232,2020-11-18T16:16:46.6971228Z,2016,390,98,321,202,0,9,0,188,0,0,292,69,0,380,0,1,1
66498,9233,2020-11-18T16:16:46.6971228Z,2017,385,101,318,180,0,8,0,205,0,0,284,67,0,377,0,1,0
66498,9234,2020-11-18T16:16:46.6981246Z,2018,377,97,318,178,0,11,3,199,0,0,280,59,0,366,0,2,0
66498,9235,2020-11-18T16:16:46.6981246Z,2019,319,90,279,156,0,12,0,163,0,0,229,40,0,307,0,3,0
66498,9236,2020-11-18T16:16:46.6981246Z,2020,304,83,269,156,0,7,1,148,0,0,221,35,0,296,0,3,1
51706,25886,2021-06-24T05:35:12.7799814Z,2021,276,103,236,131,0,9,0,145,0,0,173,40,1,265,0,1,1
51706,6568,2020-11-18T16:16:27.8065239Z,2012,287,117,228,134,0,8,0,153,0,0,170,59,1,277,0,0,1
51706,6569,2020-11-18T16:16:27.8075244Z,2013,351,147,297,176,0,18,0,175,0,0,204,54,0,332,0,0,1
51706,6570,2020-11-18T16:16:27.8075244Z,2014,341,148,266,165,0,25,0,176,0,0,193,75,1,314,0,5,1
51706,6571,2020-11-18T16:16:27.8075244Z,2015,340,155,278,171,0,20,0,169,0,0,185,62,0,320,0,7,0
51706,6572,2020-11-18T16:16:27.8075244Z,2016,314,143,240,153,0,18,9,161,0,0,171,74,0,296,0,2,0
51706,6573,2020-11-18T16:16:27.8075244Z,2017,412,164,308,208,0,17,10,204,0,0,248,104,0,395,0,5,0
51706,6574,2020-11-18T16:16:27.808527Z,2018,376,144,253,184,0,13,10,192,0,0,232,123,0,363,2,1,0
51706,6575,2020-11-18T16:16:27.808527Z,2019,319,138,257,146,0,13,10,173,0,2,181,62,0,306,1,1,0
51706,6576,2020-11-18T16:16:27.808527Z,2020,299,109,237,149,0,11,7,150,0,0,190,62,0,288,0,1,0
47662,25860,2021-06-24T05:35:10.9886956Z,2021,350,92,297,170,0,15,0,180,0,0,258,53,0,334,3,4,1
47662,6041,2020-11-18T16:16:23.9779713Z,2012,450,2,383,242,0,18,0,208,0,0,448,67,0,426,0,0,6
47662,6042,2020-11-18T16:16:23.9789718Z,2013,415,4,375,213,0,12,0,202,0,0,411,40,0,401,0,3,2
47662,6043,2020-11-18T16:16:23.9789718Z,2014,416,28,370,223,0,10,0,193,0,0,388,46,0,405,0,3,1
47662,6044,2020-11-18T16:16:23.9789718Z,2015,384,33,330,197,0,10,0,187,0,0,351,54,0,373,0,4,1
47662,6045,2020-11-18T16:16:23.9789718Z,2016,353,60,272,192,0,8,2,161,0,0,293,81,0,345,0,3,0
47662,6046,2020-11-18T16:16:23.9799727Z,2017,389,64,325,193,0,5,2,196,0,0,325,64,0,384,0,3,0
47662,6047,2020-11-18T16:16:23.9799727Z,2018,407,80,334,206,0,15,11,201,0,0,327,73,1,391,1,3,0
47662,6048,2020-11-18T16:16:23.9799727Z,2019,360,68,288,177,0,22,8,183,0,0,292,72,0,338,1,5,0
47662,6049,2020-11-18T16:16:23.9799727Z,2020,341,88,269,176,0,19,0,165,0,0,253,72,1,320,2,3,1
42945,25835,2021-06-24T05:35:10.9416617Z,2021,550,169,470,260,0,21,2,290,0,0,381,80,1,528,5,1,0
42945,5393,2020-11-18T16:16:19.3498867Z,2012,355,70,306,175,0,18,0,180,0,0,285,49,0,337,0,0,0
42945,5394,2020-11-18T16:16:19.3498867Z,2013,347,81,303,177,0,17,0,170,0,0,266,44,0,330,0,10,0
42945,5395,2020-11-18T16:16:19.3498867Z,2014,329,83,280,151,0,20,0,178,0,0,246,49,0,309,0,9,0
42945,5396,2020-11-18T16:16:19.3498867Z,2015,325,82,272,150,0,14,0,175,0,0,243,53,0,311,0,5,0
42945,5397,2020-11-18T16:16:19.3498867Z,2016,365,106,283,172,0,13,0,193,0,0,259,82,0,352,0,4,0
42945,5398,2020-11-18T16:16:19.3508867Z,2017,352,102,305,170,0,17,0,182,0,0,250,47,0,334,0,4,1
42945,5399,2020-11-18T16:16:19.3508867Z,2018,428,130,349,197,0,12,9,231,0,0,298,79,0,415,4,3,1
42945,5400,2020-11-18T16:16:19.3508867Z,2019,589,170,479,278,0,22,27,311,0,1,419,110,2,564,7,3,1
42945,5401,2020-11-18T16:16:19.759159Z,2020,557,163,469,271,0,24,13,286,0,0,394,88,1,532,6,3,0
56101,25918,2021-06-24T05:35:12.8120035Z,2021,281,74,252,137,0,4,1,144,0,0,207,29,0,276,0,0,1
56101,7568,2020-11-18T16:16:34.5450186Z,2012,502,49,431,271,0,4,0,231,0,0,453,71,0,498,0,0,0
56101,7569,2020-11-18T16:16:34.5450186Z,2013,541,91,465,260,0,0,0,281,0,0,450,76,0,541,0,1,0
56101,7570,2020-11-18T16:16:34.5450186Z,2014,527,99,455,245,0,2,0,282,0,0,428,72,0,525,0,2,0
56101,7571,2020-11-18T16:16:34.5460195Z,2015,515,100,422,234,0,0,0,281,0,0,415,93,0,515,0,0,0
56101,7572,2020-11-18T16:16:34.5460195Z,2016,500,101,312,236,0,1,0,264,0,0,399,188,0,499,0,0,0
56101,7573,2020-11-18T16:16:34.5460195Z,2017,483,135,398,239,0,5,0,244,0,0,348,85,1,477,0,2,0
56101,7574,2020-11-18T16:16:34.5460195Z,2018,458,136,378,233,0,3,1,225,0,1,322,80,0,455,1,2,0
56101,7575,2020-11-18T16:16:34.5470208Z,2019,356,117,306,180,0,1,1,176,0,0,239,50,0,355,0,0,0
56101,7576,2020-11-18T16:16:34.5470208Z,2020,323,100,267,163,0,3,2,160,0,0,223,56,0,319,0,0,1
53009,31901,2021-06-24T05:35:18.475064Z,2021,247,79,209,122,0,5,4,125,0,0,168,38,0,242,0,2,0
53009,7104,2020-11-18T16:16:32.0373497Z,2012,528,60,440,233,0,3,0,295,0,0,468,88,0,525,0,0,0
53009,7105,2020-11-18T16:16:32.0383501Z,2013,507,83,442,240,0,1,0,267,0,0,424,65,1,505,0,5,0
53009,7106,2020-11-18T16:16:32.0383501Z,2014,476,107,397,221,0,0,0,255,0,0,369,79,1,475,0,3,0
53009,7107,2020-11-18T16:16:32.0383501Z,2015,458,108,381,206,0,0,0,252,0,0,350,77,0,458,0,1,0
53009,7108,2020-11-18T16:16:32.0383501Z,2016,434,117,344,196,0,2,5,238,0,0,317,90,0,432,0,0,0
53009,7109,2020-11-18T16:16:32.0383501Z,2017,359,105,281,165,0,1,5,194,0,0,254,78,0,358,0,1,0
53009,7110,2020-11-18T16:16:32.039351Z,2018,313,99,234,155,0,1,14,158,0,1,214,79,1,311,1,1,0
53009,7111,2020-11-18T16:16:32.039351Z,2019,298,98,232,141,0,2,6,157,0,0,200,66,0,296,1,1,0
53009,7112,2020-11-18T16:16:32.039351Z,2020,268,84,212,128,0,4,6,140,0,0,184,56,0,264,0,1,0
72082,10625,2020-11-18T16:16:56.1083982Z,2012,712,151,609,344,0,6,0,368,0,0,561,103,4,702,0,0,0
72082,10626,2020-11-18T16:16:56.1083982Z,2013,633,175,545,295,0,5,0,338,0,0,458,88,4,624,0,6,0
72082,10627,2020-11-18T16:16:56.1083982Z,2014,596,171,507,285,0,6,0,311,0,0,425,89,0,590,0,5,0
72082,10628,2020-11-18T16:16:56.1093987Z,2015,491,143,409,232,0,6,0,259,0,0,348,82,2,483,0,3,0
72082,10629,2020-11-18T16:16:56.1093987Z,2016,402,144,281,189,0,9,0,213,0,0,258,121,1,392,0,0,0
72082,10630,2020-11-18T16:16:56.1093987Z,2017,519,187,437,249,0,14,1,270,0,0,332,82,0,505,0,0,0
72082,10631,2020-11-18T16:16:56.1093987Z,2018,599,195,508,258,0,13,0,341,0,0,404,91,0,585,0,1,1
72082,10632,2020-11-18T16:16:56.1093987Z,2019,596,195,521,265,0,14,1,331,0,0,401,75,0,582,0,1,0
72082,10633,2020-11-18T16:16:56.1103991Z,2020,550,174,492,252,0,5,2,298,0,0,376,58,0,545,0,1,0
72082,25625,2021-06-24T05:35:04.6581563Z,2021,545,172,493,260,0,4,0,285,0,0,373,52,0,541,0,1,0
47902,25861,2021-06-24T05:35:10.9906984Z,2021,985,285,801,467,0,20,0,518,0,0,700,184,1,963,2,5,1
47902,6059,2020-11-18T16:16:23.9839753Z,2012,888,2,668,448,0,4,0,440,0,0,886,220,0,883,0,0,1
47902,6060,2020-11-18T16:16:23.9849758Z,2013,856,2,658,441,0,6,0,415,0,0,854,198,0,849,0,2,1
47902,6061,2020-11-18T16:16:23.9849758Z,2014,940,81,735,494,0,11,0,446,0,0,859,205,0,929,0,2,0
47902,6062,2020-11-18T16:16:23.9849758Z,2015,918,65,724,455,0,13,0,463,0,0,853,194,0,905,0,2,0
47902,6063,2020-11-18T16:16:23.9849758Z,2016,876,150,665,441,0,14,3,435,0,0,726,211,0,862,0,4,0
47902,6064,2020-11-18T16:16:23.9859767Z,2017,798,142,624,389,0,11,2,409,0,0,656,174,0,787,0,3,0
47902,6065,2020-11-18T16:16:23.9859767Z,2018,909,150,712,460,0,11,4,449,0,0,759,197,0,898,1,1,0
47902,6066,2020-11-18T16:16:23.9859767Z,2019,943,208,748,460,0,8,0,483,0,0,735,195,0,933,0,3,2
47902,6067,2020-11-18T16:16:23.9859767Z,2020,908,276,711,436,0,6,0,472,0,0,632,197,0,901,0,4,1
31534,25768,2021-06-24T05:35:08.7420849Z,2021,108,28,94,53,0,1,0,55,0,0,80,14,0,106,0,0,1
31534,3698,2020-11-18T16:16:08.0573559Z,2012,212,40,162,111,0,0,0,101,0,0,172,50,0,212,0,0,0
31534,3699,2020-11-18T16:16:08.0573559Z,2013,159,41,140,82,0,2,0,77,0,0,118,19,0,157,0,4,0
31534,3700,2020-11-18T16:16:08.0573559Z,2014,151,44,139,75,0,0,0,76,0,0,107,12,0,151,0,0,0
31534,3701,2020-11-18T16:16:08.702786Z,2015,183,44,156,96,0,4,0,87,0,0,139,27,0,179,0,0,0
31534,3702,2020-11-18T16:16:08.702786Z,2016,151,41,120,72,0,4,6,79,0,0,110,31,0,147,0,0,0
31534,3703,2020-11-18T16:16:08.702786Z,2017,134,37,106,58,0,4,2,76,0,0,97,28,0,129,0,0,1
31534,3704,2020-11-18T16:16:08.7037869Z,2018,124,31,90,58,0,2,11,66,0,0,93,34,0,121,1,0,1
31534,3705,2020-11-18T16:16:08.7037869Z,2019,117,39,100,58,0,2,0,59,0,0,78,17,0,114,0,0,1
31534,3706,2020-11-18T16:16:08.7037869Z,2020,117,34,97,54,0,2,0,63,0,0,83,20,0,114,0,0,1
71472,10268,2020-11-18T16:16:53.7368208Z,2012,318,103,274,149,0,3,0,169,0,0,215,44,1,314,0,0,0
71472,10269,2020-11-18T16:16:53.7368208Z,2013,309,96,276,133,0,3,0,176,0,0,213,33,1,305,0,0,0
71472,10270,2020-11-18T16:16:53.7368208Z,2014,294,95,256,130,0,3,0,164,0,0,199,38,2,289,0,0,0
71472,10271,2020-11-18T16:16:53.7368208Z,2015,288,98,248,122,0,6,0,166,0,0,190,40,2,280,0,0,0
71472,10272,2020-11-18T16:16:53.7378194Z,2016,199,66,167,83,0,25,0,116,0,0,133,32,1,173,0,0,0
71472,10273,2020-11-18T16:16:53.7378194Z,2017,317,95,268,137,0,23,0,180,0,0,222,49,1,293,0,0,0
71472,10274,2020-11-18T16:16:53.7378194Z,2018,329,110,272,148,0,39,2,181,0,0,219,57,1,289,0,0,0
71472,10275,2020-11-18T16:16:53.7378194Z,2019,326,129,274,141,0,38,30,185,0,0,197,52,0,288,0,0,0
71472,10276,2020-11-18T16:16:53.7378194Z,2020,301,113,258,133,0,34,17,168,0,0,188,43,0,266,0,0,1
71472,25670,2021-06-24T05:35:04.7422174Z,2021,299,121,271,142,0,51,11,157,0,0,178,28,0,248,0,0,0
21055,2060,2020-11-18T16:15:58.9242659Z,2012,996,1,709,569,0,25,0,427,0,0,995,287,0,959,0,0,12
21055,2061,2020-11-18T16:15:58.9242659Z,2013,859,7,616,512,0,13,0,347,0,0,852,243,1,843,0,5,2
21055,2062,2020-11-18T16:15:58.9242659Z,2014,823,48,612,484,0,7,0,339,0,0,775,211,1,813,0,2,2
21055,2063,2020-11-18T16:15:58.9242659Z,2015,827,47,637,482,0,13,0,345,0,0,780,190,1,811,0,2,2
21055,2064,2020-11-18T16:15:58.9242659Z,2016,804,107,536,464,0,11,0,340,0,0,697,268,0,791,0,3,2
21055,2065,2020-11-18T16:15:58.9252668Z,2017,977,186,704,539,0,16,0,438,0,0,791,273,0,960,0,4,1
21055,2066,2020-11-18T16:15:58.9252668Z,2018,951,191,687,528,0,7,24,423,0,0,760,264,0,944,0,4,0
21055,2067,2020-11-18T16:15:58.9252668Z,2019,757,152,576,440,0,4,2,317,0,0,605,181,0,753,0,4,0
21055,2068,2020-11-18T16:15:58.9252668Z,2020,636,199,514,362,0,6,0,274,0,0,437,122,0,630,0,2,0
21055,25704,2021-06-24T05:35:08.6620279Z,2021,521,178,418,284,0,4,0,237,0,0,343,103,1,516,0,1,0
46334,25852,2021-06-24T05:35:10.9736851Z,2021,224,79,182,89,0,4,0,135,0,0,145,42,0,219,0,0,1
46334,5883,2020-11-18T16:16:22.5860417Z,2012,614,46,417,336,0,18,0,278,0,0,568,197,0,596,0,0,0
46334,5884,2020-11-18T16:16:22.5870431Z,2013,509,63,348,277,0,11,0,232,0,0,446,161,0,498,0,2,0
46334,5885,2020-11-18T16:16:22.5870431Z,2014,435,67,307,243,0,11,0,192,0,0,368,128,0,424,0,5,0
46334,5886,2020-11-18T16:16:22.5870431Z,2015,358,61,263,182,0,10,0,176,0,0,297,95,0,347,0,4,1
46334,5887,2020-11-18T16:16:22.5880435Z,2016,314,81,138,161,0,3,3,153,0,0,233,176,0,310,0,1,1
46334,5888,2020-11-18T16:16:22.5880435Z,2017,307,78,257,152,0,1,1,155,0,0,229,50,0,304,0,1,2
46334,5889,2020-11-18T16:16:22.5880435Z,2018,280,90,241,129,0,3,30,151,0,0,190,39,0,276,0,2,1
46334,5890,2020-11-18T16:16:22.5880435Z,2019,260,85,218,119,0,4,0,141,0,0,175,42,0,254,0,2,2
46334,5891,2020-11-18T16:16:22.5890435Z,2020,262,87,223,114,0,3,0,148,0,0,175,39,0,255,0,0,4
75838,10897,2020-11-18T16:16:57.4192739Z,2012,800,1,548,437,0,1,0,363,0,0,799,252,0,799,0,0,0
75838,10898,2020-11-18T16:16:57.4192739Z,2013,754,12,526,430,0,3,0,324,0,0,742,228,0,750,0,0,1
75838,10899,2020-11-18T16:16:57.4202739Z,2014,777,65,598,432,0,6,0,345,0,0,712,179,0,769,0,0,2
75838,10900,2020-11-18T16:16:57.4202739Z,2015,716,54,527,415,0,7,0,301,0,0,662,189,0,707,0,1,2
75838,10901,2020-11-18T16:16:58.094724Z,2016,883,144,184,485,0,10,0,398,0,0,739,699,1,872,0,1,0
75838,10902,2020-11-18T16:16:58.094724Z,2017,808,138,593,438,0,7,0,370,0,0,670,215,1,800,0,1,0
75838,10903,2020-11-18T16:16:58.094724Z,2018,843,159,653,460,0,7,0,383,0,0,684,190,1,835,13,1,0
75838,10904,2020-11-18T16:16:58.094724Z,2019,735,153,566,398,0,4,0,337,0,0,582,169,1,729,15,1,1
75838,10905,2020-11-18T16:16:58.0957244Z,2020,651,193,523,354,0,2,0,297,0,0,458,128,3,645,21,1,1
75838,32000,2021-06-24T05:35:20.3203872Z,2021,572,185,466,299,0,6,0,273,0,0,387,106,1,565,13,0,0
22053,2389,2020-11-18T16:16:01.0156602Z,2012,430,207,358,175,0,6,0,255,0,0,223,72,0,424,0,0,0
22053,2390,2020-11-18T16:16:01.0156602Z,2013,436,200,299,182,0,4,0,254,0,0,236,137,0,432,0,4,0
22053,2391,2020-11-18T16:16:01.0166611Z,2014,447,204,360,187,0,4,0,260,0,0,243,87,1,441,0,0,1
22053,2392,2020-11-18T16:16:01.0166611Z,2015,454,207,369,189,0,1,0,265,0,0,247,85,1,452,0,0,0
22053,2393,2020-11-18T16:16:01.0166611Z,2016,471,215,371,198,0,4,0,273,0,0,256,100,1,466,0,1,0
22053,2394,2020-11-18T16:16:01.017662Z,2017,403,201,334,176,0,4,0,227,0,0,202,69,0,399,0,2,0
22053,2395,2020-11-18T16:16:01.017662Z,2018,493,211,411,232,0,3,31,261,0,0,282,82,0,490,2,2,0
22053,2396,2020-11-18T16:16:01.017662Z,2019,479,231,391,220,0,2,33,259,0,0,248,88,0,477,3,1,0
22053,2397,2020-11-18T16:16:01.0186624Z,2020,468,219,404,213,0,6,36,255,0,0,249,64,0,462,1,1,0
22053,25714,2021-06-24T05:35:08.6680327Z,2021,411,184,366,176,0,7,9,235,0,0,227,45,0,404,0,1,0
73890,10680,2020-11-18T16:16:56.1274098Z,2012,708,211,527,337,0,7,0,371,0,0,497,181,0,700,0,0,1
73890,10681,2020-11-18T16:16:56.1274098Z,2013,688,217,501,331,0,4,0,357,0,0,471,187,0,683,0,4,1
73890,10682,2020-11-18T16:16:56.1274098Z,2014,678,217,486,339,0,6,0,339,0,0,461,192,0,671,0,0,1
73890,10683,2020-11-18T16:16:56.1274098Z,2015,709,233,509,354,0,9,0,355,0,0,476,200,1,698,0,1,1
73890,10684,2020-11-18T16:16:56.1274098Z,2016,536,164,180,257,0,6,0,279,0,0,372,356,2,528,0,1,0
73890,10685,2020-11-18T16:16:56.1284107Z,2017,594,219,386,307,0,5,1,287,0,0,375,208,0,587,0,2,2
73890,10686,2020-11-18T16:16:56.1284107Z,2018,581,197,480,279,0,9,5,302,0,2,384,101,0,569,0,2,3
73890,10687,2020-11-18T16:16:56.1284107Z,2019,474,187,379,226,0,7,0,248,0,0,287,95,0,464,0,0,3
73890,10688,2020-11-18T16:16:56.1284107Z,2020,458,168,384,220,0,9,0,238,0,0,290,74,0,448,0,0,1
73890,31679,2021-06-24T05:35:15.2837754Z,2021,386,136,318,196,0,7,0,190,0,0,250,68,0,378,1,0,1
18192,1513,2020-11-18T16:15:55.3578907Z,2012,515,3,414,289,0,2,0,226,0,0,512,101,0,512,0,0,1
18192,1514,2020-11-18T16:15:55.3588907Z,2013,512,8,432,279,0,2,0,233,0,0,504,80,0,507,0,4,3
18192,1515,2020-11-18T16:15:55.3588907Z,2014,523,54,430,283,0,4,0,240,0,0,469,93,0,519,0,3,0
18192,1516,2020-11-18T16:15:55.3588907Z,2015,421,43,340,217,0,3,0,204,0,0,378,81,0,418,0,1,0
18192,1517,2020-11-18T16:15:55.3588907Z,2016,457,96,375,226,0,4,3,231,0,0,361,82,0,453,0,3,0
18192,1518,2020-11-18T16:15:55.3598916Z,2017,511,138,397,227,0,4,2,284,0,0,373,114,0,507,0,5,0
18192,1519,2020-11-18T16:15:55.3598916Z,2018,561,169,440,241,0,5,6,320,0,0,392,121,0,555,0,3,1
18192,1520,2020-11-18T16:15:55.3598916Z,2019,481,135,394,221,0,5,2,260,0,0,346,87,0,476,0,1,0
18192,1521,2020-11-18T16:15:55.3598916Z,2020,458,171,395,212,0,5,1,246,0,0,287,63,0,453,0,0,0
18192,31616,2021-06-24T05:35:14.6122942Z,2021,388,155,313,193,0,7,0,195,0,0,233,75,0,380,0,1,1
25023,25749,2021-06-24T05:35:08.7040576Z,2021,277,21,185,140,0,3,0,137,0,0,256,92,0,274,0,2,0
25023,2784,2020-11-18T16:16:03.2761674Z,2016,191,7,84,117,0,5,0,74,0,0,184,107,0,186,0,0,0
25023,2785,2020-11-18T16:16:03.2771679Z,2017,211,10,107,128,0,5,0,83,0,0,201,104,0,206,0,0,0
25023,2786,2020-11-18T16:16:03.2771679Z,2018,210,5,114,125,0,4,1,85,0,0,205,96,0,206,1,2,0
25023,2787,2020-11-18T16:16:03.2771679Z,2019,302,22,156,168,0,6,0,134,0,0,280,146,0,296,0,3,0
25023,2788,2020-11-18T16:16:03.2771679Z,2020,292,21,148,154,0,6,0,138,0,0,271,144,0,286,0,3,0
44545,31846,2021-06-24T05:35:16.9719862Z,2021,298,158,272,144,0,6,2,154,0,0,140,26,1,290,0,0,1
44545,5711,2020-11-18T16:16:22.0967172Z,2012,398,101,371,175,0,2,0,223,0,0,297,27,0,396,0,0,0
44545,5712,2020-11-18T16:16:22.0967172Z,2013,369,131,346,164,0,3,0,205,0,0,238,23,0,366,0,1,0
44545,5713,2020-11-18T16:16:22.0967172Z,2014,356,167,327,154,0,2,0,202,0,0,189,29,0,353,0,0,1
44545,5714,2020-11-18T16:16:22.0977195Z,2015,333,145,309,140,0,4,0,193,0,0,188,24,0,329,0,1,0
44545,5715,2020-11-18T16:16:22.0977195Z,2016,273,144,239,110,0,2,1,163,0,0,129,34,0,271,0,1,0
44545,5716,2020-11-18T16:16:22.0977195Z,2017,300,147,272,142,0,5,0,158,0,0,153,28,0,295,0,1,0
44545,5717,2020-11-18T16:16:22.0987186Z,2018,184,76,163,85,0,3,1,99,0,0,108,21,0,181,0,0,0
44545,5718,2020-11-18T16:16:22.0987186Z,2019,337,166,321,163,0,6,1,174,0,0,171,16,0,331,0,0,0
44545,5719,2020-11-18T16:16:22.0987186Z,2020,311,163,302,147,0,8,0,164,0,0,148,9,1,301,0,0,1
70557,31655,2021-06-24T05:35:15.2317386Z,2021,268,113,238,129,0,13,3,139,0,0,155,30,0,255,0,0,0
70557,9765,2020-11-18T16:16:50.4796433Z,2012,444,170,340,215,0,7,0,229,0,0,274,104,0,437,0,0,0
70557,9766,2020-11-18T16:16:50.4796433Z,2013,418,165,328,209,0,8,0,209,0,0,253,90,0,410,0,0,0
70557,9767,2020-11-18T16:16:50.4806438Z,2014,402,167,318,209,0,8,0,193,0,0,235,84,1,393,0,0,0
70557,9768,2020-11-18T16:16:50.4806438Z,2015,402,177,309,180,0,14,0,222,0,0,225,93,1,387,0,0,0
70557,9769,2020-11-18T16:16:50.4806438Z,2016,301,123,243,152,0,11,1,149,0,0,178,58,0,290,0,0,0
70557,9770,2020-11-18T16:16:50.4806438Z,2017,287,125,236,139,0,9,2,148,0,0,162,51,0,278,0,1,0
70557,9771,2020-11-18T16:16:50.4806438Z,2018,344,135,279,160,1,11,2,184,0,0,209,65,0,333,0,0,0
70557,9772,2020-11-18T16:16:50.481646Z,2019,327,132,270,168,0,10,14,159,0,0,195,57,0,317,0,0,0
70557,9773,2020-11-18T16:16:50.481646Z,2020,318,128,271,166,0,10,0,152,0,0,190,47,1,307,0,1,0
30221,25755,2021-06-24T05:35:08.7210696Z,2021,98,34,88,52,0,1,0,46,0,0,64,10,0,97,0,0,0
30221,3264,2020-11-18T16:16:05.7248015Z,2012,137,43,112,65,0,3,0,72,0,0,94,25,0,134,0,0,0
30221,3265,2020-11-18T16:16:05.7248015Z,2013,139,43,108,65,0,3,0,74,0,0,96,31,0,136,0,0,0
30221,3266,2020-11-18T16:16:05.7248015Z,2014,147,47,119,70,0,2,0,77,0,0,100,28,0,145,0,0,0
30221,3267,2020-11-18T16:16:05.7258037Z,2015,157,36,126,70,0,3,0,87,0,0,121,31,0,154,0,1,0
30221,3268,2020-11-18T16:16:05.7258037Z,2016,140,37,77,66,0,4,0,74,0,0,103,63,0,136,0,1,0
30221,3269,2020-11-18T16:16:05.7258037Z,2017,115,31,104,57,0,5,0,58,0,0,84,11,0,109,0,0,1
30221,3270,2020-11-18T16:16:05.7258037Z,2018,67,11,50,31,0,0,0,36,0,0,56,17,0,67,0,0,0
30221,3271,2020-11-18T16:16:05.7258037Z,2019,74,21,69,33,0,0,0,41,0,0,53,5,0,74,0,0,0
30221,3272,2020-11-18T16:16:05.7258037Z,2020,99,33,91,52,0,2,0,47,0,0,66,8,0,97,0,0,0
74476,10721,2020-11-18T16:16:56.8849156Z,2012,336,106,262,158,0,5,0,178,0,0,230,74,0,331,0,0,0
74476,10722,2020-11-18T16:16:56.8849156Z,2013,331,102,258,165,0,8,0,166,0,0,229,73,0,323,0,0,0
74476,10723,2020-11-18T16:16:56.8849156Z,2014,319,100,234,154,0,9,0,165,0,0,219,85,0,310,0,0,0
74476,10724,2020-11-18T16:16:56.8859161Z,2015,321,99,223,158,0,10,0,163,0,0,222,98,0,311,0,0,0
74476,10725,2020-11-18T16:16:56.8859161Z,2016,275,94,188,128,0,8,0,147,0,0,181,87,0,267,0,1,0
74476,10726,2020-11-18T16:16:56.8859161Z,2017,256,87,187,118,0,8,0,138,0,0,169,69,0,247,0,0,1
74476,10727,2020-11-18T16:16:56.8859161Z,2018,246,85,174,121,0,7,12,125,0,0,161,72,0,239,1,0,0
74476,10728,2020-11-18T16:16:56.8859161Z,2019,240,92,168,118,0,4,2,122,0,0,148,72,0,236,2,0,0
74476,10729,2020-11-18T16:16:56.886917Z,2020,201,77,145,95,0,2,4,106,0,0,124,56,0,197,4,0,2
74476,25679,2021-06-24T05:35:08.6239998Z,2021,202,69,144,85,0,4,0,117,0,0,133,58,0,197,2,0,1
50799,25879,2021-06-24T05:35:12.7759777Z,2021,135,52,126,72,0,1,29,63,0,0,83,9,0,134,0,0,0
50799,6360,2020-11-18T16:16:26.2795097Z,2012,239,61,210,126,0,0,0,113,0,0,178,29,0,239,0,0,0
50799,6361,2020-11-18T16:16:26.2805092Z,2013,263,72,235,131,0,2,0,132,0,0,191,28,0,261,0,0,0
50799,6362,2020-11-18T16:16:26.2805092Z,2014,244,66,212,119,0,3,0,125,0,0,178,32,0,237,0,4,4
50799,6363,2020-11-18T16:16:26.2805092Z,2015,200,75,181,96,0,1,0,104,0,0,125,19,0,199,0,1,0
50799,6364,2020-11-18T16:16:26.2805092Z,2016,210,71,189,98,0,0,0,112,0,0,139,21,0,210,0,0,0
50799,6365,2020-11-18T16:16:26.2805092Z,2017,179,60,166,85,0,0,4,94,0,0,119,13,0,179,0,0,0
50799,6366,2020-11-18T16:16:26.2815106Z,2018,181,73,159,84,0,0,0,97,0,0,108,22,0,181,0,0,0
50799,6367,2020-11-18T16:16:26.2815106Z,2019,207,90,189,101,0,3,17,106,0,0,117,18,0,204,0,0,0
50799,6368,2020-11-18T16:16:26.2815106Z,2020,215,74,200,111,0,4,63,104,0,0,141,15,0,211,0,0,0
14373,1062,2020-11-18T16:15:52.4989816Z,2012,185,45,168,82,0,1,0,103,0,0,140,17,0,184,0,0,0
14373,1063,2020-11-18T16:15:52.4999821Z,2013,158,46,146,68,0,0,0,90,0,0,112,12,0,158,0,2,0
14373,1064,2020-11-18T16:15:52.4999821Z,2014,149,49,139,56,0,0,0,93,0,0,100,10,0,149,0,0,0
14373,1065,2020-11-18T16:15:52.4999821Z,2015,132,48,122,49,0,1,0,83,0,0,84,10,0,131,0,1,0
14373,1066,2020-11-18T16:15:52.4999821Z,2016,110,43,102,51,0,0,0,59,0,0,67,8,0,110,0,1,0
14373,1067,2020-11-18T16:15:52.4999821Z,2017,112,35,104,49,0,0,0,63,0,0,77,8,0,112,0,1,0
14373,1068,2020-11-18T16:15:52.4999821Z,2018,172,54,163,73,0,4,24,99,0,0,118,9,0,168,0,2,0
14373,1069,2020-11-18T16:15:52.5009821Z,2019,241,90,223,106,0,8,11,135,0,0,151,18,0,233,0,1,0
14373,1070,2020-11-18T16:15:52.5009821Z,2020,201,78,184,85,0,7,4,116,0,0,123,17,0,194,0,0,0
14373,25870,2021-06-24T05:35:11.003708Z,2021,147,51,132,60,0,5,0,87,0,0,96,15,0,142,0,0,0
44842,31847,2021-06-24T05:35:16.9739881Z,2021,92,45,89,44,0,2,0,48,0,0,47,3,0,90,0,0,0
44842,5748,2020-11-18T16:16:22.1077248Z,2012,163,46,158,91,0,1,0,72,0,0,117,5,0,162,0,0,0
44842,5749,2020-11-18T16:16:22.1077248Z,2013,169,58,168,90,0,2,0,79,0,0,111,1,0,167,0,1,0
44842,5750,2020-11-18T16:16:22.1087256Z,2014,178,70,176,89,0,1,0,89,0,0,108,2,0,177,0,0,0
44842,5751,2020-11-18T16:16:22.1087256Z,2015,147,52,128,76,0,4,0,71,0,0,95,19,0,142,0,0,1
44842,5752,2020-11-18T16:16:22.1087256Z,2016,122,54,46,54,0,4,0,68,0,0,68,76,0,117,0,0,1
44842,5753,2020-11-18T16:16:22.1097261Z,2017,119,47,115,51,0,4,0,68,0,0,72,4,0,115,0,0,0
44842,5754,2020-11-18T16:16:22.1097261Z,2018,113,46,108,44,0,3,0,69,0,0,67,5,0,110,0,0,0
44842,5755,2020-11-18T16:16:22.1097261Z,2019,119,57,116,52,0,2,0,67,0,0,62,3,0,116,0,0,1
44842,5756,2020-11-18T16:16:22.1107265Z,2020,102,49,95,45,0,2,0,57,0,0,53,7,0,100,0,0,0
35840,25801,2021-06-24T05:35:10.883621Z,2021,190,46,155,88,0,3,0,102,0,0,144,35,0,186,0,0,1
35840,4443,2020-11-18T16:16:12.5853751Z,2012,240,61,208,110,0,6,0,130,0,0,179,32,0,233,0,0,1
35840,4444,2020-11-18T16:16:12.5853751Z,2013,228,54,197,105,0,4,0,123,0,0,174,31,0,222,0,4,2
35840,4445,2020-11-18T16:16:12.5853751Z,2014,335,88,259,161,0,11,0,174,0,0,247,76,0,323,0,2,1
35840,4446,2020-11-18T16:16:12.5863742Z,2015,293,78,249,137,0,6,0,156,0,0,215,44,2,285,0,0,0
35840,4447,2020-11-18T16:16:12.5863742Z,2016,252,57,212,122,0,4,0,130,0,0,195,40,0,246,0,0,2
35840,4448,2020-11-18T16:16:12.5863742Z,2017,231,59,201,116,0,4,0,115,0,0,172,30,0,227,0,0,0
35840,4449,2020-11-18T16:16:12.5873746Z,2018,259,45,214,134,0,6,0,125,0,0,214,45,0,252,0,0,1
35840,4450,2020-11-18T16:16:12.5873746Z,2019,207,35,174,101,0,5,0,106,0,0,172,33,0,201,0,0,1
35840,4451,2020-11-18T16:16:12.5873746Z,2020,194,30,168,92,0,4,0,102,0,0,164,26,1,189,0,0,0
74039,10689,2020-11-18T16:16:56.1324134Z,2012,257,1,201,132,0,10,0,125,0,0,256,56,0,247,0,0,0
74039,10690,2020-11-18T16:16:56.1334138Z,2013,245,4,191,125,0,12,0,120,0,0,241,54,0,233,0,1,0
74039,10691,2020-11-18T16:16:56.1334138Z,2014,239,19,199,120,0,11,0,119,0,0,220,40,0,227,0,1,1
74039,10692,2020-11-18T16:16:56.1334138Z,2015,206,30,174,91,0,8,0,115,0,0,176,32,0,198,0,1,0
74039,10693,2020-11-18T16:16:56.1334138Z,2016,307,84,243,161,0,8,0,146,0,0,223,64,0,299,0,2,0
74039,10694,2020-11-18T16:16:56.1334138Z,2017,380,87,314,206,0,11,1,174,0,0,293,66,0,369,0,0,0
74039,10695,2020-11-18T16:16:56.1344152Z,2018,420,87,308,228,0,13,0,192,0,0,333,112,0,407,0,1,0
74039,10696,2020-11-18T16:16:56.1344152Z,2019,352,68,270,186,0,11,0,166,0,0,284,82,0,341,0,0,0
74039,10697,2020-11-18T16:16:56.1344152Z,2020,330,93,259,168,0,10,0,162,0,0,237,71,0,320,0,0,0
74039,25678,2021-06-24T05:35:08.6199969Z,2021,342,102,264,181,0,9,0,161,0,0,240,78,0,332,1,0,1
64956,25977,2021-06-24T05:35:12.9330901Z,2021,364,93,333,194,0,6,0,170,0,0,271,31,0,358,0,0,0
64956,8996,2020-11-18T16:16:44.4616291Z,2012,463,137,390,231,0,17,0,232,0,0,326,73,0,446,0,0,0
64956,8997,2020-11-18T16:16:44.4616291Z,2013,370,114,273,188,0,13,0,182,0,0,256,97,0,357,0,1,0
64956,8998,2020-11-18T16:16:44.46263Z,2014,392,118,299,193,0,16,0,199,0,0,274,93,0,376,0,1,0
64956,8999,2020-11-18T16:16:44.46263Z,2015,351,100,274,176,0,13,0,175,0,0,251,77,0,338,0,2,0
64956,9000,2020-11-18T16:16:44.46263Z,2016,370,100,234,191,0,14,0,179,0,0,270,136,0,355,0,3,1
64956,9001,2020-11-18T16:16:44.871904Z,2017,345,100,293,165,0,9,0,180,0,0,245,52,0,335,0,2,1
64956,9002,2020-11-18T16:16:44.871904Z,2018,322,77,280,164,0,7,9,158,0,0,245,42,0,313,0,1,2
64956,9003,2020-11-18T16:16:44.871904Z,2019,381,110,344,199,0,5,2,182,0,0,271,37,0,376,0,0,0
64956,9004,2020-11-18T16:16:44.871904Z,2020,331,89,293,169,0,5,2,162,0,0,242,38,1,323,0,0,2
70367,31649,2021-06-24T05:35:14.6743387Z,2021,380,126,316,173,0,5,1,207,0,0,254,64,0,375,0,0,0
70367,9626,2020-11-18T16:16:49.7171344Z,2012,294,46,262,149,0,2,0,145,0,0,248,32,0,292,0,0,0
70367,9627,2020-11-18T16:16:49.7171344Z,2013,288,70,251,146,0,3,0,142,0,0,218,37,0,285,0,2,0
70367,9628,2020-11-18T16:16:49.7171344Z,2014,211,76,178,100,0,4,0,111,0,0,135,33,0,207,0,2,0
70367,9629,2020-11-18T16:16:49.7181344Z,2015,191,66,153,86,0,5,0,105,0,0,125,38,0,186,0,1,0
70367,9630,2020-11-18T16:16:49.7181344Z,2016,219,86,113,85,0,3,6,134,0,0,133,106,0,216,0,2,0
70367,9631,2020-11-18T16:16:49.7181344Z,2017,406,154,341,182,0,7,1,224,0,0,252,65,0,399,0,6,0
70367,9632,2020-11-18T16:16:49.7181344Z,2018,450,143,359,199,0,1,1,251,0,0,307,91,0,449,0,2,0
70367,9633,2020-11-18T16:16:49.7191353Z,2019,461,178,382,220,0,2,1,241,0,2,283,79,0,459,0,3,0
70367,9634,2020-11-18T16:16:49.7191353Z,2020,418,155,361,190,0,6,1,228,0,0,263,57,0,412,0,3,0
43299,25838,2021-06-24T05:35:10.9446641Z,2021,99,38,92,53,0,0,0,46,0,0,61,7,0,99,0,0,0
43299,5506,2020-11-18T16:16:20.7107953Z,2012,131,53,111,54,0,6,0,77,0,0,78,20,0,125,0,0,0
43299,5507,2020-11-18T16:16:20.7117971Z,2013,132,55,98,60,0,10,0,72,0,0,77,34,0,122,0,1,0
43299,5508,2020-11-18T16:16:20.7117971Z,2014,141,58,103,61,0,9,0,80,0,0,83,38,0,132,0,3,0
43299,5509,2020-11-18T16:16:20.7117971Z,2015,134,62,97,56,0,5,0,78,0,0,72,37,0,129,0,2,0
43299,5510,2020-11-18T16:16:20.7117971Z,2016,133,61,31,59,0,6,0,74,0,0,72,102,0,127,0,2,0
43299,5511,2020-11-18T16:16:20.7127971Z,2017,132,57,119,57,0,6,0,75,0,0,75,13,0,126,0,1,0
43299,5512,2020-11-18T16:16:20.7127971Z,2018,124,51,106,57,0,4,9,67,0,0,73,18,0,120,0,1,0
43299,5513,2020-11-18T16:16:20.7127971Z,2019,90,38,80,39,0,0,0,51,0,0,52,10,0,90,0,0,0
43299,5514,2020-11-18T16:16:20.7127971Z,2020,94,42,86,41,0,0,0,53,0,0,52,8,0,94,0,0,0
75747,10839,2020-11-18T16:16:57.4152708Z,2012,249,110,217,122,0,4,0,127,0,0,139,32,0,245,0,0,0
75747,10840,2020-11-18T16:16:57.4152708Z,2013,250,108,218,116,0,0,0,134,0,0,142,32,0,250,0,0,0
75747,10841,2020-11-18T16:16:57.4152708Z,2014,236,94,199,116,0,1,0,120,0,0,142,37,0,235,0,0,0
75747,10842,2020-11-18T16:16:57.4162712Z,2015,271,100,238,129,0,5,0,142,0,0,171,33,0,266,0,1,0
75747,10843,2020-11-18T16:16:57.4162712Z,2016,280,97,239,136,0,3,3,144,0,0,183,41,0,277,0,0,0
75747,10844,2020-11-18T16:16:57.4162712Z,2017,248,80,218,112,0,4,0,136,0,0,168,30,0,244,0,0,0
75747,10845,2020-11-18T16:16:57.4162712Z,2018,264,79,222,121,0,4,1,143,0,0,185,42,0,260,2,0,0
75747,10846,2020-11-18T16:16:57.4162712Z,2019,260,83,213,119,0,3,5,141,0,0,177,47,0,257,2,0,0
75747,10847,2020-11-18T16:16:57.4172721Z,2020,249,72,215,107,0,0,0,142,0,0,177,34,0,249,2,0,0
75747,31997,2021-06-24T05:35:20.3203872Z,2021,180,54,167,84,0,2,0,96,0,0,126,13,0,178,1,0,0
70573,31656,2021-06-24T05:35:15.2367419Z,2021,252,132,224,119,0,9,3,133,0,0,120,28,0,243,0,0,0
70573,9783,2020-11-18T16:16:50.4846473Z,2012,504,95,378,231,0,7,0,273,0,0,409,126,3,490,0,0,4
70573,9784,2020-11-18T16:16:50.4856478Z,2013,433,125,344,191,0,7,0,242,0,0,308,89,2,417,0,1,7
70573,9785,2020-11-18T16:16:50.4856478Z,2014,414,197,336,180,0,11,0,234,0,0,217,78,0,398,0,3,5
70573,9786,2020-11-18T16:16:50.4856478Z,2015,449,234,370,203,0,12,0,246,0,0,215,79,0,435,0,1,2
70573,9787,2020-11-18T16:16:50.4856478Z,2016,384,206,309,180,0,8,9,204,0,0,178,75,0,376,0,4,0
70573,9788,2020-11-18T16:16:50.4856478Z,2017,374,183,312,163,0,10,23,211,0,0,191,62,0,364,0,1,0
70573,9789,2020-11-18T16:16:50.4866478Z,2018,338,163,278,147,0,7,28,191,0,0,175,60,0,331,0,1,0
70573,9790,2020-11-18T16:16:50.4866478Z,2019,324,180,282,145,0,12,14,179,0,0,144,42,0,312,0,0,0
70573,9791,2020-11-18T16:16:50.4866478Z,2020,259,145,228,123,0,8,9,136,0,0,114,31,0,251,0,0,0
42283,25831,2021-06-24T05:35:10.9376588Z,2021,247,80,221,116,0,6,0,131,0,0,167,26,0,241,1,1,0
42283,5203,2020-11-18T16:16:18.4232686Z,2012,206,69,191,101,0,1,0,105,0,0,137,15,0,205,0,0,0
42283,5204,2020-11-18T16:16:18.4242686Z,2013,199,71,178,105,0,1,0,94,0,0,128,21,0,198,0,0,0
42283,5205,2020-11-18T16:16:18.4242686Z,2014,174,56,144,98,0,0,0,76,0,0,118,30,0,174,0,2,0
42283,5206,2020-11-18T16:16:18.4242686Z,2015,187,45,151,109,0,0,0,78,0,0,142,36,0,187,0,2,0
42283,5207,2020-11-18T16:16:18.4242686Z,2016,179,46,105,92,0,0,0,87,0,0,133,74,0,179,0,0,0
42283,5208,2020-11-18T16:16:18.4252695Z,2017,222,60,176,112,0,6,0,110,0,0,162,46,0,216,0,0,0
42283,5209,2020-11-18T16:16:18.4252695Z,2018,257,88,206,122,0,6,1,135,0,0,169,51,0,251,0,0,0
42283,5210,2020-11-18T16:16:18.4252695Z,2019,287,111,244,143,0,7,0,144,0,1,176,43,0,280,1,0,0
42283,5211,2020-11-18T16:16:18.4252695Z,2020,267,94,230,136,0,4,0,131,0,0,173,37,1,262,1,0,0
32524,25775,2021-06-24T05:35:08.7480901Z,2021,124,50,112,53,0,0,0,71,0,0,74,12,0,123,0,0,1
32524,3894,2020-11-18T16:16:09.1941148Z,2012,115,36,98,51,0,0,0,64,0,0,79,17,0,115,0,0,0
32524,3895,2020-11-18T16:16:09.1951153Z,2013,115,37,73,52,0,1,0,63,0,0,78,42,0,114,0,0,0
32524,3896,2020-11-18T16:16:09.1951153Z,2014,141,52,98,65,0,0,0,76,0,0,89,43,0,141,0,0,0
32524,3897,2020-11-18T16:16:09.1951153Z,2015,146,49,118,72,0,1,0,74,0,0,97,28,0,145,0,0,0
32524,3898,2020-11-18T16:16:09.1951153Z,2016,163,51,124,80,0,0,0,83,0,0,112,39,0,163,0,0,0
32524,3899,2020-11-18T16:16:09.1951153Z,2017,153,39,124,79,0,1,0,74,0,0,114,29,0,151,0,1,1
32524,3900,2020-11-18T16:16:09.1961153Z,2018,125,33,97,66,0,0,2,59,0,1,92,28,0,125,0,0,0
32524,3901,2020-11-18T16:16:09.8625609Z,2019,144,42,107,76,0,1,0,68,0,0,102,37,0,141,0,0,2
32524,3902,2020-11-18T16:16:09.8625609Z,2020,119,39,94,53,0,0,0,66,0,0,80,25,0,118,0,0,1
70250,25645,2021-06-24T05:35:04.6951839Z,2021,547,142,389,281,0,8,0,266,0,0,405,158,2,535,0,3,2
70250,9563,2020-11-18T16:16:49.2148017Z,2012,469,135,369,235,0,20,0,234,0,0,334,100,0,449,0,0,0
70250,9564,2020-11-18T16:16:49.2158013Z,2013,455,120,361,229,0,15,0,226,0,0,335,94,1,438,0,23,1
70250,9565,2020-11-18T16:16:49.2158013Z,2014,475,134,351,245,0,14,0,230,0,0,341,124,0,461,0,18,0
70250,9566,2020-11-18T16:16:49.2158013Z,2015,551,149,363,272,0,10,0,279,0,0,402,188,0,541,0,36,0
70250,9567,2020-11-18T16:16:49.2158013Z,2016,479,123,310,253,0,2,0,226,0,0,356,169,2,474,0,15,1
70250,9568,2020-11-18T16:16:49.2158013Z,2017,608,179,391,318,0,1,0,290,0,0,429,217,2,605,0,33,0
70250,9569,2020-11-18T16:16:49.2168022Z,2018,663,155,415,336,0,18,10,327,0,0,508,248,4,637,1,29,4
70250,9570,2020-11-18T16:16:49.2168022Z,2019,660,154,425,330,0,13,0,330,0,0,506,235,4,639,1,7,4
70250,9571,2020-11-18T16:16:49.2168022Z,2020,595,146,381,300,0,11,0,295,0,0,449,214,2,580,0,3,2
52944,31900,2021-06-24T05:35:18.4760654Z,2021,366,114,315,171,0,10,20,195,0,0,252,51,0,356,0,1,0
52944,7073,2020-11-18T16:16:31.3248724Z,2012,150,76,141,64,0,1,0,86,0,0,74,9,0,149,0,0,0
52944,7074,2020-11-18T16:16:31.3248724Z,2013,153,70,131,56,0,1,0,97,0,0,83,22,0,152,0,1,0
52944,7075,2020-11-18T16:16:31.3248724Z,2014,135,53,131,56,0,1,0,79,0,0,82,4,0,134,0,1,0
52944,7076,2020-11-18T16:16:31.3248724Z,2015,170,54,161,86,0,4,0,84,0,0,116,9,0,166,0,0,0
52944,7077,2020-11-18T16:16:31.3258729Z,2016,126,43,55,56,0,5,6,70,0,0,83,71,0,120,0,0,1
52944,7078,2020-11-18T16:16:31.3258729Z,2017,138,44,124,63,0,4,9,75,0,0,94,14,0,134,0,4,0
52944,7079,2020-11-18T16:16:31.3258729Z,2018,242,71,205,119,0,8,11,123,0,0,171,37,0,234,0,4,0
52944,7080,2020-11-18T16:16:31.3258729Z,2019,380,105,331,181,0,11,20,199,0,0,275,49,0,369,0,3,0
52944,7081,2020-11-18T16:16:31.3258729Z,2020,360,110,319,166,0,12,33,194,0,0,250,41,0,348,0,3,0
78832,11029,2020-11-18T16:16:58.5150052Z,2012,463,67,327,241,0,13,0,222,0,0,396,136,0,450,0,0,0
78832,11030,2020-11-18T16:16:58.5150052Z,2013,480,131,365,230,0,11,0,250,0,0,349,115,0,468,0,1,1
78832,11031,2020-11-18T16:16:58.5150052Z,2014,460,142,349,212,0,10,0,248,0,0,318,111,0,450,0,1,0
78832,11032,2020-11-18T16:16:58.5150052Z,2015,438,153,335,217,0,10,0,221,0,0,285,103,0,428,0,2,0
78832,11033,2020-11-18T16:16:58.5160061Z,2016,396,163,326,189,0,4,4,207,0,0,233,70,0,392,0,2,0
78832,11034,2020-11-18T16:16:58.5160061Z,2017,332,135,278,159,0,5,2,173,0,0,197,54,0,327,0,0,0
78832,11035,2020-11-18T16:16:58.5160061Z,2018,328,117,263,164,3,4,3,164,0,0,211,65,0,323,1,1,1
78832,11036,2020-11-18T16:16:58.5160061Z,2019,485,196,417,252,4,7,2,233,0,0,289,68,0,477,0,1,1
78832,11037,2020-11-18T16:16:58.5160061Z,2020,398,158,355,215,0,5,0,183,0,0,240,43,0,393,1,0,0
78832,25684,2021-06-24T05:35:08.634007Z,2021,352,133,301,182,0,5,0,170,0,0,219,51,0,346,1,1,1
15396,1179,2020-11-18T16:15:53.151417Z,2012,239,84,194,111,0,1,0,128,0,0,155,45,0,238,0,0,0
15396,1180,2020-11-18T16:15:53.151417Z,2013,248,85,201,114,0,1,0,134,0,0,163,47,0,247,0,1,0
15396,1181,2020-11-18T16:15:53.1524179Z,2014,219,74,177,98,0,2,0,121,0,0,145,42,0,217,0,1,0
15396,1182,2020-11-18T16:15:53.1524179Z,2015,218,74,169,99,0,2,0,119,0,0,144,49,0,216,0,2,0
15396,1183,2020-11-18T16:15:53.1524179Z,2016,203,74,157,97,0,0,0,106,0,0,129,46,0,203,0,1,0
15396,1184,2020-11-18T16:15:53.1524179Z,2017,220,76,174,104,0,0,0,116,0,0,144,46,0,220,0,1,0
15396,1185,2020-11-18T16:15:53.1524179Z,2018,222,65,169,100,0,0,19,122,0,0,157,53,0,222,0,0,0
15396,1186,2020-11-18T16:15:53.1524179Z,2019,217,62,175,112,0,1,5,105,0,0,155,42,0,216,0,1,0
15396,1187,2020-11-18T16:15:53.1534179Z,2020,179,40,149,85,0,2,0,94,0,0,139,30,0,177,0,0,0
15396,25809,2021-06-24T05:35:10.9006329Z,2021,200,53,176,105,0,2,1,95,0,0,147,24,0,198,0,0,0
22012,2368,2020-11-18T16:16:01.011658Z,2012,577,92,434,316,0,3,0,261,0,0,485,143,0,574,0,0,0
22012,2369,2020-11-18T16:16:01.011658Z,2013,565,152,442,304,0,4,0,261,0,0,413,123,0,561,0,1,0
22012,2370,2020-11-18T16:16:01.011658Z,2014,595,184,452,303,0,1,0,292,0,0,411,143,0,594,0,1,0
22012,2371,2020-11-18T16:16:01.0126584Z,2015,605,191,454,279,0,2,0,326,0,0,414,151,0,603,0,0,0
22012,2372,2020-11-18T16:16:01.0126584Z,2016,545,169,352,257,0,1,0,288,0,0,376,193,0,544,0,0,0
22012,2373,2020-11-18T16:16:01.0126584Z,2017,494,155,377,236,0,2,1,258,0,0,339,117,1,491,0,0,0
22012,2374,2020-11-18T16:16:01.0126584Z,2018,492,162,364,245,0,1,0,247,0,0,330,128,1,490,1,0,0
22012,2375,2020-11-18T16:16:01.0136598Z,2019,502,181,379,245,0,3,3,257,0,0,321,123,0,499,1,0,0
22012,2376,2020-11-18T16:16:01.0136598Z,2020,457,157,357,221,0,3,33,236,0,0,300,100,0,454,3,0,0
22012,25713,2021-06-24T05:35:08.6680327Z,2021,455,161,368,232,0,3,26,223,0,0,294,87,0,452,2,0,0
69047,25991,2021-06-24T05:35:14.5112224Z,2021,487,157,414,247,0,9,3,240,0,0,330,73,0,478,2,1,0
69047,9303,2020-11-18T16:16:47.3745756Z,2012,395,4,341,201,0,8,0,194,0,0,391,54,0,386,0,0,1
69047,9304,2020-11-18T16:16:47.3745756Z,2013,528,15,437,268,0,17,0,260,0,0,513,91,0,509,0,2,2
69047,9305,2020-11-18T16:16:47.3745756Z,2014,607,65,481,304,0,11,0,303,0,0,542,126,0,595,0,1,1
69047,9306,2020-11-18T16:16:47.3755761Z,2015,672,46,524,345,0,11,0,327,0,0,626,148,0,661,0,2,0
69047,9307,2020-11-18T16:16:47.3755761Z,2016,602,85,437,294,0,12,11,308,0,0,517,165,0,590,0,1,0
69047,9308,2020-11-18T16:16:47.3755761Z,2017,530,95,388,263,0,15,6,267,0,0,435,142,0,515,0,0,0
69047,9309,2020-11-18T16:16:47.3755761Z,2018,604,122,461,307,0,9,5,297,0,0,482,143,0,595,1,0,0
69047,9310,2020-11-18T16:16:47.3765783Z,2019,624,144,495,308,0,16,3,316,0,0,480,129,0,608,1,1,0
69047,9311,2020-11-18T16:16:47.3765783Z,2020,554,177,443,282,0,14,8,272,0,0,377,111,0,540,3,1,0
31245,25765,2021-06-24T05:35:08.7390834Z,2021,396,58,383,189,0,11,57,207,0,0,338,13,1,384,0,0,0
31245,3593,2020-11-18T16:16:07.6420787Z,2012,655,68,598,315,0,9,0,340,0,0,587,57,15,631,0,0,0
31245,3594,2020-11-18T16:16:07.6420787Z,2013,642,78,545,309,0,5,0,333,0,0,564,97,19,618,0,0,0
31245,3595,2020-11-18T16:16:07.6420787Z,2014,630,72,558,304,0,3,0,326,0,0,558,72,24,603,0,0,0
31245,3596,2020-11-18T16:16:07.6430801Z,2015,632,70,555,310,0,7,0,322,0,0,562,77,20,605,0,0,0
31245,3597,2020-11-18T16:16:07.6430801Z,2016,610,72,438,295,0,9,116,315,0,0,538,172,16,585,0,0,0
31245,3598,2020-11-18T16:16:07.6430801Z,2017,676,84,602,326,0,19,108,350,0,0,592,74,15,642,0,4,0
31245,3599,2020-11-18T16:16:07.6430801Z,2018,678,74,604,325,0,26,166,353,0,0,604,74,15,637,0,1,0
31245,3600,2020-11-18T16:16:07.6440792Z,2019,511,68,462,235,0,16,130,276,0,0,443,49,7,488,1,2,0
31245,3601,2020-11-18T16:16:08.0233328Z,2020,449,57,406,208,0,13,106,241,0,0,392,43,3,433,0,1,0
73668,10664,2020-11-18T16:16:56.1164058Z,2012,378,45,314,176,0,6,0,202,0,0,333,64,0,372,0,0,0
73668,10665,2020-11-18T16:16:56.1174031Z,2013,378,80,324,174,0,3,0,204,0,0,298,54,0,375,0,1,0
73668,10666,2020-11-18T16:16:56.1174031Z,2014,388,104,339,182,0,7,0,206,0,0,284,49,0,381,0,0,0
73668,10667,2020-11-18T16:16:56.1174031Z,2015,350,106,299,162,0,3,0,188,0,0,244,51,0,347,0,0,0
73668,10668,2020-11-18T16:16:56.1174031Z,2016,276,75,253,128,0,2,0,148,0,0,201,23,0,274,0,0,0
73668,10669,2020-11-18T16:16:56.1174031Z,2017,246,74,218,108,0,3,1,138,0,0,172,28,0,243,0,0,0
73668,10670,2020-11-18T16:16:56.118404Z,2018,248,81,222,121,0,4,0,127,0,0,167,26,0,244,0,1,0
73668,10671,2020-11-18T16:16:56.118404Z,2019,248,90,220,131,0,5,0,117,0,0,158,28,0,243,0,0,0
73668,10672,2020-11-18T16:16:56.118404Z,2020,245,98,217,120,0,4,0,125,0,0,147,28,0,240,0,0,1
73668,25677,2021-06-24T05:35:04.7492218Z,2021,259,106,232,124,0,2,0,135,0,0,153,27,0,257,0,0,0
71217,10109,2020-11-18T16:16:53.2725101Z,2012,400,73,312,219,0,14,0,181,0,0,327,88,0,386,0,0,0
71217,10110,2020-11-18T16:16:53.2735097Z,2013,480,139,356,242,0,11,0,238,0,0,341,124,0,469,0,0,0
71217,10111,2020-11-18T16:16:53.2735097Z,2014,506,159,375,235,0,6,0,271,0,0,347,131,0,500,0,1,0
71217,10112,2020-11-18T16:16:53.2735097Z,2015,500,138,369,222,0,4,0,278,0,0,362,131,0,496,0,0,0
71217,10113,2020-11-18T16:16:53.2735097Z,2016,489,155,126,235,0,2,0,254,0,0,334,363,0,487,0,0,0
71217,10114,2020-11-18T16:16:53.2745105Z,2017,493,168,371,253,0,3,0,240,0,0,325,122,0,490,0,1,0
71217,10115,2020-11-18T16:16:53.2745105Z,2018,496,156,368,247,0,5,35,249,0,0,340,128,0,490,11,0,1
71217,10116,2020-11-18T16:16:53.2745105Z,2019,461,167,351,226,0,10,24,235,0,0,294,110,0,451,10,0,0
71217,10117,2020-11-18T16:16:53.2745105Z,2020,434,180,342,211,0,9,26,223,0,0,254,92,0,425,4,0,0
71217,31666,2021-06-24T05:35:15.2497519Z,2021,378,161,323,184,0,8,16,194,0,0,217,55,0,370,6,0,0
51375,25882,2021-06-24T05:35:12.7779791Z,2021,175,40,124,93,0,1,0,82,0,0,135,51,0,174,0,1,0
51375,6459,2020-11-18T16:16:27.0460184Z,2012,201,44,158,94,0,1,0,107,0,0,157,43,0,200,0,0,0
51375,6460,2020-11-18T16:16:27.0460184Z,2013,191,42,141,87,0,0,0,104,0,0,149,50,0,191,0,1,0
51375,6461,2020-11-18T16:16:27.0460184Z,2014,172,33,121,78,0,0,0,94,0,0,139,51,0,172,0,1,0
51375,6462,2020-11-18T16:16:27.0460184Z,2015,185,33,137,83,0,1,0,102,0,0,152,48,0,184,0,2,0
51375,6463,2020-11-18T16:16:27.0470179Z,2016,194,41,128,91,0,2,4,103,0,0,153,66,0,192,0,1,0
51375,6464,2020-11-18T16:16:27.0470179Z,2017,176,43,121,77,0,0,0,99,0,0,133,55,0,176,0,0,0
51375,6465,2020-11-18T16:16:27.0470179Z,2018,185,39,103,89,0,0,7,96,0,0,146,82,0,185,1,0,0
51375,6466,2020-11-18T16:16:27.0480202Z,2019,206,48,125,105,0,2,7,101,0,0,158,81,0,204,1,2,0
51375,6467,2020-11-18T16:16:27.0480202Z,2020,213,46,103,109,0,1,0,104,0,0,167,110,0,212,1,1,0
70615,25656,2021-06-24T05:35:04.7051902Z,2021,331,162,261,154,0,12,8,177,0,0,169,70,2,317,0,2,0
70615,9813,2020-11-18T16:16:50.8709045Z,2012,349,6,225,171,0,5,0,178,0,0,343,124,0,344,0,0,0
70615,9814,2020-11-18T16:16:50.8709045Z,2013,303,9,211,163,0,9,0,140,0,0,294,92,1,293,0,0,0
70615,9815,2020-11-18T16:16:50.8709045Z,2014,354,31,276,188,0,7,0,166,0,0,323,78,2,344,0,3,1
70615,9816,2020-11-18T16:16:50.8719058Z,2015,331,63,260,149,0,8,0,182,0,0,268,71,3,320,0,1,0
70615,9817,2020-11-18T16:16:50.8719058Z,2016,219,78,138,96,0,6,2,123,0,0,141,81,1,212,0,2,0
70615,9818,2020-11-18T16:16:50.8719058Z,2017,574,222,442,261,0,19,14,313,0,0,352,132,2,553,0,4,0
70615,9819,2020-11-18T16:16:50.8729067Z,2018,551,186,423,255,0,19,17,296,0,0,365,128,2,530,1,4,0
70615,9820,2020-11-18T16:16:50.8729067Z,2019,472,128,348,228,0,11,8,244,0,0,344,124,0,461,0,3,0
70615,9821,2020-11-18T16:16:50.8729067Z,2020,440,190,341,213,0,11,9,227,0,0,250,99,1,428,0,4,0
57323,25924,2021-06-24T05:35:12.8170069Z,2021,250,74,235,131,0,0,6,119,0,0,176,15,0,249,2,0,1
57323,7694,2020-11-18T16:16:35.1164005Z,2012,310,83,256,146,0,2,0,164,0,0,227,54,0,305,0,0,3
57323,7695,2020-11-18T16:16:35.1164005Z,2013,312,86,262,150,0,3,0,162,0,0,226,50,0,307,0,1,2
57323,7696,2020-11-18T16:16:35.1164005Z,2014,277,75,233,129,0,0,0,148,0,0,202,44,0,274,0,0,3
57323,7697,2020-11-18T16:16:35.1174005Z,2015,275,69,233,128,0,1,0,147,0,0,206,42,0,272,0,0,2
57323,7698,2020-11-18T16:16:35.1174005Z,2016,284,73,222,131,0,1,19,153,0,0,211,62,0,281,0,1,2
57323,7699,2020-11-18T16:16:35.1174005Z,2017,280,88,241,125,0,1,9,155,0,0,192,39,0,277,0,0,2
57323,7700,2020-11-18T16:16:35.1174005Z,2018,240,68,207,107,0,2,0,133,0,0,172,33,0,235,1,0,3
57323,7701,2020-11-18T16:16:35.8859134Z,2019,343,116,302,168,0,0,25,175,0,0,227,41,0,342,2,0,1
57323,7702,2020-11-18T16:16:35.8859134Z,2020,312,99,277,158,0,0,40,154,0,0,213,35,0,312,2,0,0
23531,2577,2020-11-18T16:16:02.09738Z,2012,804,1,500,437,0,4,0,367,0,0,803,304,0,800,0,0,0
23531,2578,2020-11-18T16:16:02.09738Z,2013,766,7,505,411,0,5,0,355,0,0,759,261,0,761,0,1,0
23531,2579,2020-11-18T16:16:02.0983822Z,2014,690,46,471,381,0,4,0,309,0,0,644,219,0,685,0,1,1
23531,2580,2020-11-18T16:16:02.0983822Z,2015,639,58,435,354,0,5,0,285,0,0,581,204,0,634,0,1,0
23531,2581,2020-11-18T16:16:02.0983822Z,2016,696,150,359,371,0,5,0,325,0,0,546,337,0,691,0,2,0
23531,2582,2020-11-18T16:16:02.0983822Z,2017,762,185,501,372,0,6,1,390,0,0,577,261,0,756,0,2,0
23531,2583,2020-11-18T16:16:02.0983822Z,2018,738,168,505,356,0,6,2,382,0,0,570,233,0,732,0,1,0
23531,2584,2020-11-18T16:16:02.0993813Z,2019,657,151,472,307,0,7,0,350,0,0,506,185,0,650,0,1,0
23531,2585,2020-11-18T16:16:02.0993813Z,2020,581,189,413,292,0,7,12,289,0,0,392,168,1,572,0,1,1
23531,31719,2021-06-24T05:35:15.3778429Z,2021,520,187,400,263,0,4,9,257,0,0,333,120,0,516,1,0,0
70276,31647,2021-06-24T05:35:14.6593281Z,2021,604,185,438,319,0,8,0,285,0,0,419,166,2,594,2,2,0
70276,9579,2020-11-18T16:16:49.223807Z,2012,346,0,231,179,0,17,0,167,0,0,346,115,1,328,0,0,0
70276,9580,2020-11-18T16:16:49.223807Z,2013,323,4,221,154,0,15,0,169,0,0,319,102,1,307,0,4,0
70276,9581,2020-11-18T16:16:49.223807Z,2014,312,34,216,154,0,8,0,158,0,0,278,96,2,302,0,4,0
70276,9582,2020-11-18T16:16:49.2248075Z,2015,364,57,237,168,0,11,0,196,0,0,307,127,1,352,0,5,0
70276,9583,2020-11-18T16:16:49.2248075Z,2016,577,153,369,292,0,13,7,285,0,0,424,208,1,563,0,4,0
70276,9584,2020-11-18T16:16:49.2248075Z,2017,577,125,362,290,0,10,1,287,0,0,452,215,0,567,0,1,0
70276,9585,2020-11-18T16:16:49.2248075Z,2018,619,122,378,323,0,9,0,296,0,0,497,241,0,610,0,2,0
70276,9586,2020-11-18T16:16:49.2248075Z,2019,605,119,369,326,0,13,0,279,0,0,486,236,1,591,0,0,0
70276,9587,2020-11-18T16:16:49.2258079Z,2020,616,186,374,325,0,8,0,291,0,0,430,242,1,607,0,0,0
62398,25958,2021-06-24T05:35:12.8820533Z,2021,871,341,715,445,0,43,1,426,0,0,530,156,1,825,0,1,2
62398,8475,2020-11-18T16:16:40.2208038Z,2012,886,4,656,397,0,29,0,489,0,0,882,230,2,852,0,0,3
62398,8476,2020-11-18T16:16:40.2208038Z,2013,933,11,743,423,0,40,0,510,0,0,922,190,3,886,0,0,4
62398,8477,2020-11-18T16:16:40.2208038Z,2014,938,91,772,422,0,51,0,516,0,0,847,166,1,882,0,0,4
62398,8478,2020-11-18T16:16:40.2208038Z,2015,965,92,798,466,0,49,0,499,0,0,873,167,1,912,0,0,3
62398,8479,2020-11-18T16:16:40.2218038Z,2016,975,191,510,479,0,53,0,496,0,0,784,465,2,919,0,0,1
62398,8480,2020-11-18T16:16:40.2218038Z,2017,1148,270,985,575,0,62,10,573,0,0,878,163,1,1084,0,2,1
62398,8481,2020-11-18T16:16:40.2218038Z,2018,1131,259,954,579,0,63,7,552,0,0,872,177,0,1067,1,2,1
62398,8482,2020-11-18T16:16:40.2218038Z,2019,895,219,759,459,0,44,9,436,0,0,676,136,0,850,0,0,1
62398,8483,2020-11-18T16:16:40.2218038Z,2020,853,328,731,443,0,45,11,410,0,0,525,122,0,806,0,1,2
46987,31857,2021-06-24T05:35:18.4220258Z,2021,481,145,382,246,0,10,0,235,0,0,336,99,0,470,0,3,1
46987,5946,2020-11-18T16:16:23.5196656Z,2012,439,0,294,217,0,5,0,222,0,0,439,145,0,432,0,0,2
46987,5947,2020-11-18T16:16:23.5196656Z,2013,388,2,275,202,0,6,0,186,0,0,386,113,1,379,0,2,2
46987,5948,2020-11-18T16:16:23.5196656Z,2014,412,42,295,209,0,8,0,203,0,0,370,117,1,401,0,1,2
46987,5949,2020-11-18T16:16:23.5196656Z,2015,418,32,304,212,0,10,0,206,0,0,386,114,2,406,0,3,0
46987,5950,2020-11-18T16:16:23.5196656Z,2016,412,57,43,213,0,10,0,199,0,0,355,369,2,399,0,2,1
46987,5951,2020-11-18T16:16:23.5206656Z,2017,391,74,287,207,0,8,0,184,0,0,317,104,0,382,0,1,1
46987,5952,2020-11-18T16:16:23.5206656Z,2018,494,102,368,248,0,11,0,246,0,0,392,126,0,482,0,1,1
46987,5953,2020-11-18T16:16:23.5206656Z,2019,503,99,383,262,0,14,0,241,0,0,404,120,0,489,0,4,0
46987,5954,2020-11-18T16:16:23.5206656Z,2020,486,131,373,248,0,12,0,238,0,0,355,113,1,473,0,2,0
23135,2496,2020-11-18T16:16:01.438941Z,2012,380,115,303,194,0,5,0,186,0,0,265,77,0,375,0,0,0
23135,2497,2020-11-18T16:16:01.438941Z,2013,342,112,266,174,0,6,0,168,0,0,230,76,0,336,0,0,0
23135,2498,2020-11-18T16:16:01.438941Z,2014,290,107,235,154,0,7,0,136,0,0,183,55,0,283,0,0,0
23135,2499,2020-11-18T16:16:01.4399419Z,2015,303,124,240,154,0,4,0,149,0,0,179,63,0,299,0,0,0
23135,2500,2020-11-18T16:16:01.4399419Z,2016,280,100,187,143,0,4,5,137,0,0,180,93,0,276,0,0,0
23135,2501,2020-11-18T16:16:02.0683608Z,2017,239,88,179,120,0,3,4,119,0,0,151,60,0,236,0,0,0
23135,2502,2020-11-18T16:16:02.0683608Z,2018,216,73,173,108,0,3,0,108,0,0,143,43,0,213,0,0,0
23135,2503,2020-11-18T16:16:02.0683608Z,2019,287,107,237,142,0,3,0,145,0,0,180,50,2,282,1,2,0
23135,2504,2020-11-18T16:16:02.0683608Z,2020,246,91,202,122,0,2,0,124,0,0,155,44,0,244,2,2,0
23135,31717,2021-06-24T05:35:15.3758424Z,2021,233,81,217,114,0,2,0,119,0,0,152,16,0,231,1,2,0
17871,1477,2020-11-18T16:15:54.7724994Z,2012,464,126,378,227,0,9,0,237,0,0,338,86,0,455,0,0,0
17871,1478,2020-11-18T16:15:54.7724994Z,2013,445,120,352,218,0,14,0,227,0,0,325,93,0,431,0,1,0
17871,1479,2020-11-18T16:15:54.7734994Z,2014,432,136,293,201,0,14,0,231,0,0,296,139,0,418,0,0,0
17871,1480,2020-11-18T16:15:54.7734994Z,2015,415,131,267,202,0,6,0,213,0,0,284,148,0,409,0,3,0
17871,1481,2020-11-18T16:15:54.7734994Z,2016,351,122,76,163,0,4,0,188,0,0,229,275,0,346,0,0,1
17871,1482,2020-11-18T16:15:54.7734994Z,2017,333,139,275,146,0,4,0,187,0,0,194,58,0,329,0,0,0
17871,1483,2020-11-18T16:15:54.7734994Z,2018,470,173,382,220,0,6,18,250,0,0,297,88,0,464,1,0,0
17871,1484,2020-11-18T16:15:54.7745008Z,2019,508,175,422,238,0,0,5,270,0,0,333,86,0,508,1,0,0
17871,1485,2020-11-18T16:15:54.7745008Z,2020,474,148,395,227,0,0,1,247,0,0,326,79,0,474,0,0,0
17871,25639,2021-06-24T05:35:04.6911806Z,2021,428,146,366,205,0,1,2,223,0,0,282,62,0,427,0,0,0
65946,31981,2021-06-24T05:35:20.2853619Z,2021,111,36,94,54,0,0,0,57,0,0,75,17,0,110,0,0,1
65946,9096,2020-11-18T16:16:44.8999232Z,2012,253,95,250,104,0,7,0,149,0,0,158,3,0,246,0,0,0
65946,9097,2020-11-18T16:16:44.8999232Z,2013,181,72,180,72,0,6,0,109,0,0,109,1,0,175,0,0,0
65946,9098,2020-11-18T16:16:44.9009236Z,2014,226,76,189,99,0,5,0,127,0,0,150,37,0,221,0,0,0
65946,9099,2020-11-18T16:16:44.9009236Z,2015,206,62,206,103,0,0,0,103,0,0,144,0,2,204,0,2,0
65946,9100,2020-11-18T16:16:44.9009236Z,2016,175,47,175,91,0,1,2,84,0,0,128,0,0,174,0,0,0
65946,9101,2020-11-18T16:16:45.4813113Z,2017,230,66,229,106,0,1,2,124,0,0,164,1,0,228,0,0,1
65946,9102,2020-11-18T16:16:45.4823118Z,2018,390,101,373,185,1,5,1,205,0,0,289,17,0,384,1,0,1
65946,9103,2020-11-18T16:16:45.4823118Z,2019,301,89,296,150,1,1,1,151,0,0,212,5,0,299,0,0,1
65946,9104,2020-11-18T16:16:45.4823118Z,2020,112,31,110,57,0,0,0,55,0,0,81,2,0,111,0,0,1
20594,1832,2020-11-18T16:15:57.8425449Z,2012,432,54,365,226,0,5,0,206,0,0,378,67,0,427,0,0,0
20594,1833,2020-11-18T16:15:57.8435453Z,2013,410,79,349,194,0,6,0,216,0,0,331,61,0,404,0,2,0
20594,1834,2020-11-18T16:15:57.8435453Z,2014,359,87,306,173,0,6,0,186,0,0,272,53,0,353,0,2,0
20594,1835,2020-11-18T16:15:57.8435453Z,2015,322,81,271,158,0,5,0,164,0,0,241,51,1,316,0,1,0
20594,1836,2020-11-18T16:15:57.8435453Z,2016,262,81,234,124,0,2,0,138,0,0,181,28,0,260,0,0,0
20594,1837,2020-11-18T16:15:57.844548Z,2017,139,62,123,61,0,0,0,78,0,0,77,16,0,139,0,0,0
20594,1838,2020-11-18T16:15:57.844548Z,2018,371,136,315,192,0,3,2,179,0,0,235,56,0,368,0,0,0
20594,1839,2020-11-18T16:15:57.844548Z,2019,397,165,318,195,0,3,43,202,0,0,232,79,0,394,0,0,0
20594,1840,2020-11-18T16:15:57.844548Z,2020,368,158,320,182,0,6,60,186,0,0,210,48,0,359,0,0,3
20594,31697,2021-06-24T05:35:15.3208018Z,2021,391,182,324,192,0,12,41,199,0,0,209,67,1,374,0,1,4
71381,10207,2020-11-18T16:16:53.7108013Z,2012,481,1,408,251,0,7,0,230,0,0,480,73,1,471,0,0,2
71381,10208,2020-11-18T16:16:53.7108013Z,2013,477,12,401,255,0,12,0,222,0,0,465,76,0,461,0,0,4
71381,10209,2020-11-18T16:16:53.7108013Z,2014,525,74,419,282,0,21,0,243,0,0,451,106,0,502,0,0,2
71381,10210,2020-11-18T16:16:53.7118027Z,2015,634,66,510,326,0,19,0,308,0,0,568,124,0,614,0,1,1
71381,10211,2020-11-18T16:16:53.7118027Z,2016,768,151,274,390,0,22,1,378,0,0,617,494,0,746,0,1,0
71381,10212,2020-11-18T16:16:53.7118027Z,2017,713,130,563,370,0,13,1,343,0,0,583,150,0,700,0,4,0
71381,10213,2020-11-18T16:16:53.7118027Z,2018,599,121,449,313,0,10,1,286,0,0,478,150,0,588,0,2,1
71381,10214,2020-11-18T16:16:53.7128026Z,2019,553,110,427,294,0,8,0,259,0,0,443,126,0,544,0,1,1
71381,10215,2020-11-18T16:16:53.7128026Z,2020,572,163,464,287,0,5,0,285,0,0,409,108,0,567,0,0,0
71381,31670,2021-06-24T05:35:15.2557562Z,2021,556,187,447,271,0,3,0,285,0,0,369,109,0,553,0,0,0
56077,31918,2021-06-24T05:35:18.4900745Z,2021,227,80,197,110,0,1,0,117,0,0,147,30,0,226,1,0,0
56077,7541,2020-11-18T16:16:34.5240043Z,2012,302,26,240,157,0,0,0,145,0,0,276,62,0,302,0,0,0
56077,7542,2020-11-18T16:16:34.5250065Z,2013,286,45,225,145,0,0,0,141,0,0,241,61,1,285,0,0,0
56077,7543,2020-11-18T16:16:34.5250065Z,2014,245,41,196,111,0,0,0,134,0,0,204,49,1,244,0,0,0
56077,7544,2020-11-18T16:16:34.5250065Z,2015,224,50,191,98,0,0,0,126,0,0,174,33,1,223,0,0,0
56077,7545,2020-11-18T16:16:34.5260048Z,2016,198,46,166,89,0,0,2,109,0,0,152,32,2,196,0,0,0
56077,7546,2020-11-18T16:16:34.5260048Z,2017,117,35,105,47,0,0,0,70,0,0,82,12,0,117,0,0,0
56077,7547,2020-11-18T16:16:34.5270065Z,2018,286,82,220,139,0,0,23,147,0,0,204,66,2,284,0,0,0
56077,7548,2020-11-18T16:16:34.5270065Z,2019,331,117,265,167,0,1,4,164,0,2,214,66,0,330,1,0,0
56077,7549,2020-11-18T16:16:34.5270065Z,2020,285,96,239,137,0,1,5,148,0,0,189,46,0,284,1,0,0
13912,1027,2020-11-18T16:15:52.4869736Z,2013,392,11,144,218,0,4,0,174,0,0,381,248,0,388,0,0,0
13912,1028,2020-11-18T16:15:52.4869736Z,2014,487,19,168,275,0,3,0,212,0,0,468,319,0,484,0,0,0
13912,1029,2020-11-18T16:15:52.4869736Z,2015,499,17,164,270,0,2,0,229,0,0,482,335,1,496,0,1,0
13912,1030,2020-11-18T16:15:52.4869736Z,2016,570,26,162,303,0,4,0,267,0,0,544,408,1,565,0,1,0
13912,1031,2020-11-18T16:15:52.4879736Z,2017,452,10,148,254,0,5,0,198,0,0,442,304,1,446,0,0,0
13912,1032,2020-11-18T16:15:52.4879736Z,2018,440,8,129,245,0,7,0,195,0,0,432,311,1,432,0,0,0
13912,1033,2020-11-18T16:15:52.4879736Z,2019,601,96,324,328,0,9,1,273,0,0,505,277,1,591,0,1,0
13912,1034,2020-11-18T16:15:52.4879736Z,2020,682,99,380,353,0,10,0,329,0,0,583,302,0,672,0,1,0
13912,25602,2021-06-24T05:35:04.617128Z,2021,732,97,418,374,0,10,0,358,0,0,635,314,0,722,0,0,0
17657,1405,2020-11-18T16:15:54.7514879Z,2012,212,94,167,87,0,0,0,125,0,0,118,45,0,212,0,0,0
17657,1406,2020-11-18T16:15:54.7514879Z,2013,162,77,124,69,0,1,0,93,0,0,85,38,0,161,0,2,0
17657,1407,2020-11-18T16:15:54.7514879Z,2014,138,70,102,57,0,0,0,81,0,0,68,36,0,138,0,1,0
17657,1408,2020-11-18T16:15:54.752487Z,2015,142,82,95,62,0,3,0,80,0,0,60,47,0,139,0,0,0
17657,1409,2020-11-18T16:15:54.752487Z,2016,143,82,87,53,0,5,8,90,0,0,61,56,0,138,0,0,0
17657,1410,2020-11-18T16:15:54.752487Z,2017,113,64,85,47,0,4,2,66,0,0,49,28,0,109,0,0,0
17657,1411,2020-11-18T16:15:54.752487Z,2018,295,123,220,130,0,7,0,165,0,0,172,75,0,288,0,0,0
17657,1412,2020-11-18T16:15:54.753487Z,2019,354,129,283,166,0,11,0,188,0,0,225,71,0,343,0,0,0
17657,1413,2020-11-18T16:15:54.753487Z,2020,314,116,268,147,0,7,0,167,0,0,198,46,0,307,0,0,0
17657,31814,2021-06-24T05:35:16.9019364Z,2021,275,94,237,125,0,4,1,150,0,0,181,38,1,268,0,0,2
79087,11074,2020-11-18T16:16:58.5490278Z,2012,236,79,215,113,0,7,0,123,0,0,157,21,0,229,0,0,0
79087,11075,2020-11-18T16:16:58.5490278Z,2013,218,83,185,99,0,4,0,119,0,0,135,33,0,214,0,0,0
79087,11076,2020-11-18T16:16:58.5490278Z,2014,195,78,154,92,0,3,0,103,0,0,117,41,0,192,0,2,0
79087,11077,2020-11-18T16:16:58.5500287Z,2015,202,74,163,105,0,4,0,97,0,0,128,39,0,198,0,2,0
79087,11078,2020-11-18T16:16:58.5500287Z,2016,355,120,233,178,0,2,0,177,0,0,235,122,0,352,0,0,1
79087,11079,2020-11-18T16:16:58.5500287Z,2017,320,108,232,160,0,1,0,160,0,0,212,88,0,318,0,1,1
79087,11080,2020-11-18T16:16:58.5500287Z,2018,367,108,310,172,0,4,1,195,0,0,259,57,0,362,0,0,1
79087,11081,2020-11-18T16:16:58.5510296Z,2019,417,125,355,207,0,4,0,210,0,0,292,62,0,412,0,0,1
79087,11082,2020-11-18T16:16:58.5510296Z,2020,373,127,288,185,0,5,33,188,0,0,246,85,0,367,0,0,1
79087,32002,2021-06-24T05:35:20.3243905Z,2021,320,106,287,153,0,9,0,167,0,0,214,33,0,311,0,0,0
78253,11012,2020-11-18T16:16:58.5110021Z,2013,187,62,100,73,0,0,0,114,0,0,125,87,0,187,0,1,0
78253,11013,2020-11-18T16:16:58.5110021Z,2014,658,267,556,295,0,12,0,363,0,0,391,102,1,645,0,1,0
78253,11014,2020-11-18T16:16:58.5110021Z,2015,566,241,492,257,0,12,0,309,0,0,325,74,3,551,0,0,0
78253,11015,2020-11-18T16:16:58.5110021Z,2016,461,206,408,214,0,12,1,247,0,0,255,53,2,447,0,2,0
78253,11016,2020-11-18T16:16:58.5110021Z,2017,416,194,362,200,0,12,1,216,0,0,222,54,4,398,0,4,2
78253,11017,2020-11-18T16:16:58.5120034Z,2018,426,196,363,185,0,6,2,241,0,0,230,63,0,420,4,4,0
78253,11018,2020-11-18T16:16:58.5120034Z,2019,437,206,372,204,0,6,0,233,0,0,231,65,0,430,3,2,1
78253,11019,2020-11-18T16:16:58.5120034Z,2020,406,179,363,192,0,8,0,214,0,0,227,43,0,397,1,2,1
78253,26000,2021-06-24T05:35:14.5192277Z,2021,380,162,327,184,0,9,0,196,0,0,218,53,1,370,1,0,0
76257,10933,2020-11-18T16:16:58.106732Z,2012,344,95,276,173,0,1,0,171,0,0,249,68,0,343,0,0,0
76257,10934,2020-11-18T16:16:58.1077329Z,2013,314,92,245,168,0,1,0,146,0,0,222,69,0,313,0,0,0
76257,10935,2020-11-18T16:16:58.1077329Z,2014,280,81,212,149,0,2,0,131,0,0,199,68,0,278,0,0,0
76257,10936,2020-11-18T16:16:58.1077329Z,2015,263,71,196,138,0,0,0,125,0,0,192,67,0,263,0,1,0
76257,10937,2020-11-18T16:16:58.1077329Z,2016,224,63,193,115,0,0,1,109,0,0,161,31,0,224,0,1,0
76257,10938,2020-11-18T16:16:58.1077329Z,2017,208,58,179,108,0,4,1,100,0,0,150,29,0,204,0,0,0
76257,10939,2020-11-18T16:16:58.1087334Z,2018,195,56,161,99,0,3,24,96,0,0,139,34,0,192,0,0,0
76257,10940,2020-11-18T16:16:58.1087334Z,2019,164,56,141,79,0,1,20,85,0,0,108,23,0,163,0,0,0
76257,10941,2020-11-18T16:16:58.1087334Z,2020,169,48,148,82,0,3,12,87,0,0,121,21,0,166,1,0,0
76257,31682,2021-06-24T05:35:15.2847773Z,2021,175,54,158,80,0,4,18,95,0,0,121,17,0,171,0,0,0
18184,1504,2020-11-18T16:15:55.3548898Z,2012,594,68,513,303,0,1,0,291,0,0,526,81,0,593,0,0,0
18184,1505,2020-11-18T16:15:55.3548898Z,2013,557,121,476,287,0,3,0,270,0,0,436,81,0,554,0,5,0
18184,1506,2020-11-18T16:15:55.3548898Z,2014,603,147,505,314,0,4,0,289,0,0,456,98,0,599,0,3,0
18184,1507,2020-11-18T16:15:55.3548898Z,2015,568,141,473,281,0,3,0,287,0,0,427,95,0,565,0,1,0
18184,1508,2020-11-18T16:15:55.3558889Z,2016,490,150,150,228,0,6,2,262,0,0,340,340,0,484,0,0,0
18184,1509,2020-11-18T16:15:55.3558889Z,2017,458,145,379,232,0,7,0,226,0,0,313,79,0,451,0,0,0
18184,1510,2020-11-18T16:15:55.3558889Z,2018,535,154,444,265,0,11,40,270,0,0,381,91,0,524,0,1,0
18184,1511,2020-11-18T16:15:55.3568911Z,2019,365,135,307,177,0,5,0,188,0,0,230,58,0,360,0,1,0
18184,1512,2020-11-18T16:15:55.3568911Z,2020,336,130,283,159,0,5,0,177,0,0,206,53,0,331,0,0,0
18184,25614,2021-06-24T05:35:04.6381419Z,2021,320,122,275,145,0,4,1,175,0,0,198,45,0,316,0,1,0
17418,1369,2020-11-18T16:15:54.3191964Z,2012,582,60,470,270,0,4,0,312,0,0,522,112,0,578,0,0,0
17418,1370,2020-11-18T16:15:54.3191964Z,2013,573,108,464,269,0,8,0,304,0,0,465,109,0,565,0,2,0
17418,1371,2020-11-18T16:15:54.3201973Z,2014,624,138,514,286,0,11,0,338,0,0,486,110,0,612,0,1,1
17418,1372,2020-11-18T16:15:54.3201973Z,2015,528,111,422,242,0,5,0,286,0,0,417,106,0,521,0,0,2
17418,1373,2020-11-18T16:15:54.3201973Z,2016,435,121,181,201,0,4,0,234,0,0,314,254,0,430,0,1,1
17418,1374,2020-11-18T16:15:54.3201973Z,2017,369,109,312,176,0,4,0,193,0,0,260,57,0,364,0,1,1
17418,1375,2020-11-18T16:15:54.3201973Z,2018,347,97,301,156,0,6,20,191,0,0,250,46,0,341,0,2,0
17418,1376,2020-11-18T16:15:54.3201973Z,2019,567,189,488,274,0,8,3,293,0,0,378,79,0,556,0,0,3
17418,1377,2020-11-18T16:15:54.3212Z,2020,494,169,433,232,0,9,0,262,0,0,325,61,0,485,0,0,0
17418,31610,2021-06-24T05:35:14.587276Z,2021,433,159,367,204,0,8,2,229,0,0,274,66,0,424,0,0,1
77669,11007,2020-11-18T16:16:58.5039985Z,2016,86,17,46,43,0,0,0,43,0,0,69,40,0,86,0,1,0
77669,11008,2020-11-18T16:16:58.5049981Z,2017,266,54,147,122,0,3,0,144,0,0,212,119,0,263,0,0,0
77669,11009,2020-11-18T16:16:58.5049981Z,2018,345,53,190,166,0,0,13,179,0,0,292,155,0,345,0,0,0
77669,11010,2020-11-18T16:16:58.5049981Z,2019,414,52,221,209,0,0,4,205,0,0,362,193,0,414,0,0,0
77669,11011,2020-11-18T16:16:58.5049981Z,2020,416,82,240,211,0,1,1,205,0,0,334,176,0,415,1,0,0
77669,25683,2021-06-24T05:35:08.630005Z,2021,424,92,298,216,0,1,5,208,0,0,332,126,0,423,3,0,0
36335,25806,2021-06-24T05:35:10.9006329Z,2021,476,61,409,237,0,5,4,239,0,0,415,67,6,465,0,0,0
36335,4542,2020-11-18T16:16:13.1937802Z,2012,376,0,272,196,0,8,0,180,0,0,376,104,0,367,0,0,1
36335,4543,2020-11-18T16:16:13.1937802Z,2013,454,5,334,246,0,6,0,208,0,0,449,120,0,448,0,2,0
36335,4544,2020-11-18T16:16:13.1937802Z,2014,461,17,367,250,0,1,0,211,0,0,444,94,1,459,0,1,0
36335,4545,2020-11-18T16:16:13.1947806Z,2015,461,16,355,240,0,0,0,221,0,0,445,106,1,460,0,1,0
36335,4546,2020-11-18T16:16:13.1947806Z,2016,546,34,202,292,0,4,0,254,0,0,512,344,5,537,0,1,0
36335,4547,2020-11-18T16:16:13.1947806Z,2017,561,29,437,287,0,11,1,274,0,0,532,124,4,546,0,0,0
36335,4548,2020-11-18T16:16:13.1947806Z,2018,552,34,434,283,0,13,0,269,0,0,518,118,3,536,0,0,0
36335,4549,2020-11-18T16:16:13.195782Z,2019,523,41,410,265,0,10,1,258,0,0,482,113,4,509,0,0,0
36335,4550,2020-11-18T16:16:13.195782Z,2020,500,55,405,252,0,12,0,248,0,0,445,95,3,485,0,0,0
18291,1566,2020-11-18T16:15:55.3698992Z,2013,695,164,553,355,0,11,0,340,0,0,531,142,0,682,0,2,2
18291,1567,2020-11-18T16:15:55.3708996Z,2014,879,233,738,443,0,22,0,436,0,0,646,141,0,857,0,6,0
18291,1568,2020-11-18T16:15:55.3708996Z,2015,850,226,700,416,0,14,0,434,0,0,624,150,0,836,0,6,0
18291,1569,2020-11-18T16:15:55.3708996Z,2016,781,224,485,390,0,16,0,391,0,0,557,296,0,765,0,3,0
18291,1570,2020-11-18T16:15:55.3719005Z,2017,788,238,673,388,0,11,0,400,0,0,550,115,0,777,0,3,0
18291,1571,2020-11-18T16:15:55.3719005Z,2018,731,210,588,361,0,7,61,370,0,0,521,143,0,721,5,4,3
18291,1572,2020-11-18T16:15:55.3719005Z,2019,733,265,606,366,0,9,0,367,0,1,468,127,0,721,1,5,3
18291,1573,2020-11-18T16:15:55.3729005Z,2020,699,240,575,339,0,6,0,360,0,0,459,124,0,689,0,3,4
18291,25617,2021-06-24T05:35:04.6411452Z,2021,653,239,574,313,0,6,0,340,0,0,414,79,0,644,0,1,3
42259,25830,2021-06-24T05:35:10.9376588Z,2021,170,53,152,91,0,3,0,79,0,0,117,18,0,167,1,0,0
42259,5182,2020-11-18T16:16:17.8288702Z,2012,155,57,124,75,0,0,0,80,0,0,98,31,0,155,0,0,0
42259,5183,2020-11-18T16:16:17.8288702Z,2013,167,60,139,80,0,0,0,87,0,0,107,28,0,167,0,3,0
42259,5184,2020-11-18T16:16:17.8298715Z,2014,165,63,121,83,0,3,0,82,0,0,102,44,0,162,0,0,0
42259,5185,2020-11-18T16:16:17.8298715Z,2015,172,65,137,85,0,3,0,87,0,0,107,35,0,169,0,0,0
42259,5186,2020-11-18T16:16:17.8298715Z,2016,125,48,65,60,0,3,0,65,0,0,77,60,0,122,0,0,0
42259,5187,2020-11-18T16:16:17.8298715Z,2017,251,102,207,127,0,4,0,124,0,0,149,44,0,247,0,2,0
42259,5188,2020-11-18T16:16:17.8298715Z,2018,223,79,191,112,0,3,2,111,0,0,144,32,0,220,0,0,0
42259,5189,2020-11-18T16:16:17.8308715Z,2019,215,82,178,105,0,5,1,110,0,1,133,37,0,210,1,1,0
42259,5190,2020-11-18T16:16:17.8308715Z,2020,199,67,157,107,0,3,0,92,0,0,132,42,0,196,1,0,0
70805,31661,2021-06-24T05:35:15.2427463Z,2021,246,92,230,124,0,9,0,122,0,0,154,16,0,237,0,1,0
70805,9903,2020-11-18T16:16:51.5153354Z,2012,456,67,404,238,0,10,0,218,0,0,389,52,7,438,0,0,1
70805,9904,2020-11-18T16:16:51.5153354Z,2013,441,88,396,238,0,11,0,203,0,0,353,45,4,424,0,3,2
70805,9905,2020-11-18T16:16:51.5153354Z,2014,425,99,392,230,0,11,0,195,0,0,326,33,2,408,0,4,4
70805,9906,2020-11-18T16:16:51.5153354Z,2015,330,71,304,183,0,10,0,147,0,0,259,26,3,315,0,3,2
70805,9907,2020-11-18T16:16:51.5163359Z,2016,228,57,134,125,0,2,0,103,0,0,171,94,0,225,0,0,1
70805,9908,2020-11-18T16:16:51.5163359Z,2017,241,61,216,120,0,3,0,121,0,0,180,25,0,238,0,0,0
70805,9909,2020-11-18T16:16:51.5163359Z,2018,236,62,210,110,0,2,0,126,0,0,174,26,0,234,0,0,0
70805,9910,2020-11-18T16:16:51.5173367Z,2019,320,114,281,143,0,7,0,177,0,0,206,39,0,313,0,1,0
70805,9911,2020-11-18T16:16:51.5173367Z,2020,298,104,264,143,0,8,0,155,0,0,194,34,0,289,0,1,1
24950,2748,2020-11-18T16:16:03.2711643Z,2012,386,99,274,191,0,9,0,195,0,0,287,112,0,377,0,0,0
24950,2749,2020-11-18T16:16:03.2721648Z,2013,330,97,242,163,0,7,0,167,0,0,233,88,0,323,0,1,0
24950,2750,2020-11-18T16:16:03.2721648Z,2014,306,86,211,160,0,6,0,146,0,0,220,95,0,300,0,2,0
24950,2751,2020-11-18T16:16:03.2721648Z,2015,265,79,237,132,0,5,0,133,0,0,186,28,0,259,0,5,1
24950,2752,2020-11-18T16:16:03.2721648Z,2016,253,86,197,123,0,2,0,130,0,0,167,56,1,250,0,2,0
24950,2753,2020-11-18T16:16:03.2721648Z,2017,253,98,210,111,0,2,0,142,0,0,155,43,1,248,0,1,2
24950,2754,2020-11-18T16:16:03.2731661Z,2018,311,97,219,132,0,4,4,179,0,0,214,92,0,307,0,2,0
24950,2755,2020-11-18T16:16:03.2731661Z,2019,367,131,288,178,0,6,2,189,0,0,236,79,0,361,0,1,0
24950,2756,2020-11-18T16:16:03.2731661Z,2020,326,109,262,138,0,4,2,188,0,0,217,64,0,322,0,1,0
24950,31725,2021-06-24T05:35:15.3818467Z,2021,300,99,255,127,0,9,3,173,0,0,201,45,0,291,0,0,0
70201,25644,2021-06-24T05:35:04.6971849Z,2021,463,77,268,307,0,4,0,156,0,0,386,195,0,455,1,0,4
70201,9528,2020-11-18T16:16:49.2348132Z,2012,511,19,301,336,0,3,0,175,0,0,492,210,1,507,0,0,0
70201,9529,2020-11-18T16:16:49.2358145Z,2013,459,34,303,302,0,3,0,157,0,0,425,156,1,455,0,1,0
70201,9530,2020-11-18T16:16:49.2358145Z,2014,430,42,257,283,0,3,0,147,0,0,388,173,1,426,0,0,0
70201,9531,2020-11-18T16:16:49.2358145Z,2015,459,54,262,291,0,5,0,168,0,0,405,197,1,453,0,0,0
70201,9532,2020-11-18T16:16:49.2358145Z,2016,447,61,167,301,0,4,0,146,0,0,386,280,1,442,0,0,0
70201,9533,2020-11-18T16:16:49.2368158Z,2017,540,73,259,355,0,8,0,185,0,0,467,281,1,530,0,1,1
70201,9534,2020-11-18T16:16:49.2368158Z,2018,482,66,226,318,0,7,0,164,0,0,416,256,1,473,0,1,1
70201,9535,2020-11-18T16:16:49.2368158Z,2019,464,59,199,303,0,4,0,161,0,0,405,265,1,458,0,1,1
70201,9536,2020-11-18T16:16:49.2368158Z,2020,518,87,220,350,0,4,1,168,0,0,431,298,1,512,0,1,1
20560,1814,2020-11-18T16:15:57.8375418Z,2012,684,2,548,325,0,10,0,359,0,0,682,136,0,674,0,0,0
20560,1815,2020-11-18T16:15:57.8375418Z,2013,672,4,530,323,0,4,0,349,0,0,668,142,0,668,0,3,0
20560,1816,2020-11-18T16:15:57.8385422Z,2014,697,60,559,348,0,0,0,349,0,0,637,138,0,697,0,4,0
20560,1817,2020-11-18T16:15:57.8385422Z,2015,652,49,507,323,0,0,0,329,0,0,603,145,0,652,0,4,0
20560,1818,2020-11-18T16:15:57.8385422Z,2016,659,126,352,314,0,2,1,345,0,0,533,307,0,657,0,2,0
20560,1819,2020-11-18T16:15:57.8385422Z,2017,648,139,501,322,0,4,1,326,0,0,509,147,1,643,0,0,0
20560,1820,2020-11-18T16:15:57.8395427Z,2018,616,136,484,319,0,2,2,297,0,1,480,132,1,613,1,1,0
20560,1821,2020-11-18T16:15:57.8395427Z,2019,520,151,412,266,0,1,2,254,0,0,369,108,1,518,0,1,0
20560,1822,2020-11-18T16:15:57.8395427Z,2020,499,195,394,254,0,2,1,245,0,0,304,105,0,497,0,1,0
20560,31696,2021-06-24T05:35:15.3097946Z,2021,538,198,460,268,0,3,0,270,0,0,340,78,0,535,2,1,0
62463,25959,2021-06-24T05:35:12.8950633Z,2021,320,127,286,145,0,14,0,175,0,0,193,34,0,303,0,0,3
62463,8514,2020-11-18T16:16:40.8762405Z,2012,333,71,240,151,0,6,0,182,0,0,262,93,0,327,0,0,0
62463,8515,2020-11-18T16:16:40.8762405Z,2013,324,105,253,156,0,11,0,168,0,0,219,71,0,312,0,0,1
62463,8516,2020-11-18T16:16:40.8762405Z,2014,306,126,279,143,0,16,0,163,0,0,180,27,1,289,0,0,0
62463,8517,2020-11-18T16:16:40.8772418Z,2015,274,111,250,124,0,15,0,150,0,0,163,24,0,259,0,0,0
62463,8518,2020-11-18T16:16:40.8782432Z,2016,157,79,125,65,0,6,0,92,0,0,78,32,0,151,0,0,0
62463,8519,2020-11-18T16:16:40.8792432Z,2017,278,126,239,123,0,18,1,155,0,0,152,39,0,260,0,0,0
62463,8520,2020-11-18T16:16:40.8792432Z,2018,312,129,272,144,0,15,7,168,0,0,183,40,0,297,0,0,0
62463,8521,2020-11-18T16:16:40.8792432Z,2019,333,147,286,168,0,12,7,165,0,0,186,47,0,320,0,1,1
62463,8522,2020-11-18T16:16:40.8802445Z,2020,330,121,275,165,0,14,0,165,0,0,209,55,0,315,0,0,1
61747,25955,2021-06-24T05:35:12.8750485Z,2021,305,38,185,175,0,22,0,130,0,0,267,120,4,279,0,2,0
61747,8396,2020-11-18T16:16:39.8005221Z,2012,321,7,149,193,0,33,0,128,0,0,314,172,4,281,0,0,3
61747,8397,2020-11-18T16:16:39.8005221Z,2013,321,15,150,188,0,26,0,133,0,0,306,171,5,283,0,27,7
61747,8398,2020-11-18T16:16:39.8005221Z,2014,320,21,181,185,0,29,0,135,0,0,299,139,4,272,0,24,15
61747,8399,2020-11-18T16:16:39.8005221Z,2015,327,21,194,191,0,27,0,136,0,0,306,133,4,280,0,46,16
61747,8400,2020-11-18T16:16:39.801523Z,2016,347,27,191,205,0,27,0,142,0,0,320,156,5,305,0,29,10
61747,8401,2020-11-18T16:16:40.1897824Z,2017,355,41,181,189,0,28,0,166,0,0,314,174,8,312,0,27,7
61747,8402,2020-11-18T16:16:40.1897824Z,2018,319,28,164,174,0,27,1,145,0,0,291,155,2,287,0,16,3
61747,8403,2020-11-18T16:16:40.1897824Z,2019,270,30,132,138,0,18,3,132,0,0,240,138,2,245,0,4,5
61747,8404,2020-11-18T16:16:40.1907837Z,2020,296,36,135,160,0,22,0,136,0,0,260,161,4,270,0,2,0
77552,10989,2020-11-18T16:16:58.1397543Z,2012,392,60,250,191,0,8,0,201,0,0,332,142,1,383,0,0,0
77552,10990,2020-11-18T16:16:58.1397543Z,2013,410,65,214,211,0,13,0,199,0,0,345,196,0,397,0,1,0
77552,10991,2020-11-18T16:16:58.1397543Z,2014,403,56,210,217,0,15,0,186,0,0,347,193,1,387,0,1,0
77552,10992,2020-11-18T16:16:58.1397543Z,2015,376,49,177,200,0,20,0,176,0,0,327,199,1,355,0,2,0
77552,10993,2020-11-18T16:16:58.1397543Z,2016,478,59,214,243,0,24,0,235,0,0,419,264,1,453,0,2,0
77552,10994,2020-11-18T16:16:58.1407552Z,2017,491,44,215,252,0,18,0,239,0,0,447,276,0,473,0,1,0
77552,10995,2020-11-18T16:16:58.1407552Z,2018,467,32,187,248,0,14,0,219,0,0,435,280,1,451,1,0,1
77552,10996,2020-11-18T16:16:58.1407552Z,2019,798,119,433,406,0,17,3,392,0,0,679,365,2,778,2,0,1
77552,10997,2020-11-18T16:16:58.1407552Z,2020,762,114,406,380,0,16,2,382,0,0,648,356,3,742,1,0,1
77552,25682,2021-06-24T05:35:08.6270022Z,2021,670,93,400,316,0,16,0,354,0,0,577,270,1,652,0,1,1
60400,25939,2021-06-24T05:35:12.8360203Z,2021,293,83,272,144,0,19,6,149,0,0,210,21,0,272,0,0,2
60400,8027,2020-11-18T16:16:37.5260092Z,2012,440,93,347,202,0,36,0,238,0,0,347,93,1,403,0,0,0
60400,8028,2020-11-18T16:16:37.5260092Z,2013,438,106,365,198,0,29,0,240,0,0,332,73,1,408,0,0,0
60400,8029,2020-11-18T16:16:37.5270096Z,2014,390,100,346,178,0,28,0,212,0,0,290,44,0,362,0,2,0
60400,8030,2020-11-18T16:16:37.5270096Z,2015,381,105,302,169,0,26,0,212,0,0,276,79,0,355,0,1,0
60400,8031,2020-11-18T16:16:37.528011Z,2016,406,108,297,194,0,27,0,212,0,0,298,109,0,378,0,0,1
60400,8032,2020-11-18T16:16:37.528011Z,2017,438,112,385,210,0,25,0,228,0,0,326,53,0,412,0,0,1
60400,8033,2020-11-18T16:16:37.528011Z,2018,342,69,301,169,0,19,10,173,0,0,273,41,2,320,0,0,1
60400,8034,2020-11-18T16:16:37.528011Z,2019,365,99,325,188,0,23,12,177,0,0,266,40,4,335,0,2,3
60400,8035,2020-11-18T16:16:37.528011Z,2020,318,88,278,150,0,22,7,168,0,0,230,40,0,293,0,0,3
47126,25857,2021-06-24T05:35:10.9726842Z,2021,720,111,464,383,0,6,2,337,0,0,609,256,1,711,18,3,2
47126,5973,2020-11-18T16:16:23.5316732Z,2012,699,0,401,384,0,6,0,315,0,0,699,298,2,690,0,0,1
47126,5974,2020-11-18T16:16:23.5326741Z,2013,700,0,408,392,0,5,0,308,0,0,700,292,1,694,0,3,0
47126,5975,2020-11-18T16:16:23.5326741Z,2014,707,18,412,372,0,5,0,335,0,0,689,295,0,702,0,4,0
47126,5976,2020-11-18T16:16:23.5326741Z,2015,746,19,401,389,0,3,0,357,0,0,727,345,0,743,0,5,0
47126,5977,2020-11-18T16:16:23.5326741Z,2016,759,44,390,389,0,4,4,370,0,0,715,369,0,755,0,2,0
47126,5978,2020-11-18T16:16:23.5326741Z,2017,764,55,422,388,0,3,3,376,0,0,709,342,0,761,0,4,0
47126,5979,2020-11-18T16:16:23.5336759Z,2018,894,84,493,475,0,3,28,419,0,0,810,401,0,891,12,1,0
47126,5980,2020-11-18T16:16:23.5336759Z,2019,912,99,566,462,0,7,4,450,0,2,813,346,0,905,21,3,0
47126,5981,2020-11-18T16:16:23.5336759Z,2020,842,127,509,439,0,9,3,403,0,0,715,333,2,830,27,2,1
20941,1995,2020-11-18T16:15:58.5169945Z,2012,306,85,228,146,0,2,0,160,0,0,221,78,0,304,0,0,0
20941,1996,2020-11-18T16:15:58.5169945Z,2013,253,78,196,126,0,0,0,127,0,0,175,57,0,253,0,1,0
20941,1997,2020-11-18T16:15:58.5169945Z,2014,242,79,194,122,0,1,0,120,0,0,163,48,0,241,0,1,0
20941,1998,2020-11-18T16:15:58.5179959Z,2015,213,70,166,105,0,1,0,108,0,0,143,47,0,212,0,1,0
20941,1999,2020-11-18T16:15:58.5179959Z,2016,199,90,158,89,0,1,1,110,0,0,109,41,0,198,0,1,0
20941,2000,2020-11-18T16:15:58.5179959Z,2017,148,70,123,75,0,0,7,73,0,0,78,25,0,148,0,1,0
20941,2001,2020-11-18T16:15:58.8972499Z,2018,162,57,132,78,0,2,4,84,0,0,105,30,0,160,0,1,0
20941,2002,2020-11-18T16:15:58.8972499Z,2019,138,59,119,65,1,2,1,73,0,0,79,19,0,136,0,1,0
20941,2003,2020-11-18T16:15:58.8982499Z,2020,140,62,121,67,0,2,0,73,0,0,78,19,0,138,0,1,0
20941,31703,2021-06-24T05:35:15.3338113Z,2021,140,55,121,70,0,2,0,70,0,0,85,19,0,138,0,1,0
11080,25587,2021-06-24T05:35:04.5971132Z,2021,172,60,148,83,0,7,0,89,0,0,112,24,0,165,1,1,0
11080,299,2020-11-18T16:15:46.8632223Z,2012,179,57,152,85,0,3,0,94,0,0,122,27,0,176,0,0,0
11080,300,2020-11-18T16:15:46.8632223Z,2013,151,49,124,71,0,1,0,80,0,0,102,27,0,150,0,0,0
11080,301,2020-11-18T16:15:47.5416768Z,2014,177,48,153,82,0,1,0,95,0,0,129,24,0,176,0,0,0
11080,302,2020-11-18T16:15:47.5416768Z,2015,129,47,112,59,0,3,0,70,0,0,82,17,0,126,0,0,0
11080,303,2020-11-18T16:15:47.5426772Z,2016,143,39,123,69,0,4,0,74,0,0,104,20,0,139,0,0,0
11080,304,2020-11-18T16:15:47.5426772Z,2017,139,55,118,66,0,3,0,73,0,0,84,21,0,136,0,0,0
11080,305,2020-11-18T16:15:47.5426772Z,2018,123,44,106,61,0,4,0,62,0,0,79,17,0,119,1,0,0
11080,306,2020-11-18T16:15:47.5426772Z,2019,218,88,174,108,0,4,0,110,0,0,130,44,0,214,2,0,0
11080,307,2020-11-18T16:15:47.5436777Z,2020,197,76,170,91,0,4,0,106,0,0,121,27,0,193,2,0,0
30643,31760,2021-06-24T05:35:16.8328867Z,2021,336,69,286,162,0,6,5,174,0,0,267,50,0,328,0,1,2
30643,3406,2020-11-18T16:16:07.0066536Z,2012,332,65,231,164,0,10,0,168,0,0,267,101,0,322,0,0,0
30643,3407,2020-11-18T16:16:07.0066536Z,2013,322,66,233,162,0,8,0,160,0,0,256,89,0,314,0,4,0
30643,3408,2020-11-18T16:16:07.0076536Z,2014,288,58,182,159,0,7,0,129,0,0,230,106,0,281,0,2,0
30643,3409,2020-11-18T16:16:07.0076536Z,2015,278,58,194,141,0,5,0,137,0,0,220,84,0,273,0,0,0
30643,3410,2020-11-18T16:16:07.0076536Z,2016,263,60,65,131,0,6,1,132,0,0,203,198,0,256,0,0,1
30643,3411,2020-11-18T16:16:07.0076536Z,2017,271,64,226,129,0,6,1,142,0,0,207,45,0,263,0,0,2
30643,3412,2020-11-18T16:16:07.0086549Z,2018,306,67,244,153,0,8,11,153,0,0,239,62,0,297,0,0,1
30643,3413,2020-11-18T16:16:07.0086549Z,2019,303,82,240,149,0,5,11,154,0,0,221,63,0,297,0,0,1
30643,3414,2020-11-18T16:16:07.0086549Z,2020,310,71,257,152,0,4,0,158,0,0,239,53,0,304,0,0,2
66357,31987,2021-06-24T05:35:20.3093795Z,2021,90,89,68,31,0,3,2,59,0,0,1,22,0,87,0,0,0
66357,9210,2020-11-18T16:16:46.6931202Z,2012,93,49,59,41,0,1,0,52,0,0,44,34,0,92,0,0,0
66357,9211,2020-11-18T16:16:46.6941211Z,2013,89,57,64,43,0,1,0,46,0,0,32,25,0,88,0,0,0
66357,9212,2020-11-18T16:16:46.6941211Z,2014,92,69,68,46,0,1,0,46,0,0,23,24,0,91,0,0,0
66357,9213,2020-11-18T16:16:46.6941211Z,2015,104,73,83,51,0,2,0,53,0,0,31,21,0,102,0,0,0
66357,9214,2020-11-18T16:16:46.6951224Z,2016,6,5,2,3,0,0,0,3,0,0,1,4,0,6,0,0,0
66357,9215,2020-11-18T16:16:46.6951224Z,2017,103,88,77,41,0,3,2,62,0,0,15,26,0,100,0,0,0
66357,9216,2020-11-18T16:16:46.6951224Z,2018,102,82,73,42,0,2,3,60,0,0,20,29,0,100,0,0,0
66357,9217,2020-11-18T16:16:46.6961224Z,2019,110,89,87,40,0,3,3,70,0,0,21,23,0,107,0,0,0
66357,9218,2020-11-18T16:16:46.6961224Z,2020,107,106,82,40,0,4,5,67,0,0,1,25,0,103,0,0,0
61481,25947,2021-06-24T05:35:12.8490303Z,2021,159,55,129,83,0,6,2,76,0,0,104,30,1,150,1,1,2
61481,8221,2020-11-18T16:16:39.0560257Z,2012,164,64,128,73,0,17,0,91,0,0,100,36,0,147,0,0,0
61481,8222,2020-11-18T16:16:39.0560257Z,2013,162,54,132,84,0,20,0,78,0,0,108,30,1,141,0,1,0
61481,8223,2020-11-18T16:16:39.0560257Z,2014,175,59,141,88,0,25,0,87,0,0,116,34,1,148,0,1,1
61481,8224,2020-11-18T16:16:39.0570266Z,2015,164,54,126,81,0,21,0,83,0,0,110,38,1,142,0,1,0
61481,8225,2020-11-18T16:16:39.0570266Z,2016,157,48,76,75,0,20,0,82,0,0,109,81,1,136,0,1,0
61481,8226,2020-11-18T16:16:39.0570266Z,2017,157,44,123,82,0,16,1,75,0,0,113,34,3,136,0,2,2
61481,8227,2020-11-18T16:16:39.0570266Z,2018,159,45,122,88,0,10,0,71,0,0,114,37,1,148,1,1,0
61481,8228,2020-11-18T16:16:39.0580266Z,2019,167,58,135,89,1,10,1,78,0,0,109,32,1,155,2,1,1
61481,8229,2020-11-18T16:16:39.0580266Z,2020,162,53,128,89,0,7,3,73,0,0,109,34,1,153,2,1,1
58172,25930,2021-06-24T05:35:12.8290164Z,2021,293,100,249,143,0,0,6,150,0,0,193,44,0,293,3,3,0
58172,7834,2020-11-18T16:16:36.3532253Z,2012,550,138,456,279,0,7,0,271,0,0,412,94,11,525,0,0,7
58172,7835,2020-11-18T16:16:36.3542267Z,2013,486,147,394,253,0,8,0,233,0,0,339,92,11,460,0,0,7
58172,7836,2020-11-18T16:16:36.3542267Z,2014,477,148,377,251,0,8,0,226,0,0,329,100,10,453,0,0,6
58172,7837,2020-11-18T16:16:36.3542267Z,2015,374,117,293,206,0,5,0,168,0,0,257,81,7,359,0,1,3
58172,7838,2020-11-18T16:16:36.3542267Z,2016,359,131,123,195,0,4,3,164,0,0,228,236,2,350,0,1,3
58172,7839,2020-11-18T16:16:36.3542267Z,2017,271,88,221,135,0,4,2,136,0,0,183,50,3,263,0,1,1
58172,7840,2020-11-18T16:16:36.3552271Z,2018,255,83,202,134,0,6,2,121,0,0,172,53,3,245,0,1,1
58172,7841,2020-11-18T16:16:36.3552271Z,2019,327,111,254,166,0,1,7,161,0,0,216,73,0,326,2,4,0
58172,7842,2020-11-18T16:16:36.3552271Z,2020,343,124,277,162,0,4,9,181,0,0,219,66,0,339,3,3,0
33233,25781,2021-06-24T05:35:10.8566014Z,2021,685,132,558,365,0,13,0,320,0,0,553,127,3,669,4,0,0
33233,4040,2020-11-18T16:16:10.2938488Z,2012,593,2,413,301,0,14,0,292,0,0,591,180,2,574,0,0,3
33233,4041,2020-11-18T16:16:10.2948506Z,2013,687,1,470,377,0,17,0,310,0,0,686,217,2,666,0,2,2
33233,4042,2020-11-18T16:16:10.2948506Z,2014,721,38,505,373,0,22,0,348,0,0,683,216,1,697,0,5,1
33233,4043,2020-11-18T16:16:10.2948506Z,2015,732,43,522,387,0,23,0,345,0,0,689,210,3,706,0,4,0
33233,4044,2020-11-18T16:16:10.2958506Z,2016,614,67,448,314,0,15,1,300,0,0,547,166,4,595,0,4,0
33233,4045,2020-11-18T16:16:10.2958506Z,2017,791,112,615,396,0,13,54,395,0,0,679,176,1,776,0,3,1
33233,4046,2020-11-18T16:16:10.2968519Z,2018,752,98,575,383,0,14,11,369,0,0,654,177,2,735,1,2,1
33233,4047,2020-11-18T16:16:10.2968519Z,2019,662,89,540,354,0,11,0,308,0,0,573,122,2,649,2,1,0
33233,4048,2020-11-18T16:16:10.2968519Z,2020,691,141,578,382,0,10,1,309,0,0,550,113,3,678,2,0,0
53058,25900,2021-06-24T05:35:12.7999949Z,2021,369,96,285,190,0,7,0,179,0,0,273,84,0,361,0,2,1
53058,7132,2020-11-18T16:16:32.0453541Z,2012,420,70,329,192,0,0,0,228,0,0,350,91,0,420,0,0,0
53058,7133,2020-11-18T16:16:32.0453541Z,2013,367,76,286,178,0,1,0,189,0,0,291,81,0,366,0,2,0
53058,7134,2020-11-18T16:16:32.0453541Z,2014,367,86,286,171,0,0,0,196,0,0,281,81,0,367,0,0,0
53058,7135,2020-11-18T16:16:32.046355Z,2015,455,115,350,220,0,1,0,235,0,0,340,105,0,454,0,0,0
53058,7136,2020-11-18T16:16:32.046355Z,2016,394,108,65,193,0,0,17,201,0,0,286,329,0,394,0,1,0
53058,7137,2020-11-18T16:16:32.046355Z,2017,422,123,317,218,0,0,21,204,0,0,299,105,0,422,0,4,0
53058,7138,2020-11-18T16:16:32.046355Z,2018,449,112,334,221,0,0,27,228,0,0,337,115,0,449,1,4,0
53058,7139,2020-11-18T16:16:32.046355Z,2019,425,110,308,205,0,2,0,220,0,0,315,117,0,423,1,2,0
53058,7140,2020-11-18T16:16:32.047355Z,2020,412,107,296,211,0,4,0,201,0,0,305,116,0,408,0,2,0
20669,1863,2020-11-18T16:15:57.8635587Z,2012,446,106,274,224,0,3,0,222,0,0,340,172,1,441,0,0,1
20669,1864,2020-11-18T16:15:57.8635587Z,2013,410,96,250,207,0,1,0,203,0,0,314,160,0,408,0,2,1
20669,1865,2020-11-18T16:15:57.8645596Z,2014,405,103,244,215,0,1,0,190,0,0,302,161,1,403,0,2,0
20669,1866,2020-11-18T16:15:57.8645596Z,2015,423,119,246,226,0,0,0,197,0,0,304,177,1,422,0,2,0
20669,1867,2020-11-18T16:15:57.8645596Z,2016,403,118,244,216,0,0,62,187,0,0,285,159,2,401,0,1,0
20669,1868,2020-11-18T16:15:57.8645596Z,2017,389,128,264,208,0,0,63,181,0,0,261,125,2,387,0,1,0
20669,1869,2020-11-18T16:15:57.86556Z,2018,289,90,204,141,0,0,18,148,0,0,199,85,0,289,2,0,0
20669,1870,2020-11-18T16:15:57.8665605Z,2019,279,96,208,150,0,0,54,129,0,0,183,71,0,279,2,0,0
20669,1871,2020-11-18T16:15:57.8665605Z,2020,271,89,196,131,0,1,61,140,0,0,182,75,0,270,3,0,0
20669,25696,2021-06-24T05:35:08.6510198Z,2021,270,87,227,126,0,1,32,144,0,0,183,43,0,269,1,0,0
60418,31941,2021-06-24T05:35:18.5351071Z,2021,348,117,319,162,0,6,0,186,0,0,231,29,0,338,0,0,4
60418,8036,2020-11-18T16:16:37.529011Z,2012,399,124,319,182,0,9,0,217,0,0,275,80,4,382,0,0,4
60418,8037,2020-11-18T16:16:37.529011Z,2013,400,135,322,181,0,7,0,219,0,0,265,78,0,387,0,2,6
60418,8038,2020-11-18T16:16:37.529011Z,2014,356,121,292,162,0,9,0,194,0,0,235,64,0,341,0,3,6
60418,8039,2020-11-18T16:16:37.529011Z,2015,341,117,283,155,0,7,0,186,0,0,224,58,0,327,0,2,7
60418,8040,2020-11-18T16:16:37.5300118Z,2016,289,117,237,130,0,5,0,159,0,0,172,52,0,279,0,2,5
60418,8041,2020-11-18T16:16:37.5300118Z,2017,298,129,263,123,0,2,1,175,0,0,169,35,0,293,0,0,3
60418,8042,2020-11-18T16:16:37.5300118Z,2018,335,129,293,151,0,4,9,184,0,0,206,42,0,328,0,0,3
60418,8043,2020-11-18T16:16:37.5300118Z,2019,394,127,358,188,0,5,5,206,0,0,267,36,0,384,0,0,5
60418,8044,2020-11-18T16:16:37.5310123Z,2020,352,112,321,168,0,5,0,184,0,0,240,31,0,343,0,0,4
40980,31823,2021-06-24T05:35:16.9269541Z,2021,279,116,249,142,0,9,0,137,0,0,163,30,0,270,1,0,0
40980,4913,2020-11-18T16:16:16.6530903Z,2012,356,61,209,179,0,6,0,177,0,0,295,147,0,350,0,0,0
40980,4914,2020-11-18T16:16:16.6530903Z,2013,362,84,272,174,0,11,0,188,0,0,278,90,0,351,0,1,0
40980,4915,2020-11-18T16:16:16.6530903Z,2014,352,104,264,152,0,13,0,200,0,0,248,88,0,339,0,2,0
40980,4916,2020-11-18T16:16:16.6540908Z,2015,257,83,195,116,0,9,0,141,0,0,174,62,0,248,0,2,0
40980,4917,2020-11-18T16:16:16.6540908Z,2016,238,87,186,123,0,8,0,115,0,0,151,52,0,230,0,1,0
40980,4918,2020-11-18T16:16:16.6540908Z,2017,335,138,266,158,0,12,0,177,0,0,197,69,0,323,0,3,0
40980,4919,2020-11-18T16:16:16.6550916Z,2018,332,128,273,151,0,15,6,181,0,0,204,59,0,317,0,2,0
40980,4920,2020-11-18T16:16:16.6550916Z,2019,299,123,248,137,0,9,2,162,0,0,176,51,0,290,1,3,0
40980,4921,2020-11-18T16:16:16.6550916Z,2020,312,125,254,152,0,15,0,160,0,0,187,58,0,297,1,2,0
73650,10655,2020-11-18T16:16:56.1144014Z,2012,121,1,85,54,0,4,0,67,0,0,120,36,0,117,0,0,0
73650,10656,2020-11-18T16:16:56.1154022Z,2013,121,4,92,55,0,5,0,66,0,0,117,29,0,116,0,1,0
73650,10657,2020-11-18T16:16:56.1154022Z,2014,152,22,125,72,0,10,0,80,0,0,130,27,0,142,0,0,0
73650,10658,2020-11-18T16:16:56.1154022Z,2015,294,54,265,150,0,11,0,144,0,0,240,29,0,282,0,0,1
73650,10659,2020-11-18T16:16:56.1154022Z,2016,148,32,116,78,0,6,0,70,0,0,116,32,0,142,0,0,0
73650,10660,2020-11-18T16:16:56.1164058Z,2017,162,62,140,79,0,5,0,83,0,0,100,22,0,157,0,1,0
73650,10661,2020-11-18T16:16:56.1164058Z,2018,211,81,186,110,0,8,5,101,0,0,130,25,0,203,1,1,0
73650,10662,2020-11-18T16:16:56.1164058Z,2019,236,106,205,132,0,5,9,104,0,0,130,31,0,231,1,1,0
73650,10663,2020-11-18T16:16:56.1164058Z,2020,232,125,207,129,0,4,6,103,0,0,107,25,0,228,1,2,0
73650,31678,2021-06-24T05:35:15.280774Z,2021,220,119,198,118,0,6,3,102,0,0,101,22,0,213,0,0,1
25932,25727,2021-06-24T05:35:08.6860452Z,2021,212,87,171,104,0,5,34,108,0,0,125,41,0,206,0,0,1
25932,2918,2020-11-18T16:16:04.2748354Z,2012,368,151,264,177,0,4,0,191,0,0,217,104,0,364,0,0,0
25932,2919,2020-11-18T16:16:04.2758363Z,2013,338,136,240,150,0,3,0,188,0,0,202,98,0,335,0,1,0
25932,2920,2020-11-18T16:16:04.2758363Z,2014,328,138,228,143,0,2,0,185,0,0,190,100,0,326,0,1,0
25932,2921,2020-11-18T16:16:04.2758363Z,2015,312,150,233,129,0,2,0,183,0,0,162,79,1,309,0,0,0
25932,2922,2020-11-18T16:16:04.2758363Z,2016,298,154,181,126,0,3,60,172,0,0,144,117,0,295,0,0,0
25932,2923,2020-11-18T16:16:04.2768368Z,2017,215,106,152,92,0,2,29,123,0,0,109,63,0,213,0,0,0
25932,2924,2020-11-18T16:16:04.2768368Z,2018,315,124,249,134,0,2,1,181,0,0,191,66,0,313,0,0,0
25932,2925,2020-11-18T16:16:04.2768368Z,2019,258,123,195,117,0,4,28,141,0,0,135,63,0,254,0,0,0
25932,2926,2020-11-18T16:16:04.2778363Z,2020,269,118,219,130,0,3,52,139,0,0,151,50,0,266,0,0,0
21063,2069,2020-11-18T16:15:58.9242659Z,2012,319,107,243,154,0,3,0,165,0,0,212,76,0,316,0,0,0
21063,2070,2020-11-18T16:15:58.9242659Z,2013,325,109,262,156,0,4,0,169,0,0,216,63,0,321,0,2,0
21063,2071,2020-11-18T16:15:58.9242659Z,2014,297,95,227,140,0,2,0,157,0,0,202,70,0,295,0,2,0
21063,2072,2020-11-18T16:15:58.9252668Z,2015,333,124,282,159,0,0,0,174,0,0,209,51,0,333,0,0,0
21063,2073,2020-11-18T16:15:58.9252668Z,2016,325,119,241,161,0,1,0,164,0,0,206,84,0,324,0,0,0
21063,2074,2020-11-18T16:15:58.9252668Z,2017,279,106,223,125,0,3,1,154,0,0,173,56,0,276,0,1,0
21063,2075,2020-11-18T16:15:58.9252668Z,2018,264,95,200,136,0,3,1,128,0,0,169,64,0,261,0,1,0
21063,2076,2020-11-18T16:15:58.9252668Z,2019,258,99,208,141,0,1,0,117,0,0,159,50,0,257,0,1,0
21063,2077,2020-11-18T16:15:58.9252668Z,2020,205,69,169,115,0,2,0,90,0,0,136,36,0,203,0,0,0
21063,31706,2021-06-24T05:35:15.3378151Z,2021,175,56,136,96,0,1,0,79,0,0,119,39,0,173,0,0,1
17350,1342,2020-11-18T16:15:54.3071884Z,2012,690,0,454,351,0,4,0,339,0,0,690,236,3,683,0,0,0
17350,1343,2020-11-18T16:15:54.3071884Z,2013,733,2,495,352,0,4,0,381,0,0,731,238,3,726,0,2,0
17350,1344,2020-11-18T16:15:54.3071884Z,2014,564,22,365,264,0,6,0,300,0,0,542,199,2,556,0,1,0
17350,1345,2020-11-18T16:15:54.3071884Z,2015,584,38,409,272,0,4,0,312,0,0,546,175,1,579,0,3,0
17350,1346,2020-11-18T16:15:54.3071884Z,2016,566,83,133,267,0,1,0,299,0,0,483,433,0,565,0,2,0
17350,1347,2020-11-18T16:15:54.3081897Z,2017,604,81,405,281,0,1,0,323,0,0,523,199,0,603,0,1,0
17350,1348,2020-11-18T16:15:54.3081897Z,2018,559,73,385,248,0,2,0,311,0,0,486,174,1,556,0,1,0
17350,1349,2020-11-18T16:15:54.3081897Z,2019,615,81,436,293,0,4,1,322,0,0,534,179,1,610,0,1,0
17350,1350,2020-11-18T16:15:54.3081897Z,2020,580,121,437,286,0,5,0,294,0,0,459,143,0,575,0,1,0
17350,25607,2021-06-24T05:35:04.6241323Z,2021,569,140,457,275,0,5,0,294,0,0,429,112,0,564,0,0,0
34884,25792,2021-06-24T05:35:10.8706123Z,2021,406,56,264,209,0,5,0,197,0,0,350,142,0,399,1,1,2
34884,4266,2020-11-18T16:16:11.4726362Z,2012,658,2,345,400,0,2,0,258,0,0,656,313,0,656,0,0,0
34884,4267,2020-11-18T16:16:11.4726362Z,2013,646,5,368,358,0,0,0,288,0,0,641,278,0,646,0,5,0
34884,4268,2020-11-18T16:16:11.4726362Z,2014,550,12,335,293,0,0,0,257,0,0,538,215,0,550,0,0,0
34884,4269,2020-11-18T16:16:11.4736371Z,2015,566,22,329,311,0,3,0,255,0,0,544,237,0,563,0,0,0
34884,4270,2020-11-18T16:16:11.4736371Z,2016,566,34,227,310,0,4,0,256,0,0,532,339,0,562,0,0,0
34884,4271,2020-11-18T16:16:11.4736371Z,2017,786,61,443,424,0,7,0,362,0,0,725,343,0,779,0,0,0
34884,4272,2020-11-18T16:16:11.4736371Z,2018,709,64,413,373,0,5,7,336,0,0,645,296,0,704,0,1,0
34884,4273,2020-11-18T16:16:11.4746376Z,2019,612,50,371,316,0,8,0,296,0,0,562,241,0,604,0,1,0
34884,4274,2020-11-18T16:16:11.4746376Z,2020,520,63,341,274,0,6,0,246,0,0,457,179,0,514,0,0,0
66480,25986,2021-06-24T05:35:14.5062186Z,2021,305,175,273,117,0,5,6,188,0,0,130,32,0,300,0,0,0
66480,9219,2020-11-18T16:16:46.6941211Z,2012,283,29,184,119,0,0,0,164,0,0,254,99,0,281,0,0,2
66480,9220,2020-11-18T16:16:46.6951224Z,2013,238,99,213,98,0,2,0,140,0,0,139,25,0,236,0,0,0
66480,9221,2020-11-18T16:16:46.6951224Z,2014,225,122,208,97,0,1,0,128,0,0,103,17,0,224,0,0,0
66480,9222,2020-11-18T16:16:46.6951224Z,2015,168,83,152,62,0,1,0,106,0,0,85,16,0,167,0,0,0
66480,9223,2020-11-18T16:16:46.6961224Z,2016,223,128,207,70,0,4,2,153,0,0,95,16,0,219,0,0,0
66480,9224,2020-11-18T16:16:46.6961224Z,2017,266,172,239,85,0,5,9,181,0,0,94,27,0,259,0,0,2
66480,9225,2020-11-18T16:16:46.6961224Z,2018,433,249,392,165,0,11,13,268,0,0,184,41,0,420,0,1,2
66480,9226,2020-11-18T16:16:46.6971228Z,2019,533,276,480,223,0,11,10,310,0,0,257,53,0,522,0,0,0
66480,9227,2020-11-18T16:16:46.6971228Z,2020,418,222,374,171,0,9,12,247,0,0,196,44,0,409,0,0,0
60913,25941,2021-06-24T05:35:12.8420246Z,2021,486,179,395,227,0,12,4,259,0,0,307,91,0,474,0,1,0
60913,8083,2020-11-18T16:16:37.5420198Z,2012,535,7,303,275,0,8,0,260,0,0,528,232,0,526,0,0,1
60913,8084,2020-11-18T16:16:37.5420198Z,2013,462,10,280,222,0,2,0,240,0,0,452,182,1,458,0,0,1
60913,8085,2020-11-18T16:16:37.5420198Z,2014,495,54,323,249,0,10,0,246,0,0,441,172,1,483,0,0,1
60913,8086,2020-11-18T16:16:37.5420198Z,2015,458,27,336,238,0,10,0,220,0,0,431,122,0,448,0,1,0
60913,8087,2020-11-18T16:16:37.5420198Z,2016,543,67,340,288,0,8,1,255,0,0,476,203,0,535,0,0,0
60913,8088,2020-11-18T16:16:37.5430207Z,2017,495,57,350,262,0,6,1,233,0,0,438,145,0,487,0,0,2
60913,8089,2020-11-18T16:16:37.5430207Z,2018,497,74,376,267,0,10,6,230,0,0,423,121,0,485,0,0,2
60913,8090,2020-11-18T16:16:37.5430207Z,2019,725,164,598,358,0,17,4,367,0,0,561,127,0,706,1,0,2
60913,8091,2020-11-18T16:16:37.5430207Z,2020,594,197,511,293,0,11,2,301,0,0,397,83,0,583,0,0,0
20404,1725,2020-11-18T16:15:57.398249Z,2012,278,111,220,116,0,1,0,162,0,0,167,58,5,272,0,0,0
20404,1726,2020-11-18T16:15:57.3992494Z,2013,303,122,254,131,0,3,0,172,0,0,181,49,3,297,0,1,0
20404,1727,2020-11-18T16:15:57.3992494Z,2014,321,127,254,146,0,6,0,175,0,0,194,67,3,312,0,0,0
20404,1728,2020-11-18T16:15:57.3992494Z,2015,305,126,246,133,0,6,0,172,0,0,179,59,0,299,0,0,0
20404,1729,2020-11-18T16:15:57.4002494Z,2016,233,80,190,111,0,7,0,122,0,0,153,43,0,226,0,0,0
20404,1730,2020-11-18T16:15:57.4002494Z,2017,345,123,273,157,0,6,0,188,0,0,222,72,0,339,0,0,0
20404,1731,2020-11-18T16:15:57.4002494Z,2018,352,123,276,157,0,5,1,195,0,0,229,76,1,346,1,1,0
20404,1732,2020-11-18T16:15:57.4002494Z,2019,429,143,345,202,0,2,0,227,0,0,286,84,0,427,1,0,0
20404,1733,2020-11-18T16:15:57.4012503Z,2020,409,127,350,197,0,2,0,212,0,0,282,59,0,407,0,0,0
20404,31693,2021-06-24T05:35:15.3067917Z,2021,398,126,360,190,0,3,0,208,0,0,272,38,2,393,1,0,0
32367,25773,2021-06-24T05:35:08.7480901Z,2021,215,40,148,108,0,3,0,107,0,0,175,67,0,212,0,0,0
32367,3846,2020-11-18T16:16:09.180105Z,2012,262,60,242,107,0,11,0,155,0,0,202,20,0,251,0,0,0
32367,3847,2020-11-18T16:16:09.180105Z,2013,254,56,195,122,0,13,0,132,0,0,198,59,0,239,0,3,2
32367,3848,2020-11-18T16:16:09.1811055Z,2014,198,42,181,91,0,9,0,107,0,0,156,17,0,189,0,2,0
32367,3849,2020-11-18T16:16:09.1811055Z,2015,223,49,185,105,0,15,0,118,0,0,174,38,0,208,0,7,0
32367,3850,2020-11-18T16:16:09.1811055Z,2016,184,28,157,103,0,10,0,81,0,0,156,27,0,174,0,2,0
32367,3851,2020-11-18T16:16:09.1811055Z,2017,201,30,171,118,0,7,0,83,0,0,171,30,0,194,0,0,0
32367,3852,2020-11-18T16:16:09.1811055Z,2018,278,31,235,141,0,9,0,137,0,0,247,43,0,269,0,2,0
32367,3853,2020-11-18T16:16:09.1821064Z,2019,235,36,222,121,0,6,0,114,0,0,199,13,0,229,0,1,0
32367,3854,2020-11-18T16:16:09.1821064Z,2020,241,36,219,126,0,10,0,115,0,0,205,22,0,231,0,0,0
52514,31896,2021-06-24T05:35:18.4670592Z,2021,668,191,548,341,0,4,3,327,0,0,477,120,1,663,1,1,0
52514,6870,2020-11-18T16:16:30.1680997Z,2012,887,2,645,502,0,6,0,385,0,0,885,242,1,880,0,0,0
52514,6871,2020-11-18T16:16:30.169101Z,2013,934,5,772,512,0,15,0,422,0,0,929,162,0,919,0,3,0
52514,6872,2020-11-18T16:16:30.169101Z,2014,1015,65,830,561,0,11,0,454,0,0,950,185,0,1004,0,3,0
52514,6873,2020-11-18T16:16:30.169101Z,2015,940,69,774,525,0,7,0,415,0,0,871,166,1,932,0,2,0
52514,6874,2020-11-18T16:16:30.169101Z,2016,742,99,428,411,0,5,3,331,0,0,643,314,0,737,0,0,0
52514,6875,2020-11-18T16:16:30.169101Z,2017,909,131,755,496,0,8,0,413,0,0,778,154,0,899,0,1,2
52514,6876,2020-11-18T16:16:30.1701015Z,2018,850,131,685,455,0,8,0,395,0,1,719,165,0,842,2,1,0
52514,6877,2020-11-18T16:16:30.1701015Z,2019,976,181,793,495,0,11,0,481,0,0,795,183,0,965,2,1,0
52514,6878,2020-11-18T16:16:30.1701015Z,2020,879,210,724,448,0,7,8,431,0,0,669,155,1,871,1,0,0
35543,25797,2021-06-24T05:35:10.8756152Z,2021,62,62,52,20,0,1,0,42,0,0,0,10,0,61,0,0,0
35543,4365,2020-11-18T16:16:12.1710991Z,2012,95,47,78,30,0,0,0,65,0,0,48,17,0,94,0,0,1
35543,4366,2020-11-18T16:16:12.1710991Z,2013,94,63,79,38,0,0,0,56,0,0,31,15,0,93,0,1,1
35543,4367,2020-11-18T16:16:12.1710991Z,2014,83,64,70,38,0,0,0,45,0,0,19,13,0,83,0,0,0
35543,4368,2020-11-18T16:16:12.1721Z,2015,58,46,46,20,0,0,0,38,0,0,12,12,0,58,0,0,0
35543,4369,2020-11-18T16:16:12.1721Z,2016,56,49,47,17,0,1,0,39,0,0,7,9,0,55,0,0,0
35543,4370,2020-11-18T16:16:12.1731004Z,2017,53,42,45,20,0,1,0,33,0,0,11,8,0,52,0,1,0
35543,4371,2020-11-18T16:16:12.1731004Z,2018,52,47,44,19,0,1,1,33,0,0,5,8,0,51,0,1,0
35543,4372,2020-11-18T16:16:12.1741009Z,2019,55,53,44,21,0,1,0,34,0,0,2,11,1,53,0,1,0
35543,4373,2020-11-18T16:16:12.1741009Z,2020,61,61,50,21,0,1,0,40,0,0,0,11,0,60,0,0,0
62182,31959,2021-06-24T05:35:20.2493365Z,2021,405,123,346,192,0,1,4,213,0,0,282,59,0,402,0,0,2
62182,8466,2020-11-18T16:16:40.2178007Z,2012,440,121,336,222,0,5,0,218,0,0,319,104,0,435,0,0,0
62182,8467,2020-11-18T16:16:40.218802Z,2013,315,85,243,165,0,3,0,150,0,0,230,72,0,312,0,0,0
62182,8468,2020-11-18T16:16:40.218802Z,2014,364,103,268,189,0,8,0,175,0,0,261,96,0,356,0,0,0
62182,8469,2020-11-18T16:16:40.218802Z,2015,445,117,353,227,0,10,0,218,0,0,328,92,0,435,0,0,0
62182,8470,2020-11-18T16:16:40.218802Z,2016,548,138,418,285,0,11,11,263,0,0,410,130,0,536,0,1,1
62182,8471,2020-11-18T16:16:40.218802Z,2017,478,119,374,254,0,10,27,224,0,0,359,104,0,467,0,1,1
62182,8472,2020-11-18T16:16:40.2198024Z,2018,524,119,412,246,0,8,12,278,0,0,405,112,0,516,0,0,0
62182,8473,2020-11-18T16:16:40.2198024Z,2019,536,173,440,279,0,4,4,257,0,0,363,96,0,530,0,0,2
62182,8474,2020-11-18T16:16:40.2198024Z,2020,469,147,388,230,0,1,4,239,0,0,322,81,0,465,0,0,3
47951,31863,2021-06-24T05:35:18.4280305Z,2021,685,198,552,348,0,20,1,337,0,0,487,133,0,663,1,0,2
47951,6068,2020-11-18T16:16:23.9889785Z,2012,666,93,479,339,0,15,0,327,0,0,573,187,1,650,0,0,0
47951,6069,2020-11-18T16:16:23.9889785Z,2013,682,160,466,358,0,18,0,324,0,0,522,216,0,664,0,2,0
47951,6070,2020-11-18T16:16:23.9889785Z,2014,656,166,454,339,0,21,0,317,0,0,490,202,0,634,0,0,1
47951,6071,2020-11-18T16:16:23.9889785Z,2015,648,163,432,338,0,22,0,310,0,0,485,216,0,624,0,0,2
47951,6072,2020-11-18T16:16:23.9889785Z,2016,606,159,145,319,0,18,2,287,0,0,447,461,0,586,0,2,2
47951,6073,2020-11-18T16:16:23.9899789Z,2017,604,174,431,337,0,9,0,267,0,0,430,173,1,593,0,1,1
47951,6074,2020-11-18T16:16:23.9899789Z,2018,491,163,362,231,0,11,0,260,0,0,328,129,0,480,2,0,0
47951,6075,2020-11-18T16:16:23.9899789Z,2019,691,216,496,342,0,14,1,349,0,1,475,195,0,676,4,3,1
47951,6076,2020-11-18T16:16:23.9899789Z,2020,707,196,525,356,0,18,0,351,0,0,511,182,0,689,4,1,0
58099,31930,2021-06-24T05:35:18.5271013Z,2021,235,66,206,98,0,1,5,137,0,0,169,29,1,233,0,0,0
58099,7784,2020-11-18T16:16:35.9219379Z,2012,226,50,176,113,0,0,0,113,0,0,176,50,0,226,0,0,0
58099,7785,2020-11-18T16:16:35.9219379Z,2013,253,63,199,130,0,0,0,123,0,0,190,54,0,253,0,3,0
58099,7786,2020-11-18T16:16:35.9219379Z,2014,226,52,167,104,0,0,0,122,0,0,174,59,0,226,0,1,0
58099,7787,2020-11-18T16:16:35.9219379Z,2015,194,51,142,87,0,0,0,107,0,0,143,52,0,194,0,1,0
58099,7788,2020-11-18T16:16:35.9229379Z,2016,187,48,142,77,0,0,0,110,0,0,139,45,0,187,0,2,0
58099,7789,2020-11-18T16:16:35.9229379Z,2017,197,50,147,89,0,0,0,108,0,0,147,50,0,197,0,1,0
58099,7790,2020-11-18T16:16:35.9229379Z,2018,159,37,123,81,0,0,0,78,0,0,122,36,0,159,0,0,0
58099,7791,2020-11-18T16:16:35.9229379Z,2019,295,87,224,129,0,0,1,166,0,0,208,71,0,295,2,0,0
58099,7792,2020-11-18T16:16:35.9229379Z,2020,311,81,243,145,0,1,4,166,0,0,230,68,0,310,0,0,0
50542,31877,2021-06-24T05:35:18.4490462Z,2021,303,109,263,137,0,0,0,166,0,0,194,40,0,302,0,0,1
50542,6236,2020-11-18T16:16:25.5149985Z,2012,282,109,243,124,0,0,0,158,0,0,173,39,1,281,0,0,0
50542,6237,2020-11-18T16:16:25.5149985Z,2013,334,114,226,144,0,3,0,190,0,0,220,108,0,331,0,4,0
50542,6238,2020-11-18T16:16:25.5149985Z,2014,344,120,234,154,0,0,0,190,0,0,224,110,0,344,0,2,0
50542,6239,2020-11-18T16:16:25.5159985Z,2015,350,130,237,162,0,2,0,188,0,0,220,113,0,348,0,1,0
50542,6240,2020-11-18T16:16:25.5159985Z,2016,344,137,245,154,0,0,0,190,0,0,207,99,0,344,0,0,0
50542,6241,2020-11-18T16:16:25.5159985Z,2017,337,123,246,153,0,1,0,184,0,0,214,91,0,336,0,0,0
50542,6242,2020-11-18T16:16:25.5159985Z,2018,298,103,206,137,0,2,0,161,0,0,195,92,0,296,0,0,0
50542,6243,2020-11-18T16:16:25.5169999Z,2019,305,115,235,146,0,1,2,159,0,0,190,70,0,304,0,0,0
50542,6244,2020-11-18T16:16:25.5169999Z,2020,301,110,230,134,0,0,0,167,0,0,191,71,0,301,0,0,0
31609,31771,2021-06-24T05:35:16.8388914Z,2021,207,55,167,91,0,2,3,116,0,0,152,40,0,204,1,0,1
31609,3732,2020-11-18T16:16:08.7177962Z,2012,257,48,174,126,0,9,0,131,0,0,209,83,0,248,0,0,0
31609,3733,2020-11-18T16:16:08.7177962Z,2013,248,46,178,124,0,9,0,124,0,0,202,70,0,239,0,0,0
31609,3734,2020-11-18T16:16:08.7177962Z,2014,239,39,151,129,0,5,0,110,0,0,200,88,0,234,0,0,0
31609,3735,2020-11-18T16:16:08.7177962Z,2015,209,38,162,115,0,7,0,94,0,0,171,47,0,202,0,1,0
31609,3736,2020-11-18T16:16:08.7177962Z,2016,194,46,149,110,0,6,0,84,0,0,148,45,0,188,0,1,0
31609,3737,2020-11-18T16:16:08.7187967Z,2017,163,44,136,92,0,6,0,71,0,0,119,27,0,157,0,0,0
31609,3738,2020-11-18T16:16:08.7187967Z,2018,141,31,96,80,0,6,1,61,0,0,110,45,0,133,0,0,2
31609,3739,2020-11-18T16:16:08.7187967Z,2019,214,52,175,106,0,4,0,108,0,0,162,39,0,210,0,0,0
31609,3740,2020-11-18T16:16:08.7187967Z,2020,212,56,170,98,0,4,0,114,0,0,156,42,0,208,0,0,0
51292,31882,2021-06-24T05:35:18.4550497Z,2021,225,49,178,117,0,5,1,108,0,0,176,47,0,220,0,0,0
51292,6426,2020-11-18T16:16:27.0380122Z,2012,243,63,197,135,0,0,0,108,0,0,180,46,0,243,0,0,0
51292,6427,2020-11-18T16:16:27.0380122Z,2013,220,52,186,131,0,1,0,89,0,0,168,34,0,219,0,1,0
51292,6428,2020-11-18T16:16:27.0390135Z,2014,195,48,144,118,0,1,0,77,0,0,147,51,0,194,0,1,0
51292,6429,2020-11-18T16:16:27.0390135Z,2015,238,68,193,136,0,2,0,102,0,0,170,45,0,236,0,2,0
51292,6430,2020-11-18T16:16:27.0390135Z,2016,233,58,82,132,0,1,0,101,0,0,175,151,0,232,0,0,0
51292,6431,2020-11-18T16:16:27.0390135Z,2017,232,57,178,123,0,1,0,109,0,0,175,54,0,231,0,1,0
51292,6432,2020-11-18T16:16:27.0400135Z,2018,203,47,159,112,0,2,4,91,0,0,156,44,0,201,1,0,0
51292,6433,2020-11-18T16:16:27.0400135Z,2019,242,62,186,129,0,3,53,113,0,0,180,56,0,239,0,0,0
51292,6434,2020-11-18T16:16:27.0400135Z,2020,226,58,172,113,0,4,37,113,0,0,168,54,0,222,1,0,0
20305,1667,2020-11-18T16:15:56.6077187Z,2012,329,100,233,142,0,0,0,187,0,0,229,96,0,327,0,0,2
20305,1668,2020-11-18T16:15:56.6087191Z,2013,367,127,271,160,0,0,0,207,0,0,240,96,0,367,0,0,0
20305,1669,2020-11-18T16:15:56.6087191Z,2014,371,128,248,157,0,1,0,214,0,0,243,123,0,370,0,2,0
20305,1670,2020-11-18T16:15:56.6087191Z,2015,371,126,261,163,0,1,0,208,0,0,245,110,0,370,0,2,0
20305,1671,2020-11-18T16:15:56.6087191Z,2016,302,102,212,149,0,1,1,153,0,0,200,90,1,300,0,3,0
20305,1672,2020-11-18T16:15:56.6087191Z,2017,262,105,190,128,0,2,0,134,0,0,157,72,1,259,0,2,0
20305,1673,2020-11-18T16:15:56.6097209Z,2018,268,96,179,129,0,4,28,139,0,0,172,89,1,263,10,1,0
20305,1674,2020-11-18T16:15:56.6097209Z,2019,218,81,148,111,0,3,21,107,0,0,137,70,0,215,11,0,0
20305,1675,2020-11-18T16:15:56.6097209Z,2020,199,57,141,101,0,0,14,98,0,0,142,58,0,199,6,0,0
20305,25689,2021-06-24T05:35:08.6330074Z,2021,173,47,145,88,0,0,6,85,0,0,126,28,0,172,6,0,1
24927,25723,2021-06-24T05:35:08.6770389Z,2021,212,52,159,100,0,0,3,112,0,0,160,53,0,212,2,1,0
24927,2739,2020-11-18T16:16:03.270163Z,2012,215,54,182,93,0,5,0,122,0,0,161,33,0,210,0,0,0
24927,2740,2020-11-18T16:16:03.270163Z,2013,211,60,156,81,0,0,0,130,0,0,151,55,0,211,0,1,0
24927,2741,2020-11-18T16:16:03.2711643Z,2014,202,63,143,88,0,1,0,114,0,0,139,59,0,201,0,0,0
24927,2742,2020-11-18T16:16:03.2711643Z,2015,194,63,169,89,0,3,0,105,0,0,131,25,0,191,0,0,0
24927,2743,2020-11-18T16:16:03.2711643Z,2016,178,53,146,75,0,3,0,103,0,0,125,32,0,175,0,1,0
24927,2744,2020-11-18T16:16:03.2711643Z,2017,180,58,146,83,0,3,0,97,0,0,122,34,0,177,0,2,0
24927,2745,2020-11-18T16:16:03.2711643Z,2018,228,58,159,109,0,5,17,119,0,0,170,69,1,222,2,3,0
24927,2746,2020-11-18T16:16:03.2721648Z,2019,237,79,149,115,0,2,0,122,0,0,158,88,0,235,2,3,0
24927,2747,2020-11-18T16:16:03.2721648Z,2020,220,59,130,107,0,1,1,113,0,0,161,90,0,219,2,1,0
54551,31911,2021-06-24T05:35:18.4810688Z,2021,329,107,288,161,0,7,0,168,0,0,222,41,0,321,0,1,1
54551,7390,2020-11-18T16:16:33.2561592Z,2012,401,36,315,198,0,0,0,203,0,0,365,86,0,401,0,0,0
54551,7391,2020-11-18T16:16:33.2561592Z,2013,541,75,423,257,0,0,0,284,0,0,466,118,0,540,0,6,1
54551,7392,2020-11-18T16:16:33.2571588Z,2014,539,88,428,262,0,1,0,277,0,0,451,111,0,536,0,2,2
54551,7393,2020-11-18T16:16:33.2571588Z,2015,551,91,464,270,0,3,0,281,0,0,460,87,0,546,0,4,2
54551,7394,2020-11-18T16:16:33.2571588Z,2016,402,104,138,191,0,1,2,211,0,0,298,264,0,401,0,3,0
54551,7395,2020-11-18T16:16:33.2571588Z,2017,385,79,334,185,0,3,2,200,0,0,306,51,0,382,0,2,0
54551,7396,2020-11-18T16:16:33.2581597Z,2018,354,65,296,175,0,3,22,179,0,0,289,58,0,351,4,1,0
54551,7397,2020-11-18T16:16:33.2581597Z,2019,317,78,266,161,0,1,9,156,0,0,239,51,0,316,1,3,0
54551,7398,2020-11-18T16:16:33.2581597Z,2020,344,100,291,170,0,7,8,174,0,0,244,53,0,337,0,2,0
70417,31650,2021-06-24T05:35:14.6743387Z,2021,535,242,459,257,0,16,5,278,0,0,293,76,0,518,0,5,1
70417,9650,2020-11-18T16:16:49.7201358Z,2012,364,142,289,156,0,0,0,208,0,0,222,75,0,363,0,0,1
70417,9651,2020-11-18T16:16:49.7201358Z,2013,337,134,270,151,0,1,0,186,0,0,203,67,0,336,0,1,0
70417,9652,2020-11-18T16:16:49.7201358Z,2014,322,123,247,145,0,0,0,177,0,0,199,75,0,322,0,0,0
70417,9653,2020-11-18T16:16:49.7201358Z,2015,284,114,223,135,0,1,0,149,0,0,170,61,0,283,0,1,0
70417,9654,2020-11-18T16:16:49.721138Z,2016,231,107,185,101,0,1,0,130,0,0,124,46,0,230,0,1,0
70417,9655,2020-11-18T16:16:49.721138Z,2017,245,109,198,94,0,2,0,151,0,0,136,47,0,243,0,2,0
70417,9656,2020-11-18T16:16:49.721138Z,2018,481,201,359,213,0,11,3,268,0,0,280,122,1,469,0,1,0
70417,9657,2020-11-18T16:16:49.721138Z,2019,519,237,400,243,0,10,1,276,0,0,282,119,0,509,0,1,0
70417,9658,2020-11-18T16:16:49.7221407Z,2020,494,216,392,239,0,10,2,255,0,0,278,102,0,483,0,1,1
61762,31957,2021-06-24T05:35:20.2463341Z,2021,189,35,136,102,0,11,1,87,0,0,154,53,0,177,0,0,1
61762,8409,2020-11-18T16:16:40.2017904Z,2012,300,0,195,195,0,25,0,105,0,0,300,105,0,275,0,0,0
61762,8410,2020-11-18T16:16:40.2027908Z,2013,309,0,201,211,0,33,0,98,0,0,309,108,0,276,0,0,0
61762,8411,2020-11-18T16:16:40.2027908Z,2014,310,9,189,211,0,36,0,99,0,0,301,121,0,273,0,0,1
61762,8412,2020-11-18T16:16:40.2027908Z,2015,291,19,183,199,0,28,0,92,0,0,272,108,0,262,0,1,1
61762,8413,2020-11-18T16:16:40.2027908Z,2016,278,30,133,181,0,19,0,97,0,0,248,145,0,258,0,1,1
61762,8414,2020-11-18T16:16:40.2037917Z,2017,299,27,215,193,0,17,0,106,0,0,272,84,0,282,0,0,0
61762,8415,2020-11-18T16:16:40.2037917Z,2018,291,42,203,175,0,23,0,116,0,0,249,88,1,266,0,0,1
61762,8416,2020-11-18T16:16:40.2037917Z,2019,252,44,185,150,0,14,0,102,0,0,208,67,1,236,0,0,1
61762,8417,2020-11-18T16:16:40.2037917Z,2020,236,47,173,142,0,11,0,94,0,0,189,63,0,224,0,0,1
70763,25659,2021-06-24T05:35:04.7282065Z,2021,475,161,451,227,0,10,0,248,0,0,314,24,1,464,0,0,0
70763,9880,2020-11-18T16:16:50.8899187Z,2012,466,114,440,224,0,10,0,242,0,0,352,26,1,455,0,0,0
70763,9881,2020-11-18T16:16:50.8899187Z,2013,494,126,433,240,0,8,0,254,0,0,368,61,2,484,0,1,0
70763,9882,2020-11-18T16:16:50.8899187Z,2014,507,130,422,246,0,6,0,261,0,0,377,85,2,498,0,0,1
70763,9883,2020-11-18T16:16:50.8909196Z,2015,484,117,401,229,0,10,0,255,0,0,367,83,2,471,0,0,1
70763,9884,2020-11-18T16:16:50.8909196Z,2016,435,114,109,215,0,10,0,220,0,0,321,326,0,424,0,0,1
70763,9885,2020-11-18T16:16:50.8909196Z,2017,476,132,426,223,0,7,0,253,0,0,344,50,2,466,0,1,1
70763,9886,2020-11-18T16:16:50.8909196Z,2018,424,125,376,199,0,8,0,225,0,0,299,48,0,416,0,1,0
70763,9887,2020-11-18T16:16:50.8919205Z,2019,548,189,509,287,0,12,0,261,0,0,359,39,0,536,0,0,0
70763,9888,2020-11-18T16:16:50.8919205Z,2020,522,173,500,279,0,15,0,243,0,0,349,22,0,507,0,0,0
32243,25771,2021-06-24T05:35:08.7430854Z,2021,238,74,210,112,0,0,0,126,0,0,164,28,0,234,0,2,4
32243,3798,2020-11-18T16:16:08.7308047Z,2012,285,57,258,131,0,6,0,154,0,0,228,27,2,277,0,0,0
32243,3799,2020-11-18T16:16:08.7308047Z,2013,242,49,218,120,0,4,0,122,0,0,193,24,3,235,0,4,0
32243,3800,2020-11-18T16:16:08.7308047Z,2014,282,63,223,132,0,5,0,150,0,0,219,59,2,275,0,0,0
32243,3801,2020-11-18T16:16:09.1670966Z,2015,400,109,352,183,0,1,0,217,0,0,291,48,1,397,0,3,1
32243,3802,2020-11-18T16:16:09.1670966Z,2016,398,112,289,173,0,4,0,225,0,0,286,109,2,390,0,3,2
32243,3803,2020-11-18T16:16:09.1680979Z,2017,356,112,328,143,0,5,0,213,0,0,244,28,1,349,0,0,1
32243,3804,2020-11-18T16:16:09.1680979Z,2018,358,117,318,149,0,3,5,209,0,0,241,40,1,354,0,0,0
32243,3805,2020-11-18T16:16:09.1680979Z,2019,317,94,291,152,1,1,0,165,0,0,223,26,0,314,0,2,2
32243,3806,2020-11-18T16:16:09.1680979Z,2020,298,98,276,147,0,0,1,151,0,0,200,22,0,296,0,2,2
62612,25963,2021-06-24T05:35:12.9000671Z,2021,284,93,250,144,0,11,1,140,0,0,191,34,1,270,0,0,2
62612,8612,2020-11-18T16:16:42.1631006Z,2012,279,86,250,139,0,16,0,140,0,0,193,29,0,263,0,0,0
62612,8613,2020-11-18T16:16:42.1641006Z,2013,243,90,223,115,0,12,0,128,0,0,153,20,0,231,0,0,0
62612,8614,2020-11-18T16:16:42.1641006Z,2014,220,84,161,91,0,11,0,129,0,0,136,59,0,209,0,0,0
62612,8615,2020-11-18T16:16:42.1641006Z,2015,241,100,218,102,0,11,0,139,0,0,141,23,0,229,0,0,1
62612,8616,2020-11-18T16:16:42.1641006Z,2016,224,93,201,99,0,7,1,125,0,0,131,23,0,216,0,0,1
62612,8617,2020-11-18T16:16:42.1651019Z,2017,282,117,273,127,0,7,0,155,0,0,165,9,0,274,0,1,1
62612,8618,2020-11-18T16:16:42.1651019Z,2018,252,92,229,104,0,11,1,148,0,0,160,23,0,239,1,0,2
62612,8619,2020-11-18T16:16:42.1651019Z,2019,315,116,298,160,0,13,2,155,0,0,199,17,0,301,0,0,1
62612,8620,2020-11-18T16:16:42.1661028Z,2020,280,96,247,137,0,12,5,143,0,0,184,33,0,267,0,0,1
71746,10451,2020-11-18T16:16:54.7224731Z,2012,320,99,243,148,0,3,0,172,0,0,221,77,0,317,0,0,0
71746,10452,2020-11-18T16:16:54.7224731Z,2013,302,99,205,150,0,1,0,152,0,0,203,97,0,301,0,0,0
71746,10453,2020-11-18T16:16:54.7224731Z,2014,291,89,204,153,0,0,0,138,0,0,202,87,0,291,0,0,0
71746,10454,2020-11-18T16:16:54.7224731Z,2015,280,91,213,146,0,2,0,134,0,0,189,67,0,278,0,4,0
71746,10455,2020-11-18T16:16:54.7234727Z,2016,250,88,73,121,0,3,0,129,0,0,162,177,0,247,0,1,0
71746,10456,2020-11-18T16:16:54.7234727Z,2017,239,93,197,113,0,1,0,126,0,0,146,42,0,237,0,1,1
71746,10457,2020-11-18T16:16:54.7234727Z,2018,249,83,200,120,0,2,0,129,0,0,166,49,0,245,0,2,2
71746,10458,2020-11-18T16:16:54.7234727Z,2019,277,110,224,145,0,2,1,132,0,0,167,53,0,274,0,1,1
71746,10459,2020-11-18T16:16:54.7234727Z,2020,281,113,229,146,0,2,0,135,0,0,168,52,0,278,0,1,1
71746,31622,2021-06-24T05:35:14.6213004Z,2021,269,105,234,139,0,1,0,130,0,0,164,35,0,267,0,3,1
72058,10610,2020-11-18T16:16:56.1013929Z,2012,332,79,256,166,0,3,0,166,0,0,253,76,0,329,0,0,0
72058,10611,2020-11-18T16:16:56.1013929Z,2013,315,79,259,153,0,2,0,162,0,0,236,56,0,313,0,1,0
72058,10612,2020-11-18T16:16:56.1023933Z,2014,308,76,227,150,0,3,0,158,0,0,232,81,0,305,0,2,0
72058,10613,2020-11-18T16:16:56.1023933Z,2015,343,86,255,166,0,6,0,177,0,0,257,88,0,336,0,2,1
72058,10614,2020-11-18T16:16:56.1023933Z,2016,327,77,247,156,0,6,2,171,0,0,250,80,0,320,0,2,1
72058,10615,2020-11-18T16:16:56.1023933Z,2017,304,79,253,152,0,2,1,152,0,0,225,51,0,302,0,1,0
72058,10616,2020-11-18T16:16:56.1023933Z,2018,301,79,249,144,2,0,1,157,0,0,222,52,0,301,0,0,0
72058,10617,2020-11-18T16:16:56.1033938Z,2019,326,101,278,157,0,4,1,169,0,0,225,48,0,320,0,0,2
72058,10618,2020-11-18T16:16:56.1033938Z,2020,311,108,273,149,0,7,0,162,0,0,203,38,0,302,0,0,2
72058,31626,2021-06-24T05:35:14.6223009Z,2021,244,79,211,113,0,6,0,131,0,0,165,33,0,236,0,0,2
61549,25949,2021-06-24T05:35:12.8680432Z,2021,227,79,189,110,0,5,2,117,0,0,148,38,0,222,0,0,0
61549,8268,2020-11-18T16:16:39.0730373Z,2012,245,79,174,121,0,4,0,124,0,0,166,71,0,241,0,0,0
61549,8269,2020-11-18T16:16:39.0740382Z,2013,299,84,221,146,0,8,0,153,0,0,215,78,0,291,0,0,0
61549,8270,2020-11-18T16:16:39.0740382Z,2014,280,88,180,131,0,8,0,149,0,0,192,100,0,272,0,0,0
61549,8271,2020-11-18T16:16:39.0740382Z,2015,291,88,232,141,0,11,0,150,0,0,203,59,1,279,0,0,0
61549,8272,2020-11-18T16:16:39.0750382Z,2016,250,73,108,125,0,7,0,125,0,0,177,142,1,242,0,0,0
61549,8273,2020-11-18T16:16:39.0750382Z,2017,281,90,242,138,0,6,0,143,0,0,191,39,1,274,0,0,0
61549,8274,2020-11-18T16:16:39.0750382Z,2018,264,83,206,129,0,6,1,135,0,0,181,58,0,256,2,2,2
61549,8275,2020-11-18T16:16:39.0760382Z,2019,240,84,190,120,0,7,0,120,0,0,156,50,0,232,2,1,1
61549,8276,2020-11-18T16:16:39.0760382Z,2020,226,87,175,107,0,6,5,119,0,0,139,51,0,220,0,0,0
51870,25888,2021-06-24T05:35:12.781982Z,2021,300,95,254,141,0,3,0,159,0,0,205,46,0,297,0,0,0
51870,6623,2020-11-18T16:16:28.2258042Z,2012,467,56,317,252,0,2,0,215,0,0,411,150,0,465,0,0,0
51870,6624,2020-11-18T16:16:28.2258042Z,2013,494,93,359,243,0,3,0,251,0,0,401,135,0,491,0,4,0
51870,6625,2020-11-18T16:16:28.2258042Z,2014,509,130,394,258,0,3,0,251,0,0,379,115,0,506,0,3,0
51870,6626,2020-11-18T16:16:28.2268051Z,2015,476,113,375,228,0,3,0,248,0,0,363,101,0,473,0,2,0
51870,6627,2020-11-18T16:16:28.2268051Z,2016,433,127,98,207,0,2,2,226,0,0,306,335,0,431,0,1,0
51870,6628,2020-11-18T16:16:28.2268051Z,2017,452,153,357,208,0,2,5,244,0,0,299,95,0,450,0,3,0
51870,6629,2020-11-18T16:16:28.2268051Z,2018,394,135,311,184,0,2,15,210,0,0,259,83,0,392,0,0,0
51870,6630,2020-11-18T16:16:28.2278056Z,2019,372,132,291,171,0,4,2,201,0,0,240,81,0,368,0,0,0
51870,6631,2020-11-18T16:16:28.2278056Z,2020,326,113,268,148,0,2,10,178,0,0,213,58,0,324,0,0,0
61705,31956,2021-06-24T05:35:20.247335Z,2021,244,84,209,119,0,35,0,125,0,0,160,35,0,208,0,0,1
61705,8381,2020-11-18T16:16:39.7965203Z,2012,300,50,252,137,0,40,0,163,0,0,250,48,2,254,0,0,4
61705,8382,2020-11-18T16:16:39.7965203Z,2013,282,80,241,130,0,35,0,152,0,0,202,41,1,244,0,0,2
61705,8383,2020-11-18T16:16:39.7965203Z,2014,264,79,224,134,0,39,0,130,0,0,185,40,1,224,0,1,0
61705,8384,2020-11-18T16:16:39.7975203Z,2015,236,75,205,112,0,43,0,124,0,0,161,31,1,192,0,0,0
61705,8385,2020-11-18T16:16:39.7975203Z,2016,177,66,137,81,0,26,0,96,0,0,111,40,1,149,0,1,1
61705,8386,2020-11-18T16:16:39.7975203Z,2017,257,105,216,111,0,30,4,146,0,0,152,41,0,225,0,2,2
61705,8387,2020-11-18T16:16:39.7975203Z,2018,235,86,187,110,0,25,4,125,0,0,149,48,0,210,0,0,0
61705,8388,2020-11-18T16:16:39.7975203Z,2019,289,80,246,146,0,56,0,143,0,0,209,43,1,232,0,0,0
61705,8389,2020-11-18T16:16:39.7985217Z,2020,275,88,237,135,0,54,1,140,0,0,187,38,1,220,0,0,0
42390,31833,2021-06-24T05:35:16.96398Z,2021,240,83,201,120,0,2,0,120,0,0,157,39,0,237,0,0,1
42390,5231,2020-11-18T16:16:18.4352748Z,2012,168,61,140,73,0,0,0,95,0,0,107,28,0,168,0,0,0
42390,5232,2020-11-18T16:16:18.4352748Z,2013,224,92,182,101,0,2,0,123,0,0,132,42,0,221,0,4,1
42390,5233,2020-11-18T16:16:18.4352748Z,2014,242,91,196,114,0,3,0,128,0,0,151,46,0,238,0,0,1
42390,5234,2020-11-18T16:16:18.4352748Z,2015,246,95,199,124,0,8,0,122,0,0,151,47,0,238,0,1,0
42390,5235,2020-11-18T16:16:18.4362762Z,2016,236,93,68,117,0,10,0,119,0,0,143,168,0,226,0,2,0
42390,5236,2020-11-18T16:16:18.4362762Z,2017,199,69,148,103,0,2,0,96,0,0,130,51,0,197,0,1,0
42390,5237,2020-11-18T16:16:18.4362762Z,2018,207,79,178,109,0,8,5,98,0,0,128,29,0,199,1,2,0
42390,5238,2020-11-18T16:16:18.4362762Z,2019,260,92,215,143,0,3,1,117,0,2,168,45,0,257,1,2,0
42390,5239,2020-11-18T16:16:18.4372775Z,2020,245,86,216,120,0,5,0,125,0,0,159,29,0,240,0,0,0
75705,10811,2020-11-18T16:16:57.3922561Z,2012,415,66,333,217,0,5,0,198,0,0,349,82,0,410,0,0,0
75705,10812,2020-11-18T16:16:57.3922561Z,2013,428,102,357,207,0,6,0,221,0,0,326,71,0,421,0,3,1
75705,10813,2020-11-18T16:16:57.3932565Z,2014,448,118,362,220,0,3,0,228,0,0,330,86,1,443,0,2,1
75705,10814,2020-11-18T16:16:57.3932565Z,2015,456,133,390,225,0,3,0,231,0,0,323,66,1,452,0,2,0
75705,10815,2020-11-18T16:16:57.3932565Z,2016,290,100,247,153,0,3,0,137,0,0,190,43,0,287,0,0,0
75705,10816,2020-11-18T16:16:57.394257Z,2017,282,101,237,131,0,6,0,151,0,0,181,45,1,275,0,0,0
75705,10817,2020-11-18T16:16:57.394257Z,2018,347,116,299,180,0,7,0,167,0,0,231,48,2,337,10,0,1
75705,10818,2020-11-18T16:16:57.394257Z,2019,314,124,269,159,0,4,9,155,0,0,190,45,2,308,9,0,0
75705,10819,2020-11-18T16:16:57.395257Z,2020,255,99,218,124,0,4,51,131,0,0,156,37,1,250,2,0,0
75705,25994,2021-06-24T05:35:14.5122229Z,2021,223,88,206,109,0,3,0,114,0,0,135,17,0,220,2,0,0
31302,31768,2021-06-24T05:35:16.8408924Z,2021,303,69,257,156,0,7,0,147,0,0,234,46,1,294,2,1,1
31302,3634,2020-11-18T16:16:08.0383435Z,2012,398,47,239,206,0,6,0,192,0,0,351,159,7,385,0,0,0
31302,3635,2020-11-18T16:16:08.0383435Z,2013,303,51,253,165,0,1,0,138,0,0,252,50,1,301,0,2,0
31302,3636,2020-11-18T16:16:08.0383435Z,2014,297,67,260,148,0,1,0,149,0,0,230,37,3,293,0,0,0
31302,3637,2020-11-18T16:16:08.0383435Z,2015,301,59,237,148,0,2,0,153,0,0,242,64,2,297,0,4,0
31302,3638,2020-11-18T16:16:08.0383435Z,2016,261,68,191,124,0,1,1,137,0,0,193,70,2,258,0,3,0
31302,3639,2020-11-18T16:16:08.039343Z,2017,262,63,221,130,0,0,1,132,0,0,199,41,0,262,0,3,0
31302,3640,2020-11-18T16:16:08.039343Z,2018,432,92,342,223,0,9,0,209,0,0,340,90,0,422,1,4,1
31302,3641,2020-11-18T16:16:08.0403443Z,2019,385,96,309,199,0,7,1,186,0,0,289,76,0,377,3,2,1
31302,3642,2020-11-18T16:16:08.0403443Z,2020,327,80,272,176,0,7,1,151,0,0,247,55,0,320,2,1,0
20255,1645,2020-11-18T16:15:56.5776995Z,2012,515,70,391,258,0,5,0,257,0,0,445,124,1,509,0,0,0
20255,1646,2020-11-18T16:15:56.5776995Z,2013,425,108,342,209,0,4,0,216,0,0,317,83,2,419,0,3,0
20255,1647,2020-11-18T16:15:56.5787Z,2014,389,115,303,176,0,0,0,213,0,0,274,86,0,389,0,2,0
20255,1648,2020-11-18T16:15:56.5787Z,2015,358,105,266,167,0,0,0,191,0,0,253,92,0,358,0,1,0
20255,1649,2020-11-18T16:15:56.5787Z,2016,267,75,130,130,0,1,1,137,0,0,192,137,0,266,0,0,0
20255,1650,2020-11-18T16:15:56.5787Z,2017,248,82,197,125,0,3,2,123,0,0,166,51,0,245,0,3,0
20255,1651,2020-11-18T16:15:56.5787Z,2018,448,79,240,232,0,5,44,216,0,1,369,208,0,443,8,1,0
20255,1652,2020-11-18T16:15:56.5797004Z,2019,460,82,227,248,0,6,0,212,0,2,378,233,0,454,10,2,0
20255,1653,2020-11-18T16:15:56.5797004Z,2020,522,113,236,272,0,8,13,250,0,0,409,286,0,513,12,2,1
20255,31690,2021-06-24T05:35:15.3017884Z,2021,538,106,318,299,0,8,13,239,0,0,432,220,0,529,12,4,1
32268,25772,2021-06-24T05:35:08.7460887Z,2021,239,45,221,115,0,2,0,124,0,0,194,18,0,237,0,0,0
32268,3816,2020-11-18T16:16:09.1751015Z,2012,405,104,291,205,0,0,0,200,0,0,301,114,0,405,0,0,0
32268,3817,2020-11-18T16:16:09.1751015Z,2013,369,91,273,197,0,0,0,172,0,0,278,96,0,369,0,0,0
32268,3818,2020-11-18T16:16:09.1751015Z,2014,372,77,225,191,0,0,0,181,0,0,295,147,0,372,0,0,0
32268,3819,2020-11-18T16:16:09.1761024Z,2015,386,84,253,204,0,4,0,182,0,0,302,133,0,382,0,0,0
32268,3820,2020-11-18T16:16:09.1761024Z,2016,342,66,194,176,0,5,0,166,0,0,276,148,2,335,0,2,0
32268,3821,2020-11-18T16:16:09.1761024Z,2017,313,68,265,158,0,7,0,155,0,0,245,48,2,304,0,1,0
32268,3822,2020-11-18T16:16:09.1761024Z,2018,329,66,291,162,1,6,1,167,0,0,263,38,2,321,1,0,0
32268,3823,2020-11-18T16:16:09.1771033Z,2019,271,60,251,133,0,5,0,138,0,0,211,20,0,266,1,0,0
32268,3824,2020-11-18T16:16:09.1771033Z,2020,264,53,244,128,0,6,1,136,0,0,211,20,0,258,0,1,0
61499,31949,2021-06-24T05:35:18.5441133Z,2021,218,66,205,109,0,15,2,109,0,0,152,13,0,203,0,0,0
61499,8230,2020-11-18T16:16:39.0620302Z,2012,309,109,298,154,0,5,0,155,0,0,200,11,0,304,0,0,0
61499,8231,2020-11-18T16:16:39.0620302Z,2013,323,111,307,158,0,8,0,165,0,0,212,16,0,315,0,1,0
61499,8232,2020-11-18T16:16:39.0630302Z,2014,321,110,301,148,0,7,0,173,0,0,211,20,0,314,0,2,0
61499,8233,2020-11-18T16:16:39.0630302Z,2015,323,96,309,143,0,8,0,180,0,0,227,14,0,315,0,2,0
61499,8234,2020-11-18T16:16:39.0630302Z,2016,267,92,251,123,0,5,0,144,0,0,175,16,0,262,0,0,0
61499,8235,2020-11-18T16:16:39.0630302Z,2017,233,70,224,119,0,10,1,114,0,0,163,9,0,223,0,0,0
61499,8236,2020-11-18T16:16:39.0630302Z,2018,224,59,216,104,0,12,0,120,0,0,165,8,0,212,0,0,0
61499,8237,2020-11-18T16:16:39.0640302Z,2019,267,79,258,124,0,12,0,143,0,0,188,9,0,253,0,0,2
61499,8238,2020-11-18T16:16:39.0640302Z,2020,238,74,214,114,0,13,0,124,0,0,164,24,0,224,0,0,1
35816,31802,2021-06-24T05:35:16.8769178Z,2021,264,82,221,121,0,7,0,143,0,0,182,43,0,257,0,1,0
35816,4434,2020-11-18T16:16:12.5803711Z,2012,658,1,465,346,0,8,0,312,0,0,657,193,0,650,0,0,0
35816,4435,2020-11-18T16:16:12.5803711Z,2013,559,3,393,308,0,3,0,251,0,0,556,166,0,556,0,1,0
35816,4436,2020-11-18T16:16:12.5813711Z,2014,521,25,373,287,0,3,0,234,0,0,496,148,0,518,0,0,0
35816,4437,2020-11-18T16:16:12.5813711Z,2015,460,24,324,226,0,2,0,234,0,0,436,136,0,458,0,2,0
35816,4438,2020-11-18T16:16:12.5813711Z,2016,576,88,458,277,0,4,3,299,0,0,488,118,0,572,0,2,0
35816,4439,2020-11-18T16:16:12.5823724Z,2017,485,86,369,232,0,5,2,253,0,0,399,116,0,480,0,3,0
35816,4440,2020-11-18T16:16:12.5823724Z,2018,452,82,358,223,0,4,14,229,0,0,370,94,0,448,0,3,0
35816,4441,2020-11-18T16:16:12.5823724Z,2019,358,56,286,176,0,5,1,182,0,0,302,72,0,353,0,3,0
35816,4442,2020-11-18T16:16:12.5833738Z,2020,295,76,245,136,0,3,0,159,0,0,219,50,0,291,0,3,1
10967,266,2020-11-18T16:15:46.8572187Z,2012,274,67,203,130,0,5,0,144,0,0,207,71,0,269,0,0,0
10967,267,2020-11-18T16:15:46.8582191Z,2013,368,92,249,181,0,10,0,187,0,0,276,119,0,358,0,5,0
10967,268,2020-11-18T16:15:46.8582191Z,2014,402,96,256,199,0,20,0,203,0,0,306,146,0,382,0,1,0
10967,269,2020-11-18T16:15:46.8582191Z,2015,456,108,284,224,0,22,0,232,0,0,348,172,0,434,0,6,0
10967,270,2020-11-18T16:15:46.8582191Z,2016,469,111,197,231,0,20,0,238,0,0,358,272,0,449,0,5,0
10967,271,2020-11-18T16:15:46.8582191Z,2017,447,111,260,231,0,10,0,216,0,0,336,187,0,437,0,3,0
10967,272,2020-11-18T16:15:46.85922Z,2018,389,107,249,198,0,13,1,191,0,0,282,140,0,376,4,2,0
10967,273,2020-11-18T16:15:46.85922Z,2019,377,123,253,191,0,12,0,186,0,0,254,124,0,365,2,1,0
10967,274,2020-11-18T16:15:46.85922Z,2020,407,126,293,205,0,11,0,202,0,0,281,114,0,396,0,1,0
10967,31587,2021-06-24T05:35:14.5302353Z,2021,409,117,322,206,0,12,0,203,0,0,292,87,0,396,0,1,1
15917,1278,2020-11-18T16:15:53.6127249Z,2012,459,47,378,226,0,21,0,233,0,0,412,81,0,438,0,0,0
15917,1279,2020-11-18T16:15:53.6127249Z,2013,465,69,364,232,0,17,0,233,0,0,396,101,0,448,0,2,0
15917,1280,2020-11-18T16:15:53.6127249Z,2014,502,98,388,242,0,18,0,260,0,0,404,114,0,484,0,0,0
15917,1281,2020-11-18T16:15:53.6127249Z,2015,477,84,369,239,0,18,0,238,0,0,393,108,0,459,0,1,0
15917,1282,2020-11-18T16:15:53.6137254Z,2016,522,119,390,252,0,22,2,270,0,0,403,132,0,500,0,3,0
15917,1283,2020-11-18T16:15:53.6137254Z,2017,462,108,353,237,0,16,5,225,0,0,354,109,0,446,0,2,0
15917,1284,2020-11-18T16:15:53.6137254Z,2018,571,160,456,286,0,13,12,285,0,0,411,115,0,558,6,3,0
15917,1285,2020-11-18T16:15:53.6137254Z,2019,510,159,385,262,0,24,10,248,0,0,351,125,0,486,8,4,0
15917,1286,2020-11-18T16:15:53.6137254Z,2020,510,164,397,245,0,17,0,265,0,0,346,113,0,493,13,4,0
15917,25605,2021-06-24T05:35:04.620129Z,2021,451,132,369,226,0,17,0,225,0,0,319,82,0,432,7,1,2
46052,25850,2021-06-24T05:35:10.9666807Z,2021,506,161,435,263,0,17,1,243,0,0,345,71,1,488,2,0,0
46052,5848,2020-11-18T16:16:22.5760351Z,2012,504,67,354,236,0,17,0,268,0,0,437,150,0,487,0,0,0
46052,5849,2020-11-18T16:16:22.5760351Z,2013,532,123,372,242,0,14,0,290,0,0,409,160,0,517,0,3,1
46052,5850,2020-11-18T16:16:22.5770351Z,2014,502,139,356,219,0,13,0,283,0,0,363,146,0,489,0,2,0
46052,5851,2020-11-18T16:16:22.5770351Z,2015,486,138,355,228,0,21,0,258,0,0,348,131,0,465,0,3,0
46052,5852,2020-11-18T16:16:22.5770351Z,2016,425,137,234,211,0,18,0,214,0,0,288,191,0,407,0,1,0
46052,5853,2020-11-18T16:16:22.5770351Z,2017,420,145,297,213,0,11,0,207,0,0,275,123,0,409,0,1,0
46052,5854,2020-11-18T16:16:22.5780364Z,2018,444,133,304,204,0,13,0,240,0,0,311,140,0,431,3,1,0
46052,5855,2020-11-18T16:16:22.5780364Z,2019,582,195,429,289,0,16,7,293,0,1,387,153,0,566,3,2,0
46052,5856,2020-11-18T16:16:22.5780364Z,2020,557,180,435,284,0,22,16,273,0,0,377,122,0,535,3,2,0
12799,31601,2021-06-24T05:35:14.5632592Z,2021,280,98,243,135,0,8,0,145,0,0,182,37,0,272,0,2,0
12799,854,2020-11-18T16:15:51.335204Z,2012,433,184,399,176,0,0,0,257,0,0,249,34,0,433,0,0,0
12799,855,2020-11-18T16:15:51.335204Z,2013,442,202,404,174,0,0,0,268,0,0,240,38,0,442,0,0,0
12799,856,2020-11-18T16:15:51.336204Z,2014,419,191,382,167,0,1,0,252,0,0,228,37,0,418,0,1,0
12799,857,2020-11-18T16:15:51.336204Z,2015,385,179,354,156,0,0,0,229,0,0,206,31,0,385,0,2,0
12799,858,2020-11-18T16:15:51.336204Z,2016,370,180,72,154,0,4,0,216,0,0,190,298,0,366,0,2,0
12799,859,2020-11-18T16:15:51.336204Z,2017,279,127,257,126,0,6,1,153,0,0,152,22,0,273,0,1,0
12799,860,2020-11-18T16:15:51.3372062Z,2018,268,117,214,123,0,7,7,145,0,0,151,54,0,261,2,3,0
12799,861,2020-11-18T16:15:51.3372062Z,2019,373,156,329,182,0,9,6,191,0,0,217,44,0,361,3,1,3
12799,862,2020-11-18T16:15:51.3372062Z,2020,304,124,274,152,0,9,0,152,0,0,180,30,0,295,1,0,0
50468,25874,2021-06-24T05:35:11.0587463Z,2021,734,180,505,391,0,16,0,343,0,0,554,229,1,717,3,1,0
50468,6204,2020-11-18T16:16:25.4919825Z,2012,712,1,481,357,0,6,0,355,0,0,711,231,0,705,0,0,1
50468,6205,2020-11-18T16:16:25.4919825Z,2013,677,6,477,336,0,6,0,341,0,0,671,200,0,670,0,2,1
50468,6206,2020-11-18T16:16:25.4919825Z,2014,653,46,431,329,0,6,0,324,0,0,607,222,0,646,0,2,1
50468,6207,2020-11-18T16:16:25.4919825Z,2015,733,53,487,369,0,7,0,364,0,0,680,246,0,726,0,1,0
50468,6208,2020-11-18T16:16:25.4929847Z,2016,706,91,174,358,0,5,0,348,0,0,615,532,1,700,0,1,0
50468,6209,2020-11-18T16:16:25.4929847Z,2017,685,88,429,353,0,5,0,332,0,0,597,256,1,679,0,1,0
50468,6210,2020-11-18T16:16:25.4929847Z,2018,739,112,477,371,0,7,1,368,0,0,627,262,1,731,2,0,0
50468,6211,2020-11-18T16:16:25.4929847Z,2019,729,129,464,371,0,14,3,358,0,1,600,265,0,715,1,1,0
50468,6212,2020-11-18T16:16:25.4929847Z,2020,735,176,480,370,0,16,0,365,0,0,559,255,1,718,0,1,0
58495,25933,2021-06-24T05:35:12.8310169Z,2021,98,37,75,49,0,0,0,49,0,0,61,23,0,98,0,0,0
58495,7888,2020-11-18T16:16:36.3732396Z,2012,194,57,119,96,0,0,0,98,0,0,137,75,0,194,0,0,0
58495,7889,2020-11-18T16:16:36.3732396Z,2013,190,52,121,89,0,0,0,101,0,0,138,69,0,190,0,2,0
58495,7890,2020-11-18T16:16:36.3732396Z,2014,178,52,93,87,0,0,0,91,0,0,126,85,0,178,0,0,0
58495,7891,2020-11-18T16:16:36.3732396Z,2015,178,46,109,89,0,0,0,89,0,0,132,69,0,178,0,1,0
58495,7892,2020-11-18T16:16:36.3732396Z,2016,157,37,101,77,0,0,1,80,0,0,120,56,0,157,0,0,0
58495,7893,2020-11-18T16:16:36.3732396Z,2017,113,33,68,56,0,1,0,57,0,0,80,45,0,112,0,0,0
58495,7894,2020-11-18T16:16:36.3742396Z,2018,93,27,47,47,0,1,6,46,0,0,66,46,0,92,0,0,0
58495,7895,2020-11-18T16:16:36.3742396Z,2019,89,41,44,37,0,0,1,52,0,0,48,45,0,89,0,1,0
58495,7896,2020-11-18T16:16:36.3742396Z,2020,94,43,69,42,0,0,0,52,0,0,51,25,0,94,0,1,0
43794,25843,2021-06-24T05:35:10.9656807Z,2021,315,98,297,138,0,3,0,177,0,0,217,18,0,312,1,1,0
43794,5684,2020-11-18T16:16:21.1821099Z,2012,384,132,338,177,0,1,0,207,0,0,252,46,0,383,0,0,0
43794,5685,2020-11-18T16:16:21.1821099Z,2013,329,118,288,159,0,2,0,170,0,0,211,41,0,327,0,14,0
43794,5686,2020-11-18T16:16:21.1821099Z,2014,313,106,239,139,0,1,0,174,0,0,207,74,0,312,0,8,0
43794,5687,2020-11-18T16:16:21.1821099Z,2015,267,92,233,119,0,1,0,148,0,0,175,34,0,266,0,6,0
43794,5688,2020-11-18T16:16:21.1821099Z,2016,326,96,164,142,0,0,9,184,0,0,230,162,0,326,0,6,0
43794,5689,2020-11-18T16:16:21.1831108Z,2017,267,71,235,126,0,1,8,141,0,0,196,32,0,266,0,3,0
43794,5690,2020-11-18T16:16:21.1831108Z,2018,301,90,281,139,0,1,8,162,0,0,211,20,0,300,2,1,0
43794,5691,2020-11-18T16:16:21.1831108Z,2019,388,118,348,175,0,2,6,213,0,0,270,40,0,386,3,3,0
43794,5692,2020-11-18T16:16:21.1831108Z,2020,357,113,319,162,0,4,0,195,0,0,244,38,0,353,3,2,0
52555,31897,2021-06-24T05:35:18.5000817Z,2021,166,164,135,58,0,0,5,108,0,0,2,31,0,166,1,0,0
52555,6899,2020-11-18T16:16:30.1650992Z,2012,128,68,101,36,0,1,0,92,0,0,60,27,0,127,0,0,0
52555,6900,2020-11-18T16:16:30.1660988Z,2013,136,93,120,40,0,0,0,96,0,0,43,16,0,136,0,0,0
52555,6901,2020-11-18T16:16:30.8635645Z,2014,179,153,145,48,0,0,0,131,0,0,26,34,0,179,0,0,0
52555,6902,2020-11-18T16:16:30.8635645Z,2015,183,142,155,56,0,0,0,127,0,0,41,28,0,183,0,0,0
52555,6903,2020-11-18T16:16:30.8645658Z,2016,195,164,34,57,0,2,5,138,0,0,31,161,0,193,0,0,0
52555,6904,2020-11-18T16:16:30.8645658Z,2017,175,143,149,48,0,0,8,127,0,0,32,26,0,175,0,0,0
52555,6905,2020-11-18T16:16:30.8645658Z,2018,176,158,145,56,0,0,5,120,0,0,18,31,0,176,2,1,0
52555,6906,2020-11-18T16:16:30.8655667Z,2019,173,165,139,59,0,0,8,114,0,1,8,34,0,173,2,0,0
52555,6907,2020-11-18T16:16:30.8655667Z,2020,169,168,135,58,0,0,9,111,0,0,1,34,0,169,1,0,0
75713,10820,2020-11-18T16:16:57.394257Z,2012,475,171,398,231,0,0,0,244,0,0,304,77,0,475,0,0,0
75713,10821,2020-11-18T16:16:57.394257Z,2013,429,155,367,221,0,0,0,208,0,0,274,62,0,427,0,0,2
75713,10822,2020-11-18T16:16:57.395257Z,2014,432,168,366,210,0,4,0,222,0,0,264,66,0,426,0,4,2
75713,10823,2020-11-18T16:16:57.395257Z,2015,400,167,322,195,0,9,0,205,0,0,233,78,0,389,0,5,2
75713,10824,2020-11-18T16:16:57.395257Z,2016,418,169,294,212,0,8,1,206,0,0,249,124,0,408,0,2,2
75713,10825,2020-11-18T16:16:57.395257Z,2017,402,173,329,203,0,13,0,199,0,0,229,73,0,389,0,0,0
75713,10826,2020-11-18T16:16:57.3962583Z,2018,360,131,291,177,0,9,5,183,0,0,229,69,0,350,3,0,1
75713,10827,2020-11-18T16:16:57.3962583Z,2019,360,138,295,177,0,10,0,183,0,0,222,65,0,350,4,0,0
75713,10828,2020-11-18T16:16:57.3962583Z,2020,377,145,305,182,0,9,12,195,0,0,232,72,0,368,4,0,0
75713,31996,2021-06-24T05:35:20.3203872Z,2021,396,151,316,189,0,14,2,207,0,0,245,80,0,382,2,0,0
70045,31642,2021-06-24T05:35:14.6553244Z,2021,409,167,343,198,0,9,0,211,0,0,242,66,1,399,0,0,0
70045,9420,2020-11-18T16:16:48.5013283Z,2012,470,170,310,218,0,3,0,252,0,0,300,160,0,467,0,0,0
70045,9421,2020-11-18T16:16:48.5023287Z,2013,455,178,296,217,0,5,0,238,0,0,277,159,0,450,0,3,0
70045,9422,2020-11-18T16:16:48.5023287Z,2014,473,174,371,230,0,8,0,243,0,0,299,102,0,464,0,3,1
70045,9423,2020-11-18T16:16:48.5023287Z,2015,479,171,371,226,0,6,0,253,0,0,308,108,0,472,0,0,1
70045,9424,2020-11-18T16:16:48.5023287Z,2016,364,139,245,166,0,3,1,198,0,0,225,119,0,361,0,1,0
70045,9425,2020-11-18T16:16:48.5023287Z,2017,367,144,300,168,0,3,0,199,0,0,223,67,0,364,0,0,0
70045,9426,2020-11-18T16:16:48.5033292Z,2018,418,140,275,191,0,8,3,227,0,0,278,143,0,410,0,0,0
70045,9427,2020-11-18T16:16:48.5033292Z,2019,509,195,401,239,0,13,5,270,0,0,314,108,0,496,0,3,0
70045,9428,2020-11-18T16:16:48.5033292Z,2020,447,174,347,218,0,12,1,229,0,0,273,100,0,433,0,2,2
44529,25844,2021-06-24T05:35:10.9666807Z,2021,212,112,186,77,0,0,0,135,0,0,100,26,0,212,1,0,0
44529,5702,2020-11-18T16:16:22.0907137Z,2012,97,41,89,44,0,2,0,53,0,0,56,8,0,95,0,0,0
44529,5703,2020-11-18T16:16:22.0907137Z,2013,99,43,92,44,0,1,0,55,0,0,56,7,0,98,0,0,0
44529,5704,2020-11-18T16:16:22.0907137Z,2014,115,55,102,52,0,2,0,63,0,0,60,13,0,113,0,0,0
44529,5705,2020-11-18T16:16:22.0917142Z,2015,122,60,110,48,0,4,0,74,0,0,62,12,0,118,0,0,0
44529,5706,2020-11-18T16:16:22.0917142Z,2016,161,78,134,60,0,9,0,101,0,0,83,27,0,152,0,4,0
44529,5707,2020-11-18T16:16:22.0917142Z,2017,185,89,152,76,0,5,0,109,0,0,96,33,0,180,0,2,0
44529,5708,2020-11-18T16:16:22.0927146Z,2018,175,88,144,67,0,6,0,108,0,0,87,31,0,169,1,0,0
44529,5709,2020-11-18T16:16:22.0927146Z,2019,196,108,170,72,0,4,0,124,0,0,88,26,0,192,1,0,0
44529,5710,2020-11-18T16:16:22.0927146Z,2020,207,108,188,69,0,3,0,138,0,0,99,19,0,204,1,0,0
51946,25889,2021-06-24T05:35:12.7829829Z,2021,341,103,295,151,0,9,0,190,0,0,238,46,1,330,0,0,1
51946,6641,2020-11-18T16:16:28.2288047Z,2012,336,99,279,154,0,11,0,182,0,0,237,57,0,325,0,0,0
51946,6642,2020-11-18T16:16:28.2288047Z,2013,315,94,265,143,0,8,0,172,0,0,221,50,0,307,0,2,0
51946,6643,2020-11-18T16:16:28.2288047Z,2014,322,104,277,145,0,9,0,177,0,0,218,45,0,313,0,2,0
51946,6644,2020-11-18T16:16:28.2298069Z,2015,302,95,269,148,0,10,0,154,0,0,207,33,0,292,0,3,0
51946,6645,2020-11-18T16:16:28.2298069Z,2016,298,89,149,151,0,9,0,147,0,0,209,149,0,289,0,0,0
51946,6646,2020-11-18T16:16:28.2298069Z,2017,288,99,256,145,0,8,0,143,0,0,189,32,0,280,0,0,0
51946,6647,2020-11-18T16:16:28.2298069Z,2018,255,75,227,123,0,8,0,132,0,0,180,28,0,247,0,0,0
51946,6648,2020-11-18T16:16:28.2298069Z,2019,376,124,341,183,1,9,10,193,0,0,252,35,0,367,0,0,0
51946,6649,2020-11-18T16:16:28.230806Z,2020,367,112,339,173,0,12,5,194,0,0,255,28,0,353,0,0,2
30973,25763,2021-06-24T05:35:08.7360802Z,2021,769,141,513,385,0,6,0,384,0,0,628,256,1,761,0,2,1
30973,3514,2020-11-18T16:16:07.6070547Z,2012,621,5,409,323,0,4,0,298,0,0,616,212,0,617,0,0,0
30973,3515,2020-11-18T16:16:07.6070547Z,2013,566,18,381,279,0,3,0,287,0,0,548,185,2,559,0,3,2
30973,3516,2020-11-18T16:16:07.6080547Z,2014,754,74,506,362,0,7,0,392,0,0,680,248,1,745,0,1,1
30973,3517,2020-11-18T16:16:07.6080547Z,2015,681,60,435,339,0,8,0,342,0,0,621,246,0,672,0,1,1
30973,3518,2020-11-18T16:16:07.6080547Z,2016,657,81,352,345,0,15,1,312,0,0,576,305,0,642,0,1,0
30973,3519,2020-11-18T16:16:07.609056Z,2017,733,110,460,403,0,13,0,330,0,0,623,273,1,719,0,1,0
30973,3520,2020-11-18T16:16:07.609056Z,2018,749,102,454,406,0,14,0,343,0,0,647,295,1,733,0,0,1
30973,3521,2020-11-18T16:16:07.609056Z,2019,686,103,408,370,0,5,0,316,0,0,583,278,1,679,0,1,1
30973,3522,2020-11-18T16:16:07.609056Z,2020,758,145,460,383,0,5,0,375,0,0,613,298,1,751,0,1,1
63123,31974,2021-06-24T05:35:20.2813594Z,2021,219,109,202,128,0,7,1,91,0,0,110,17,0,211,1,0,1
63123,8881,2020-11-18T16:16:43.9272726Z,2012,276,2,223,119,0,8,0,157,0,0,274,53,1,266,0,0,1
63123,8882,2020-11-18T16:16:43.9272726Z,2013,232,7,203,97,0,4,0,135,0,0,225,29,0,227,0,1,1
63123,8883,2020-11-18T16:16:43.9272726Z,2014,257,44,239,111,0,8,0,146,0,0,213,18,0,249,0,0,0
63123,8884,2020-11-18T16:16:43.9272726Z,2015,269,43,252,130,0,10,0,139,0,0,226,17,0,259,0,0,0
63123,8885,2020-11-18T16:16:43.9272726Z,2016,281,70,250,144,0,20,0,137,0,0,211,31,0,260,0,1,1
63123,8886,2020-11-18T16:16:43.928273Z,2017,277,67,259,139,0,30,0,138,0,0,210,18,0,247,0,1,0
63123,8887,2020-11-18T16:16:43.928273Z,2018,271,59,254,143,0,24,0,128,0,0,212,17,0,247,0,0,0
63123,8888,2020-11-18T16:16:43.928273Z,2019,272,78,250,145,0,14,0,127,0,0,194,22,0,258,0,0,0
63123,8889,2020-11-18T16:16:43.928273Z,2020,237,115,224,130,0,9,1,107,0,0,122,13,0,227,0,0,1
35782,25800,2021-06-24T05:35:10.8806186Z,2021,421,68,295,212,0,3,0,209,0,0,353,126,0,418,2,0,0
35782,4419,2020-11-18T16:16:12.5843738Z,2012,528,2,344,289,0,14,0,239,0,0,526,184,0,512,0,0,2
35782,4420,2020-11-18T16:16:12.5843738Z,2013,521,6,360,284,0,10,0,237,0,0,515,161,0,509,0,8,2
35782,4421,2020-11-18T16:16:12.5843738Z,2014,485,19,334,260,0,4,0,225,0,0,466,151,0,481,0,6,0
35782,4422,2020-11-18T16:16:12.5853751Z,2015,447,8,307,253,0,5,0,194,0,0,439,140,0,442,0,3,0
35782,4423,2020-11-18T16:16:12.5853751Z,2016,586,50,239,343,0,3,0,243,0,0,536,347,0,583,0,2,0
35782,4424,2020-11-18T16:16:12.5853751Z,2017,609,54,437,343,0,4,0,266,0,0,555,172,1,604,0,1,0
35782,4425,2020-11-18T16:16:12.5863742Z,2018,625,55,450,361,0,5,0,264,0,0,570,175,1,619,1,1,0
35782,4426,2020-11-18T16:16:12.5863742Z,2019,533,42,393,298,0,6,0,235,0,0,491,140,1,526,1,1,0
35782,4427,2020-11-18T16:16:12.5863742Z,2020,477,60,335,249,0,4,0,228,0,0,417,142,0,473,0,0,0
30239,31757,2021-06-24T05:35:16.8288834Z,2021,275,89,260,138,0,9,0,137,0,0,186,15,1,263,1,0,2
30239,3273,2020-11-18T16:16:05.7308073Z,2012,299,54,213,154,0,7,0,145,0,0,245,86,0,291,0,0,1
30239,3274,2020-11-18T16:16:05.7308073Z,2013,264,47,220,142,0,15,0,122,0,0,217,44,0,248,0,8,1
30239,3275,2020-11-18T16:16:05.7318073Z,2014,270,55,206,137,0,12,0,133,0,0,215,64,0,258,0,6,0
30239,3276,2020-11-18T16:16:05.7318073Z,2015,338,65,289,164,0,14,0,174,0,0,273,49,0,324,0,2,0
30239,3277,2020-11-18T16:16:05.7318073Z,2016,300,64,267,156,0,14,10,144,0,0,236,33,0,286,0,2,0
30239,3278,2020-11-18T16:16:05.7318073Z,2017,282,83,242,156,0,10,0,126,0,0,199,40,0,271,0,1,1
30239,3279,2020-11-18T16:16:05.7318073Z,2018,275,60,227,148,0,12,12,127,0,0,215,48,0,263,0,0,0
30239,3280,2020-11-18T16:16:05.7328077Z,2019,324,88,287,170,0,7,0,154,0,0,236,37,0,314,0,0,3
30239,3281,2020-11-18T16:16:05.7328077Z,2020,291,85,261,145,0,6,0,146,0,0,206,30,1,281,1,0,3
12336,31633,2021-06-24T05:35:14.633309Z,2021,110,35,104,59,0,1,0,51,0,0,75,6,8,101,0,0,0
12336,687,2020-11-18T16:15:50.2594862Z,2012,291,70,255,139,0,6,0,152,0,0,221,36,0,284,0,0,1
12336,688,2020-11-18T16:15:50.2604871Z,2013,272,73,235,136,0,5,0,136,0,0,199,37,0,266,0,6,1
12336,689,2020-11-18T16:15:50.2604871Z,2014,262,79,235,127,0,4,0,135,0,0,183,27,1,256,0,2,1
12336,690,2020-11-18T16:15:50.2604871Z,2015,231,64,193,108,0,2,0,123,0,0,167,38,0,228,0,2,1
12336,691,2020-11-18T16:15:50.2604871Z,2016,194,62,73,86,0,3,0,108,0,0,132,121,3,188,0,2,0
12336,692,2020-11-18T16:15:50.2604871Z,2017,175,43,148,78,0,1,0,97,0,0,132,27,1,173,0,0,0
12336,693,2020-11-18T16:15:50.2614875Z,2018,156,32,129,65,0,1,0,91,0,0,124,27,14,141,0,0,0
12336,694,2020-11-18T16:15:50.2614875Z,2019,114,33,98,51,0,0,0,63,0,0,81,16,8,106,0,0,0
12336,695,2020-11-18T16:15:50.2614875Z,2020,110,32,95,55,0,0,0,55,0,0,78,15,5,105,0,0,0
62950,25968,2021-06-24T05:35:12.9070723Z,2021,341,117,316,186,0,47,6,155,0,0,224,25,2,292,1,0,0
62950,8773,2020-11-18T16:16:42.8485571Z,2012,584,4,354,305,0,18,0,279,0,0,580,230,0,566,0,0,0
62950,8774,2020-11-18T16:16:42.8495571Z,2013,557,17,391,313,0,33,0,244,0,0,540,166,3,521,0,2,0
62950,8775,2020-11-18T16:16:42.8495571Z,2014,506,47,375,286,0,44,0,220,0,0,459,131,3,458,0,0,1
62950,8776,2020-11-18T16:16:42.8495571Z,2015,452,42,315,228,0,47,0,224,0,0,410,137,2,401,0,1,2
62950,8777,2020-11-18T16:16:42.850558Z,2016,360,78,191,175,0,31,1,185,0,0,282,169,3,322,0,1,4
62950,8778,2020-11-18T16:16:42.850558Z,2017,407,114,319,203,0,48,2,204,0,0,293,88,2,354,0,0,3
62950,8779,2020-11-18T16:16:42.8515584Z,2018,495,149,404,239,0,54,2,256,0,0,346,91,2,438,1,0,1
62950,8780,2020-11-18T16:16:42.8515584Z,2019,568,168,455,279,0,67,1,289,0,0,400,113,3,495,2,0,3
62950,8781,2020-11-18T16:16:42.8515584Z,2020,420,132,365,217,0,60,8,203,0,0,288,55,3,357,1,0,0
41921,31829,2021-06-24T05:35:16.9509709Z,2021,204,73,189,94,0,4,0,110,0,0,131,15,0,200,3,1,0
41921,5077,2020-11-18T16:16:17.1143949Z,2012,227,28,171,101,0,4,0,126,0,0,199,56,0,221,0,0,2
41921,5078,2020-11-18T16:16:17.1143949Z,2013,233,47,176,111,0,8,0,122,0,0,186,57,0,224,0,3,1
41921,5079,2020-11-18T16:16:17.1143949Z,2014,193,49,150,88,0,4,0,105,0,0,144,43,0,189,0,1,0
41921,5080,2020-11-18T16:16:17.1143949Z,2015,178,44,134,77,0,9,0,101,0,0,134,44,0,169,0,1,0
41921,5081,2020-11-18T16:16:17.1143949Z,2016,171,47,127,77,0,10,3,94,0,0,124,44,0,161,0,0,0
41921,5082,2020-11-18T16:16:17.1153958Z,2017,233,89,185,99,0,4,2,134,0,0,144,48,0,229,0,0,0
41921,5083,2020-11-18T16:16:17.1153958Z,2018,241,87,193,98,0,2,4,143,0,0,154,48,0,239,1,0,0
41921,5084,2020-11-18T16:16:17.1153958Z,2019,241,85,210,109,0,5,0,132,0,0,156,31,0,236,3,0,0
41921,5085,2020-11-18T16:16:17.1153958Z,2020,224,79,193,105,0,4,0,119,0,0,145,31,0,220,3,0,0
28365,3125,2020-11-18T16:16:05.3305395Z,2012,448,126,312,229,0,6,0,219,0,0,322,136,0,442,0,0,0
28365,3126,2020-11-18T16:16:05.3305395Z,2013,452,139,327,221,0,5,0,231,0,0,313,125,0,447,0,0,0
28365,3127,2020-11-18T16:16:05.3305395Z,2014,434,138,284,212,0,10,0,222,0,0,296,150,0,424,0,1,0
28365,3128,2020-11-18T16:16:05.3315409Z,2015,430,143,328,201,0,8,0,229,0,0,287,102,0,421,0,0,1
28365,3129,2020-11-18T16:16:05.3315409Z,2016,406,140,153,200,0,7,0,206,0,0,266,253,0,399,0,0,0
28365,3130,2020-11-18T16:16:05.3315409Z,2017,378,137,323,186,0,5,0,192,0,0,241,55,0,373,0,1,0
28365,3131,2020-11-18T16:16:05.3315409Z,2018,368,136,294,178,0,7,0,190,0,0,232,74,0,361,0,0,0
28365,3132,2020-11-18T16:16:05.3315409Z,2019,340,139,265,164,1,7,26,176,0,0,201,75,0,333,0,0,0
28365,3133,2020-11-18T16:16:05.3325409Z,2020,307,105,243,138,0,1,0,169,0,0,202,64,0,306,0,0,0
28365,31739,2021-06-24T05:35:15.4098672Z,2021,301,86,261,141,0,3,2,160,0,0,215,40,0,298,0,0,0
65995,25981,2021-06-24T05:35:14.5032153Z,2021,285,72,242,154,0,21,0,131,0,0,213,43,0,264,0,0,0
65995,9123,2020-11-18T16:16:45.4933185Z,2012,469,50,308,224,0,9,0,245,0,0,419,161,1,456,0,0,3
65995,9124,2020-11-18T16:16:45.4933185Z,2013,498,69,353,241,0,8,0,257,0,0,429,145,2,487,0,0,1
65995,9125,2020-11-18T16:16:45.4933185Z,2014,510,86,362,240,0,10,0,270,0,0,424,148,3,497,0,1,0
65995,9126,2020-11-18T16:16:45.4933185Z,2015,500,92,355,257,0,16,0,243,0,0,408,145,1,483,0,1,0
65995,9127,2020-11-18T16:16:45.4943198Z,2016,490,112,316,251,0,23,0,239,0,0,378,174,1,466,0,0,0
65995,9128,2020-11-18T16:16:45.4943198Z,2017,478,117,326,222,0,27,0,256,0,0,361,152,1,450,0,1,0
65995,9129,2020-11-18T16:16:45.4943198Z,2018,505,98,347,230,0,25,0,275,0,0,407,158,1,479,1,0,0
65995,9130,2020-11-18T16:16:45.4943198Z,2019,361,86,272,179,0,24,1,182,0,0,275,89,0,337,1,1,0
65995,9131,2020-11-18T16:16:45.4953203Z,2020,301,66,242,160,0,25,3,141,0,0,235,59,0,275,0,1,1
61515,25948,2021-06-24T05:35:12.8670427Z,2021,223,63,186,119,0,10,0,104,0,0,160,37,0,213,0,0,0
61515,8246,2020-11-18T16:16:39.0660319Z,2012,312,93,242,151,0,14,0,161,0,0,219,70,0,298,0,0,0
61515,8247,2020-11-18T16:16:39.0660319Z,2013,226,68,172,109,0,8,0,117,0,0,158,54,0,218,0,0,0
61515,8248,2020-11-18T16:16:39.0660319Z,2014,214,76,166,103,0,5,0,111,0,0,138,48,0,209,0,0,0
61515,8249,2020-11-18T16:16:39.0670328Z,2015,288,93,226,134,0,16,0,154,0,0,195,62,0,271,0,0,1
61515,8250,2020-11-18T16:16:39.0670328Z,2016,296,99,155,150,0,13,1,146,0,0,197,141,1,281,0,0,1
61515,8251,2020-11-18T16:16:39.0670328Z,2017,291,101,244,148,0,19,0,143,0,0,190,47,0,272,0,0,0
61515,8252,2020-11-18T16:16:39.0670328Z,2018,257,74,224,135,0,21,0,122,0,0,183,33,0,235,0,0,1
61515,8253,2020-11-18T16:16:39.0680337Z,2019,245,80,190,128,0,19,0,117,0,0,165,55,0,225,0,0,1
61515,8254,2020-11-18T16:16:39.0680337Z,2020,259,75,209,131,0,16,0,128,0,0,184,50,0,241,0,0,2
62877,31967,2021-06-24T05:35:20.2733537Z,2021,254,110,242,122,0,26,1,132,0,0,144,12,0,228,0,0,0
62877,8708,2020-11-18T16:16:42.8275425Z,2012,270,3,219,141,0,37,0,129,0,0,267,51,0,233,0,0,0
62877,8709,2020-11-18T16:16:42.8275425Z,2013,278,7,243,148,0,23,0,130,0,0,271,35,0,255,0,0,0
62877,8710,2020-11-18T16:16:42.8285448Z,2014,253,19,219,134,0,24,0,119,0,0,234,34,0,229,0,0,0
62877,8711,2020-11-18T16:16:42.8285448Z,2015,277,62,249,119,0,9,0,158,0,0,215,28,0,267,0,0,1
62877,8712,2020-11-18T16:16:42.8285448Z,2016,228,48,175,115,0,18,0,113,0,0,180,53,0,210,0,0,0
62877,8713,2020-11-18T16:16:42.8295447Z,2017,243,70,217,111,0,13,0,132,0,0,173,26,0,230,0,0,0
62877,8714,2020-11-18T16:16:42.8295447Z,2018,298,76,261,138,0,19,1,160,0,0,222,37,0,279,0,0,0
62877,8715,2020-11-18T16:16:42.8295447Z,2019,291,57,259,147,0,30,2,144,0,0,234,32,1,260,0,0,0
62877,8716,2020-11-18T16:16:42.8295447Z,2020,253,103,234,118,0,28,2,135,0,0,150,19,0,225,0,0,0
20982,2010,2020-11-18T16:15:58.9102588Z,2012,591,0,365,266,0,1,0,325,0,0,591,226,0,590,0,0,0
20982,2011,2020-11-18T16:15:58.9102588Z,2013,655,0,453,286,0,3,0,369,0,0,655,202,0,652,0,1,0
20982,2012,2020-11-18T16:15:58.9102588Z,2014,678,51,480,283,0,6,0,395,0,0,627,198,0,671,0,0,1
20982,2013,2020-11-18T16:15:58.9102588Z,2015,649,41,457,278,0,7,0,371,0,0,608,192,0,641,0,0,1
20982,2014,2020-11-18T16:15:58.9112583Z,2016,649,92,438,290,0,8,3,359,0,0,557,211,0,641,0,0,0
20982,2015,2020-11-18T16:15:58.9112583Z,2017,748,108,504,352,0,9,0,396,0,0,640,244,0,738,0,0,1
20982,2016,2020-11-18T16:15:58.9112583Z,2018,763,107,523,374,0,11,27,389,0,0,656,240,0,751,0,0,1
20982,2017,2020-11-18T16:15:58.9112583Z,2019,729,119,514,372,0,8,8,357,0,0,610,215,0,720,0,3,1
20982,2018,2020-11-18T16:15:58.9112583Z,2020,749,173,510,406,0,5,7,343,0,0,576,239,0,744,1,2,0
20982,25702,2021-06-24T05:35:08.6640289Z,2021,802,181,599,423,0,4,2,379,0,0,621,203,0,798,3,4,0
63149,31975,2021-06-24T05:35:20.2823599Z,2021,249,118,240,123,0,8,1,126,0,0,131,9,0,240,0,0,1
63149,8899,2020-11-18T16:16:43.9252717Z,2012,299,42,294,153,0,5,0,146,0,0,257,5,0,294,0,0,0
63149,8900,2020-11-18T16:16:43.9262721Z,2013,275,62,261,145,0,8,0,130,0,0,213,14,0,266,0,1,1
63149,8901,2020-11-18T16:16:44.4356121Z,2014,228,63,211,125,0,8,0,103,0,0,165,17,0,219,0,0,1
63149,8902,2020-11-18T16:16:44.4366126Z,2015,195,60,181,104,0,6,0,91,0,0,135,14,0,189,0,1,0
63149,8903,2020-11-18T16:16:44.4366126Z,2016,206,84,127,108,0,3,0,98,0,0,122,79,0,203,0,0,0
63149,8904,2020-11-18T16:16:44.4366126Z,2017,201,86,194,106,0,4,0,95,0,0,115,7,0,197,0,0,0
63149,8905,2020-11-18T16:16:44.4366126Z,2018,190,73,181,95,0,2,1,95,0,0,117,9,0,188,0,0,0
63149,8906,2020-11-18T16:16:44.4366126Z,2019,193,69,182,99,0,4,2,94,0,0,124,11,0,189,0,0,0
63149,8907,2020-11-18T16:16:44.4376135Z,2020,243,100,226,120,0,13,1,123,0,0,143,17,0,230,1,0,0
70243,31646,2021-06-24T05:35:14.6653333Z,2021,417,188,372,193,0,10,0,224,0,0,229,45,0,407,0,0,0
70243,9554,2020-11-18T16:16:49.2137999Z,2012,504,194,405,238,0,7,0,266,0,0,310,99,1,496,0,0,0
70243,9555,2020-11-18T16:16:49.2137999Z,2013,454,186,387,213,0,5,0,241,0,0,268,67,0,449,0,7,0
70243,9556,2020-11-18T16:16:49.2137999Z,2014,406,178,337,189,0,4,0,217,0,0,228,69,0,402,0,6,0
70243,9557,2020-11-18T16:16:49.2137999Z,2015,396,178,334,167,0,8,0,229,0,0,218,62,0,387,0,15,1
70243,9558,2020-11-18T16:16:49.2148017Z,2016,334,157,110,138,0,7,0,196,0,0,177,224,0,325,0,10,2
70243,9559,2020-11-18T16:16:49.2148017Z,2017,411,198,364,174,0,10,0,237,0,0,213,47,0,399,0,7,2
70243,9560,2020-11-18T16:16:49.2148017Z,2018,444,196,378,195,0,5,2,249,0,0,248,66,0,439,0,3,0
70243,9561,2020-11-18T16:16:49.2148017Z,2019,414,216,365,193,0,9,0,221,0,0,198,49,0,405,0,1,0
70243,9562,2020-11-18T16:16:49.2148017Z,2020,395,192,351,184,0,9,28,211,0,0,203,44,0,386,0,0,0
71084,10047,2020-11-18T16:16:52.5800475Z,2012,398,61,303,187,0,3,0,211,0,0,337,95,1,389,0,0,5
71084,10048,2020-11-18T16:16:52.5800475Z,2013,381,98,306,176,0,2,0,205,0,0,283,75,1,377,0,1,1
71084,10049,2020-11-18T16:16:52.5800475Z,2014,388,123,313,179,0,2,0,209,0,0,265,75,0,386,0,3,0
71084,10050,2020-11-18T16:16:52.5810484Z,2015,378,107,298,186,0,4,0,192,0,0,271,80,0,374,0,3,0
71084,10051,2020-11-18T16:16:52.5810484Z,2016,337,122,258,146,0,5,6,191,0,0,215,79,0,332,0,0,0
71084,10052,2020-11-18T16:16:52.5810484Z,2017,354,133,282,168,0,2,20,186,0,0,221,72,0,352,0,1,0
71084,10053,2020-11-18T16:16:52.5810484Z,2018,359,137,305,178,0,7,12,181,0,0,222,54,0,350,0,0,2
71084,10054,2020-11-18T16:16:52.582048Z,2019,354,153,308,175,1,10,22,179,0,0,201,46,1,341,1,0,2
71084,10055,2020-11-18T16:16:52.582048Z,2020,306,144,272,140,0,4,7,166,0,0,162,34,1,299,0,0,2
71084,25618,2021-06-24T05:35:04.6471491Z,2021,276,125,234,130,0,2,0,146,0,0,151,42,0,273,0,0,1
17459,1378,2020-11-18T16:15:54.3242004Z,2012,392,135,322,190,0,13,0,202,0,0,257,70,0,379,0,0,0
17459,1379,2020-11-18T16:15:54.3252013Z,2013,406,142,337,204,0,17,0,202,0,0,264,69,1,388,0,1,0
17459,1380,2020-11-18T16:15:54.3252013Z,2014,362,131,302,173,0,18,0,189,0,0,231,60,0,344,0,1,0
17459,1381,2020-11-18T16:15:54.3252013Z,2015,347,134,298,168,0,15,0,179,0,0,213,49,0,331,0,1,1
17459,1382,2020-11-18T16:15:54.3252013Z,2016,296,127,150,144,0,13,0,152,0,0,169,146,0,283,0,1,0
17459,1383,2020-11-18T16:15:54.3252013Z,2017,290,130,265,142,0,9,2,148,0,0,160,25,0,281,0,1,0
17459,1384,2020-11-18T16:15:54.3262013Z,2018,257,98,222,121,0,8,1,136,0,0,159,35,0,248,0,0,1
17459,1385,2020-11-18T16:15:54.3262013Z,2019,270,91,240,136,0,2,0,134,0,0,179,30,0,268,0,0,0
17459,1386,2020-11-18T16:15:54.3262013Z,2020,267,83,242,136,0,3,0,131,0,0,184,25,0,263,0,0,1
17459,25609,2021-06-24T05:35:04.6271343Z,2021,248,69,232,126,0,1,0,122,0,0,179,16,0,246,0,0,1
47571,25858,2021-06-24T05:35:10.9816913Z,2021,246,101,213,94,0,4,0,152,0,0,145,33,0,240,1,0,2
47571,5998,2020-11-18T16:16:23.5376777Z,2012,445,83,365,228,0,2,0,217,0,0,362,80,0,442,0,0,1
47571,5999,2020-11-18T16:16:23.5376777Z,2013,411,93,323,209,0,3,0,202,0,0,318,88,0,407,0,2,1
47571,6000,2020-11-18T16:16:23.5376777Z,2014,420,94,335,207,0,5,0,213,0,0,326,85,2,412,0,4,1
47571,6001,2020-11-18T16:16:23.9629615Z,2015,414,110,338,198,0,8,0,216,0,0,304,76,3,402,0,6,1
47571,6002,2020-11-18T16:16:23.9629615Z,2016,266,74,164,135,0,6,2,131,0,0,192,102,0,259,0,1,1
47571,6003,2020-11-18T16:16:23.963962Z,2017,272,101,226,130,0,8,0,142,0,0,171,46,0,264,0,3,0
47571,6004,2020-11-18T16:16:23.963962Z,2018,288,108,251,131,0,8,0,157,0,0,180,37,0,279,1,2,1
47571,6005,2020-11-18T16:16:23.963962Z,2019,293,122,253,130,0,5,1,163,0,0,171,40,0,288,1,1,0
47571,6006,2020-11-18T16:16:23.963962Z,2020,253,101,215,105,0,6,0,148,0,0,152,38,0,247,1,0,0
64949,31978,2021-06-24T05:35:20.2833609Z,2021,248,73,224,125,0,8,1,123,0,0,175,24,1,239,0,0,0
64949,8987,2020-11-18T16:16:44.4896478Z,2012,339,109,293,161,0,0,0,178,0,0,230,46,0,339,0,0,0
64949,8988,2020-11-18T16:16:44.4896478Z,2013,341,108,285,175,0,1,0,166,0,0,233,56,0,340,0,3,0
64949,8989,2020-11-18T16:16:44.4896478Z,2014,309,108,275,151,0,2,0,158,0,0,201,34,0,307,0,0,0
64949,8990,2020-11-18T16:16:44.4896478Z,2015,303,100,266,160,0,5,0,143,0,0,203,37,0,298,0,0,0
64949,8991,2020-11-18T16:16:44.4896478Z,2016,221,77,194,117,0,4,0,104,0,0,144,27,0,217,0,0,0
64949,8992,2020-11-18T16:16:44.4906491Z,2017,211,71,187,107,0,3,0,104,0,0,140,24,0,208,0,1,0
64949,8993,2020-11-18T16:16:44.4906491Z,2018,333,94,310,176,0,8,3,157,0,0,239,23,0,325,0,1,0
64949,8994,2020-11-18T16:16:44.4906491Z,2019,265,88,250,137,2,9,2,128,0,0,177,15,0,256,0,1,0
64949,8995,2020-11-18T16:16:44.4906491Z,2020,274,83,246,139,0,9,0,135,0,0,191,28,0,263,0,1,2
36327,31807,2021-06-24T05:35:16.8959321Z,2021,299,103,247,146,0,4,1,153,0,0,196,52,0,295,0,0,0
36327,4533,2020-11-18T16:16:13.1907784Z,2012,398,106,304,183,0,1,0,215,0,0,292,94,1,396,0,0,0
36327,4534,2020-11-18T16:16:13.1907784Z,2013,397,124,289,175,0,3,0,222,0,0,273,108,1,393,0,2,0
36327,4535,2020-11-18T16:16:13.1907784Z,2014,376,120,239,175,0,4,0,201,0,0,256,137,0,372,0,1,0
36327,4536,2020-11-18T16:16:13.1907784Z,2015,339,110,263,152,0,6,0,187,0,0,229,76,0,331,0,1,2
36327,4537,2020-11-18T16:16:13.1917788Z,2016,313,98,245,152,0,5,1,161,0,0,215,68,0,306,0,0,2
36327,4538,2020-11-18T16:16:13.1917788Z,2017,360,112,277,182,0,6,0,178,0,0,248,83,0,352,0,1,2
36327,4539,2020-11-18T16:16:13.1917788Z,2018,393,122,309,178,0,8,0,215,0,0,271,84,0,385,0,0,0
36327,4540,2020-11-18T16:16:13.1917788Z,2019,371,125,300,185,0,8,1,186,0,0,246,71,0,363,0,2,0
36327,4541,2020-11-18T16:16:13.1927793Z,2020,358,112,283,175,0,7,0,183,0,0,246,75,0,351,0,0,0
52571,25896,2021-06-24T05:35:12.7899877Z,2021,245,93,238,114,0,6,4,131,0,0,152,7,0,236,0,0,3
52571,6908,2020-11-18T16:16:30.8695689Z,2012,239,78,232,118,0,0,0,121,0,0,161,7,0,239,0,0,0
52571,6909,2020-11-18T16:16:30.8695689Z,2013,221,82,219,109,0,0,0,112,0,0,139,2,0,220,0,2,1
52571,6910,2020-11-18T16:16:30.8705694Z,2014,225,88,219,107,0,1,0,118,0,0,137,6,0,224,0,1,0
52571,6911,2020-11-18T16:16:30.8705694Z,2015,229,88,224,105,0,5,0,124,0,0,141,5,0,224,0,5,0
52571,6912,2020-11-18T16:16:30.8705694Z,2016,252,99,165,115,0,5,3,137,0,0,153,87,0,247,0,5,0
52571,6913,2020-11-18T16:16:30.8715703Z,2017,217,106,213,93,0,3,1,124,0,0,111,4,0,214,0,3,0
52571,6914,2020-11-18T16:16:30.8715703Z,2018,287,118,283,138,0,8,2,149,0,0,169,4,0,278,0,0,1
52571,6915,2020-11-18T16:16:30.8715703Z,2019,406,158,376,190,0,10,3,216,0,0,248,30,0,393,0,0,3
52571,6916,2020-11-18T16:16:30.8725707Z,2020,362,141,337,175,0,9,0,187,0,0,221,25,0,350,0,0,3
50609,25876,2021-06-24T05:35:11.0577449Z,2021,254,98,198,114,0,0,0,140,0,0,156,56,0,254,0,4,0
50609,6259,2020-11-18T16:16:25.5119963Z,2012,403,99,313,190,0,0,0,213,0,0,304,90,0,403,0,0,0
50609,6260,2020-11-18T16:16:25.5119963Z,2013,375,105,300,168,0,0,0,207,0,0,270,75,1,374,0,3,0
50609,6261,2020-11-18T16:16:25.5119963Z,2014,330,102,237,145,0,0,0,185,0,0,228,93,0,330,0,3,0
50609,6262,2020-11-18T16:16:25.5119963Z,2015,333,105,250,144,0,0,0,189,0,0,228,83,0,333,0,4,0
50609,6263,2020-11-18T16:16:25.5129967Z,2016,339,121,188,146,0,2,3,193,0,0,218,151,0,336,0,2,1
50609,6264,2020-11-18T16:16:25.5129967Z,2017,313,123,246,140,0,5,0,173,0,0,190,67,0,307,0,3,1
50609,6265,2020-11-18T16:16:25.5129967Z,2018,310,107,243,140,1,8,0,170,0,0,203,67,0,302,0,4,0
50609,6266,2020-11-18T16:16:25.5129967Z,2019,273,122,201,118,0,0,1,155,0,0,151,72,0,273,0,3,0
50609,6267,2020-11-18T16:16:25.5129967Z,2020,249,103,186,103,0,0,1,146,0,0,146,63,0,249,0,3,0
20990,2019,2020-11-18T16:15:58.9112583Z,2012,478,155,388,239,0,3,0,239,0,0,323,90,0,474,0,0,1
20990,2020,2020-11-18T16:15:58.9112583Z,2013,465,168,386,221,0,4,0,244,0,0,297,79,0,461,0,2,0
20990,2021,2020-11-18T16:15:58.9112583Z,2014,416,156,336,188,0,5,0,228,0,0,260,80,0,411,0,1,0
20990,2022,2020-11-18T16:15:58.9112583Z,2015,423,156,341,189,0,6,0,234,0,0,267,82,0,417,0,1,0
20990,2023,2020-11-18T16:15:58.9112583Z,2016,407,167,322,184,0,6,2,223,0,0,240,85,0,401,0,0,0
20990,2024,2020-11-18T16:15:58.9122588Z,2017,384,143,301,182,0,2,0,202,0,0,241,83,0,382,0,0,0
20990,2025,2020-11-18T16:15:58.9122588Z,2018,403,153,323,184,0,2,0,219,0,0,250,80,0,401,0,0,0
20990,2026,2020-11-18T16:15:58.9122588Z,2019,373,166,264,162,0,1,0,211,0,0,207,109,0,372,0,0,0
20990,2027,2020-11-18T16:15:58.9122588Z,2020,353,150,259,151,0,3,0,202,0,0,203,94,0,350,0,0,0
20990,31704,2021-06-24T05:35:15.3378151Z,2021,300,123,253,131,0,4,4,169,0,0,177,47,0,296,0,0,0
32532,31777,2021-06-24T05:35:16.8549029Z,2021,136,51,114,62,0,1,5,74,0,0,85,22,1,134,0,1,0
32532,3903,2020-11-18T16:16:09.8685658Z,2012,315,35,242,136,0,0,0,179,0,0,280,73,0,315,0,0,0
32532,3904,2020-11-18T16:16:09.8695663Z,2013,283,50,212,140,0,0,0,143,0,0,233,71,0,283,0,3,0
32532,3905,2020-11-18T16:16:09.8695663Z,2014,299,61,243,157,0,2,0,142,0,0,238,56,0,297,0,2,0
32532,3906,2020-11-18T16:16:09.8705676Z,2015,316,66,253,175,0,2,0,141,0,0,250,63,0,314,0,0,0
32532,3907,2020-11-18T16:16:09.8705676Z,2016,297,83,218,152,0,4,1,145,0,0,214,79,0,293,0,1,0
32532,3908,2020-11-18T16:16:09.8715672Z,2017,270,67,222,133,0,3,2,137,0,0,203,48,0,267,0,0,0
32532,3909,2020-11-18T16:16:09.8715672Z,2018,252,66,199,126,0,1,0,126,0,0,186,53,1,250,0,1,0
32532,3910,2020-11-18T16:16:09.8715672Z,2019,244,84,196,121,0,1,0,123,0,0,160,48,0,243,0,1,0
32532,3911,2020-11-18T16:16:09.8725681Z,2020,198,73,159,104,0,2,0,94,0,0,125,39,1,195,0,1,0
71308,10143,2020-11-18T16:16:53.2825154Z,2012,209,68,156,90,0,0,0,119,0,0,141,53,0,209,0,0,0
71308,10144,2020-11-18T16:16:53.2825154Z,2013,207,65,146,99,0,3,0,108,0,0,142,61,0,204,0,0,0
71308,10145,2020-11-18T16:16:53.2825154Z,2014,200,63,146,90,0,1,0,110,0,0,137,54,2,197,0,0,0
71308,10146,2020-11-18T16:16:53.2825154Z,2015,187,54,126,80,0,0,0,107,0,0,133,61,0,186,0,0,1
71308,10147,2020-11-18T16:16:53.2835177Z,2016,135,38,100,63,0,0,0,72,0,0,97,35,0,134,0,0,1
71308,10148,2020-11-18T16:16:53.2835177Z,2017,142,33,106,83,0,0,0,59,0,0,109,36,0,142,0,0,0
71308,10149,2020-11-18T16:16:53.2835177Z,2018,165,41,123,89,0,2,1,76,0,0,124,42,0,163,4,0,0
71308,10150,2020-11-18T16:16:53.2845172Z,2019,209,71,160,112,0,1,4,97,0,0,138,49,0,208,6,0,0
71308,10151,2020-11-18T16:16:53.2845172Z,2020,195,64,150,101,0,0,11,94,0,0,131,45,0,195,7,0,0
71308,25666,2021-06-24T05:35:04.7332103Z,2021,173,56,146,90,0,0,7,83,0,0,117,27,0,173,2,0,0
34769,25790,2021-06-24T05:35:10.8716128Z,2021,204,73,181,94,0,0,0,110,0,0,131,23,0,204,0,0,0
34769,4230,2020-11-18T16:16:11.4416162Z,2012,289,74,206,134,0,10,0,155,0,0,215,83,2,276,0,0,1
34769,4231,2020-11-18T16:16:11.4416162Z,2013,291,79,179,136,0,10,0,155,0,0,212,112,1,279,0,2,1
34769,4232,2020-11-18T16:16:11.4416162Z,2014,279,71,172,134,0,9,0,145,0,0,208,107,2,267,0,3,1
34769,4233,2020-11-18T16:16:11.4416162Z,2015,294,72,193,142,0,13,0,152,0,0,222,101,1,278,0,9,2
34769,4234,2020-11-18T16:16:11.4426171Z,2016,285,77,77,130,0,14,0,155,0,0,208,208,1,266,0,4,4
34769,4235,2020-11-18T16:16:11.4426171Z,2017,254,67,213,117,0,12,0,137,0,0,187,41,1,238,0,1,3
34769,4236,2020-11-18T16:16:11.4426171Z,2018,217,56,149,100,0,5,2,117,0,0,161,68,0,210,0,0,2
34769,4237,2020-11-18T16:16:11.4426171Z,2019,226,68,190,99,0,3,0,127,0,2,158,36,0,222,0,0,1
34769,4238,2020-11-18T16:16:11.4426171Z,2020,236,79,196,110,0,2,1,126,0,0,157,40,0,233,0,0,1
75739,10830,2020-11-18T16:16:57.4012614Z,2012,418,27,358,213,0,12,0,205,0,0,391,60,9,392,0,0,5
75739,10831,2020-11-18T16:16:57.4022628Z,2013,366,50,327,188,0,10,0,178,0,0,316,39,7,341,0,6,8
75739,10832,2020-11-18T16:16:57.4022628Z,2014,346,76,314,158,0,8,0,188,0,0,270,32,6,324,0,4,8
75739,10833,2020-11-18T16:16:57.4022628Z,2015,355,77,321,169,0,14,0,186,0,0,278,34,3,332,0,4,6
75739,10834,2020-11-18T16:16:57.4032628Z,2016,341,87,5,155,0,17,1,186,0,0,254,336,1,318,0,2,5
75739,10835,2020-11-18T16:16:57.4032628Z,2017,310,73,266,138,0,11,0,172,0,0,237,44,0,294,0,1,5
75739,10836,2020-11-18T16:16:57.4032628Z,2018,378,98,322,173,0,13,0,205,0,0,280,56,0,361,1,1,4
75739,10837,2020-11-18T16:16:57.4032628Z,2019,353,94,316,146,0,11,0,207,0,0,259,37,0,342,1,2,0
75739,10838,2020-11-18T16:16:57.4042628Z,2020,290,91,255,121,0,7,0,169,0,0,199,35,0,283,1,1,0
75739,25995,2021-06-24T05:35:14.5142243Z,2021,285,98,254,115,0,7,3,170,0,0,187,31,0,278,0,0,0
41566,31826,2021-06-24T05:35:16.9289556Z,2021,178,55,161,82,0,2,0,96,0,0,123,17,0,176,0,0,0
41566,5004,2020-11-18T16:16:17.0913804Z,2012,167,51,149,81,0,0,0,86,0,0,116,18,0,167,0,0,0
41566,5005,2020-11-18T16:16:17.0913804Z,2013,158,48,121,79,0,0,0,79,0,0,110,37,0,158,0,1,0
41566,5006,2020-11-18T16:16:17.0923804Z,2014,150,37,123,76,0,1,0,74,0,0,113,27,0,149,0,1,0
41566,5007,2020-11-18T16:16:17.0923804Z,2015,134,39,110,58,0,1,0,76,0,0,95,24,0,133,0,0,0
41566,5008,2020-11-18T16:16:17.0923804Z,2016,127,39,94,63,0,1,0,64,0,0,88,33,0,125,0,0,1
41566,5009,2020-11-18T16:16:17.0923804Z,2017,154,42,139,78,0,1,0,76,0,0,112,15,0,152,0,1,1
41566,5010,2020-11-18T16:16:17.0923804Z,2018,118,37,100,57,0,0,0,61,0,0,81,18,0,118,0,0,0
41566,5011,2020-11-18T16:16:17.0933821Z,2019,200,71,170,91,0,0,0,109,0,0,129,30,1,198,0,0,1
41566,5012,2020-11-18T16:16:17.0933821Z,2020,182,58,160,85,0,0,21,97,0,0,124,22,0,182,0,0,0
78857,11038,2020-11-18T16:16:58.5160061Z,2012,681,10,432,358,0,2,0,323,0,0,671,249,0,679,0,0,0
78857,11039,2020-11-18T16:16:58.5170065Z,2013,699,11,457,364,0,4,0,335,0,0,688,242,0,695,0,0,0
78857,11040,2020-11-18T16:16:58.5170065Z,2014,762,50,493,410,0,7,0,352,0,0,712,269,0,755,0,0,0
78857,11041,2020-11-18T16:16:58.5170065Z,2015,783,50,514,408,0,6,0,375,0,0,733,269,0,777,0,0,0
78857,11042,2020-11-18T16:16:58.5170065Z,2016,767,75,479,394,0,5,0,373,0,0,692,288,0,762,0,0,0
78857,11043,2020-11-18T16:16:58.5170065Z,2017,765,103,488,372,0,2,0,393,0,0,662,277,0,762,0,0,1
78857,11044,2020-11-18T16:16:58.5180065Z,2018,711,87,460,354,0,3,26,357,0,0,624,251,0,707,10,0,1
78857,11045,2020-11-18T16:16:58.5180065Z,2019,771,143,522,386,0,7,5,385,0,0,628,249,0,763,19,0,1
78857,11046,2020-11-18T16:16:58.5180065Z,2020,848,170,578,436,0,11,12,412,0,0,678,270,0,836,29,0,1
78857,31686,2021-06-24T05:35:15.2937831Z,2021,860,173,644,442,0,12,0,418,0,0,687,216,0,847,22,0,1
33308,25782,2021-06-24T05:35:10.8596037Z,2021,220,81,200,105,0,13,0,115,0,0,139,20,0,207,0,1,0
33308,4058,2020-11-18T16:16:10.3008542Z,2012,275,80,233,131,0,13,0,144,0,0,195,42,0,262,0,0,0
33308,4059,2020-11-18T16:16:10.3018564Z,2013,319,114,279,140,0,14,0,179,0,0,205,40,0,304,0,0,1
33308,4060,2020-11-18T16:16:10.3018564Z,2014,298,96,265,131,0,8,0,167,0,0,202,33,0,290,0,1,0
33308,4061,2020-11-18T16:16:10.3018564Z,2015,296,105,270,136,0,15,0,160,0,0,191,26,0,281,0,13,0
33308,4062,2020-11-18T16:16:10.3018564Z,2016,265,100,248,118,0,17,18,147,0,0,165,17,0,248,0,9,0
33308,4063,2020-11-18T16:16:10.3028555Z,2017,255,105,231,116,0,14,16,139,0,0,150,24,0,241,0,4,0
33308,4064,2020-11-18T16:16:10.3028555Z,2018,286,104,261,127,0,12,3,159,0,0,182,25,0,274,1,2,0
33308,4065,2020-11-18T16:16:10.3028555Z,2019,286,113,266,147,0,11,11,139,0,0,173,20,0,275,0,1,0
33308,4066,2020-11-18T16:16:10.3038564Z,2020,272,99,254,134,0,12,0,138,0,0,173,18,0,260,0,1,0
27557,25734,2021-06-24T05:35:08.6850442Z,2021,677,186,513,347,0,6,1,330,0,0,491,164,0,671,1,0,0
27557,3047,2020-11-18T16:16:04.7631607Z,2012,630,0,359,333,0,3,0,297,0,0,630,271,0,627,0,0,0
27557,3048,2020-11-18T16:16:04.7631607Z,2013,666,1,427,344,0,3,0,322,0,0,665,239,0,663,0,0,0
27557,3049,2020-11-18T16:16:04.7641612Z,2014,696,39,462,364,0,1,0,332,0,0,657,234,0,694,0,1,1
27557,3050,2020-11-18T16:16:04.7641612Z,2015,707,35,454,357,0,0,0,350,0,0,672,253,0,706,0,2,1
27557,3051,2020-11-18T16:16:04.7641612Z,2016,714,89,97,362,0,3,1,352,0,0,625,617,0,710,0,3,1
27557,3052,2020-11-18T16:16:04.7641612Z,2017,816,110,531,412,0,3,1,404,0,0,706,285,0,813,0,1,0
27557,3053,2020-11-18T16:16:04.7641612Z,2018,750,103,477,399,0,5,1,351,0,0,647,273,0,745,0,0,0
27557,3054,2020-11-18T16:16:04.765163Z,2019,678,132,467,366,0,5,11,312,0,0,546,211,0,673,0,0,0
27557,3055,2020-11-18T16:16:04.765163Z,2020,693,175,495,364,0,5,18,329,0,0,518,198,0,688,1,0,0
51656,25885,2021-06-24T05:35:12.7799814Z,2021,423,160,354,205,0,8,6,218,0,0,263,69,1,411,3,3,3
51656,6543,2020-11-18T16:16:27.8025199Z,2012,303,82,232,137,0,3,0,166,0,0,221,71,0,300,0,0,0
51656,6544,2020-11-18T16:16:27.8025199Z,2013,333,94,244,148,0,6,0,185,0,0,239,89,2,325,0,5,0
51656,6545,2020-11-18T16:16:27.8025199Z,2014,332,110,240,163,0,6,0,169,0,0,222,92,3,323,0,2,0
51656,6546,2020-11-18T16:16:27.8035204Z,2015,347,114,249,167,0,7,0,180,0,0,233,98,5,334,0,7,1
51656,6547,2020-11-18T16:16:27.8035204Z,2016,337,132,172,159,0,11,7,178,0,0,205,165,3,322,0,2,1
51656,6548,2020-11-18T16:16:27.8035204Z,2017,355,137,255,162,0,14,11,193,0,0,218,100,1,339,0,0,1
51656,6549,2020-11-18T16:16:27.8035204Z,2018,329,120,246,158,0,18,0,171,0,0,209,83,0,310,0,3,1
51656,6550,2020-11-18T16:16:27.8035204Z,2019,447,183,332,226,0,13,6,221,0,0,264,115,0,433,3,3,1
51656,6551,2020-11-18T16:16:27.8045212Z,2020,441,179,322,210,0,8,10,231,0,0,262,119,0,431,4,3,2
62174,25957,2021-06-24T05:35:12.8820533Z,2021,274,69,205,138,0,4,0,136,0,0,205,69,0,270,1,0,0
62174,8457,2020-11-18T16:16:40.218802Z,2012,406,54,238,203,0,3,0,203,0,0,352,168,1,402,0,0,0
62174,8458,2020-11-18T16:16:40.218802Z,2013,390,65,254,198,0,3,0,192,0,0,325,136,2,385,0,0,0
62174,8459,2020-11-18T16:16:40.218802Z,2014,413,71,273,210,0,4,0,203,0,0,342,140,3,406,0,0,0
62174,8460,2020-11-18T16:16:40.218802Z,2015,427,75,293,218,0,5,0,209,0,0,352,134,2,420,0,0,0
62174,8461,2020-11-18T16:16:40.218802Z,2016,411,94,223,203,0,3,0,208,0,0,317,188,0,408,0,0,0
62174,8462,2020-11-18T16:16:40.218802Z,2017,388,78,230,188,0,5,0,200,0,0,310,158,0,383,0,0,0
62174,8463,2020-11-18T16:16:40.2198024Z,2018,365,62,199,186,0,5,0,179,0,0,303,166,0,360,0,0,0
62174,8464,2020-11-18T16:16:40.2198024Z,2019,315,66,197,159,0,4,0,156,0,0,249,118,1,310,0,0,0
62174,8465,2020-11-18T16:16:40.2198024Z,2020,292,53,197,162,0,1,1,130,0,0,239,95,0,291,1,0,0
51797,25887,2021-06-24T05:35:12.7809828Z,2021,235,79,202,127,0,3,0,108,0,0,156,33,1,231,0,0,0
51797,6592,2020-11-18T16:16:27.8395453Z,2012,341,70,269,177,0,10,0,164,0,0,271,72,0,331,0,0,0
51797,6593,2020-11-18T16:16:27.8395453Z,2013,340,86,289,185,0,9,0,155,0,0,254,51,0,331,0,0,0
51797,6594,2020-11-18T16:16:27.8395453Z,2014,308,79,267,166,0,10,0,142,0,0,229,41,0,298,0,1,0
51797,6595,2020-11-18T16:16:27.8395453Z,2015,296,69,258,157,0,9,0,139,0,0,227,38,0,287,0,1,0
51797,6596,2020-11-18T16:16:27.8395453Z,2016,250,74,198,132,0,8,0,118,0,0,176,52,0,242,0,0,0
51797,6597,2020-11-18T16:16:27.8405453Z,2017,204,61,166,115,0,5,0,89,0,0,143,38,0,199,0,0,0
51797,6598,2020-11-18T16:16:27.8405453Z,2018,185,50,148,106,0,5,17,79,0,0,135,37,0,180,0,0,0
51797,6599,2020-11-18T16:16:27.8405453Z,2019,146,42,117,83,0,3,0,63,0,0,104,29,0,143,1,0,0
51797,6600,2020-11-18T16:16:27.8405453Z,2020,142,42,111,81,0,2,0,61,0,0,100,31,0,139,1,0,1
71340,10171,2020-11-18T16:16:53.2915226Z,2012,424,98,311,228,0,0,0,196,0,0,326,113,0,423,0,0,1
71340,10172,2020-11-18T16:16:53.2915226Z,2013,345,84,249,179,0,0,0,166,0,0,261,96,0,344,0,1,1
71340,10173,2020-11-18T16:16:53.2915226Z,2014,364,100,242,192,0,1,0,172,0,0,264,122,0,363,0,1,0
71340,10174,2020-11-18T16:16:53.2925221Z,2015,348,90,277,185,0,0,0,163,0,0,258,71,0,347,0,1,1
71340,10175,2020-11-18T16:16:53.2925221Z,2016,308,78,166,155,0,0,0,153,0,0,230,142,0,308,0,0,0
71340,10176,2020-11-18T16:16:53.2925221Z,2017,301,85,256,147,0,0,0,154,0,0,216,45,0,301,0,1,0
71340,10177,2020-11-18T16:16:53.2925221Z,2018,294,91,249,141,0,1,0,153,0,0,203,45,0,293,12,1,0
71340,10178,2020-11-18T16:16:53.2925221Z,2019,316,113,275,151,0,2,8,165,0,0,203,41,0,314,15,0,0
71340,10179,2020-11-18T16:16:53.2935239Z,2020,329,118,288,159,0,3,9,170,0,0,211,41,0,326,13,0,0
71340,31668,2021-06-24T05:35:15.2497519Z,2021,313,104,285,158,0,4,0,155,0,0,209,28,0,309,11,0,0
34199,31787,2021-06-24T05:35:16.8619086Z,2021,371,94,323,175,0,8,0,196,0,0,277,48,1,356,6,5,6
34199,4137,2020-11-18T16:16:11.0223368Z,2012,548,66,368,275,0,10,0,273,0,0,482,180,5,533,0,0,0
34199,4138,2020-11-18T16:16:11.0223368Z,2013,496,79,338,256,0,7,0,240,0,0,417,158,4,485,0,1,0
34199,4139,2020-11-18T16:16:11.0223368Z,2014,460,85,293,229,0,7,0,231,0,0,375,167,4,449,0,0,0
34199,4140,2020-11-18T16:16:11.0233363Z,2015,512,98,368,245,0,6,0,267,0,0,414,144,6,500,0,3,0
34199,4141,2020-11-18T16:16:11.0233363Z,2016,447,92,214,221,0,8,0,226,0,0,355,233,5,434,0,3,0
34199,4142,2020-11-18T16:16:11.0233363Z,2017,349,79,283,165,0,5,1,184,0,0,270,66,2,342,0,0,0
34199,4143,2020-11-18T16:16:11.0233363Z,2018,361,78,278,171,0,6,0,190,0,0,283,83,1,354,6,0,0
34199,4144,2020-11-18T16:16:11.0233363Z,2019,448,124,355,217,0,4,4,231,0,0,324,93,1,443,8,3,0
34199,4145,2020-11-18T16:16:11.0243372Z,2020,399,101,328,179,0,5,1,220,0,0,298,71,0,393,8,1,1
44891,25846,2021-06-24T05:35:10.9696822Z,2021,494,145,414,241,0,19,2,253,0,0,349,80,0,474,3,1,1
44891,5770,2020-11-18T16:16:22.1147296Z,2012,396,82,267,192,0,14,0,204,0,0,314,129,0,382,0,0,0
44891,5771,2020-11-18T16:16:22.1147296Z,2013,382,92,245,193,0,10,0,189,0,0,290,137,0,372,0,1,0
44891,5772,2020-11-18T16:16:22.1147296Z,2014,389,95,264,197,0,10,0,192,0,0,294,125,0,379,0,3,0
44891,5773,2020-11-18T16:16:22.1157305Z,2015,403,105,263,193,0,12,0,210,0,0,298,140,0,391,0,1,0
44891,5774,2020-11-18T16:16:22.1157305Z,2016,328,101,216,154,0,9,9,174,0,0,227,112,0,319,0,0,0
44891,5775,2020-11-18T16:16:22.1157305Z,2017,313,97,228,152,0,6,8,161,0,0,216,85,0,307,0,0,0
44891,5776,2020-11-18T16:16:22.1167309Z,2018,407,121,296,192,0,12,6,215,0,0,286,111,0,394,3,2,1
44891,5777,2020-11-18T16:16:22.1167309Z,2019,504,163,369,224,0,17,0,280,0,0,341,135,0,486,3,0,1
44891,5778,2020-11-18T16:16:22.1167309Z,2020,485,148,380,221,0,19,1,264,0,0,337,105,0,465,3,0,1
72090,10634,2020-11-18T16:16:56.1103991Z,2012,644,112,524,326,0,3,0,318,0,0,532,120,15,625,0,0,1
72090,10635,2020-11-18T16:16:56.1103991Z,2013,496,108,421,258,0,2,0,238,0,0,388,75,14,480,0,3,0
72090,10636,2020-11-18T16:16:56.1113991Z,2014,524,132,428,274,0,0,0,250,0,0,392,96,10,514,0,2,0
72090,10637,2020-11-18T16:16:56.1113991Z,2015,538,138,443,268,0,2,0,270,0,0,400,95,3,533,0,0,0
72090,10638,2020-11-18T16:16:56.1113991Z,2016,412,131,305,189,0,1,1,223,0,0,281,107,1,409,0,0,1
72090,10639,2020-11-18T16:16:56.1113991Z,2017,385,127,340,182,0,3,2,203,0,0,258,45,0,380,0,1,2
72090,10640,2020-11-18T16:16:56.1123996Z,2018,514,143,444,267,0,3,0,247,0,1,371,70,0,510,0,0,1
72090,10641,2020-11-18T16:16:56.1123996Z,2019,511,160,443,268,0,3,0,243,0,0,351,68,0,507,0,1,1
72090,10642,2020-11-18T16:16:56.1123996Z,2020,507,165,446,243,0,2,0,264,0,0,342,61,0,503,0,1,2
72090,31627,2021-06-24T05:35:14.6253033Z,2021,471,156,433,226,0,0,0,245,0,0,315,38,0,470,0,0,1
12724,25636,2021-06-24T05:35:04.6901797Z,2021,164,65,143,83,0,1,1,81,0,0,99,21,0,163,0,0,0
12724,827,2020-11-18T16:15:51.3312017Z,2012,262,66,209,114,0,11,0,148,0,0,196,53,0,251,0,0,0
12724,828,2020-11-18T16:15:51.3312017Z,2013,270,73,207,115,0,7,0,155,0,0,197,63,0,263,0,3,0
12724,829,2020-11-18T16:15:51.3322017Z,2014,257,73,186,107,0,5,0,150,0,0,184,71,0,252,0,0,0
12724,830,2020-11-18T16:15:51.3322017Z,2015,246,76,173,101,0,4,0,145,0,0,170,73,0,242,0,1,0
12724,831,2020-11-18T16:15:51.3322017Z,2016,197,76,147,85,0,4,0,112,0,0,121,50,0,193,0,0,0
12724,832,2020-11-18T16:15:51.3332017Z,2017,187,68,141,72,0,2,0,115,0,0,119,46,0,185,0,0,0
12724,833,2020-11-18T16:15:51.3332017Z,2018,198,74,159,80,0,2,0,118,0,0,124,39,0,196,4,0,0
12724,834,2020-11-18T16:15:51.3332017Z,2019,165,72,133,68,0,1,0,97,0,0,93,32,0,164,3,0,0
12724,835,2020-11-18T16:15:51.3332017Z,2020,161,67,129,74,0,0,0,87,0,0,94,32,0,161,2,0,0
32680,25777,2021-06-24T05:35:08.7510916Z,2021,544,126,429,263,0,6,0,281,0,0,418,115,0,538,4,0,0
32680,3941,2020-11-18T16:16:09.8825747Z,2012,546,60,452,290,0,3,0,256,0,0,486,94,1,538,0,0,4
32680,3942,2020-11-18T16:16:09.8825747Z,2013,550,91,453,286,0,7,0,264,0,0,459,97,0,538,0,7,5
32680,3943,2020-11-18T16:16:09.8835761Z,2014,525,103,411,272,0,4,0,253,0,0,422,114,0,516,0,6,5
32680,3944,2020-11-18T16:16:09.8835761Z,2015,521,98,405,260,0,7,0,261,0,0,423,116,0,510,0,5,4
32680,3945,2020-11-18T16:16:09.8835761Z,2016,473,96,336,242,0,6,1,231,0,0,377,137,0,467,0,1,0
32680,3946,2020-11-18T16:16:09.8845765Z,2017,341,82,249,167,0,3,0,174,0,0,259,92,0,338,0,0,0
32680,3947,2020-11-18T16:16:09.8845765Z,2018,357,78,267,178,0,6,0,179,0,0,279,90,0,351,1,0,0
32680,3948,2020-11-18T16:16:09.8845765Z,2019,547,131,407,277,0,3,1,270,0,0,416,140,0,544,3,0,0
32680,3949,2020-11-18T16:16:09.885577Z,2020,514,109,379,255,0,4,0,259,0,0,405,135,0,510,1,0,0
11932,31596,2021-06-24T05:35:14.556254Z,2021,401,152,348,172,0,6,20,229,0,0,249,53,1,394,9,0,0
11932,520,2020-11-18T16:15:49.6640928Z,2012,771,173,647,360,0,2,0,411,0,0,598,124,0,769,0,0,0
11932,521,2020-11-18T16:15:49.6650928Z,2013,726,193,620,332,0,1,0,394,0,0,533,106,0,725,0,15,0
11932,522,2020-11-18T16:15:49.6650928Z,2014,690,208,576,318,0,0,0,372,0,0,482,114,0,690,0,13,0
11932,523,2020-11-18T16:15:49.6650928Z,2015,619,187,516,298,0,2,0,321,0,0,432,103,0,617,0,10,0
11932,524,2020-11-18T16:15:49.6660942Z,2016,470,163,406,215,0,6,0,255,0,0,307,64,0,464,0,7,0
11932,525,2020-11-18T16:15:49.6660942Z,2017,413,133,342,192,0,4,0,221,0,0,280,71,0,409,0,1,0
11932,526,2020-11-18T16:15:49.6660942Z,2018,472,150,379,217,0,4,9,255,0,0,322,93,0,468,12,1,0
11932,527,2020-11-18T16:15:49.6670955Z,2019,438,173,362,194,0,5,12,244,0,0,265,76,0,433,14,3,0
11932,528,2020-11-18T16:15:49.6670955Z,2020,437,168,364,192,0,6,1,245,0,0,269,73,0,431,12,1,0
51458,31885,2021-06-24T05:35:18.457052Z,2021,154,37,127,74,0,1,4,80,0,0,117,27,0,152,1,1,1
51458,6492,2020-11-18T16:16:27.0570259Z,2012,352,73,299,154,0,0,0,198,0,0,279,53,0,352,0,0,0
51458,6493,2020-11-18T16:16:27.0570259Z,2013,295,67,251,122,0,0,0,173,0,0,228,44,0,295,0,6,0
51458,6494,2020-11-18T16:16:27.0570259Z,2014,273,72,225,118,0,0,0,155,0,0,201,48,0,273,0,0,0
51458,6495,2020-11-18T16:16:27.0580254Z,2015,270,75,238,115,0,0,0,155,0,0,195,32,1,269,0,0,0
51458,6496,2020-11-18T16:16:27.0580254Z,2016,241,64,183,104,0,0,9,137,0,0,177,58,1,240,0,0,0
51458,6497,2020-11-18T16:16:27.0580254Z,2017,190,54,165,78,0,0,5,112,0,0,136,25,0,190,0,0,0
51458,6498,2020-11-18T16:16:27.0580254Z,2018,201,50,162,88,0,0,30,113,0,0,151,39,0,201,4,0,0
51458,6499,2020-11-18T16:16:27.0580254Z,2019,172,50,144,80,0,0,9,92,0,0,122,28,0,172,2,1,0
51458,6500,2020-11-18T16:16:27.0590263Z,2020,172,48,144,72,0,3,1,100,0,0,124,28,0,168,1,1,1
41020,25823,2021-06-24T05:35:10.913642Z,2021,331,87,239,146,0,9,0,185,0,0,244,92,0,321,0,1,1
41020,4940,2020-11-18T16:16:16.6580939Z,2012,245,51,173,108,0,6,0,137,0,0,194,72,0,239,0,0,0
41020,4941,2020-11-18T16:16:16.6590938Z,2013,312,84,213,135,0,7,0,177,0,0,228,99,0,305,0,4,0
41020,4942,2020-11-18T16:16:16.6590938Z,2014,325,94,212,143,0,7,0,182,0,0,231,113,0,318,0,0,0
41020,4943,2020-11-18T16:16:16.6590938Z,2015,369,109,222,156,0,8,0,213,0,0,260,147,0,361,0,5,0
41020,4944,2020-11-18T16:16:16.6600943Z,2016,376,109,159,173,0,13,2,203,0,0,267,217,0,363,0,9,0
41020,4945,2020-11-18T16:16:16.6600943Z,2017,351,91,207,171,0,10,0,180,0,0,260,144,0,340,0,8,1
41020,4946,2020-11-18T16:16:16.6600943Z,2018,349,84,223,166,0,8,2,183,0,0,265,126,0,340,0,3,1
41020,4947,2020-11-18T16:16:16.6600943Z,2019,343,92,210,150,0,9,0,193,0,0,251,133,0,333,0,4,1
41020,4948,2020-11-18T16:16:16.6610952Z,2020,337,84,214,158,0,10,0,179,0,0,253,123,0,327,0,2,0
51441,25883,2021-06-24T05:35:12.77898Z,2021,188,60,152,84,0,4,0,104,0,0,128,36,0,184,0,0,0
51441,6483,2020-11-18T16:16:27.0570259Z,2012,266,40,240,126,0,1,0,140,0,0,226,26,0,265,0,0,0
51441,6484,2020-11-18T16:16:27.0580254Z,2013,231,44,187,116,0,0,0,115,0,0,187,44,0,231,0,2,0
51441,6485,2020-11-18T16:16:27.0580254Z,2014,260,57,219,130,0,0,0,130,0,0,203,41,0,260,0,1,0
51441,6486,2020-11-18T16:16:27.0580254Z,2015,238,61,201,119,0,0,0,119,0,0,177,37,0,238,0,5,0
51441,6487,2020-11-18T16:16:27.0580254Z,2016,246,66,215,122,0,1,1,124,0,0,180,31,0,245,0,2,0
51441,6488,2020-11-18T16:16:27.0580254Z,2017,267,65,239,125,0,6,1,142,0,0,202,28,0,261,0,2,0
51441,6489,2020-11-18T16:16:27.0590263Z,2018,292,74,244,131,0,3,21,161,0,0,218,48,0,289,4,1,0
51441,6490,2020-11-18T16:16:27.0590263Z,2019,248,83,194,114,0,3,36,134,0,0,165,54,1,244,0,0,0
51441,6491,2020-11-18T16:16:27.0590263Z,2020,219,71,175,101,0,3,15,118,0,0,148,44,1,215,0,0,0
32433,25774,2021-06-24T05:35:08.7470883Z,2021,223,52,180,112,0,4,2,111,0,0,171,43,0,219,0,0,0
32433,3862,2020-11-18T16:16:09.1871108Z,2012,321,49,264,151,0,0,0,170,0,0,272,57,0,321,0,0,0
32433,3863,2020-11-18T16:16:09.1871108Z,2013,283,56,230,128,0,1,0,155,0,0,227,53,0,282,0,0,0
32433,3864,2020-11-18T16:16:09.1881099Z,2014,266,63,208,124,0,2,0,142,0,0,203,58,0,264,0,0,0
32433,3865,2020-11-18T16:16:09.1881099Z,2015,283,55,222,136,0,4,0,147,0,0,228,61,0,279,0,0,0
32433,3866,2020-11-18T16:16:09.1881099Z,2016,256,55,192,125,0,3,0,131,0,0,201,64,1,251,0,1,1
32433,3867,2020-11-18T16:16:09.1881099Z,2017,217,49,181,108,0,2,0,109,0,0,168,36,0,215,0,0,0
32433,3868,2020-11-18T16:16:09.1881099Z,2018,220,44,184,101,0,6,1,119,0,0,176,36,0,214,0,0,0
32433,3869,2020-11-18T16:16:09.1881099Z,2019,222,48,191,116,0,4,2,106,0,0,174,31,0,218,0,0,0
32433,3870,2020-11-18T16:16:09.1891108Z,2020,215,49,189,115,0,5,0,100,0,0,166,26,0,210,0,0,0
17749,1432,2020-11-18T16:15:54.7584901Z,2012,712,158,529,331,0,2,0,381,0,0,554,183,0,710,0,0,0
17749,1433,2020-11-18T16:15:54.7594905Z,2013,807,246,564,377,0,5,0,430,0,0,561,243,1,800,0,2,1
17749,1434,2020-11-18T16:15:54.7594905Z,2014,736,266,548,336,0,7,0,400,0,0,470,188,1,727,0,1,1
17749,1435,2020-11-18T16:15:54.7594905Z,2015,784,276,624,365,0,5,0,419,0,0,508,160,1,777,0,4,1
17749,1436,2020-11-18T16:15:54.7594905Z,2016,752,280,568,359,0,3,0,393,0,0,472,184,1,747,0,7,1
17749,1437,2020-11-18T16:15:54.7594905Z,2017,706,284,587,325,0,5,1,381,0,0,422,119,1,699,0,7,1
17749,1438,2020-11-18T16:15:54.7604914Z,2018,529,212,424,248,0,6,0,281,0,0,317,105,0,522,0,1,1
17749,1439,2020-11-18T16:15:54.7604914Z,2019,675,266,501,327,0,5,2,348,0,0,409,174,0,669,1,3,1
17749,1440,2020-11-18T16:15:54.7604914Z,2020,688,263,559,338,0,4,0,350,0,0,425,129,0,681,0,2,3
17749,25611,2021-06-24T05:35:04.6321381Z,2021,595,226,491,293,0,3,0,302,0,0,369,104,1,584,0,0,7
20172,1618,2020-11-18T16:15:56.572696Z,2012,363,86,259,170,0,1,0,193,0,0,277,104,0,360,0,0,2
20172,1619,2020-11-18T16:15:56.572696Z,2013,370,109,277,175,0,3,0,195,0,0,261,93,0,364,0,2,3
20172,1620,2020-11-18T16:15:56.572696Z,2014,361,122,253,167,0,2,0,194,0,0,239,108,0,356,0,2,3
20172,1621,2020-11-18T16:15:56.572696Z,2015,343,117,258,155,0,2,0,188,0,0,226,85,0,338,0,3,3
20172,1622,2020-11-18T16:15:56.572696Z,2016,333,114,170,147,0,2,3,186,0,0,219,163,0,329,0,2,2
20172,1623,2020-11-18T16:15:56.5736968Z,2017,272,85,216,129,0,2,0,143,0,0,187,56,0,268,0,2,2
20172,1624,2020-11-18T16:15:56.5736968Z,2018,324,103,258,151,0,3,37,173,0,0,221,66,0,321,0,1,0
20172,1625,2020-11-18T16:15:56.5736968Z,2019,317,134,253,139,0,5,16,178,0,0,183,64,0,312,0,0,0
20172,1626,2020-11-18T16:15:56.5736968Z,2020,291,124,255,129,0,4,21,162,0,0,167,36,0,287,0,0,0
20172,25687,2021-06-24T05:35:08.6330074Z,2021,264,102,236,120,0,2,7,144,0,0,162,28,0,262,0,0,0
43729,31843,2021-06-24T05:35:16.9739881Z,2021,292,88,264,139,0,3,0,153,0,0,204,28,0,289,4,2,0
43729,5651,2020-11-18T16:16:21.1741046Z,2012,623,109,494,306,0,5,0,317,0,0,514,129,0,618,0,0,0
43729,5652,2020-11-18T16:16:21.1741046Z,2013,683,153,541,326,0,4,0,357,0,0,530,142,0,679,0,0,0
43729,5653,2020-11-18T16:16:21.1741046Z,2014,658,155,494,320,0,2,0,338,0,0,503,164,0,656,0,1,0
43729,5654,2020-11-18T16:16:21.1741046Z,2015,578,138,445,286,0,5,0,292,0,0,440,133,0,573,0,2,0
43729,5655,2020-11-18T16:16:21.175105Z,2016,541,138,414,247,0,3,0,294,0,0,403,127,0,538,0,0,0
43729,5656,2020-11-18T16:16:21.175105Z,2017,475,131,390,228,0,4,0,247,0,0,344,85,0,471,0,2,0
43729,5657,2020-11-18T16:16:21.175105Z,2018,361,89,298,177,0,2,3,184,0,0,272,63,0,359,4,0,0
43729,5658,2020-11-18T16:16:21.175105Z,2019,329,90,267,150,0,4,0,179,0,0,239,62,0,325,7,0,0
43729,5659,2020-11-18T16:16:21.175105Z,2020,303,85,259,144,0,2,0,159,0,0,218,44,0,301,7,1,0
48306,31866,2021-06-24T05:35:18.4350357Z,2021,270,94,246,135,0,2,1,135,0,0,176,24,0,266,0,0,2
48306,6122,2020-11-18T16:16:25.0727026Z,2012,670,146,538,345,0,20,0,325,0,0,524,132,1,643,0,0,6
48306,6123,2020-11-18T16:16:25.0727026Z,2013,573,156,460,293,0,15,0,280,0,0,417,113,1,553,0,3,4
48306,6124,2020-11-18T16:16:25.073704Z,2014,551,158,412,275,0,14,0,276,0,0,393,139,1,535,0,3,1
48306,6125,2020-11-18T16:16:25.073704Z,2015,476,144,395,241,0,10,0,235,0,0,332,81,0,464,0,3,2
48306,6126,2020-11-18T16:16:25.073704Z,2016,438,147,190,220,0,6,0,218,0,0,291,248,0,431,0,1,1
48306,6127,2020-11-18T16:16:25.073704Z,2017,374,140,308,184,0,3,1,190,0,0,234,66,0,369,0,0,2
48306,6128,2020-11-18T16:16:25.073704Z,2018,373,133,303,173,0,6,12,200,0,0,240,70,0,366,0,2,1
48306,6129,2020-11-18T16:16:25.0747044Z,2019,358,139,311,172,0,5,6,186,0,0,219,47,0,352,0,2,1
48306,6130,2020-11-18T16:16:25.0747044Z,2020,354,133,297,177,0,5,4,177,0,0,221,57,0,348,0,2,1
12518,25634,2021-06-24T05:35:04.6901797Z,2021,175,69,151,74,0,0,0,101,0,0,106,24,0,175,2,0,0
12518,756,2020-11-18T16:15:50.9059165Z,2012,243,29,167,120,0,9,0,123,0,0,214,76,0,234,0,0,0
12518,757,2020-11-18T16:15:50.9059165Z,2013,226,28,154,108,0,9,0,118,0,0,198,72,0,217,0,0,0
12518,758,2020-11-18T16:15:50.9059165Z,2014,212,29,154,94,0,5,0,118,0,0,183,58,0,207,0,1,0
12518,759,2020-11-18T16:15:50.906917Z,2015,196,31,145,83,0,2,0,113,0,0,165,51,0,194,0,0,0
12518,760,2020-11-18T16:15:50.906917Z,2016,201,42,151,90,0,0,0,111,0,0,159,50,0,201,0,0,0
12518,761,2020-11-18T16:15:50.906917Z,2017,190,41,145,86,0,0,0,104,0,0,149,45,0,190,0,0,0
12518,762,2020-11-18T16:15:50.906917Z,2018,195,44,144,85,0,0,1,110,0,0,151,51,0,195,2,0,0
12518,763,2020-11-18T16:15:50.906917Z,2019,186,59,142,84,0,0,0,102,0,0,127,44,0,186,2,0,0
12518,764,2020-11-18T16:15:50.9079183Z,2020,195,63,146,86,0,0,0,109,0,0,132,49,0,195,2,0,0
12716,31637,2021-06-24T05:35:14.6413148Z,2021,169,54,156,60,0,4,0,109,0,0,115,13,0,165,1,0,0
12716,818,2020-11-18T16:15:51.3291995Z,2012,268,74,220,115,0,7,0,153,0,0,194,48,1,258,0,0,2
12716,819,2020-11-18T16:15:51.3291995Z,2013,259,91,209,104,0,1,0,155,0,0,168,50,0,258,0,3,0
12716,820,2020-11-18T16:15:51.3302004Z,2014,250,91,191,103,0,2,0,147,0,0,159,59,2,246,0,3,0
12716,821,2020-11-18T16:15:51.3302004Z,2015,245,87,205,96,0,1,0,149,0,0,158,40,2,242,0,2,0
12716,822,2020-11-18T16:15:51.3302004Z,2016,218,78,167,85,0,2,0,133,0,0,140,51,0,216,0,0,0
12716,823,2020-11-18T16:15:51.3302004Z,2017,186,65,157,73,0,2,0,113,0,0,121,29,2,182,0,0,0
12716,824,2020-11-18T16:15:51.3302004Z,2018,166,60,136,73,0,0,0,93,0,0,106,30,0,166,4,0,0
12716,825,2020-11-18T16:15:51.3312017Z,2019,179,68,160,74,0,0,0,105,0,0,111,19,0,179,3,0,0
12716,826,2020-11-18T16:15:51.3312017Z,2020,189,67,162,72,0,4,0,117,0,0,122,27,0,185,2,0,0
70334,25647,2021-06-24T05:35:04.6981863Z,2021,183,66,159,87,0,6,6,96,0,0,117,24,0,177,0,0,0
70334,9611,2020-11-18T16:16:49.7081277Z,2012,397,104,314,192,0,6,0,205,0,0,293,83,0,390,0,0,1
70334,9612,2020-11-18T16:16:49.7091295Z,2013,378,106,293,180,0,9,0,198,0,0,272,85,0,369,0,4,0
70334,9613,2020-11-18T16:16:49.7091295Z,2014,363,119,291,176,0,8,0,187,0,0,244,72,0,355,0,3,0
70334,9614,2020-11-18T16:16:49.7091295Z,2015,343,118,263,158,0,11,0,185,0,0,225,80,0,332,0,4,0
70334,9615,2020-11-18T16:16:49.7091295Z,2016,266,89,185,127,0,6,4,139,0,0,177,81,0,260,0,1,0
70334,9616,2020-11-18T16:16:49.7101295Z,2017,248,97,201,111,0,7,5,137,0,0,151,47,0,241,0,2,0
70334,9617,2020-11-18T16:16:49.7101295Z,2018,218,83,167,96,0,8,10,122,0,0,135,51,0,210,0,0,0
70334,9618,2020-11-18T16:16:49.7101295Z,2019,225,94,182,114,0,6,16,111,0,0,131,43,0,218,0,0,1
70334,9619,2020-11-18T16:16:49.7111304Z,2020,220,76,183,114,0,5,11,106,0,0,144,37,0,215,0,0,0
22566,2449,2020-11-18T16:16:01.4319361Z,2012,445,74,316,218,0,1,0,227,0,0,371,129,1,443,0,0,0
22566,2450,2020-11-18T16:16:01.4319361Z,2013,403,84,270,204,0,2,0,199,0,0,319,133,1,398,0,2,2
22566,2451,2020-11-18T16:16:01.4319361Z,2014,400,82,297,199,0,3,0,201,0,0,318,103,1,395,0,2,1
22566,2452,2020-11-18T16:16:01.4329374Z,2015,357,72,267,177,0,4,0,180,0,0,285,90,1,351,0,4,1
22566,2453,2020-11-18T16:16:01.4329374Z,2016,318,74,34,152,0,5,1,166,0,0,244,284,0,313,0,1,0
22566,2454,2020-11-18T16:16:01.4329374Z,2017,258,65,201,117,0,1,0,141,0,0,193,57,0,257,0,0,0
22566,2455,2020-11-18T16:16:01.4339379Z,2018,269,61,203,122,0,3,4,147,0,0,208,66,0,266,0,0,0
22566,2456,2020-11-18T16:16:01.4339379Z,2019,280,80,215,121,0,3,3,159,0,0,200,65,0,276,0,0,1
22566,2457,2020-11-18T16:16:01.4339379Z,2020,273,73,213,116,0,5,0,157,0,0,200,60,0,268,0,0,0
22566,31749,2021-06-24T05:35:15.4328821Z,2021,259,63,217,119,0,4,1,140,0,0,196,42,0,255,0,0,0
43752,31844,2021-06-24T05:35:16.9689843Z,2021,406,102,321,190,0,1,9,216,0,0,304,85,0,403,0,2,2
43752,5675,2020-11-18T16:16:21.1811095Z,2012,457,78,335,207,0,31,0,250,0,0,379,122,0,426,0,0,0
43752,5676,2020-11-18T16:16:21.1811095Z,2013,401,78,318,176,0,23,0,225,0,0,323,83,0,378,0,0,0
43752,5677,2020-11-18T16:16:21.1811095Z,2014,426,96,311,198,0,25,0,228,0,0,330,115,0,401,0,1,0
43752,5678,2020-11-18T16:16:21.1821099Z,2015,423,105,323,198,0,20,0,225,0,0,318,100,0,403,0,5,0
43752,5679,2020-11-18T16:16:21.1821099Z,2016,449,121,338,198,0,18,0,251,0,0,328,111,0,431,0,4,0
43752,5680,2020-11-18T16:16:21.1821099Z,2017,415,109,324,192,0,14,0,223,0,0,306,91,0,401,0,4,0
43752,5681,2020-11-18T16:16:21.1821099Z,2018,372,97,290,169,0,14,1,203,0,0,275,82,0,358,2,3,0
43752,5682,2020-11-18T16:16:21.1821099Z,2019,395,102,297,180,0,10,0,215,0,0,293,98,0,382,0,2,3
43752,5683,2020-11-18T16:16:21.1831108Z,2020,375,96,286,171,0,10,0,204,0,0,279,89,0,365,0,1,0
41004,25822,2021-06-24T05:35:10.913642Z,2021,254,98,218,120,0,8,0,134,0,0,156,36,0,246,1,2,0
41004,4922,2020-11-18T16:16:16.6560925Z,2012,327,67,255,165,0,3,0,162,0,0,260,72,1,323,0,0,0
41004,4923,2020-11-18T16:16:16.6570925Z,2013,327,89,255,161,0,3,0,166,0,0,238,72,0,322,0,1,2
41004,4924,2020-11-18T16:16:16.6570925Z,2014,270,91,212,127,0,3,0,143,0,0,179,58,0,263,0,0,4
41004,4925,2020-11-18T16:16:16.6570925Z,2015,305,117,248,148,0,7,0,157,0,0,188,57,0,294,0,3,4
41004,4926,2020-11-18T16:16:16.6580939Z,2016,316,136,173,149,0,6,1,167,0,0,180,143,2,306,0,1,2
41004,4927,2020-11-18T16:16:16.6580939Z,2017,300,111,241,138,0,4,0,162,0,0,189,59,2,292,0,2,2
41004,4928,2020-11-18T16:16:16.6580939Z,2018,289,108,229,142,0,6,8,147,0,0,181,60,1,280,0,4,2
41004,4929,2020-11-18T16:16:16.6590938Z,2019,345,122,285,161,0,6,0,184,0,0,223,60,0,339,0,3,0
41004,4930,2020-11-18T16:16:16.6590938Z,2020,311,117,255,144,0,6,0,167,0,0,194,56,0,305,0,2,0
20339,1685,2020-11-18T16:15:56.6127231Z,2012,294,70,228,143,0,3,0,151,0,0,224,66,0,291,0,0,0
20339,1686,2020-11-18T16:15:56.6127231Z,2013,273,75,200,131,0,1,0,142,0,0,198,73,0,272,0,2,0
20339,1687,2020-11-18T16:15:56.6127231Z,2014,270,83,200,132,0,0,0,138,0,0,187,70,0,270,0,4,0
20339,1688,2020-11-18T16:15:56.6127231Z,2015,269,89,203,124,0,1,0,145,0,0,180,66,0,268,0,4,0
20339,1689,2020-11-18T16:15:56.6137231Z,2016,245,79,44,111,0,1,0,134,0,0,166,201,0,244,0,1,0
20339,1690,2020-11-18T16:15:56.6137231Z,2017,217,74,166,99,0,1,0,118,0,0,143,51,0,216,0,0,0
20339,1691,2020-11-18T16:15:56.6137231Z,2018,185,65,132,86,0,4,29,99,0,0,120,53,0,181,1,0,0
20339,1692,2020-11-18T16:15:56.6137231Z,2019,148,53,117,73,0,4,0,75,0,0,95,31,0,144,1,0,0
20339,1693,2020-11-18T16:15:56.6137231Z,2020,137,47,117,70,0,3,7,67,0,0,90,20,0,134,1,0,0
20339,25690,2021-06-24T05:35:08.6350092Z,2021,126,46,108,67,0,4,14,59,0,0,80,18,0,122,1,0,0
21543,2221,2020-11-18T16:16:00.0179981Z,2012,477,83,296,232,0,1,0,245,0,0,394,181,0,476,0,0,0
21543,2222,2020-11-18T16:16:00.0179981Z,2013,447,97,293,220,0,1,0,227,0,0,350,154,0,446,0,1,0
21543,2223,2020-11-18T16:16:00.018999Z,2014,391,98,242,203,0,1,0,188,0,0,293,149,0,390,0,1,0
21543,2224,2020-11-18T16:16:00.018999Z,2015,409,97,248,215,0,2,0,194,0,0,312,161,0,407,0,0,0
21543,2225,2020-11-18T16:16:00.018999Z,2016,488,127,302,274,0,1,4,214,0,0,361,186,0,487,0,0,0
21543,2226,2020-11-18T16:16:00.018999Z,2017,435,123,305,236,0,3,6,199,0,0,312,130,0,432,0,0,0
21543,2227,2020-11-18T16:16:00.0200003Z,2018,399,113,279,207,0,5,0,192,0,0,286,120,0,394,3,2,0
21543,2228,2020-11-18T16:16:00.0200003Z,2019,480,154,362,242,0,13,4,238,0,0,326,118,0,466,3,3,1
21543,2229,2020-11-18T16:16:00.0200003Z,2020,444,141,341,220,0,14,0,224,0,0,303,103,0,429,3,2,1
21543,31710,2021-06-24T05:35:15.3378151Z,2021,438,137,389,205,0,12,0,233,0,0,301,49,0,425,3,0,1
30742,31761,2021-06-24T05:35:16.8318858Z,2021,414,110,332,218,0,6,10,196,0,0,304,82,0,408,5,0,0
30742,3437,2020-11-18T16:16:07.0156607Z,2012,679,105,508,326,0,0,0,353,0,0,574,171,0,679,0,0,0
30742,3438,2020-11-18T16:16:07.0156607Z,2013,639,102,475,311,0,0,0,328,0,0,537,164,0,638,0,4,1
30742,3439,2020-11-18T16:16:07.0166603Z,2014,536,94,417,255,0,1,0,281,0,0,442,119,0,534,0,2,1
30742,3440,2020-11-18T16:16:07.0166603Z,2015,474,81,368,240,0,6,0,234,0,0,393,106,0,466,0,4,2
30742,3441,2020-11-18T16:16:07.0166603Z,2016,443,93,194,217,0,5,1,226,0,0,350,249,1,436,0,4,1
30742,3442,2020-11-18T16:16:07.0166603Z,2017,466,123,348,232,0,7,0,234,0,0,343,118,1,457,0,3,1
30742,3443,2020-11-18T16:16:07.0166603Z,2018,484,106,364,228,0,9,0,256,0,0,378,120,0,474,1,0,1
30742,3444,2020-11-18T16:16:07.0176616Z,2019,503,136,393,248,0,6,3,255,0,2,367,110,0,497,4,0,0
30742,3445,2020-11-18T16:16:07.0176616Z,2020,428,119,348,225,0,9,9,203,0,0,309,80,0,419,5,0,0
40469,31819,2021-06-24T05:35:16.9229508Z,2021,819,249,683,390,0,16,0,429,0,0,570,136,2,798,0,2,3
40469,4773,2020-11-18T16:16:15.3352107Z,2012,587,110,464,289,0,10,0,298,0,0,477,123,0,577,0,0,0
40469,4774,2020-11-18T16:16:15.3352107Z,2013,667,168,518,313,0,10,0,354,0,0,499,149,0,657,0,3,0
40469,4775,2020-11-18T16:16:15.3352107Z,2014,739,231,580,336,0,18,0,403,0,0,508,159,0,719,0,4,2
40469,4776,2020-11-18T16:16:15.3362111Z,2015,749,238,580,347,0,17,0,402,0,0,511,169,0,728,0,4,4
40469,4777,2020-11-18T16:16:15.3362111Z,2016,791,256,568,345,0,15,14,446,0,0,535,223,0,773,0,1,3
40469,4778,2020-11-18T16:16:15.3362111Z,2017,796,262,650,336,0,12,14,460,0,0,534,146,1,780,0,2,3
40469,4779,2020-11-18T16:16:15.3362111Z,2018,768,209,652,334,0,11,0,434,0,0,559,116,2,749,3,3,6
40469,4780,2020-11-18T16:16:15.3362111Z,2019,814,255,706,365,0,16,0,449,0,0,559,108,1,794,1,4,3
40469,4781,2020-11-18T16:16:15.3372115Z,2020,801,240,659,381,0,12,17,420,0,0,561,142,2,784,0,2,3
42812,25834,2021-06-24T05:35:10.9196463Z,2021,233,58,189,129,0,1,0,104,0,0,175,44,0,232,0,0,0
42812,5357,2020-11-18T16:16:19.3378778Z,2012,416,92,377,209,0,3,0,207,0,0,324,39,0,413,0,0,0
42812,5358,2020-11-18T16:16:19.3388787Z,2013,345,91,317,167,0,1,0,178,0,0,254,28,0,342,0,2,2
42812,5359,2020-11-18T16:16:19.3388787Z,2014,310,90,280,151,0,1,0,159,0,0,220,30,0,309,0,2,0
42812,5360,2020-11-18T16:16:19.3388787Z,2015,309,95,282,151,0,3,0,158,0,0,214,27,0,306,0,4,0
42812,5361,2020-11-18T16:16:19.3388787Z,2016,284,91,196,133,0,3,0,151,0,0,193,88,0,281,0,1,0
42812,5362,2020-11-18T16:16:19.3388787Z,2017,296,102,271,141,0,3,2,155,0,0,194,25,0,293,0,2,0
42812,5363,2020-11-18T16:16:19.3398791Z,2018,240,69,218,125,0,0,11,115,0,0,171,22,0,240,0,2,0
42812,5364,2020-11-18T16:16:19.3398791Z,2019,249,75,231,139,0,2,0,110,0,0,174,18,0,247,0,0,0
42812,5365,2020-11-18T16:16:19.3398791Z,2020,235,72,214,137,0,3,0,98,0,0,163,21,0,228,0,0,4
42952,31837,2021-06-24T05:35:16.96298Z,2021,483,162,357,226,0,9,0,257,0,0,321,126,0,470,0,1,4
42952,5402,2020-11-18T16:16:19.7691674Z,2012,705,185,482,362,0,2,0,343,0,0,520,223,0,702,0,0,1
42952,5403,2020-11-18T16:16:19.7691674Z,2013,692,210,481,355,0,3,0,337,0,0,482,211,0,689,0,5,0
42952,5404,2020-11-18T16:16:19.7701679Z,2014,663,227,462,340,0,9,0,323,0,0,436,201,0,654,0,3,0
42952,5405,2020-11-18T16:16:19.7701679Z,2015,652,229,448,345,0,12,0,307,0,0,423,204,0,640,0,3,0
42952,5406,2020-11-18T16:16:19.7701679Z,2016,571,211,397,293,0,9,0,278,0,0,360,174,0,562,0,3,0
42952,5407,2020-11-18T16:16:19.7701679Z,2017,547,199,392,284,0,9,0,263,0,0,348,155,0,538,0,1,0
42952,5408,2020-11-18T16:16:19.7701679Z,2018,502,156,356,251,0,9,1,251,0,0,346,146,0,492,0,1,1
42952,5409,2020-11-18T16:16:19.7711732Z,2019,597,187,442,295,0,12,0,302,0,3,410,155,0,584,0,2,1
42952,5410,2020-11-18T16:16:19.7711732Z,2020,535,160,397,257,0,11,9,278,0,0,375,138,0,522,0,2,2
71068,10029,2020-11-18T16:16:52.5740422Z,2012,351,75,304,151,0,0,0,200,0,0,276,47,0,351,0,0,0
71068,10030,2020-11-18T16:16:52.5740422Z,2013,324,85,283,139,0,1,0,185,0,0,239,41,0,323,0,3,0
71068,10031,2020-11-18T16:16:52.5740422Z,2014,302,80,244,131,0,1,0,171,0,0,222,58,0,301,0,0,0
71068,10032,2020-11-18T16:16:52.5740422Z,2015,358,100,317,157,0,1,0,201,0,0,258,41,0,357,0,0,0
71068,10033,2020-11-18T16:16:52.5750435Z,2016,328,97,90,137,0,1,19,191,0,0,231,238,0,327,0,0,0
71068,10034,2020-11-18T16:16:52.5750435Z,2017,308,91,272,127,0,1,7,181,0,0,217,36,0,305,0,0,2
71068,10035,2020-11-18T16:16:52.5750435Z,2018,376,103,341,166,0,2,35,210,0,0,273,35,0,373,6,1,1
71068,10036,2020-11-18T16:16:52.5750435Z,2019,324,104,298,149,0,3,34,175,0,0,220,26,0,321,6,0,0
71068,10037,2020-11-18T16:16:52.5750435Z,2020,306,87,268,135,0,2,6,171,0,0,219,38,0,302,7,0,2
71068,25664,2021-06-24T05:35:04.7362118Z,2021,294,81,273,128,0,2,8,166,0,0,213,21,1,289,6,0,2
62943,31969,2021-06-24T05:35:20.2763552Z,2021,340,137,321,168,0,3,3,172,0,0,203,19,0,336,1,1,1
62943,8764,2020-11-18T16:16:42.8405509Z,2012,342,88,304,163,0,2,0,179,0,0,254,38,0,339,0,0,1
62943,8765,2020-11-18T16:16:42.8405509Z,2013,342,109,296,168,0,0,0,174,0,0,233,46,0,341,0,0,1
62943,8766,2020-11-18T16:16:42.8405509Z,2014,326,114,275,151,0,4,0,175,0,0,212,51,0,321,0,10,1
62943,8767,2020-11-18T16:16:42.8415518Z,2015,295,114,261,122,0,3,0,173,0,0,181,34,0,292,0,5,0
62943,8768,2020-11-18T16:16:42.8415518Z,2016,197,80,172,76,0,2,4,121,0,0,117,25,0,195,0,3,0
62943,8769,2020-11-18T16:16:42.8425527Z,2017,333,151,295,151,0,4,0,182,0,0,182,38,0,329,0,3,0
62943,8770,2020-11-18T16:16:42.8425527Z,2018,380,148,329,190,0,1,1,190,0,0,232,51,0,379,2,2,0
62943,8771,2020-11-18T16:16:42.8425527Z,2019,329,143,291,160,0,1,8,169,0,0,186,38,0,328,2,1,0
62943,8772,2020-11-18T16:16:42.8425527Z,2020,318,136,290,163,0,2,0,155,0,0,182,28,0,315,2,1,1
10322,31581,2021-06-24T05:35:14.5202277Z,2021,214,86,203,118,0,3,0,96,0,0,128,11,0,211,0,0,0
10322,67,2020-11-18T16:15:45.5803666Z,2012,297,67,246,155,0,0,0,142,0,0,230,51,0,297,0,0,0
10322,68,2020-11-18T16:15:45.5813666Z,2013,318,97,267,153,0,2,0,165,0,0,221,51,1,315,0,3,0
10322,69,2020-11-18T16:15:45.5813666Z,2014,289,97,229,140,0,3,0,149,0,0,192,60,1,285,0,3,0
10322,70,2020-11-18T16:15:45.5813666Z,2015,288,111,233,140,0,1,0,148,0,0,177,55,0,286,0,2,1
10322,71,2020-11-18T16:15:45.5813666Z,2016,227,101,112,104,0,3,0,123,0,0,126,115,0,224,0,1,0
10322,72,2020-11-18T16:15:45.5813666Z,2017,274,117,225,127,0,3,2,147,0,0,157,49,0,271,0,4,0
10322,73,2020-11-18T16:15:45.5813666Z,2018,246,89,212,123,0,3,18,123,0,0,157,34,0,243,0,4,0
10322,74,2020-11-18T16:15:45.582368Z,2019,223,85,198,125,0,7,30,98,0,0,138,25,0,216,0,0,0
10322,75,2020-11-18T16:15:45.582368Z,2020,245,105,222,135,0,6,0,110,0,0,140,23,0,239,0,0,0
40220,25816,2021-06-24T05:35:10.9076382Z,2021,529,115,401,254,0,16,0,275,0,0,414,128,4,506,0,2,3
40220,4675,2020-11-18T16:16:14.4145966Z,2012,565,87,367,279,0,21,0,286,0,0,478,198,0,544,0,0,0
40220,4676,2020-11-18T16:16:14.4145966Z,2013,560,96,366,270,0,19,0,290,0,0,464,194,0,541,0,12,0
40220,4677,2020-11-18T16:16:14.4155966Z,2014,543,94,358,266,0,16,0,277,0,0,449,185,2,525,0,3,0
40220,4678,2020-11-18T16:16:14.4155966Z,2015,526,104,362,261,0,10,0,265,0,0,422,164,1,515,0,7,0
40220,4679,2020-11-18T16:16:14.4155966Z,2016,513,107,326,265,0,10,13,248,0,0,406,187,1,502,0,5,0
40220,4680,2020-11-18T16:16:14.416597Z,2017,537,113,375,273,0,15,0,264,0,0,424,162,1,521,0,6,0
40220,4681,2020-11-18T16:16:14.416597Z,2018,664,131,448,361,0,26,0,303,0,0,533,216,0,638,3,2,0
40220,4682,2020-11-18T16:16:14.416597Z,2019,728,168,528,377,0,28,2,351,0,0,560,200,1,698,1,5,1
40220,4683,2020-11-18T16:16:14.4175975Z,2020,627,147,463,307,0,17,1,320,0,0,480,164,2,608,0,2,0
21352,2173,2020-11-18T16:15:59.6097254Z,2012,252,59,203,117,0,6,0,135,0,0,193,49,0,246,0,0,0
21352,2174,2020-11-18T16:15:59.6107263Z,2013,211,59,163,109,0,6,0,102,0,0,152,48,0,205,0,2,0
21352,2175,2020-11-18T16:15:59.6107263Z,2014,215,81,154,105,0,11,0,110,0,0,134,61,0,204,0,2,0
21352,2176,2020-11-18T16:15:59.6107263Z,2015,234,112,191,108,0,4,0,126,0,0,122,43,0,230,0,6,0
21352,2177,2020-11-18T16:15:59.6107263Z,2016,242,111,190,103,0,0,7,139,0,0,131,52,0,242,0,2,0
21352,2178,2020-11-18T16:15:59.6107263Z,2017,208,90,172,92,0,0,2,116,0,0,118,36,0,208,0,2,0
21352,2179,2020-11-18T16:15:59.6117267Z,2018,137,49,112,58,0,0,0,79,0,0,88,25,0,137,0,1,0
21352,2180,2020-11-18T16:15:59.6117267Z,2019,161,58,136,70,0,1,9,91,0,0,103,25,0,160,0,1,0
21352,2181,2020-11-18T16:15:59.6117267Z,2020,219,97,193,93,0,1,8,126,0,0,122,26,0,218,0,1,0
21352,31709,2021-06-24T05:35:15.3398179Z,2021,215,82,191,93,0,1,1,122,0,0,133,24,0,214,0,1,0
50443,31875,2021-06-24T05:35:18.4470453Z,2021,216,94,172,97,0,7,0,119,0,0,122,44,0,209,0,1,0
50443,6195,2020-11-18T16:16:25.104724Z,2012,366,104,292,185,0,0,0,181,0,0,262,74,1,365,0,0,0
50443,6196,2020-11-18T16:16:25.1057249Z,2013,332,106,266,168,0,1,0,164,0,0,226,66,0,331,0,0,0
50443,6197,2020-11-18T16:16:25.1057249Z,2014,278,86,215,139,0,0,0,139,0,0,192,63,0,278,0,0,0
50443,6198,2020-11-18T16:16:25.1057249Z,2015,266,92,211,139,0,3,0,127,0,0,174,55,0,263,0,0,0
50443,6199,2020-11-18T16:16:25.1057249Z,2016,214,76,156,108,0,1,0,106,0,0,138,58,0,213,0,1,0
50443,6200,2020-11-18T16:16:25.1057249Z,2017,183,58,145,92,0,2,0,91,0,0,125,38,0,181,0,0,0
50443,6201,2020-11-18T16:16:25.4859785Z,2018,191,63,135,95,0,3,0,96,0,0,128,56,0,188,0,1,0
50443,6202,2020-11-18T16:16:25.4859785Z,2019,226,99,170,104,0,3,7,122,0,0,127,56,0,223,0,1,0
50443,6203,2020-11-18T16:16:25.4869798Z,2020,242,98,187,108,0,6,0,134,0,0,144,55,0,236,0,1,0
10546,126,2020-11-18T16:15:46.3718947Z,2012,427,105,336,207,0,12,0,220,0,0,322,91,1,414,0,0,0
10546,127,2020-11-18T16:15:46.3718947Z,2013,421,122,331,187,0,17,0,234,0,0,299,90,1,402,0,5,1
10546,128,2020-11-18T16:15:46.3728956Z,2014,471,162,348,216,0,11,0,255,0,0,309,123,0,459,0,4,1
10546,129,2020-11-18T16:15:46.3728956Z,2015,646,227,485,310,0,11,0,336,0,0,419,161,0,632,0,3,3
10546,130,2020-11-18T16:15:46.3728956Z,2016,539,185,121,271,0,10,2,268,0,0,354,418,0,527,0,3,2
10546,131,2020-11-18T16:15:46.3728956Z,2017,542,188,406,263,0,9,1,279,0,0,354,136,0,531,0,1,2
10546,132,2020-11-18T16:15:46.3728956Z,2018,630,218,475,308,0,11,28,322,0,1,412,155,0,619,0,2,0
10546,133,2020-11-18T16:15:46.3728956Z,2019,703,274,556,365,0,11,0,338,0,0,429,147,0,692,0,3,0
10546,134,2020-11-18T16:15:46.373896Z,2020,576,220,451,301,0,9,0,275,0,0,356,125,0,567,0,3,0
10546,31583,2021-06-24T05:35:14.5242306Z,2021,538,200,440,281,0,4,12,257,0,0,338,98,0,534,0,2,0
41012,31824,2021-06-24T05:35:16.9279555Z,2021,336,93,301,168,0,5,0,168,0,0,243,35,1,330,1,0,0
41012,4931,2020-11-18T16:16:16.6580939Z,2012,380,93,256,189,0,14,0,191,0,0,287,124,0,366,0,0,0
41012,4932,2020-11-18T16:16:16.6580939Z,2013,346,106,273,181,0,12,0,165,0,0,240,73,0,334,0,3,0
41012,4933,2020-11-18T16:16:16.6580939Z,2014,307,97,255,175,0,12,0,132,0,0,210,52,0,295,0,2,0
41012,4934,2020-11-18T16:16:16.6590938Z,2015,279,86,225,154,0,8,0,125,0,0,193,54,0,271,0,1,0
41012,4935,2020-11-18T16:16:16.6590938Z,2016,290,89,228,162,0,13,2,128,0,0,201,62,0,277,0,5,0
41012,4936,2020-11-18T16:16:16.6590938Z,2017,270,75,216,147,0,16,0,123,0,0,195,54,1,253,0,5,0
41012,4937,2020-11-18T16:16:16.6600943Z,2018,255,80,193,135,0,6,0,120,0,0,175,62,1,248,0,2,0
41012,4938,2020-11-18T16:16:16.6600943Z,2019,327,108,280,161,0,7,0,166,0,0,219,47,3,317,1,0,0
41012,4939,2020-11-18T16:16:16.6600943Z,2020,349,103,309,177,0,7,0,172,0,0,246,40,1,341,1,0,0
76349,10942,2020-11-18T16:16:58.1097342Z,2012,699,161,578,345,0,4,0,354,0,0,538,121,0,695,0,0,0
76349,10943,2020-11-18T16:16:58.1097342Z,2013,681,174,565,344,0,4,0,337,0,0,507,116,0,677,0,0,0
76349,10944,2020-11-18T16:16:58.1097342Z,2014,668,180,525,331,0,7,0,337,0,0,488,143,0,661,0,7,0
76349,10945,2020-11-18T16:16:58.1107347Z,2015,652,168,496,321,0,8,0,331,0,0,484,156,1,643,0,6,0
76349,10946,2020-11-18T16:16:58.1107347Z,2016,612,161,440,297,0,7,2,315,0,0,451,172,1,604,0,1,0
76349,10947,2020-11-18T16:16:58.1107347Z,2017,624,160,454,311,0,9,0,313,0,0,464,170,1,613,0,3,1
76349,10948,2020-11-18T16:16:58.1107347Z,2018,614,158,458,309,0,7,9,305,0,0,456,156,1,605,0,0,1
76349,10949,2020-11-18T16:16:58.1107347Z,2019,639,209,495,316,0,10,10,323,0,0,430,144,0,628,0,0,1
76349,10950,2020-11-18T16:16:58.1117351Z,2020,590,192,472,289,0,3,0,301,0,0,398,118,1,582,0,0,4
76349,31629,2021-06-24T05:35:14.6283057Z,2021,525,162,422,261,0,1,4,264,0,0,363,103,1,521,0,0,2
43398,25840,2021-06-24T05:35:10.9456646Z,2021,436,166,343,211,0,9,0,225,0,0,270,93,0,427,1,0,0
43398,5548,2020-11-18T16:16:20.720802Z,2012,510,114,390,219,0,5,0,291,0,0,396,120,0,505,0,0,0
43398,5549,2020-11-18T16:16:20.720802Z,2013,415,109,309,185,0,3,0,230,0,0,306,106,0,412,0,0,0
43398,5550,2020-11-18T16:16:20.7218029Z,2014,368,101,284,163,0,2,0,205,0,0,267,84,0,365,0,0,1
43398,5551,2020-11-18T16:16:20.7218029Z,2015,377,116,288,168,0,1,0,209,0,0,261,89,0,376,0,0,0
43398,5552,2020-11-18T16:16:20.7218029Z,2016,331,100,243,150,0,2,9,181,0,0,231,88,1,328,0,2,0
43398,5553,2020-11-18T16:16:20.7218029Z,2017,266,93,211,130,0,2,15,136,0,0,173,55,1,263,0,3,0
43398,5554,2020-11-18T16:16:20.7218029Z,2018,230,79,182,109,0,2,1,121,0,0,151,48,0,228,0,2,0
43398,5555,2020-11-18T16:16:20.7228042Z,2019,327,119,272,155,0,6,0,172,0,0,208,55,0,321,0,1,0
43398,5556,2020-11-18T16:16:20.7228042Z,2020,426,171,364,205,0,7,0,221,0,0,255,62,0,419,0,0,0
21212,2133,2020-11-18T16:15:59.5947151Z,2012,308,67,219,137,0,0,0,171,0,0,241,89,0,308,0,0,0
21212,2134,2020-11-18T16:15:59.5947151Z,2013,315,75,254,141,0,0,0,174,0,0,240,61,0,315,0,0,0
21212,2135,2020-11-18T16:15:59.5947151Z,2014,286,78,215,126,0,0,0,160,0,0,208,71,0,286,0,0,0
21212,2136,2020-11-18T16:15:59.5957173Z,2015,296,77,226,138,0,0,0,158,0,0,219,70,0,296,0,0,0
21212,2137,2020-11-18T16:15:59.5957173Z,2016,321,98,181,143,0,0,1,178,0,0,223,140,0,321,0,0,0
21212,2138,2020-11-18T16:15:59.5957173Z,2017,300,102,237,134,0,3,4,166,0,0,198,63,0,297,0,1,0
21212,2139,2020-11-18T16:15:59.5957173Z,2018,318,90,248,144,0,2,35,174,0,0,228,70,0,316,4,2,0
21212,2140,2020-11-18T16:15:59.5957173Z,2019,438,120,340,217,0,1,4,221,0,2,318,98,0,434,6,0,3
21212,2141,2020-11-18T16:15:59.596716Z,2020,411,98,316,214,0,3,6,197,0,0,313,95,0,405,6,0,3
21212,25707,2021-06-24T05:35:08.6660317Z,2021,367,91,309,183,0,3,2,184,0,0,276,58,0,362,5,2,2
53140,31902,2021-06-24T05:35:18.4790669Z,2021,427,137,354,211,0,6,1,216,0,0,290,73,0,421,0,0,0
53140,7164,2020-11-18T16:16:32.0643671Z,2012,429,104,332,208,0,0,0,221,0,0,325,97,0,429,0,0,0
53140,7165,2020-11-18T16:16:32.0643671Z,2013,405,114,323,196,0,0,0,209,0,0,291,82,0,405,0,0,0
53140,7166,2020-11-18T16:16:32.0653675Z,2014,406,116,319,202,0,3,0,204,0,0,290,87,0,403,0,0,0
53140,7167,2020-11-18T16:16:32.0653675Z,2015,363,99,291,182,0,1,0,181,0,0,264,72,0,362,0,1,0
53140,7168,2020-11-18T16:16:32.0653675Z,2016,305,107,236,164,0,1,0,141,0,0,198,69,0,304,0,0,0
53140,7169,2020-11-18T16:16:32.0653675Z,2017,313,105,256,164,0,3,1,149,0,0,208,57,0,310,0,0,0
53140,7170,2020-11-18T16:16:32.0653675Z,2018,403,127,305,199,0,2,0,204,0,0,276,98,0,401,0,0,0
53140,7171,2020-11-18T16:16:32.066368Z,2019,489,170,382,241,0,3,0,248,0,0,319,107,0,486,0,0,0
53140,7172,2020-11-18T16:16:32.066368Z,2020,451,159,364,218,0,4,0,233,0,0,292,87,0,447,0,0,0
31427,31769,2021-06-24T05:35:16.8398915Z,2021,345,64,274,164,0,2,0,181,0,0,281,71,0,343,7,1,0
31427,3682,2020-11-18T16:16:08.0553537Z,2012,313,46,232,162,0,2,0,151,0,0,267,81,1,310,0,0,0
31427,3683,2020-11-18T16:16:08.0563555Z,2013,380,68,292,189,0,1,0,191,0,0,312,88,1,378,0,5,0
31427,3684,2020-11-18T16:16:08.0563555Z,2014,432,87,311,215,0,2,0,217,0,0,345,121,0,430,0,6,0
31427,3685,2020-11-18T16:16:08.0563555Z,2015,447,94,325,229,0,3,0,218,0,0,353,122,1,443,0,4,0
31427,3686,2020-11-18T16:16:08.0573559Z,2016,438,96,274,239,0,5,2,199,0,0,342,164,0,433,0,4,0
31427,3687,2020-11-18T16:16:08.0573559Z,2017,390,86,274,196,0,1,14,194,0,0,304,116,0,388,0,4,1
31427,3688,2020-11-18T16:16:08.0573559Z,2018,365,72,270,185,0,1,45,180,0,0,293,95,0,363,7,1,1
31427,3689,2020-11-18T16:16:08.0583559Z,2019,379,72,270,187,0,0,0,192,0,1,307,109,0,379,11,1,0
31427,3690,2020-11-18T16:16:08.0583559Z,2020,345,61,260,168,0,0,0,177,0,0,284,85,1,344,10,1,0
12914,31602,2021-06-24T05:35:14.5672617Z,2021,336,115,270,156,0,3,0,180,0,0,221,66,0,333,0,4,0
12914,896,2020-11-18T16:15:51.3442093Z,2012,576,192,450,262,0,4,0,314,0,0,384,126,0,572,0,0,0
12914,897,2020-11-18T16:15:51.3452102Z,2013,560,222,412,270,0,4,0,290,0,0,338,148,0,556,0,1,0
12914,898,2020-11-18T16:15:51.3452102Z,2014,543,227,410,257,0,5,0,286,0,0,316,133,0,538,0,3,0
12914,899,2020-11-18T16:15:51.3452102Z,2015,526,206,414,254,0,2,0,272,0,0,320,112,0,524,0,2,0
12914,900,2020-11-18T16:15:51.3462107Z,2016,477,195,207,231,0,0,0,246,0,0,282,270,0,477,0,3,0
12914,901,2020-11-18T16:15:52.0236634Z,2017,369,144,307,187,0,0,2,182,0,0,225,62,0,369,0,2,0
12914,902,2020-11-18T16:15:52.0236634Z,2018,398,146,333,189,0,0,8,209,0,1,252,65,0,398,0,4,0
12914,903,2020-11-18T16:15:52.0236634Z,2019,339,126,260,162,0,0,0,177,0,0,213,79,0,339,0,0,0
12914,904,2020-11-18T16:15:52.0246643Z,2020,345,127,283,165,0,1,0,180,0,0,218,62,0,344,0,0,0
22459,2428,2020-11-18T16:16:01.4229304Z,2012,374,54,302,183,0,7,0,191,0,0,320,72,0,367,0,0,0
22459,2429,2020-11-18T16:16:01.4229304Z,2013,358,56,291,169,0,4,0,189,0,0,302,67,0,354,0,3,0
22459,2430,2020-11-18T16:16:01.4239313Z,2014,316,56,265,145,0,5,0,171,0,0,260,51,0,311,0,4,0
22459,2431,2020-11-18T16:16:01.4239313Z,2015,357,74,279,167,0,5,0,190,0,0,283,78,0,351,0,3,1
22459,2432,2020-11-18T16:16:01.4239313Z,2016,340,78,267,160,0,7,0,180,0,0,262,73,0,333,0,2,0
22459,2433,2020-11-18T16:16:01.4249317Z,2017,272,63,209,118,0,5,0,154,0,0,209,63,0,267,0,4,0
22459,2434,2020-11-18T16:16:01.4249317Z,2018,260,65,200,122,0,6,0,138,0,0,195,60,0,254,0,4,0
22459,2435,2020-11-18T16:16:01.4249317Z,2019,270,67,216,142,0,5,2,128,0,0,203,54,0,265,0,6,0
22459,2436,2020-11-18T16:16:01.4249317Z,2020,274,82,219,144,0,6,2,130,0,0,192,55,0,267,0,5,1
22459,25747,2021-06-24T05:35:08.7060591Z,2021,285,84,207,148,0,2,1,137,0,0,201,78,0,283,2,5,0
53686,25905,2021-06-24T05:35:12.8019954Z,2021,123,36,113,50,0,0,13,73,0,0,87,10,0,123,0,0,0
53686,7311,2020-11-18T16:16:33.2381482Z,2012,290,49,250,130,0,0,0,160,0,0,241,40,0,290,0,0,0
53686,7312,2020-11-18T16:16:33.2381482Z,2013,287,58,242,133,0,4,0,154,0,0,229,45,0,283,0,3,0
53686,7313,2020-11-18T16:16:33.2391478Z,2014,248,60,215,116,0,2,0,132,0,0,188,33,0,246,0,1,0
53686,7314,2020-11-18T16:16:33.2391478Z,2015,258,74,220,123,0,0,0,135,0,0,184,38,0,258,0,1,0
53686,7315,2020-11-18T16:16:33.2391478Z,2016,246,71,77,119,0,2,0,127,0,0,175,169,0,244,0,1,0
53686,7316,2020-11-18T16:16:33.2391478Z,2017,191,58,179,87,0,2,0,104,0,0,133,12,0,189,0,0,0
53686,7317,2020-11-18T16:16:33.2401478Z,2018,168,46,150,77,0,1,0,91,0,0,122,18,0,167,1,0,0
53686,7318,2020-11-18T16:16:33.2401478Z,2019,143,46,128,69,0,1,0,74,0,0,97,15,0,142,0,0,0
53686,7319,2020-11-18T16:16:33.2401478Z,2020,127,38,113,51,0,0,0,76,0,0,89,14,0,127,0,0,0
32748,25778,2021-06-24T05:35:10.8465942Z,2021,234,40,189,114,0,0,0,120,0,0,194,45,0,233,0,0,1
32748,3972,2020-11-18T16:16:09.891581Z,2012,353,36,254,161,0,6,0,192,0,0,317,99,0,347,0,0,0
32748,3973,2020-11-18T16:16:09.891581Z,2013,350,38,252,159,0,1,0,191,0,0,312,98,0,349,0,1,0
32748,3974,2020-11-18T16:16:09.892581Z,2014,335,50,236,153,0,0,0,182,0,0,285,99,0,335,0,0,0
32748,3975,2020-11-18T16:16:09.892581Z,2015,338,50,256,159,0,4,0,179,0,0,288,82,1,333,0,4,0
32748,3976,2020-11-18T16:16:09.8935823Z,2016,343,55,253,160,0,6,0,183,0,0,288,90,0,337,0,2,0
32748,3977,2020-11-18T16:16:09.8935823Z,2017,310,48,238,147,0,6,0,163,0,0,262,72,0,304,0,3,0
32748,3978,2020-11-18T16:16:09.8945837Z,2018,363,50,276,171,0,6,0,192,0,0,313,87,0,357,1,1,0
32748,3979,2020-11-18T16:16:09.8945837Z,2019,300,46,223,139,0,1,0,161,0,0,254,77,0,299,1,1,0
32748,3980,2020-11-18T16:16:09.8945837Z,2020,257,48,195,112,0,1,0,145,0,0,209,62,0,256,0,1,0
25239,25751,2021-06-24T05:35:08.7100615Z,2021,274,78,235,133,0,9,0,141,0,0,196,39,0,265,0,0,0
25239,2854,2020-11-18T16:16:03.6904468Z,2012,431,77,286,195,0,6,0,236,0,0,354,145,0,425,0,0,0
25239,2855,2020-11-18T16:16:03.6904468Z,2013,383,80,301,181,0,14,0,202,0,0,303,82,0,369,0,2,0
25239,2856,2020-11-18T16:16:03.6904468Z,2014,288,61,235,146,0,9,0,142,0,0,227,53,0,278,0,1,1
25239,2857,2020-11-18T16:16:03.6914446Z,2015,303,81,256,141,0,7,0,162,0,0,222,47,0,295,0,2,1
25239,2858,2020-11-18T16:16:03.6914446Z,2016,202,59,187,97,0,0,2,105,0,0,143,15,0,201,0,1,1
25239,2859,2020-11-18T16:16:03.6914446Z,2017,203,61,179,101,0,3,0,102,0,0,142,24,0,199,0,2,1
25239,2860,2020-11-18T16:16:03.6924455Z,2018,224,56,190,113,0,2,13,111,0,0,168,34,0,221,0,0,1
25239,2861,2020-11-18T16:16:03.6924455Z,2019,278,91,243,131,0,9,4,147,0,0,187,35,0,269,0,0,0
25239,2862,2020-11-18T16:16:03.6924455Z,2020,292,85,248,144,0,11,1,148,0,0,207,44,0,281,0,1,0
10892,241,2020-11-18T16:15:46.8482124Z,2012,533,92,421,270,0,31,0,263,0,0,441,112,0,501,0,0,1
10892,242,2020-11-18T16:15:46.8482124Z,2013,513,122,403,253,0,29,0,260,0,0,391,110,0,483,0,31,1
10892,243,2020-11-18T16:15:46.8482124Z,2014,442,115,345,205,0,24,0,237,0,0,327,97,0,417,0,25,1
10892,244,2020-11-18T16:15:46.8482124Z,2015,467,136,382,217,0,16,0,250,0,0,331,85,0,450,0,26,1
10892,245,2020-11-18T16:15:46.8492133Z,2016,401,124,331,198,0,12,0,203,0,0,277,70,0,388,0,15,1
10892,246,2020-11-18T16:15:46.8492133Z,2017,334,95,289,157,0,13,0,177,0,0,239,45,0,320,0,10,1
10892,247,2020-11-18T16:15:46.8492133Z,2018,310,86,268,155,0,5,1,155,0,0,224,42,2,303,2,1,0
10892,248,2020-11-18T16:15:46.8492133Z,2019,289,96,252,142,0,3,0,147,0,0,193,37,0,286,1,1,0
10892,249,2020-11-18T16:15:46.8492133Z,2020,265,85,230,135,0,1,0,130,0,0,180,35,0,264,0,1,0
10892,25585,2021-06-24T05:35:04.5971132Z,2021,278,87,245,129,0,3,4,149,0,0,191,33,1,274,0,1,0
51938,31890,2021-06-24T05:35:18.4620549Z,2021,171,54,129,84,0,1,3,87,0,0,117,42,0,169,0,0,1
51938,6632,2020-11-18T16:16:28.2258042Z,2012,292,74,226,135,0,1,0,157,0,0,218,66,0,291,0,0,0
51938,6633,2020-11-18T16:16:28.2268051Z,2013,281,83,221,118,0,0,0,163,0,0,198,60,0,280,0,2,1
51938,6634,2020-11-18T16:16:28.2268051Z,2014,290,100,217,129,0,3,0,161,0,0,190,73,0,286,0,4,1
51938,6635,2020-11-18T16:16:28.2268051Z,2015,240,87,181,102,0,3,0,138,0,0,153,59,1,235,0,2,1
51938,6636,2020-11-18T16:16:28.2268051Z,2016,198,69,127,87,0,1,6,111,0,0,129,71,1,196,0,0,0
51938,6637,2020-11-18T16:16:28.2278056Z,2017,150,48,111,72,0,0,1,78,0,0,102,39,1,149,0,0,0
51938,6638,2020-11-18T16:16:28.2278056Z,2018,221,68,168,114,0,1,4,107,0,0,153,53,1,219,0,0,0
51938,6639,2020-11-18T16:16:28.2278056Z,2019,202,64,152,101,0,2,3,101,0,0,138,50,0,200,0,0,0
51938,6640,2020-11-18T16:16:28.2288047Z,2020,212,62,165,109,0,2,17,103,0,0,150,47,0,209,0,0,1
15453,1228,2020-11-18T16:15:53.6007169Z,2012,362,83,268,165,0,15,0,197,0,0,279,94,0,347,0,0,0
15453,1229,2020-11-18T16:15:53.6017178Z,2013,349,90,261,168,0,19,0,181,0,0,259,88,0,330,0,9,0
15453,1230,2020-11-18T16:15:53.6017178Z,2014,328,83,225,162,0,25,0,166,0,0,245,103,0,303,0,6,0
15453,1231,2020-11-18T16:15:53.6017178Z,2015,326,92,234,158,0,16,0,168,0,0,234,92,0,310,0,4,0
15453,1232,2020-11-18T16:15:53.6017178Z,2016,343,94,169,166,0,17,0,177,0,0,249,174,0,326,0,3,0
15453,1233,2020-11-18T16:15:53.6017178Z,2017,265,81,188,122,0,14,0,143,0,0,184,77,0,251,0,0,0
15453,1234,2020-11-18T16:15:53.6027182Z,2018,241,75,194,104,0,12,20,137,0,0,166,47,0,229,0,0,0
15453,1235,2020-11-18T16:15:53.6027182Z,2019,362,124,299,171,0,16,0,191,0,0,238,63,0,346,1,1,0
15453,1236,2020-11-18T16:15:53.6027182Z,2020,389,134,315,190,0,20,1,199,0,0,255,74,0,369,0,1,0
15453,25811,2021-06-24T05:35:10.9016339Z,2021,361,116,285,186,0,15,2,175,0,0,245,76,0,346,0,1,0
20321,1676,2020-11-18T16:15:56.6107218Z,2012,600,131,432,283,0,2,0,317,0,0,469,168,2,595,0,0,1
20321,1677,2020-11-18T16:15:56.6107218Z,2013,628,166,459,294,0,4,0,334,0,0,462,169,2,621,0,1,1
20321,1678,2020-11-18T16:15:56.6107218Z,2014,642,173,437,300,0,8,0,342,0,0,469,205,3,630,0,0,1
20321,1679,2020-11-18T16:15:56.6107218Z,2015,603,172,398,287,0,5,0,316,0,0,431,205,2,595,0,2,1
20321,1680,2020-11-18T16:15:56.6107218Z,2016,567,182,322,264,0,5,0,303,0,0,385,245,2,559,0,0,1
20321,1681,2020-11-18T16:15:56.6117222Z,2017,527,175,376,249,0,2,0,278,0,0,352,151,1,523,0,0,1
20321,1682,2020-11-18T16:15:56.6117222Z,2018,500,156,363,242,0,2,2,258,0,0,344,137,0,497,3,0,1
20321,1683,2020-11-18T16:15:56.6117222Z,2019,407,131,288,195,0,2,3,212,0,0,276,119,0,405,3,0,0
20321,1684,2020-11-18T16:15:56.6117222Z,2020,336,111,233,159,0,5,5,177,0,0,225,103,0,331,3,0,0
20321,31691,2021-06-24T05:35:15.3037911Z,2021,300,109,242,141,0,6,9,159,0,0,191,58,0,294,3,0,0
12401,25633,2021-06-24T05:35:04.6841758Z,2021,285,107,250,138,0,0,0,147,0,0,178,35,0,285,2,0,0
12401,731,2020-11-18T16:15:50.9009134Z,2012,325,64,267,138,0,1,0,187,0,0,261,58,0,324,0,0,0
12401,732,2020-11-18T16:15:50.9009134Z,2013,348,83,282,159,0,1,0,189,0,0,265,66,0,347,0,1,0
12401,733,2020-11-18T16:15:50.9009134Z,2014,423,111,335,197,0,2,0,226,0,0,312,88,0,421,0,1,0
12401,734,2020-11-18T16:15:50.9009134Z,2015,463,106,367,215,0,5,0,248,0,0,357,96,0,458,0,2,0
12401,735,2020-11-18T16:15:50.9019139Z,2016,394,97,174,184,0,5,0,210,0,0,297,220,0,389,0,2,0
12401,736,2020-11-18T16:15:50.9019139Z,2017,355,89,270,164,0,4,0,191,0,0,266,85,0,351,0,0,0
12401,737,2020-11-18T16:15:50.9019139Z,2018,341,81,263,154,0,5,3,187,0,0,260,78,0,336,4,0,0
12401,738,2020-11-18T16:15:50.9019139Z,2019,339,115,266,169,0,1,2,170,0,0,224,73,0,338,4,0,0
12401,739,2020-11-18T16:15:50.9029148Z,2020,319,110,249,160,0,0,0,159,0,0,209,70,0,319,4,0,0
26765,25731,2021-06-24T05:35:08.6850442Z,2021,231,58,198,103,0,1,0,128,0,0,173,33,0,230,4,0,0
26765,2990,2020-11-18T16:16:04.3018528Z,2012,431,120,373,218,0,5,0,213,0,0,311,58,1,425,0,0,0
26765,2991,2020-11-18T16:16:04.3018528Z,2013,402,142,349,205,0,4,0,197,0,0,260,53,1,397,0,2,0
26765,2992,2020-11-18T16:16:04.3018528Z,2014,377,137,312,183,0,1,0,194,0,0,240,65,0,376,0,3,0
26765,2993,2020-11-18T16:16:04.3028533Z,2015,369,116,306,181,0,2,0,188,0,0,253,63,0,367,0,0,0
26765,2994,2020-11-18T16:16:04.3028533Z,2016,289,104,96,139,0,2,0,150,0,0,185,193,0,287,0,0,0
26765,2995,2020-11-18T16:16:04.3028533Z,2017,262,122,229,132,0,1,1,130,0,0,140,33,0,261,0,0,0
26765,2996,2020-11-18T16:16:04.3028533Z,2018,305,118,256,131,0,2,15,174,0,0,187,49,0,303,0,1,0
26765,2997,2020-11-18T16:16:04.3038542Z,2019,338,99,276,172,0,0,3,166,0,0,239,62,0,338,5,0,0
26765,2998,2020-11-18T16:16:04.3038542Z,2020,311,78,243,151,0,3,0,160,0,0,233,68,0,308,4,0,0
25007,25724,2021-06-24T05:35:08.6770389Z,2021,148,52,124,69,0,2,18,79,0,0,96,24,0,146,0,0,0
25007,2775,2020-11-18T16:16:03.2791692Z,2012,261,50,206,107,0,3,0,154,0,0,211,55,1,256,0,0,1
25007,2776,2020-11-18T16:16:03.2791692Z,2013,265,58,217,112,0,6,0,153,0,0,207,48,1,258,0,4,0
25007,2777,2020-11-18T16:16:03.2801701Z,2014,267,65,225,115,0,5,0,152,0,0,202,42,1,261,0,3,0
25007,2778,2020-11-18T16:16:03.2801701Z,2015,312,79,247,151,0,5,0,161,0,0,233,65,1,305,0,3,1
25007,2779,2020-11-18T16:16:03.2801701Z,2016,279,83,222,135,0,7,0,144,0,0,196,57,1,271,0,2,0
25007,2780,2020-11-18T16:16:03.2801701Z,2017,275,88,230,132,0,5,0,143,0,0,187,45,1,269,0,0,0
25007,2781,2020-11-18T16:16:03.2801701Z,2018,270,83,222,132,0,3,25,138,0,0,187,48,0,267,0,0,0
25007,2782,2020-11-18T16:16:03.281171Z,2019,201,66,173,95,0,3,0,106,0,0,135,28,0,198,0,0,0
25007,2783,2020-11-18T16:16:03.281171Z,2020,165,59,141,75,0,3,24,90,0,0,106,24,0,162,0,0,0
40030,31815,2021-06-24T05:35:16.9029369Z,2021,276,90,244,144,0,5,0,132,0,0,186,32,0,270,0,0,1
40030,4590,2020-11-18T16:16:13.2177962Z,2012,239,53,206,113,0,1,0,126,0,0,186,33,15,219,0,0,4
40030,4591,2020-11-18T16:16:13.2177962Z,2013,229,65,187,98,0,1,0,131,0,0,164,42,15,209,0,1,4
40030,4592,2020-11-18T16:16:13.2177962Z,2014,200,61,164,78,0,0,0,122,0,0,139,36,12,186,0,0,2
40030,4593,2020-11-18T16:16:13.2177962Z,2015,167,54,140,64,0,0,0,103,0,0,113,27,9,157,0,0,1
40030,4594,2020-11-18T16:16:13.2187967Z,2016,150,44,17,68,0,0,0,82,0,0,106,133,8,141,0,0,1
40030,4595,2020-11-18T16:16:13.2187967Z,2017,137,52,120,59,0,0,0,78,0,0,85,17,0,137,0,0,0
40030,4596,2020-11-18T16:16:13.2187967Z,2018,293,87,263,140,0,0,0,153,0,0,206,30,0,291,0,0,2
40030,4597,2020-11-18T16:16:13.2187967Z,2019,260,91,234,135,0,3,0,125,0,0,169,26,0,257,0,0,0
40030,4598,2020-11-18T16:16:13.2187967Z,2020,248,75,216,129,0,2,0,119,0,0,173,32,0,245,0,0,1
41582,25825,2021-06-24T05:35:10.9146439Z,2021,402,118,343,208,0,6,0,194,0,0,284,59,0,394,0,2,2
41582,5013,2020-11-18T16:16:17.0913804Z,2012,408,92,364,187,0,6,0,221,0,0,316,44,0,402,0,0,0
41582,5014,2020-11-18T16:16:17.0913804Z,2013,333,91,295,155,0,5,0,178,0,0,242,38,0,328,0,10,0
41582,5015,2020-11-18T16:16:17.0913804Z,2014,427,130,334,197,0,6,0,230,0,0,297,93,0,421,0,9,0
41582,5016,2020-11-18T16:16:17.0913804Z,2015,409,130,332,200,0,2,0,209,0,0,279,77,0,407,0,6,0
41582,5017,2020-11-18T16:16:17.0923804Z,2016,394,132,280,199,0,4,0,195,0,0,262,114,0,388,0,11,2
41582,5018,2020-11-18T16:16:17.0923804Z,2017,308,113,274,153,0,3,0,155,0,0,195,34,0,305,0,2,0
41582,5019,2020-11-18T16:16:17.0923804Z,2018,448,149,383,212,0,2,2,236,0,0,299,65,0,444,0,2,2
41582,5020,2020-11-18T16:16:17.0923804Z,2019,442,149,393,206,0,1,1,236,0,0,293,49,0,440,0,2,1
41582,5021,2020-11-18T16:16:17.0923804Z,2020,441,142,388,217,0,2,0,224,0,0,299,53,0,436,0,2,3
21659,2258,2020-11-18T16:16:00.0310061Z,2012,393,88,294,191,0,0,0,202,0,0,305,99,0,393,0,0,0
21659,2259,2020-11-18T16:16:00.0320075Z,2013,405,113,307,193,0,0,0,212,0,0,292,98,0,404,0,2,1
21659,2260,2020-11-18T16:16:00.0320075Z,2014,402,139,310,179,0,0,0,223,0,0,263,92,0,402,0,2,0
21659,2261,2020-11-18T16:16:00.0320075Z,2015,400,145,273,180,0,4,0,220,0,0,255,127,0,396,0,0,0
21659,2262,2020-11-18T16:16:00.0320075Z,2016,405,153,125,182,0,1,1,223,0,0,252,280,0,404,0,0,0
21659,2263,2020-11-18T16:16:00.033007Z,2017,366,161,292,167,0,1,2,199,0,0,205,74,0,363,0,0,2
21659,2264,2020-11-18T16:16:00.033007Z,2018,390,140,318,187,0,3,0,203,0,0,250,72,0,384,1,0,3
21659,2265,2020-11-18T16:16:00.033007Z,2019,529,198,442,267,0,3,23,262,0,0,331,87,0,522,7,0,4
21659,2266,2020-11-18T16:16:00.033007Z,2020,504,198,427,242,0,7,19,262,0,0,306,77,0,496,7,0,1
21659,25710,2021-06-24T05:35:08.6670309Z,2021,452,177,383,216,0,3,1,236,0,0,275,69,0,448,5,0,1
71035,10002,2020-11-18T16:16:52.5660373Z,2012,459,97,307,208,0,7,0,251,0,0,362,152,0,452,0,0,0
71035,10003,2020-11-18T16:16:52.5660373Z,2013,450,130,348,202,0,5,0,248,0,0,320,102,0,445,0,0,0
71035,10004,2020-11-18T16:16:52.5670377Z,2014,462,157,392,214,0,6,0,248,0,0,305,70,0,455,0,2,1
71035,10005,2020-11-18T16:16:52.5670377Z,2015,443,139,367,204,0,7,0,239,0,0,304,76,0,435,0,2,1
71035,10006,2020-11-18T16:16:52.5670377Z,2016,369,132,70,165,0,5,0,204,0,0,237,299,0,363,0,0,1
71035,10007,2020-11-18T16:16:52.5670377Z,2017,398,150,329,175,0,6,1,223,0,0,248,69,0,392,0,0,0
71035,10008,2020-11-18T16:16:52.5670377Z,2018,442,156,359,205,0,6,4,237,0,0,286,83,0,436,3,1,0
71035,10009,2020-11-18T16:16:52.5680386Z,2019,416,160,347,204,0,5,3,212,0,0,256,69,0,411,1,1,0
71035,10010,2020-11-18T16:16:52.5680386Z,2020,390,153,194,188,0,3,27,202,0,0,237,196,0,387,1,0,0
71035,31664,2021-06-24T05:35:15.2707668Z,2021,340,123,304,164,0,3,27,176,0,0,217,36,1,336,1,0,0
20537,1787,2020-11-18T16:15:57.4142597Z,2012,255,55,227,122,0,1,0,133,0,0,200,28,0,254,0,0,0
20537,1788,2020-11-18T16:15:57.4142597Z,2013,218,63,190,94,0,0,0,124,0,0,155,28,0,218,0,3,0
20537,1789,2020-11-18T16:15:57.4142597Z,2014,206,71,186,87,0,2,0,119,0,0,135,20,0,204,0,0,0
20537,1790,2020-11-18T16:15:57.4152583Z,2015,213,73,196,90,0,2,0,123,0,0,140,17,0,211,0,0,0
20537,1791,2020-11-18T16:15:57.4152583Z,2016,241,89,183,108,0,2,0,133,0,0,152,58,0,238,0,0,1
20537,1792,2020-11-18T16:15:57.4152583Z,2017,199,72,175,94,0,1,0,105,0,0,127,24,0,197,0,0,1
20537,1793,2020-11-18T16:15:57.4152583Z,2018,185,64,150,88,0,1,0,97,0,0,121,35,0,183,0,0,1
20537,1794,2020-11-18T16:15:57.4152583Z,2019,182,59,164,85,0,0,13,97,0,0,123,18,0,182,0,0,0
20537,1795,2020-11-18T16:15:57.4162592Z,2020,159,58,139,71,0,0,1,88,0,0,101,20,0,159,0,0,0
20537,25693,2021-06-24T05:35:08.6390117Z,2021,151,50,132,65,0,0,1,86,0,0,101,19,0,151,0,0,0
20545,1796,2020-11-18T16:15:57.4122588Z,2012,343,77,278,175,0,4,0,168,0,0,266,65,0,339,0,0,0
20545,1797,2020-11-18T16:15:57.4122588Z,2013,297,83,255,144,0,4,0,153,0,0,214,42,0,293,0,1,0
20545,1798,2020-11-18T16:15:57.4122588Z,2014,267,87,227,135,0,5,0,132,0,0,180,40,1,261,0,2,0
20545,1799,2020-11-18T16:15:57.4122588Z,2015,220,78,188,113,0,5,0,107,0,0,142,32,1,214,0,1,0
20545,1800,2020-11-18T16:15:57.4132574Z,2016,288,107,210,135,0,4,1,153,0,0,181,78,1,283,0,1,0
20545,1801,2020-11-18T16:15:57.8265342Z,2017,260,104,234,121,0,5,2,139,0,0,156,26,0,254,0,0,1
20545,1802,2020-11-18T16:15:57.8265342Z,2018,218,86,185,99,0,1,0,119,0,0,132,33,0,217,3,0,0
20545,1803,2020-11-18T16:15:57.8265342Z,2019,215,81,191,103,0,3,0,112,0,0,134,24,0,211,5,0,1
20545,1804,2020-11-18T16:15:57.8275346Z,2020,200,69,176,92,0,2,0,108,0,0,131,24,0,198,5,0,0
20545,31695,2021-06-24T05:35:15.3067917Z,2021,188,64,170,93,0,3,16,95,0,0,124,18,0,184,3,0,1
41814,31828,2021-06-24T05:35:16.9279555Z,2021,200,62,177,94,0,2,0,106,0,0,138,23,0,198,0,0,0
41814,5047,2020-11-18T16:16:17.1013865Z,2012,290,71,225,143,0,2,0,147,0,0,219,65,0,288,0,0,0
41814,5048,2020-11-18T16:16:17.1013865Z,2013,309,85,237,151,0,2,0,158,0,0,224,72,0,307,0,4,0
41814,5049,2020-11-18T16:16:17.1013865Z,2014,333,92,260,165,0,3,0,168,0,0,241,73,0,330,0,2,0
41814,5050,2020-11-18T16:16:17.1013865Z,2015,319,91,245,156,0,2,0,163,0,0,228,74,0,317,0,2,0
41814,5051,2020-11-18T16:16:17.102387Z,2016,258,80,197,129,0,0,1,129,0,0,178,61,0,258,0,0,0
41814,5052,2020-11-18T16:16:17.102387Z,2017,220,67,187,110,0,0,0,110,0,0,153,33,0,220,0,0,0
41814,5053,2020-11-18T16:16:17.102387Z,2018,200,63,170,98,0,4,0,102,0,0,137,30,0,195,0,0,1
41814,5054,2020-11-18T16:16:17.102387Z,2019,224,70,189,111,0,4,0,113,0,1,154,35,0,220,0,0,0
41814,5055,2020-11-18T16:16:17.102387Z,2020,221,69,179,104,0,1,0,117,0,0,152,42,0,220,0,0,0
12922,25601,2021-06-24T05:35:04.6141251Z,2021,562,221,446,268,0,13,0,294,0,0,341,116,0,547,8,1,2
12922,905,2020-11-18T16:15:52.0186612Z,2012,705,196,534,337,0,1,0,368,0,0,509,171,0,704,0,0,0
12922,906,2020-11-18T16:15:52.0186612Z,2013,700,220,526,365,0,5,0,335,0,0,480,174,0,695,0,2,0
12922,907,2020-11-18T16:15:52.0186612Z,2014,699,231,474,365,0,5,0,334,0,0,468,225,0,694,0,1,0
12922,908,2020-11-18T16:15:52.0186612Z,2015,725,233,478,386,0,9,0,339,0,0,492,247,0,716,0,1,0
12922,909,2020-11-18T16:15:52.0186612Z,2016,702,257,434,343,0,8,0,359,0,0,445,268,0,694,0,0,0
12922,910,2020-11-18T16:15:52.0196603Z,2017,711,255,490,347,0,13,0,364,0,0,456,221,0,698,0,0,0
12922,911,2020-11-18T16:15:52.0196603Z,2018,735,263,472,350,0,15,0,385,0,0,472,263,0,720,13,0,0
12922,912,2020-11-18T16:15:52.0196603Z,2019,677,269,473,335,0,13,0,342,0,0,408,204,0,664,14,0,0
12922,913,2020-11-18T16:15:52.0196603Z,2020,635,246,460,306,0,14,0,329,0,0,389,175,0,619,14,1,2
32540,25776,2021-06-24T05:35:08.7460887Z,2021,178,47,143,77,0,5,0,101,0,0,131,35,0,173,2,0,0
32540,3912,2020-11-18T16:16:09.8715672Z,2012,223,21,173,110,0,4,0,113,0,0,202,50,8,211,0,0,0
32540,3913,2020-11-18T16:16:09.8725681Z,2013,236,26,195,115,0,2,0,121,0,0,210,41,6,228,0,3,0
32540,3914,2020-11-18T16:16:09.8725681Z,2014,226,25,176,106,0,2,0,120,0,0,201,50,4,220,0,1,0
32540,3915,2020-11-18T16:16:09.8725681Z,2015,244,32,183,111,0,11,0,133,0,0,212,61,2,231,0,2,0
32540,3916,2020-11-18T16:16:09.8725681Z,2016,206,34,67,89,0,8,0,117,0,0,172,139,2,196,0,0,0
32540,3917,2020-11-18T16:16:09.8735689Z,2017,162,31,119,74,0,4,0,88,0,0,131,43,1,157,0,0,0
32540,3918,2020-11-18T16:16:09.8735689Z,2018,128,20,86,59,0,5,0,69,0,0,108,42,0,123,2,0,0
32540,3919,2020-11-18T16:16:09.8735689Z,2019,111,27,79,45,0,5,0,66,0,1,84,32,0,106,2,0,0
32540,3920,2020-11-18T16:16:09.8745689Z,2020,152,40,115,66,0,3,2,86,0,0,112,37,0,149,3,0,0
10512,113,2020-11-18T16:15:46.3708934Z,2012,652,172,476,322,0,6,0,330,0,0,480,176,0,645,0,0,1
10512,114,2020-11-18T16:15:46.3708934Z,2013,606,200,434,312,0,3,0,294,0,0,406,172,0,602,0,1,1
10512,115,2020-11-18T16:15:46.3708934Z,2014,598,189,429,310,0,3,0,288,0,0,409,169,0,594,0,1,1
10512,116,2020-11-18T16:15:46.3708934Z,2015,566,175,407,300,0,2,0,266,0,0,391,159,0,564,0,2,0
10512,117,2020-11-18T16:15:46.3708934Z,2016,522,181,358,272,0,4,1,250,0,0,341,164,0,518,0,1,0
10512,118,2020-11-18T16:15:46.3708934Z,2017,503,177,373,264,0,6,1,239,0,0,326,130,0,496,0,2,1
10512,119,2020-11-18T16:15:46.3718947Z,2018,492,159,397,255,0,7,6,237,0,0,333,95,0,484,0,2,1
10512,120,2020-11-18T16:15:46.3718947Z,2019,465,172,335,220,0,2,2,245,0,0,293,130,0,463,0,4,0
10512,121,2020-11-18T16:15:46.3718947Z,2020,504,184,419,243,0,1,0,261,0,0,320,85,0,503,0,4,0
10512,25581,2021-06-24T05:35:04.5911084Z,2021,481,181,417,236,0,3,2,245,0,0,300,64,1,477,0,3,0
21881,2333,2020-11-18T16:16:01.0056545Z,2012,234,47,188,122,0,0,0,112,0,0,187,46,0,234,0,0,0
21881,2334,2020-11-18T16:16:01.0056545Z,2013,216,58,185,115,0,0,0,101,0,0,158,31,0,216,0,0,0
21881,2335,2020-11-18T16:16:01.0066545Z,2014,214,60,176,110,0,0,0,104,0,0,154,38,0,214,0,1,0
21881,2336,2020-11-18T16:16:01.0066545Z,2015,239,70,201,123,0,1,0,116,0,0,169,38,1,237,0,0,0
21881,2337,2020-11-18T16:16:01.0066545Z,2016,267,91,150,144,0,2,10,123,0,0,176,117,0,265,0,0,0
21881,2338,2020-11-18T16:16:01.0076553Z,2017,280,111,236,138,0,2,2,142,0,0,169,44,0,278,0,0,0
21881,2339,2020-11-18T16:16:01.0076553Z,2018,311,117,263,154,2,3,2,157,0,0,194,48,0,308,1,1,0
21881,2340,2020-11-18T16:16:01.0086567Z,2019,350,138,287,163,0,2,1,187,0,0,212,63,0,348,0,0,0
21881,2341,2020-11-18T16:16:01.0086567Z,2020,325,116,265,140,0,2,3,185,0,0,209,60,0,323,0,0,0
21881,31714,2021-06-24T05:35:15.3728395Z,2021,303,110,277,136,0,1,5,167,0,0,193,26,0,302,0,0,0
13334,31869,2021-06-24T05:35:18.4350357Z,2021,91,15,88,41,0,0,1,50,0,0,76,3,0,91,0,3,0
13334,977,2020-11-18T16:15:52.0446772Z,2012,193,35,170,101,0,5,0,92,0,0,158,23,0,188,0,0,0
13334,978,2020-11-18T16:15:52.0446772Z,2013,179,40,160,93,0,5,0,86,0,0,139,19,0,174,0,0,0
13334,979,2020-11-18T16:15:52.0456786Z,2014,167,36,149,84,0,5,0,83,0,0,131,18,0,161,0,4,1
13334,980,2020-11-18T16:15:52.0456786Z,2015,147,42,124,74,0,4,0,73,0,0,105,23,0,142,0,5,1
13334,981,2020-11-18T16:15:52.0456786Z,2016,137,43,121,72,0,5,0,65,0,0,94,16,0,131,0,2,1
13334,982,2020-11-18T16:15:52.0466781Z,2017,116,30,102,62,0,4,0,54,0,0,86,14,0,111,0,2,1
13334,983,2020-11-18T16:15:52.0466781Z,2018,119,19,105,61,0,5,0,58,0,0,100,14,0,113,0,2,1
13334,984,2020-11-18T16:15:52.0466781Z,2019,75,15,62,39,0,2,1,36,0,0,60,13,0,73,0,3,0
13334,985,2020-11-18T16:15:52.0466781Z,2020,89,13,78,44,0,2,1,45,0,0,76,11,0,87,0,3,0
12666,25635,2021-06-24T05:35:04.6861777Z,2021,138,52,130,64,0,1,0,74,0,0,86,8,0,137,0,0,0
12666,802,2020-11-18T16:15:51.323196Z,2012,177,37,139,74,0,3,0,103,0,0,140,38,0,174,0,0,0
12666,803,2020-11-18T16:15:51.323196Z,2013,174,45,134,78,0,3,0,96,0,0,129,40,1,170,0,1,0
12666,804,2020-11-18T16:15:51.324196Z,2014,180,44,143,86,0,3,0,94,0,0,136,37,1,176,0,1,0
12666,805,2020-11-18T16:15:51.324196Z,2015,157,35,129,76,0,3,0,81,0,0,122,28,1,153,0,0,0
12666,806,2020-11-18T16:15:51.324196Z,2016,159,54,141,75,0,3,0,84,0,0,105,18,0,156,0,3,0
12666,807,2020-11-18T16:15:51.324196Z,2017,146,56,135,65,0,1,0,81,0,0,90,11,0,143,0,2,2
12666,808,2020-11-18T16:15:51.324196Z,2018,144,55,128,67,0,1,1,77,0,0,89,16,0,141,1,2,2
12666,809,2020-11-18T16:15:51.3251973Z,2019,151,62,135,61,0,2,0,90,0,0,89,16,0,146,1,2,3
12666,810,2020-11-18T16:15:51.3251973Z,2020,144,57,127,61,0,1,0,83,0,0,87,17,0,140,1,2,3
43745,25842,2021-06-24T05:35:10.9586754Z,2021,309,82,264,156,0,9,0,153,0,0,227,45,0,299,0,2,1
43745,5666,2020-11-18T16:16:21.1811095Z,2012,352,64,273,163,0,0,0,189,0,0,288,79,0,352,0,0,0
43745,5667,2020-11-18T16:16:21.1811095Z,2013,355,77,280,162,0,0,0,193,0,0,278,75,0,355,0,7,0
43745,5668,2020-11-18T16:16:21.1811095Z,2014,346,90,270,166,0,0,0,180,0,0,256,76,0,346,0,3,0
43745,5669,2020-11-18T16:16:21.1811095Z,2015,365,90,279,177,0,0,0,188,0,0,275,86,0,365,0,3,0
43745,5670,2020-11-18T16:16:21.1811095Z,2016,361,103,196,176,0,1,0,185,0,0,258,165,0,360,0,1,0
43745,5671,2020-11-18T16:16:21.1821099Z,2017,407,109,309,198,0,2,1,209,0,0,298,98,0,405,0,1,0
43745,5672,2020-11-18T16:16:21.1821099Z,2018,319,78,242,153,0,2,0,166,0,0,241,77,0,316,2,0,1
43745,5673,2020-11-18T16:16:21.1821099Z,2019,288,79,224,148,0,10,0,140,0,0,209,64,0,278,1,1,0
43745,5674,2020-11-18T16:16:21.1821099Z,2020,255,63,207,136,0,13,0,119,0,0,192,48,0,242,0,0,0
51433,31884,2021-06-24T05:35:18.4560506Z,2021,210,57,177,91,0,8,14,119,0,0,153,33,0,202,1,0,0
51433,6474,2020-11-18T16:16:27.0500206Z,2012,290,42,222,145,0,1,0,145,0,0,248,68,1,288,0,0,0
51433,6475,2020-11-18T16:16:27.0500206Z,2013,311,62,260,162,0,7,0,149,0,0,249,51,0,304,0,3,0
51433,6476,2020-11-18T16:16:27.0510219Z,2014,271,57,222,138,0,5,0,133,0,0,214,49,0,266,0,2,0
51433,6477,2020-11-18T16:16:27.0510219Z,2015,245,53,200,128,0,9,0,117,0,0,192,45,0,236,0,5,0
51433,6478,2020-11-18T16:16:27.0510219Z,2016,219,50,178,111,0,6,2,108,0,0,169,41,0,213,0,3,0
51433,6479,2020-11-18T16:16:27.0510219Z,2017,248,65,214,128,0,11,1,120,0,0,183,34,0,237,0,6,0
51433,6480,2020-11-18T16:16:27.0520228Z,2018,292,66,228,142,0,10,7,150,0,0,226,64,0,282,3,5,0
51433,6481,2020-11-18T16:16:27.0520228Z,2019,216,58,172,93,0,6,12,123,0,0,158,44,0,210,0,2,0
51433,6482,2020-11-18T16:16:27.0520228Z,2020,221,60,164,103,0,5,20,118,0,0,161,57,0,216,0,1,0
71050,10020,2020-11-18T16:16:52.5730422Z,2012,711,145,541,341,0,3,0,370,0,0,566,170,0,707,0,0,1
71050,10021,2020-11-18T16:16:52.5730422Z,2013,587,133,453,286,0,2,0,301,0,0,454,134,0,584,0,1,1
71050,10022,2020-11-18T16:16:52.5730422Z,2014,556,140,414,264,0,1,0,292,0,0,416,142,0,554,0,0,1
71050,10023,2020-11-18T16:16:52.5730422Z,2015,533,144,434,262,0,2,0,271,0,0,389,99,0,530,0,1,1
71050,10024,2020-11-18T16:16:52.5730422Z,2016,393,112,259,190,0,2,0,203,0,0,281,134,0,390,0,0,1
71050,10025,2020-11-18T16:16:52.5740422Z,2017,378,120,293,181,0,2,0,197,0,0,258,85,0,376,0,1,0
71050,10026,2020-11-18T16:16:52.5740422Z,2018,388,122,274,184,0,1,2,204,0,0,266,114,0,386,1,0,1
71050,10027,2020-11-18T16:16:52.5740422Z,2019,416,161,337,190,0,1,3,226,0,0,255,79,0,415,1,0,0
71050,10028,2020-11-18T16:16:52.5740422Z,2020,399,154,328,193,0,1,15,206,0,0,245,71,0,398,0,0,0
71050,31665,2021-06-24T05:35:15.2477505Z,2021,360,137,309,165,0,1,0,195,0,0,223,51,0,359,0,0,0
36046,25805,2021-06-24T05:35:10.8956305Z,2021,333,39,316,165,0,7,109,168,0,0,294,17,9,317,1,2,0
36046,4515,2020-11-18T16:16:13.1827726Z,2012,494,11,413,240,0,7,0,254,0,0,483,81,2,485,0,0,0
36046,4516,2020-11-18T16:16:13.1837739Z,2013,486,22,415,236,0,10,0,250,0,0,464,71,6,470,0,3,0
36046,4517,2020-11-18T16:16:13.1837739Z,2014,471,22,407,248,0,6,0,223,0,0,449,64,9,455,0,2,1
36046,4518,2020-11-18T16:16:13.1837739Z,2015,418,20,356,222,0,12,0,196,0,0,398,62,4,402,0,1,0
36046,4519,2020-11-18T16:16:13.1837739Z,2016,425,51,306,206,0,9,0,219,0,0,374,119,4,412,0,0,0
36046,4520,2020-11-18T16:16:13.1847753Z,2017,442,66,394,200,0,4,0,242,0,0,376,48,11,427,0,4,0
36046,4521,2020-11-18T16:16:13.1847753Z,2018,356,59,316,159,0,3,1,197,0,0,297,40,8,345,1,2,0
36046,4522,2020-11-18T16:16:13.1847753Z,2019,542,78,472,273,0,8,1,269,0,0,464,70,8,525,0,0,1
36046,4523,2020-11-18T16:16:13.1847753Z,2020,364,49,315,179,0,3,0,185,0,0,315,49,8,352,1,1,1
21873,2324,2020-11-18T16:16:01.0036527Z,2012,247,52,205,116,0,2,0,131,0,0,195,42,0,245,0,0,0
21873,2325,2020-11-18T16:16:01.0036527Z,2013,244,71,206,111,0,1,0,133,0,0,173,38,0,243,0,0,0
21873,2326,2020-11-18T16:16:01.0036527Z,2014,205,73,165,97,0,4,0,108,0,0,132,40,0,201,0,0,0
21873,2327,2020-11-18T16:16:01.0046536Z,2015,178,55,139,79,0,3,0,99,0,0,123,39,0,175,0,1,0
21873,2328,2020-11-18T16:16:01.0046536Z,2016,137,11,70,75,0,3,0,62,0,0,126,67,0,134,0,3,0
21873,2329,2020-11-18T16:16:01.0056545Z,2017,174,13,97,90,0,1,0,84,0,0,161,77,0,173,0,3,0
21873,2330,2020-11-18T16:16:01.0056545Z,2018,197,12,103,107,0,1,0,90,0,0,185,94,0,196,0,2,0
21873,2331,2020-11-18T16:16:01.0056545Z,2019,163,11,81,87,0,1,0,76,0,0,152,82,0,161,0,1,1
21873,2332,2020-11-18T16:16:01.0066545Z,2020,188,12,115,102,0,7,0,86,0,0,176,73,0,180,0,1,1
21873,25712,2021-06-24T05:35:08.6670309Z,2021,206,12,165,108,0,3,0,98,0,0,194,41,0,202,0,1,1
20214,1636,2020-11-18T16:15:56.5776995Z,2012,300,56,254,148,0,2,0,152,0,0,244,46,1,297,0,0,0
20214,1637,2020-11-18T16:15:56.5776995Z,2013,332,70,272,167,0,3,0,165,0,0,262,60,1,328,0,1,0
20214,1638,2020-11-18T16:15:56.5787Z,2014,300,71,233,147,0,3,0,153,0,0,229,67,0,297,0,0,0
20214,1639,2020-11-18T16:15:56.5787Z,2015,325,93,233,162,0,2,0,163,0,0,232,92,0,323,0,0,0
20214,1640,2020-11-18T16:15:56.5787Z,2016,352,102,142,179,0,4,0,173,0,0,250,210,0,348,0,0,0
20214,1641,2020-11-18T16:15:56.5787Z,2017,365,108,232,186,0,5,0,179,0,0,257,133,0,360,0,0,0
20214,1642,2020-11-18T16:15:56.5787Z,2018,370,107,227,192,0,3,6,178,0,0,263,143,0,367,0,0,0
20214,1643,2020-11-18T16:15:56.5787Z,2019,404,123,245,204,0,2,3,200,0,0,281,159,0,402,0,0,0
20214,1644,2020-11-18T16:15:56.5797004Z,2020,411,114,253,202,0,4,4,209,0,0,297,158,0,407,0,0,0
20214,25688,2021-06-24T05:35:08.6330074Z,2021,399,127,285,194,0,4,0,205,0,0,272,114,0,395,0,1,0
71357,10180,2020-11-18T16:16:53.2915226Z,2012,553,126,394,295,0,0,0,258,0,0,427,159,0,553,0,0,0
71357,10181,2020-11-18T16:16:53.2915226Z,2013,488,135,359,241,0,3,0,247,0,0,353,129,0,485,0,0,0
71357,10182,2020-11-18T16:16:53.2915226Z,2014,425,114,291,202,0,3,0,223,0,0,311,134,0,422,0,0,0
71357,10183,2020-11-18T16:16:53.2915226Z,2015,459,127,315,216,0,1,0,243,0,0,332,144,0,458,0,0,0
71357,10184,2020-11-18T16:16:53.2925221Z,2016,393,109,287,185,0,1,1,208,0,0,284,106,0,392,0,0,0
71357,10185,2020-11-18T16:16:53.2925221Z,2017,372,101,255,184,0,0,0,188,0,0,271,117,0,372,0,0,0
71357,10186,2020-11-18T16:16:53.2925221Z,2018,351,107,239,164,0,2,0,187,0,0,244,112,0,349,6,0,0
71357,10187,2020-11-18T16:16:53.2925221Z,2019,329,111,246,150,0,4,0,179,0,0,218,83,0,325,3,0,0
71357,10188,2020-11-18T16:16:53.2925221Z,2020,332,106,259,160,0,5,0,172,0,0,226,73,0,327,5,0,0
71357,25667,2021-06-24T05:35:04.7322098Z,2021,286,87,235,134,0,3,0,152,0,0,199,51,0,283,4,0,0
30759,25760,2021-06-24T05:35:08.7320777Z,2021,597,147,478,294,0,14,0,303,0,0,450,119,0,583,0,3,0
30759,3446,2020-11-18T16:16:07.0146585Z,2012,461,127,311,216,0,16,0,245,0,0,334,150,0,445,0,0,0
30759,3447,2020-11-18T16:16:07.0156607Z,2013,602,167,436,297,0,12,0,305,0,0,435,166,0,590,0,4,0
30759,3448,2020-11-18T16:16:07.0156607Z,2014,737,194,527,366,0,17,0,371,0,0,543,210,0,718,0,5,2
30759,3449,2020-11-18T16:16:07.0156607Z,2015,740,192,493,376,0,15,0,364,0,0,548,247,0,724,0,3,1
30759,3450,2020-11-18T16:16:07.0156607Z,2016,734,202,440,356,0,10,0,378,0,0,532,294,0,723,0,0,1
30759,3451,2020-11-18T16:16:07.0156607Z,2017,646,178,430,314,0,11,0,332,0,0,468,216,0,633,0,2,2
30759,3452,2020-11-18T16:16:07.0156607Z,2018,682,172,463,343,0,11,0,339,0,0,510,219,0,671,0,2,0
30759,3453,2020-11-18T16:16:07.0166603Z,2019,656,181,476,315,0,12,0,341,0,0,475,180,1,643,1,3,0
30759,3454,2020-11-18T16:16:07.0166603Z,2020,591,162,428,286,0,13,0,305,0,0,429,163,1,575,0,3,2
11494,25591,2021-06-24T05:35:04.601116Z,2021,218,66,188,104,0,5,0,114,0,0,152,30,0,203,1,1,10
11494,429,2020-11-18T16:15:48.8375422Z,2012,381,66,325,180,0,7,0,201,0,0,315,56,0,359,0,0,15
11494,430,2020-11-18T16:15:48.8375422Z,2013,339,72,297,153,0,8,0,186,0,0,267,42,0,318,0,35,13
11494,431,2020-11-18T16:15:48.8375422Z,2014,334,85,289,146,0,5,0,188,0,0,249,45,0,319,0,19,10
11494,432,2020-11-18T16:15:48.8375422Z,2015,270,78,228,125,0,2,0,145,0,0,192,42,0,264,0,9,4
11494,433,2020-11-18T16:15:48.8385427Z,2016,252,91,136,122,0,2,0,130,0,0,161,116,0,246,0,5,4
11494,434,2020-11-18T16:15:48.8385427Z,2017,296,99,243,136,0,17,0,160,0,0,197,53,0,279,0,5,0
11494,435,2020-11-18T16:15:48.8385427Z,2018,281,75,224,140,0,15,0,141,0,0,206,57,0,266,0,4,0
11494,436,2020-11-18T16:15:48.8385427Z,2019,250,73,209,130,0,5,0,120,0,0,177,41,0,233,0,2,12
11494,437,2020-11-18T16:15:48.8395431Z,2020,241,65,203,116,0,5,0,125,0,0,176,38,0,225,0,1,11
21865,2315,2020-11-18T16:16:01.0036527Z,2012,268,60,221,129,0,0,0,139,0,0,208,47,0,268,0,0,0
21865,2316,2020-11-18T16:16:01.0036527Z,2013,294,80,241,144,0,1,0,150,0,0,214,53,0,293,0,5,0
21865,2317,2020-11-18T16:16:01.0046536Z,2014,392,110,315,192,0,2,0,200,0,0,282,77,0,390,0,3,0
21865,2318,2020-11-18T16:16:01.0056545Z,2015,468,135,371,238,0,1,0,230,0,0,333,97,0,467,0,2,0
21865,2319,2020-11-18T16:16:01.0056545Z,2016,470,131,120,243,0,1,15,227,0,0,339,350,0,469,0,0,0
21865,2320,2020-11-18T16:16:01.0066545Z,2017,385,126,313,198,0,0,9,187,0,0,259,72,0,385,0,0,0
21865,2321,2020-11-18T16:16:01.0066545Z,2018,382,128,293,196,0,1,60,186,0,0,254,89,0,381,1,1,0
21865,2322,2020-11-18T16:16:01.0076553Z,2019,454,140,358,230,0,2,1,224,0,0,314,96,0,452,1,4,0
21865,2323,2020-11-18T16:16:01.0076553Z,2020,427,125,341,222,0,1,14,205,0,0,302,86,0,425,0,0,1
21865,31713,2021-06-24T05:35:15.3708385Z,2021,401,114,347,212,0,1,2,189,0,0,287,54,0,399,1,0,1
32458,31776,2021-06-24T05:35:16.8549029Z,2021,194,32,156,102,0,8,0,92,0,0,162,38,0,186,0,2,0
32458,3875,2020-11-18T16:16:09.1911117Z,2012,426,52,303,202,0,5,0,224,0,0,374,123,0,421,0,0,0
32458,3876,2020-11-18T16:16:09.1921126Z,2013,395,73,298,187,0,4,0,208,0,0,322,97,0,391,0,3,0
32458,3877,2020-11-18T16:16:09.1921126Z,2014,304,64,223,154,0,5,0,150,0,0,240,81,0,299,0,0,0
32458,3878,2020-11-18T16:16:09.1921126Z,2015,347,71,278,165,0,6,0,182,0,0,276,69,0,341,0,2,0
32458,3879,2020-11-18T16:16:09.1921126Z,2016,301,68,217,137,0,8,0,164,0,0,233,84,0,293,0,2,0
32458,3880,2020-11-18T16:16:09.1921126Z,2017,270,70,205,120,0,3,1,150,0,0,200,65,0,267,0,0,0
32458,3881,2020-11-18T16:16:09.1931144Z,2018,260,47,195,127,0,5,0,133,0,0,213,65,0,255,0,1,0
32458,3882,2020-11-18T16:16:09.1931144Z,2019,219,49,168,95,0,3,3,124,0,0,170,51,0,216,0,1,0
32458,3883,2020-11-18T16:16:09.1931144Z,2020,205,45,160,106,0,6,0,99,0,0,160,45,0,199,0,1,0
31393,25767,2021-06-24T05:35:08.741084Z,2021,171,53,159,78,0,1,0,93,0,0,118,12,0,170,0,0,0
31393,3670,2020-11-18T16:16:08.0533528Z,2012,366,58,288,165,0,17,0,201,0,0,308,78,1,348,0,0,0
31393,3671,2020-11-18T16:16:08.0543528Z,2013,407,73,327,196,0,12,0,211,0,0,334,80,0,394,0,3,1
31393,3672,2020-11-18T16:16:08.0543528Z,2014,404,76,331,192,0,9,0,212,0,0,328,73,0,394,0,5,1
31393,3673,2020-11-18T16:16:08.0543528Z,2015,395,66,328,195,0,14,0,200,0,0,329,67,0,381,0,9,0
31393,3674,2020-11-18T16:16:08.0543528Z,2016,374,67,153,185,0,9,0,189,0,0,307,221,0,364,0,4,1
31393,3675,2020-11-18T16:16:08.0553537Z,2017,306,61,250,150,0,9,0,156,0,0,245,56,0,297,0,5,0
31393,3676,2020-11-18T16:16:08.0553537Z,2018,241,47,204,124,0,9,0,117,0,0,194,37,0,232,3,0,0
31393,3677,2020-11-18T16:16:08.0553537Z,2019,202,56,171,107,0,7,0,95,0,0,146,31,0,192,1,0,3
31393,3678,2020-11-18T16:16:08.0563555Z,2020,195,60,166,88,0,2,2,107,0,0,135,29,0,193,0,0,0
58123,31747,2021-06-24T05:35:15.4248764Z,2021,220,77,189,101,0,1,5,119,0,0,143,31,0,219,1,2,0
58123,7807,2020-11-18T16:16:36.3462213Z,2012,315,39,244,156,0,3,0,159,0,0,276,71,1,306,0,0,5
58123,7808,2020-11-18T16:16:36.3462213Z,2013,338,70,266,170,0,3,0,168,0,0,268,72,2,329,0,3,4
58123,7809,2020-11-18T16:16:36.3472213Z,2014,348,82,281,172,0,4,0,176,0,0,266,67,1,343,0,2,0
58123,7810,2020-11-18T16:16:36.3472213Z,2015,333,81,264,154,0,10,0,179,0,0,252,69,1,322,0,5,0
58123,7811,2020-11-18T16:16:36.3472213Z,2016,275,83,222,128,0,11,3,147,0,0,192,53,0,264,0,0,0
58123,7812,2020-11-18T16:16:36.3472213Z,2017,282,82,236,128,0,7,2,154,0,0,200,46,0,275,0,3,0
58123,7813,2020-11-18T16:16:36.3472213Z,2018,280,88,228,136,0,5,9,144,0,1,192,52,0,275,2,2,0
58123,7814,2020-11-18T16:16:36.3472213Z,2019,254,92,210,109,0,3,9,145,0,0,162,44,0,251,3,2,0
58123,7815,2020-11-18T16:16:36.3482222Z,2020,243,86,203,107,0,4,8,136,0,0,157,40,0,239,3,3,0
12765,25637,2021-06-24T05:35:04.6941826Z,2021,250,66,217,131,0,3,0,119,0,0,184,33,0,247,3,1,0
12765,845,2020-11-18T16:15:51.3342035Z,2012,368,65,299,172,0,3,0,196,0,0,303,69,1,364,0,0,0
12765,846,2020-11-18T16:15:51.3342035Z,2013,330,67,283,148,0,3,0,182,0,0,263,47,0,327,0,2,0
12765,847,2020-11-18T16:15:51.3342035Z,2014,315,66,260,151,0,2,0,164,0,0,249,55,0,313,0,1,0
12765,848,2020-11-18T16:15:51.335204Z,2015,256,55,216,125,0,1,0,131,0,0,201,40,1,253,0,0,1
12765,849,2020-11-18T16:15:51.335204Z,2016,286,77,205,143,0,1,0,143,0,0,209,81,0,284,0,0,1
12765,850,2020-11-18T16:15:51.335204Z,2017,275,74,239,134,0,1,0,141,0,0,201,36,0,273,0,2,1
12765,851,2020-11-18T16:15:51.335204Z,2018,233,64,202,112,0,1,0,121,0,0,169,31,0,232,4,0,0
12765,852,2020-11-18T16:15:51.336204Z,2019,264,71,220,123,0,1,2,141,0,1,193,44,0,263,3,1,0
12765,853,2020-11-18T16:15:51.336204Z,2020,260,77,222,133,0,3,0,127,0,0,183,38,0,257,4,2,0
21022,2044,2020-11-18T16:15:58.9172624Z,2012,247,80,215,121,0,0,0,126,0,0,167,32,0,247,0,0,0
21022,2045,2020-11-18T16:15:58.9182628Z,2013,258,99,236,131,0,0,0,127,0,0,159,22,0,258,0,0,0
21022,2046,2020-11-18T16:15:58.9182628Z,2014,255,106,213,135,0,0,0,120,0,0,149,42,0,255,0,0,0
21022,2047,2020-11-18T16:15:58.9182628Z,2015,269,125,235,141,0,1,0,128,0,0,144,34,0,268,0,1,0
21022,2048,2020-11-18T16:15:58.9182628Z,2016,251,118,207,134,0,1,13,117,0,0,133,44,0,250,0,0,0
21022,2049,2020-11-18T16:15:58.9182628Z,2017,177,89,161,92,0,2,2,85,0,0,88,16,0,175,0,0,0
21022,2050,2020-11-18T16:15:58.9182628Z,2018,171,82,145,87,0,1,10,84,0,0,89,26,0,170,0,0,0
21022,2051,2020-11-18T16:15:58.9192637Z,2019,202,86,164,94,0,1,3,108,0,0,116,38,0,201,0,0,0
21022,2052,2020-11-18T16:15:58.9192637Z,2020,195,79,166,91,0,0,5,104,0,0,116,29,0,193,0,0,2
21022,31705,2021-06-24T05:35:15.3388156Z,2021,209,73,172,105,0,0,3,104,0,0,136,37,0,209,0,0,0
11031,284,2020-11-18T16:15:46.8622218Z,2012,476,91,403,240,0,21,0,236,0,0,385,73,0,455,0,0,0
11031,285,2020-11-18T16:15:46.8622218Z,2013,457,97,377,230,0,20,0,227,0,0,360,80,0,437,0,3,0
11031,286,2020-11-18T16:15:46.8632223Z,2014,424,95,334,217,0,14,0,207,0,0,329,90,0,410,0,4,0
11031,287,2020-11-18T16:15:46.8632223Z,2015,383,91,313,193,0,8,0,190,0,0,292,70,0,375,0,3,0
11031,288,2020-11-18T16:15:46.8632223Z,2016,402,102,219,201,0,10,0,201,0,0,300,183,0,392,0,2,0
11031,289,2020-11-18T16:15:46.8632223Z,2017,348,79,277,171,0,6,2,177,0,0,269,71,0,342,0,1,0
11031,290,2020-11-18T16:15:46.8632223Z,2018,353,78,281,184,0,7,15,169,0,0,275,72,0,346,4,0,0
11031,291,2020-11-18T16:15:46.8642227Z,2019,323,78,257,163,0,0,1,160,0,0,245,66,0,323,2,0,0
11031,292,2020-11-18T16:15:46.8642227Z,2020,283,61,222,146,0,0,0,137,0,0,222,61,0,283,6,0,0
11031,31588,2021-06-24T05:35:14.5302353Z,2021,264,55,228,137,0,0,1,127,0,0,209,36,0,264,6,0,0
35014,25793,2021-06-24T05:35:10.8746147Z,2021,272,69,226,126,0,5,0,146,0,0,203,46,0,263,0,0,4
35014,4287,2020-11-18T16:16:11.4796411Z,2012,503,51,253,232,0,0,0,271,0,0,452,250,0,503,0,0,0
35014,4288,2020-11-18T16:16:11.480642Z,2013,439,59,264,208,0,1,0,231,0,0,380,175,1,437,0,5,0
35014,4289,2020-11-18T16:16:11.480642Z,2014,437,66,275,215,0,3,0,222,0,0,371,162,1,431,0,1,2
35014,4290,2020-11-18T16:16:11.480642Z,2015,361,61,214,181,0,6,0,180,0,0,300,147,0,353,0,1,2
35014,4291,2020-11-18T16:16:11.480642Z,2016,313,49,57,150,0,3,0,163,0,0,264,256,0,308,0,1,2
35014,4292,2020-11-18T16:16:11.480642Z,2017,291,59,246,138,0,5,1,153,0,0,232,45,0,284,0,1,2
35014,4293,2020-11-18T16:16:11.480642Z,2018,301,64,259,141,0,3,0,160,0,0,237,42,0,296,0,2,2
35014,4294,2020-11-18T16:16:11.4816434Z,2019,335,74,293,154,0,2,4,181,0,0,261,42,0,331,0,1,2
35014,4295,2020-11-18T16:16:11.4816434Z,2020,293,68,233,133,0,3,0,160,0,0,225,60,0,287,0,1,3
11312,25588,2021-06-24T05:35:04.5991146Z,2021,194,63,174,94,0,4,0,100,0,0,131,20,0,190,0,1,0
11312,347,2020-11-18T16:15:47.584704Z,2012,304,68,265,134,0,4,0,170,0,0,236,39,0,300,0,0,0
11312,348,2020-11-18T16:15:47.5857049Z,2013,307,80,274,133,0,0,0,174,0,0,227,33,0,307,0,0,0
11312,349,2020-11-18T16:15:47.5857049Z,2014,262,68,238,118,0,0,0,144,0,0,194,24,0,262,0,0,0
11312,350,2020-11-18T16:15:47.5857049Z,2015,251,73,215,117,0,0,0,134,0,0,178,36,0,251,0,0,0
11312,351,2020-11-18T16:15:47.5857049Z,2016,226,71,197,116,0,0,0,110,0,0,155,29,0,226,0,0,0
11312,352,2020-11-18T16:15:47.5857049Z,2017,173,55,155,80,0,2,0,93,0,0,118,18,0,171,0,0,0
11312,353,2020-11-18T16:15:47.5867053Z,2018,164,42,135,74,0,2,0,90,0,0,122,29,0,162,1,1,0
11312,354,2020-11-18T16:15:47.5867053Z,2019,182,56,154,83,0,2,0,99,0,0,126,28,0,178,1,2,2
11312,355,2020-11-18T16:15:47.5867053Z,2020,198,65,163,93,0,8,0,105,0,0,133,35,0,190,0,0,0
57835,25745,2021-06-24T05:35:08.7020571Z,2021,260,92,193,121,0,3,10,139,0,0,168,67,0,256,0,0,1
57835,7748,2020-11-18T16:16:35.9129317Z,2012,426,40,353,204,0,2,0,222,0,0,386,73,2,422,0,0,0
57835,7749,2020-11-18T16:16:35.9129317Z,2013,352,71,291,179,0,3,0,173,0,0,281,61,4,344,0,11,1
57835,7750,2020-11-18T16:16:35.9129317Z,2014,325,91,261,162,0,0,0,163,0,0,234,64,0,325,0,9,0
57835,7751,2020-11-18T16:16:35.9139321Z,2015,442,112,350,214,0,3,0,228,0,0,330,92,2,435,0,14,2
57835,7752,2020-11-18T16:16:35.9139321Z,2016,348,113,246,164,0,6,2,184,0,0,235,102,2,340,0,2,0
57835,7753,2020-11-18T16:16:35.9139321Z,2017,329,112,256,149,0,6,1,180,0,0,217,73,1,322,0,2,0
57835,7754,2020-11-18T16:16:35.9139321Z,2018,291,92,233,135,0,4,1,156,0,1,199,58,0,287,0,1,0
57835,7755,2020-11-18T16:16:35.9149326Z,2019,309,117,264,140,0,5,4,169,0,0,192,45,0,304,0,2,0
57835,7756,2020-11-18T16:16:35.9149326Z,2020,318,116,271,149,0,4,0,169,0,0,202,47,0,313,0,0,1
22020,2377,2020-11-18T16:16:01.011658Z,2012,360,101,276,186,0,5,0,174,0,0,259,84,0,354,0,0,1
22020,2378,2020-11-18T16:16:01.011658Z,2013,331,112,247,171,0,10,0,160,0,0,219,84,1,319,0,2,1
22020,2379,2020-11-18T16:16:01.011658Z,2014,327,115,251,165,0,4,0,162,0,0,212,76,0,322,0,1,1
22020,2380,2020-11-18T16:16:01.011658Z,2015,320,123,242,171,0,2,0,149,0,0,197,78,0,318,0,1,0
22020,2381,2020-11-18T16:16:01.0126584Z,2016,286,124,218,141,0,2,0,145,0,0,162,68,0,284,0,1,0
22020,2382,2020-11-18T16:16:01.0126584Z,2017,264,113,204,126,0,3,1,138,0,0,151,60,0,261,0,1,0
22020,2383,2020-11-18T16:16:01.0126584Z,2018,232,86,175,110,0,5,5,122,0,0,146,57,0,227,0,1,0
22020,2384,2020-11-18T16:16:01.0126584Z,2019,250,130,200,100,0,3,8,150,0,0,120,50,0,247,1,2,0
22020,2385,2020-11-18T16:16:01.0126584Z,2020,210,108,164,94,0,1,10,116,0,0,102,46,0,209,1,1,0
22020,31715,2021-06-24T05:35:15.3718381Z,2021,201,102,174,94,0,4,4,107,0,0,99,27,0,196,0,0,1
58248,25931,2021-06-24T05:35:12.8300164Z,2021,138,29,118,58,0,0,0,80,0,0,109,20,0,138,1,0,0
58248,7852,2020-11-18T16:16:36.3572289Z,2012,126,37,111,56,0,3,0,70,0,0,89,15,0,123,0,0,0
58248,7853,2020-11-18T16:16:36.3572289Z,2013,102,34,79,45,0,0,0,57,0,0,68,23,0,102,0,1,0
58248,7854,2020-11-18T16:16:36.3572289Z,2014,121,39,99,64,0,0,0,57,0,0,82,22,0,121,0,2,0
58248,7855,2020-11-18T16:16:36.3572289Z,2015,102,36,80,52,0,1,0,50,0,0,66,22,0,100,0,0,1
58248,7856,2020-11-18T16:16:36.3582294Z,2016,108,32,80,54,0,0,8,54,0,0,76,28,0,108,0,0,0
58248,7857,2020-11-18T16:16:36.3582294Z,2017,102,20,79,54,0,0,9,48,0,0,82,23,0,102,0,0,0
58248,7858,2020-11-18T16:16:36.3582294Z,2018,189,43,138,82,0,0,32,107,0,0,146,51,0,189,1,0,0
58248,7859,2020-11-18T16:16:36.3582294Z,2019,181,45,148,80,0,0,21,101,0,0,136,33,0,181,1,0,0
58248,7860,2020-11-18T16:16:36.3592307Z,2020,158,38,133,68,0,0,20,90,0,0,120,25,0,158,1,0,0
60442,25940,2021-06-24T05:35:12.8390231Z,2021,256,77,216,111,0,4,18,145,0,0,179,40,0,252,0,0,0
60442,8055,2020-11-18T16:16:37.5330136Z,2012,254,39,214,131,0,5,0,123,0,0,215,40,1,248,0,0,0
60442,8056,2020-11-18T16:16:37.534014Z,2013,242,58,203,125,0,2,0,117,0,0,184,39,0,240,0,0,0
60442,8057,2020-11-18T16:16:37.534014Z,2014,216,62,182,114,0,3,0,102,0,0,154,34,0,213,0,0,0
60442,8058,2020-11-18T16:16:37.534014Z,2015,206,53,160,111,0,4,0,95,0,0,153,46,0,202,0,0,0
60442,8059,2020-11-18T16:16:37.534014Z,2016,205,56,171,105,0,4,6,100,0,0,149,34,0,201,0,0,0
60442,8060,2020-11-18T16:16:37.534014Z,2017,243,76,219,110,0,6,6,133,0,0,167,24,0,237,0,2,0
60442,8061,2020-11-18T16:16:37.5350149Z,2018,290,85,266,123,0,3,20,167,0,0,205,24,0,287,0,1,0
60442,8062,2020-11-18T16:16:37.5350149Z,2019,290,75,256,133,0,5,11,157,0,0,215,34,0,285,0,0,0
60442,8063,2020-11-18T16:16:37.5350149Z,2020,238,72,204,105,0,4,15,133,0,0,166,34,0,234,0,0,0
28084,3107,2020-11-18T16:16:05.324536Z,2012,437,119,311,209,0,2,0,228,0,0,318,126,0,435,0,0,0
28084,3108,2020-11-18T16:16:05.324536Z,2013,420,127,302,198,0,3,0,222,0,0,293,118,0,417,0,2,0
28084,3109,2020-11-18T16:16:05.324536Z,2014,411,128,252,197,0,3,0,214,0,0,283,159,0,408,0,1,0
28084,3110,2020-11-18T16:16:05.324536Z,2015,405,121,271,206,0,5,0,199,0,0,284,134,0,400,0,0,0
28084,3111,2020-11-18T16:16:05.324536Z,2016,393,120,242,214,0,3,0,179,0,0,273,151,0,390,0,1,0
28084,3112,2020-11-18T16:16:05.3255364Z,2017,337,99,219,176,0,5,0,161,0,0,238,118,0,332,0,0,0
28084,3113,2020-11-18T16:16:05.3255364Z,2018,279,86,200,134,0,3,2,145,0,0,193,79,0,276,1,0,0
28084,3114,2020-11-18T16:16:05.3255364Z,2019,345,113,229,166,0,4,0,179,0,1,232,116,0,341,0,0,0
28084,3115,2020-11-18T16:16:05.3255364Z,2020,296,95,202,138,0,3,1,158,0,0,201,94,0,293,0,0,0
28084,31738,2021-06-24T05:35:15.4118677Z,2021,254,78,188,116,0,1,2,138,0,0,176,66,1,252,0,0,0
45468,31849,2021-06-24T05:35:16.9779905Z,2021,259,116,210,119,0,4,2,140,0,0,143,49,0,255,4,1,0
45468,5803,2020-11-18T16:16:22.5550217Z,2012,280,3,238,104,0,0,0,176,0,0,277,42,0,280,0,0,0
45468,5804,2020-11-18T16:16:22.5550217Z,2013,242,6,213,93,0,0,0,149,0,0,236,29,0,242,0,0,0
45468,5805,2020-11-18T16:16:22.5550217Z,2014,327,44,293,148,0,0,0,179,0,0,283,34,0,327,0,1,0
45468,5806,2020-11-18T16:16:22.5560212Z,2015,217,26,190,92,0,0,0,125,0,0,191,27,1,216,0,2,0
45468,5807,2020-11-18T16:16:22.5560212Z,2016,213,62,166,84,0,2,2,129,0,0,151,47,1,210,0,2,0
45468,5808,2020-11-18T16:16:22.5560212Z,2017,213,68,164,76,0,5,3,137,0,0,145,49,1,207,0,1,0
45468,5809,2020-11-18T16:16:22.5560212Z,2018,288,100,239,113,0,6,5,175,0,0,188,49,0,282,5,0,0
45468,5810,2020-11-18T16:16:22.5570221Z,2019,239,75,203,98,0,7,0,141,0,0,164,36,0,232,5,0,0
45468,5811,2020-11-18T16:16:22.5570221Z,2020,247,112,225,106,0,7,4,141,0,0,135,22,0,240,3,0,0
62927,25967,2021-06-24T05:35:12.9070723Z,2021,265,81,236,131,0,6,0,134,0,0,184,29,0,259,0,0,0
62927,8748,2020-11-18T16:16:42.8375492Z,2012,242,69,196,127,0,7,0,115,0,0,173,46,0,235,0,0,0
62927,8749,2020-11-18T16:16:42.8375492Z,2013,234,62,189,127,0,7,0,107,0,0,172,45,1,226,0,2,0
62927,8750,2020-11-18T16:16:42.8375492Z,2014,260,76,166,132,0,12,0,128,0,0,184,94,1,246,0,1,1
62927,8751,2020-11-18T16:16:42.8385509Z,2015,343,105,271,173,0,17,0,170,0,0,238,72,1,322,0,2,3
62927,8752,2020-11-18T16:16:42.8385509Z,2016,289,89,154,146,0,4,0,143,0,0,200,135,0,283,0,1,2
62927,8753,2020-11-18T16:16:42.8395514Z,2017,286,79,216,139,0,4,0,147,0,0,207,70,0,280,0,1,2
62927,8754,2020-11-18T16:16:42.8395514Z,2018,329,76,263,167,0,5,2,162,0,0,253,66,0,322,0,0,2
62927,8755,2020-11-18T16:16:42.8405509Z,2019,284,82,238,145,0,5,0,139,0,0,202,46,0,277,0,0,2
62927,8756,2020-11-18T16:16:42.8405509Z,2020,261,78,224,132,0,8,0,129,0,0,183,37,0,251,0,0,2
64410,31977,2021-06-24T05:35:20.2833609Z,2021,243,79,232,124,0,0,2,119,0,0,164,11,0,243,0,0,0
64410,8955,2020-11-18T16:16:44.4506224Z,2012,296,87,271,146,0,2,0,150,0,0,209,25,0,292,0,0,2
64410,8956,2020-11-18T16:16:44.4506224Z,2013,284,86,259,142,0,2,0,142,0,0,198,25,0,279,0,0,3
64410,8957,2020-11-18T16:16:44.4506224Z,2014,273,80,243,135,0,1,0,138,0,0,193,30,0,269,0,0,3
64410,8958,2020-11-18T16:16:44.4506224Z,2015,277,90,258,130,0,2,0,147,0,0,187,19,0,275,0,0,0
64410,8959,2020-11-18T16:16:44.4516224Z,2016,230,77,208,103,0,1,0,127,0,0,153,22,0,229,0,1,0
64410,8960,2020-11-18T16:16:44.4516224Z,2017,243,75,222,130,0,3,1,113,0,0,168,21,0,240,0,1,0
64410,8961,2020-11-18T16:16:44.4516224Z,2018,206,64,188,106,0,2,0,100,0,0,142,18,0,204,0,2,0
64410,8962,2020-11-18T16:16:44.4516224Z,2019,257,85,236,133,0,1,4,124,0,0,172,21,0,256,0,2,0
64410,8963,2020-11-18T16:16:44.4516224Z,2020,247,74,232,131,0,0,4,116,0,0,173,15,0,247,0,0,0
51482,25884,2021-06-24T05:35:12.77898Z,2021,95,19,83,45,0,0,0,50,0,0,76,12,1,94,1,0,0
51482,6501,2020-11-18T16:16:27.7785039Z,2012,121,24,107,53,0,2,0,68,0,0,97,14,0,119,0,0,0
51482,6502,2020-11-18T16:16:27.7785039Z,2013,125,28,108,58,0,2,0,67,0,0,97,17,0,123,0,0,0
51482,6503,2020-11-18T16:16:27.7795052Z,2014,120,27,107,59,0,5,0,61,0,0,93,13,0,115,0,2,0
51482,6504,2020-11-18T16:16:27.7795052Z,2015,118,25,104,50,0,5,0,68,0,0,93,14,0,113,0,2,0
51482,6505,2020-11-18T16:16:27.7795052Z,2016,111,21,99,49,0,3,0,62,0,0,90,12,0,108,0,0,0
51482,6506,2020-11-18T16:16:27.7795052Z,2017,87,16,83,39,0,0,0,48,0,0,71,4,0,87,0,1,0
51482,6507,2020-11-18T16:16:27.7795052Z,2018,93,15,82,47,0,2,10,46,0,0,78,11,0,91,0,1,0
51482,6508,2020-11-18T16:16:27.7805061Z,2019,71,15,68,32,0,2,1,39,0,0,56,3,0,69,1,1,0
51482,6509,2020-11-18T16:16:27.7805061Z,2020,74,17,64,31,0,1,2,43,0,0,57,10,1,72,1,0,0
71878,10516,2020-11-18T16:16:55.4219401Z,2012,328,96,238,167,0,4,0,161,0,0,232,90,0,324,0,0,0
71878,10517,2020-11-18T16:16:55.4219401Z,2013,317,98,211,158,0,5,0,159,0,0,219,106,0,312,0,0,0
71878,10518,2020-11-18T16:16:55.4229401Z,2014,316,93,219,161,0,9,0,155,0,0,223,97,0,307,0,0,0
71878,10519,2020-11-18T16:16:55.4229401Z,2015,329,96,230,166,0,6,0,163,0,0,233,99,0,323,0,4,0
71878,10520,2020-11-18T16:16:55.4229401Z,2016,328,99,222,153,0,6,0,175,0,0,229,106,0,322,0,3,0
71878,10521,2020-11-18T16:16:55.4239406Z,2017,308,84,239,141,0,3,0,167,0,0,224,69,0,305,0,2,0
71878,10522,2020-11-18T16:16:55.4239406Z,2018,287,82,227,134,0,5,0,153,0,0,205,60,0,282,3,0,0
71878,10523,2020-11-18T16:16:55.4239406Z,2019,400,124,331,185,0,2,0,215,0,0,276,69,0,396,3,0,2
71878,10524,2020-11-18T16:16:55.4239406Z,2020,323,92,271,155,0,1,0,168,0,0,231,52,0,319,3,0,3
71878,25623,2021-06-24T05:35:04.6581563Z,2021,316,92,267,159,0,1,0,157,0,0,224,49,0,314,2,4,1
75770,10849,2020-11-18T16:16:57.411269Z,2012,276,104,207,126,0,1,0,150,0,0,172,69,0,275,0,0,0
75770,10850,2020-11-18T16:16:57.411269Z,2013,292,119,221,136,0,0,0,156,0,0,173,71,0,291,0,0,1
75770,10851,2020-11-18T16:16:57.411269Z,2014,223,100,176,102,0,0,0,121,0,0,123,47,0,222,0,0,1
75770,10852,2020-11-18T16:16:57.411269Z,2015,252,93,180,123,0,0,0,129,0,0,159,72,0,250,0,1,2
75770,10853,2020-11-18T16:16:57.4122677Z,2016,282,100,158,137,0,2,0,145,0,0,182,124,0,280,0,0,0
75770,10854,2020-11-18T16:16:57.4122677Z,2017,310,117,217,151,0,2,0,159,0,0,193,93,0,308,0,0,0
75770,10855,2020-11-18T16:16:57.4122677Z,2018,358,104,245,169,0,2,0,189,0,0,254,113,0,356,1,0,0
75770,10856,2020-11-18T16:16:57.4122677Z,2019,335,103,237,166,0,3,0,169,0,0,232,98,0,331,2,0,1
75770,10857,2020-11-18T16:16:57.4122677Z,2020,313,91,235,154,0,4,0,159,0,0,222,78,0,309,1,0,0
75770,25996,2021-06-24T05:35:14.5122229Z,2021,306,89,240,153,0,4,0,153,0,0,217,66,0,302,0,0,0
57026,25922,2021-06-24T05:35:12.8170069Z,2021,199,85,169,94,0,5,18,105,0,0,114,30,1,192,0,0,1
57026,7649,2020-11-18T16:16:35.0863791Z,2012,385,104,332,177,0,11,0,208,0,0,281,53,0,374,0,0,0
57026,7650,2020-11-18T16:16:35.0873813Z,2013,372,100,328,186,0,11,0,186,0,0,272,44,0,361,0,1,0
57026,7651,2020-11-18T16:16:35.0873813Z,2014,351,101,304,178,0,9,0,173,0,0,250,47,0,342,0,0,0
57026,7652,2020-11-18T16:16:35.0873813Z,2015,313,102,272,161,0,11,0,152,0,0,211,41,0,302,0,0,0
57026,7653,2020-11-18T16:16:35.0883809Z,2016,320,115,264,164,0,8,0,156,0,0,205,56,0,311,0,0,1
57026,7654,2020-11-18T16:16:35.0883809Z,2017,222,85,201,97,0,3,0,125,0,0,137,21,0,218,0,0,1
57026,7655,2020-11-18T16:16:35.0883809Z,2018,264,91,203,115,0,5,0,149,0,0,173,61,0,257,0,0,2
57026,7656,2020-11-18T16:16:35.0893809Z,2019,269,100,184,131,0,3,1,138,0,0,169,85,0,266,0,0,0
57026,7657,2020-11-18T16:16:35.0893809Z,2020,242,100,210,119,0,2,2,123,0,0,142,32,0,239,0,0,1
30098,31754,2021-06-24T05:35:15.4558989Z,2021,333,111,264,132,0,10,9,201,0,0,222,69,0,323,0,1,0
30098,3214,2020-11-18T16:16:05.7127936Z,2012,305,4,196,150,0,2,0,155,0,0,301,109,4,297,0,0,2
30098,3215,2020-11-18T16:16:05.7137944Z,2013,261,8,167,122,0,4,0,139,0,0,253,94,3,252,0,1,2
30098,3216,2020-11-18T16:16:05.7137944Z,2014,301,30,222,139,0,6,0,162,0,0,271,79,0,292,0,4,3
30098,3217,2020-11-18T16:16:05.7137944Z,2015,325,27,256,156,0,6,0,169,0,0,298,69,0,316,0,6,3
30098,3218,2020-11-18T16:16:05.7137944Z,2016,448,74,290,221,0,10,3,227,0,0,374,158,0,437,0,6,1
30098,3219,2020-11-18T16:16:05.7147958Z,2017,510,73,409,242,0,10,1,268,0,0,437,101,0,500,0,5,0
30098,3220,2020-11-18T16:16:05.7147958Z,2018,436,82,330,193,0,12,18,243,0,0,354,106,0,424,0,4,0
30098,3221,2020-11-18T16:16:05.7147958Z,2019,392,78,307,185,0,7,4,207,0,0,314,85,0,385,0,2,0
30098,3222,2020-11-18T16:16:05.7157962Z,2020,404,115,331,164,0,9,9,240,0,0,289,73,0,395,0,1,0
62646,31965,2021-06-24T05:35:20.2693504Z,2021,357,127,339,156,0,14,0,201,0,0,230,18,5,338,0,3,0
62646,8621,2020-11-18T16:16:42.1961228Z,2012,213,61,177,97,0,10,0,116,0,0,152,36,0,203,0,0,0
62646,8622,2020-11-18T16:16:42.1961228Z,2013,276,97,243,132,0,10,0,144,0,0,179,33,0,266,0,0,0
62646,8623,2020-11-18T16:16:42.1961228Z,2014,275,97,240,125,0,13,0,150,0,0,178,35,0,262,0,0,0
62646,8624,2020-11-18T16:16:42.1961228Z,2015,262,89,211,132,0,12,0,130,0,0,173,51,0,250,0,0,0
62646,8625,2020-11-18T16:16:42.1961228Z,2016,226,83,176,103,0,5,0,123,0,0,143,50,0,221,0,0,0
62646,8626,2020-11-18T16:16:42.1961228Z,2017,197,68,189,87,0,4,1,110,0,0,129,8,0,193,0,2,0
62646,8627,2020-11-18T16:16:42.1971233Z,2018,269,98,243,120,0,4,0,149,0,0,171,26,1,264,0,0,0
62646,8628,2020-11-18T16:16:42.1971233Z,2019,296,113,283,132,0,10,0,164,0,0,183,13,0,286,0,0,0
62646,8629,2020-11-18T16:16:42.1971233Z,2020,367,131,344,160,0,15,1,207,0,0,236,23,0,352,0,0,0
75788,10858,2020-11-18T16:16:57.4132695Z,2012,438,163,324,214,0,2,0,224,0,0,275,114,1,432,0,0,3
75788,10859,2020-11-18T16:16:57.4132695Z,2013,437,168,327,220,0,4,0,217,0,0,269,110,0,428,0,3,5
75788,10860,2020-11-18T16:16:57.4132695Z,2014,447,178,297,222,0,8,0,225,0,0,269,150,1,435,0,3,3
75788,10861,2020-11-18T16:16:57.4132695Z,2015,501,194,412,255,0,5,0,246,0,0,307,89,1,493,0,0,2
75788,10862,2020-11-18T16:16:57.4132695Z,2016,530,206,247,256,0,8,0,274,0,0,324,283,1,519,0,0,2
75788,10863,2020-11-18T16:16:57.4142695Z,2017,485,194,404,241,0,7,0,244,0,0,291,81,1,476,0,1,1
75788,10864,2020-11-18T16:16:57.4142695Z,2018,494,179,390,238,0,9,1,256,0,0,315,104,1,484,1,1,0
75788,10865,2020-11-18T16:16:57.4142695Z,2019,478,185,373,227,0,8,0,251,0,0,293,105,1,469,1,1,0
75788,10866,2020-11-18T16:16:57.4142695Z,2020,482,180,383,220,0,8,0,262,0,0,302,99,2,472,1,1,0
75788,31998,2021-06-24T05:35:20.3223886Z,2021,427,146,338,188,0,5,0,239,0,0,281,89,2,419,0,1,1
53702,31907,2021-06-24T05:35:18.4830702Z,2021,241,65,173,118,0,0,7,123,0,0,176,68,0,241,2,1,0
53702,7320,2020-11-18T16:16:33.2391478Z,2012,321,71,156,177,0,0,0,144,0,0,250,165,0,321,0,0,0
53702,7321,2020-11-18T16:16:33.2391478Z,2013,314,70,159,172,0,0,0,142,0,0,244,155,0,314,0,3,0
53702,7322,2020-11-18T16:16:33.2401478Z,2014,318,73,172,171,0,0,0,147,0,0,245,146,0,318,0,1,0
53702,7323,2020-11-18T16:16:33.2401478Z,2015,328,63,164,179,0,2,0,149,0,0,265,164,0,326,0,2,0
53702,7324,2020-11-18T16:16:33.2401478Z,2016,302,56,112,162,0,0,1,140,0,0,246,190,1,301,0,2,0
53702,7325,2020-11-18T16:16:33.2411482Z,2017,255,57,157,133,0,1,0,122,0,0,198,98,0,254,0,0,0
53702,7326,2020-11-18T16:16:33.2411482Z,2018,249,55,165,125,0,0,0,124,0,0,194,84,0,249,4,0,0
53702,7327,2020-11-18T16:16:33.2411482Z,2019,289,76,192,156,0,0,1,133,0,1,213,97,0,289,3,2,0
53702,7328,2020-11-18T16:16:33.2411482Z,2020,272,73,98,142,0,0,0,130,0,0,199,174,0,272,3,1,0
34355,31790,2021-06-24T05:35:16.8659102Z,2021,275,91,234,128,0,2,1,147,0,0,184,41,0,273,0,1,0
34355,4203,2020-11-18T16:16:11.4376126Z,2012,578,70,414,298,0,7,0,280,0,0,508,164,0,570,0,0,1
34355,4204,2020-11-18T16:16:11.4376126Z,2013,500,87,382,250,0,10,0,250,0,0,413,118,0,489,0,2,1
34355,4205,2020-11-18T16:16:11.4376126Z,2014,432,99,345,203,0,8,0,229,0,0,333,87,0,424,0,1,0
34355,4206,2020-11-18T16:16:11.4386144Z,2015,381,99,317,175,0,5,0,206,0,0,282,64,0,376,0,0,0
34355,4207,2020-11-18T16:16:11.4386144Z,2016,260,75,210,131,0,1,1,129,0,0,185,50,0,259,0,0,0
34355,4208,2020-11-18T16:16:11.4386144Z,2017,236,54,201,122,0,2,0,114,0,0,182,35,0,234,0,0,0
34355,4209,2020-11-18T16:16:11.4396144Z,2018,342,99,261,159,0,3,2,183,0,0,243,81,0,339,0,2,0
34355,4210,2020-11-18T16:16:11.4396144Z,2019,351,113,259,176,0,5,4,175,0,0,238,92,0,346,0,1,0
34355,4211,2020-11-18T16:16:11.4396144Z,2020,316,104,251,152,0,4,0,164,0,0,212,65,0,311,0,0,1
44511,31845,2021-06-24T05:35:16.9799924Z,2021,74,21,70,35,0,2,0,39,0,0,53,4,0,72,0,1,0
44511,5693,2020-11-18T16:16:21.1861131Z,2012,279,68,230,128,0,11,0,151,0,0,211,49,0,267,0,0,1
44511,5694,2020-11-18T16:16:21.1861131Z,2013,280,72,227,126,0,7,0,154,0,0,208,53,4,268,0,6,1
44511,5695,2020-11-18T16:16:21.1861131Z,2014,255,64,209,119,0,6,0,136,0,0,191,46,5,244,0,3,0
44511,5696,2020-11-18T16:16:21.1871139Z,2015,240,67,200,111,0,3,0,129,0,0,173,40,3,234,0,2,0
44511,5697,2020-11-18T16:16:21.1871139Z,2016,236,67,196,110,0,2,0,126,0,0,169,40,1,233,0,1,0
44511,5698,2020-11-18T16:16:21.1871139Z,2017,214,61,173,101,0,3,0,113,0,0,153,41,2,209,0,2,0
44511,5699,2020-11-18T16:16:21.1871139Z,2018,179,50,151,89,0,3,0,90,0,0,129,28,2,173,0,2,1
44511,5700,2020-11-18T16:16:21.1881148Z,2019,105,30,92,51,0,3,0,54,0,0,75,13,1,99,0,1,2
44511,5701,2020-11-18T16:16:22.0767036Z,2020,87,25,77,40,0,2,0,47,0,0,62,10,1,83,0,1,1
41061,31825,2021-06-24T05:35:16.9289556Z,2021,705,177,514,341,0,27,0,364,0,0,528,191,0,678,5,4,0
41061,4949,2020-11-18T16:16:16.6640974Z,2012,308,5,165,158,0,15,0,150,0,0,303,143,0,293,0,0,0
41061,4950,2020-11-18T16:16:16.6640974Z,2013,527,12,320,263,0,16,0,264,0,0,515,207,0,511,0,3,0
41061,4951,2020-11-18T16:16:16.6650974Z,2014,534,40,324,249,0,21,0,285,0,0,494,210,0,512,0,4,1
41061,4952,2020-11-18T16:16:16.6650974Z,2015,538,34,325,267,0,17,0,271,0,0,504,213,0,520,0,3,1
41061,4953,2020-11-18T16:16:16.6650974Z,2016,755,132,411,371,0,20,0,384,0,0,623,344,0,734,0,3,1
41061,4954,2020-11-18T16:16:16.6650974Z,2017,767,131,440,374,0,22,0,393,0,0,636,327,0,745,0,3,0
41061,4955,2020-11-18T16:16:16.6660987Z,2018,712,124,413,350,0,19,12,362,0,1,588,299,0,693,8,2,0
41061,4956,2020-11-18T16:16:16.6660987Z,2019,721,139,457,362,0,22,2,359,0,0,582,264,0,699,10,4,0
41061,4957,2020-11-18T16:16:16.6660987Z,2020,716,176,452,345,0,20,1,371,0,0,540,264,0,696,11,4,0
42085,31830,2021-06-24T05:35:16.9519719Z,2021,182,112,163,75,0,0,0,107,0,0,70,19,0,181,0,0,1
42085,5128,2020-11-18T16:16:17.8108581Z,2012,188,92,160,84,0,1,0,104,0,0,96,28,0,187,0,0,0
42085,5129,2020-11-18T16:16:17.8108581Z,2013,175,94,162,77,0,0,0,98,0,0,81,13,0,175,0,0,0
42085,5130,2020-11-18T16:16:17.8108581Z,2014,180,91,165,81,0,7,0,99,0,0,89,15,0,173,0,0,0
42085,5131,2020-11-18T16:16:17.8108581Z,2015,194,107,186,76,0,6,0,118,0,0,87,8,0,188,0,0,0
42085,5132,2020-11-18T16:16:17.8118604Z,2016,195,104,146,80,0,8,3,115,0,0,91,49,0,187,0,0,0
42085,5133,2020-11-18T16:16:17.8118604Z,2017,239,147,226,96,0,10,4,143,0,0,92,13,0,229,0,0,0
42085,5134,2020-11-18T16:16:17.8118604Z,2018,222,133,217,87,0,8,4,135,0,0,89,5,0,214,0,0,0
42085,5135,2020-11-18T16:16:17.8118604Z,2019,197,125,185,92,0,7,2,105,0,0,72,12,0,190,0,0,0
42085,5136,2020-11-18T16:16:17.812859Z,2020,192,120,189,84,0,4,1,108,0,0,72,3,0,187,0,0,1
47357,31859,2021-06-24T05:35:18.4240281Z,2021,323,116,282,162,0,11,0,161,0,0,207,41,0,312,0,1,0
47357,5982,2020-11-18T16:16:23.534675Z,2012,542,179,328,256,0,16,0,286,0,0,363,214,0,526,0,0,0
47357,5983,2020-11-18T16:16:23.534675Z,2013,602,228,475,289,0,22,0,313,0,0,374,127,1,578,0,8,1
47357,5984,2020-11-18T16:16:23.534675Z,2014,540,196,386,267,0,21,0,273,0,0,344,154,0,519,0,6,0
47357,5985,2020-11-18T16:16:23.534675Z,2015,475,165,366,235,0,15,0,240,0,0,310,109,0,460,0,2,0
47357,5986,2020-11-18T16:16:23.5356763Z,2016,482,161,342,230,0,14,0,252,0,0,321,140,0,468,0,1,0
47357,5987,2020-11-18T16:16:23.5356763Z,2017,491,166,395,229,0,13,4,262,0,0,325,96,0,478,0,0,0
47357,5988,2020-11-18T16:16:23.5356763Z,2018,481,140,358,246,0,13,0,235,0,0,341,123,0,468,1,4,0
47357,5989,2020-11-18T16:16:23.5356763Z,2019,495,197,413,240,0,14,2,255,0,0,298,82,0,481,0,2,0
47357,5990,2020-11-18T16:16:23.5366777Z,2020,385,153,330,182,0,11,0,203,0,0,232,55,0,372,0,1,2
75234,10748,2020-11-18T16:16:56.8939223Z,2012,322,108,239,144,0,4,0,178,0,0,214,83,0,318,0,0,0
75234,10749,2020-11-18T16:16:56.8939223Z,2013,300,84,220,144,0,2,0,156,0,0,216,80,0,298,0,2,0
75234,10750,2020-11-18T16:16:56.8939223Z,2014,311,79,244,160,0,5,0,151,0,0,232,67,0,306,0,2,0
75234,10751,2020-11-18T16:16:56.8949223Z,2015,302,81,235,165,0,4,0,137,0,0,221,67,0,298,0,0,0
75234,10752,2020-11-18T16:16:56.8949223Z,2016,270,79,209,143,0,3,0,127,0,0,191,61,0,267,0,0,0
75234,10753,2020-11-18T16:16:56.8949223Z,2017,300,84,213,161,0,5,0,139,0,0,216,87,0,295,0,0,0
75234,10754,2020-11-18T16:16:56.8949223Z,2018,324,87,232,174,0,4,0,150,0,0,237,92,0,320,3,0,0
75234,10755,2020-11-18T16:16:56.8949223Z,2019,354,94,263,184,0,6,0,170,0,0,260,91,0,348,3,0,0
75234,10756,2020-11-18T16:16:56.8959232Z,2020,380,100,290,196,0,9,1,184,0,0,280,90,0,371,3,0,0
75234,25680,2021-06-24T05:35:08.6250007Z,2021,395,109,315,202,0,10,0,193,0,0,286,80,0,385,3,0,0
25312,2866,2020-11-18T16:16:03.6934464Z,2012,248,40,146,136,0,1,0,112,0,0,208,102,0,247,0,0,0
25312,2867,2020-11-18T16:16:03.6944468Z,2013,222,31,105,123,0,0,0,99,0,0,191,117,0,222,0,7,0
25312,2868,2020-11-18T16:16:03.6944468Z,2014,335,49,179,187,0,0,0,148,0,0,286,156,0,335,0,8,0
25312,2869,2020-11-18T16:16:03.6944468Z,2015,351,54,163,183,0,1,0,168,0,0,297,188,0,350,0,7,0
25312,2870,2020-11-18T16:16:03.6954473Z,2016,318,42,146,152,0,2,0,166,0,0,276,172,0,316,0,3,0
25312,2871,2020-11-18T16:16:03.6954473Z,2017,321,52,163,163,0,4,0,158,0,0,269,158,0,317,0,4,0
25312,2872,2020-11-18T16:16:03.6954473Z,2018,337,50,179,177,0,2,16,160,0,0,287,158,0,335,3,3,0
25312,2873,2020-11-18T16:16:03.6964486Z,2019,304,49,163,170,0,0,0,134,0,0,255,141,0,304,5,1,0
25312,2874,2020-11-18T16:16:03.6964486Z,2020,361,55,211,201,0,1,13,160,0,0,306,150,1,359,5,0,0
25312,31726,2021-06-24T05:35:15.3848486Z,2021,365,53,239,197,0,1,9,168,0,0,312,126,0,364,4,0,0
56085,25917,2021-06-24T05:35:12.8110034Z,2021,343,124,278,138,0,2,2,205,0,0,219,65,0,341,2,1,0
56085,7550,2020-11-18T16:16:34.5290074Z,2012,369,69,239,168,0,2,0,201,0,0,300,130,0,367,0,0,0
56085,7551,2020-11-18T16:16:34.5290074Z,2013,254,67,180,121,0,3,0,133,0,0,187,74,0,251,0,2,0
56085,7552,2020-11-18T16:16:34.5300079Z,2014,420,123,327,185,0,3,0,235,0,0,297,93,0,414,0,4,3
56085,7553,2020-11-18T16:16:34.5300079Z,2015,380,105,291,170,0,3,0,210,0,0,275,89,0,376,0,8,1
56085,7554,2020-11-18T16:16:34.5300079Z,2016,410,131,320,208,0,2,0,202,0,0,279,90,0,407,0,0,1
56085,7555,2020-11-18T16:16:34.5300079Z,2017,416,146,327,221,0,1,6,195,0,0,270,89,0,415,0,2,0
56085,7556,2020-11-18T16:16:34.5300079Z,2018,370,137,273,179,0,0,10,191,0,0,233,97,0,370,2,0,0
56085,7557,2020-11-18T16:16:34.5310101Z,2019,366,144,303,149,0,2,6,217,0,0,222,63,0,364,5,1,0
56085,7558,2020-11-18T16:16:34.5310101Z,2020,363,139,296,141,0,5,6,222,0,0,224,67,0,358,8,0,0
66316,25985,2021-06-24T05:35:14.5062186Z,2021,361,43,187,186,0,13,0,175,0,0,318,174,1,347,0,0,0
66316,9201,2020-11-18T16:16:46.6881171Z,2012,355,34,143,201,0,8,0,154,0,0,321,212,0,346,0,0,1
66316,9202,2020-11-18T16:16:46.6891197Z,2013,350,52,144,199,0,10,0,151,0,0,298,206,0,339,0,0,1
66316,9203,2020-11-18T16:16:46.6891197Z,2014,409,75,180,214,0,16,0,195,0,0,334,229,0,392,0,0,1
66316,9204,2020-11-18T16:16:46.6891197Z,2015,395,89,210,219,0,11,0,176,0,0,306,185,0,384,0,0,0
66316,9205,2020-11-18T16:16:46.6901179Z,2016,400,89,184,203,0,12,0,197,0,0,311,216,0,388,0,0,0
66316,9206,2020-11-18T16:16:46.6901179Z,2017,302,47,144,143,0,9,0,159,0,0,255,158,0,291,0,0,2
66316,9207,2020-11-18T16:16:46.6901179Z,2018,322,36,117,166,0,3,0,156,0,0,286,205,4,313,0,0,2
66316,9208,2020-11-18T16:16:46.6911197Z,2019,335,50,146,181,0,6,0,154,0,0,285,189,3,326,1,0,0
66316,9209,2020-11-18T16:16:46.6911197Z,2020,342,35,164,183,0,11,0,159,0,0,307,178,4,327,0,0,0
56820,25744,2021-06-24T05:35:08.7040576Z,2021,627,192,486,301,0,17,3,326,0,0,435,141,0,610,0,3,0
56820,7622,2020-11-18T16:16:35.0773746Z,2012,563,1,422,319,0,3,0,244,0,0,562,141,1,558,0,0,1
56820,7623,2020-11-18T16:16:35.0783742Z,2013,523,3,400,285,0,4,0,238,0,0,520,123,0,517,0,7,2
56820,7624,2020-11-18T16:16:35.0783742Z,2014,444,13,350,242,0,2,0,202,0,0,431,94,0,440,0,9,2
56820,7625,2020-11-18T16:16:35.0783742Z,2015,364,26,295,194,0,1,0,170,0,0,338,69,1,359,0,3,3
56820,7626,2020-11-18T16:16:35.0793746Z,2016,416,59,140,214,0,5,0,202,0,0,357,276,2,409,0,3,0
56820,7627,2020-11-18T16:16:35.0793746Z,2017,382,52,291,194,0,5,0,188,0,0,330,91,2,374,0,2,1
56820,7628,2020-11-18T16:16:35.0793746Z,2018,365,60,296,178,0,4,1,187,0,0,305,69,1,358,0,1,2
56820,7629,2020-11-18T16:16:35.080376Z,2019,689,193,546,323,0,14,3,366,0,0,496,143,0,675,0,4,0
56820,7630,2020-11-18T16:16:35.080376Z,2020,637,196,513,304,0,15,1,333,0,0,441,124,0,622,0,4,0
47894,31862,2021-06-24T05:35:18.4280305Z,2021,890,193,711,435,0,5,2,455,0,0,697,179,0,884,0,4,1
47894,6050,2020-11-18T16:16:23.9789718Z,2012,801,3,563,405,0,31,0,396,0,0,798,238,1,769,0,0,0
47894,6051,2020-11-18T16:16:23.9789718Z,2013,823,3,561,408,0,18,0,415,0,0,820,262,1,804,0,0,0
47894,6052,2020-11-18T16:16:23.9789718Z,2014,834,29,552,422,0,15,0,412,0,0,805,282,0,819,0,0,0
47894,6053,2020-11-18T16:16:23.9799727Z,2015,862,20,577,438,0,17,0,424,0,0,842,285,0,845,0,2,0
47894,6054,2020-11-18T16:16:23.9799727Z,2016,864,54,74,446,0,16,0,418,0,0,810,790,0,847,0,1,1
47894,6055,2020-11-18T16:16:23.9799727Z,2017,736,62,446,382,0,9,5,354,0,0,674,290,0,727,0,2,0
47894,6056,2020-11-18T16:16:23.9799727Z,2018,827,84,569,414,0,10,13,413,0,0,743,258,0,817,0,1,0
47894,6057,2020-11-18T16:16:23.9809731Z,2019,1022,143,742,496,0,10,3,526,0,0,879,280,0,1012,0,1,0
47894,6058,2020-11-18T16:16:23.9809731Z,2020,930,182,657,464,0,5,2,466,0,0,748,273,0,925,0,0,0
11320,31590,2021-06-24T05:35:14.5542521Z,2021,322,78,275,160,0,3,1,162,0,0,244,47,0,318,5,0,1
11320,356,2020-11-18T16:15:47.584704Z,2012,308,44,253,149,0,1,0,159,0,0,264,55,6,301,0,0,0
11320,357,2020-11-18T16:15:47.5857049Z,2013,294,60,250,140,0,1,0,154,0,0,234,44,3,290,0,1,0
11320,358,2020-11-18T16:15:47.5857049Z,2014,290,70,233,148,0,0,0,142,0,0,220,57,2,288,0,0,0
11320,359,2020-11-18T16:15:47.5857049Z,2015,279,70,228,153,0,3,0,126,0,0,209,51,1,275,0,1,0
11320,360,2020-11-18T16:15:47.5857049Z,2016,239,70,188,133,0,2,1,106,0,0,169,51,0,237,0,1,0
11320,361,2020-11-18T16:15:47.5867053Z,2017,260,73,202,152,0,3,1,108,0,0,187,58,0,257,0,1,0
11320,362,2020-11-18T16:15:47.5867053Z,2018,286,79,243,150,0,3,57,136,0,0,207,43,0,283,3,0,0
11320,363,2020-11-18T16:15:47.5867053Z,2019,335,86,260,176,0,0,0,159,0,0,249,75,0,335,5,0,0
11320,364,2020-11-18T16:15:47.5867053Z,2020,322,80,270,161,0,4,0,161,0,0,242,52,0,318,5,0,0
35618,25798,2021-06-24T05:35:10.8766157Z,2021,605,126,447,287,0,10,0,318,0,0,479,158,0,594,3,5,1
35618,4383,2020-11-18T16:16:12.1811066Z,2012,671,1,477,369,0,7,0,302,0,0,670,194,6,637,0,0,21
35618,4384,2020-11-18T16:16:12.1811066Z,2013,647,9,468,360,0,9,0,287,0,0,638,179,9,619,0,2,10
35618,4385,2020-11-18T16:16:12.1811066Z,2014,658,36,456,378,0,11,0,280,0,0,622,202,6,641,0,1,0
35618,4386,2020-11-18T16:16:12.1821071Z,2015,683,34,489,369,0,12,0,314,0,0,649,194,3,668,0,2,0
35618,4387,2020-11-18T16:16:12.1821071Z,2016,732,73,514,386,0,16,0,346,0,0,659,218,1,714,0,2,1
35618,4388,2020-11-18T16:16:12.1821071Z,2017,894,121,643,445,0,12,0,449,0,0,773,251,3,878,0,4,1
35618,4389,2020-11-18T16:16:12.1831075Z,2018,778,96,533,390,0,9,1,388,0,0,682,245,2,766,1,4,1
35618,4390,2020-11-18T16:16:12.1831075Z,2019,636,83,473,326,0,9,0,310,0,0,553,163,2,624,1,4,1
35618,4391,2020-11-18T16:16:12.1831075Z,2020,638,130,463,308,0,8,0,330,0,0,508,175,0,630,5,5,0
56432,25920,2021-06-24T05:35:12.813004Z,2021,528,155,441,253,0,8,0,275,0,0,373,87,0,518,4,0,2
56432,7604,2020-11-18T16:16:35.0703684Z,2012,625,0,477,337,0,23,0,288,0,0,625,148,0,601,0,0,1
56432,7605,2020-11-18T16:16:35.0703684Z,2013,640,3,519,346,0,14,0,294,0,0,637,121,0,626,0,1,0
56432,7606,2020-11-18T16:16:35.0703684Z,2014,616,50,507,315,0,8,0,301,0,0,566,109,0,608,0,3,0
56432,7607,2020-11-18T16:16:35.0713697Z,2015,607,37,501,313,0,3,0,294,0,0,570,106,0,604,0,3,0
56432,7608,2020-11-18T16:16:35.0713697Z,2016,540,74,246,283,0,2,4,257,0,0,466,294,0,537,0,1,1
56432,7609,2020-11-18T16:16:35.0713697Z,2017,430,62,354,210,0,2,0,220,0,0,368,76,0,428,0,1,0
56432,7610,2020-11-18T16:16:35.0713697Z,2018,509,123,419,239,0,4,8,270,0,0,386,90,0,505,5,1,0
56432,7611,2020-11-18T16:16:35.0723697Z,2019,500,107,406,227,0,5,9,273,0,0,393,94,0,495,2,2,0
56432,7612,2020-11-18T16:16:35.0723697Z,2020,457,136,376,213,0,4,1,244,0,0,321,81,0,452,0,0,1
17368,1351,2020-11-18T16:15:54.3101911Z,2012,625,0,422,318,0,2,0,307,0,0,625,203,0,623,0,0,0
17368,1352,2020-11-18T16:15:54.3111911Z,2013,563,2,374,264,0,1,0,299,0,0,561,189,0,562,0,3,0
17368,1353,2020-11-18T16:15:54.3111911Z,2014,527,35,361,263,0,2,0,264,0,0,492,166,0,524,0,2,1
17368,1354,2020-11-18T16:15:54.3111911Z,2015,556,51,382,275,0,1,0,281,0,0,505,174,0,553,0,2,2
17368,1355,2020-11-18T16:15:54.3111911Z,2016,666,128,78,371,0,5,1,295,0,0,538,588,0,660,0,1,1
17368,1356,2020-11-18T16:15:54.3111911Z,2017,714,132,502,389,0,7,1,325,0,0,582,212,0,707,0,2,0
17368,1357,2020-11-18T16:15:54.3121919Z,2018,664,110,462,355,0,7,1,309,0,0,554,202,0,657,5,2,0
17368,1358,2020-11-18T16:15:54.3121919Z,2019,504,91,359,245,1,4,0,259,0,0,413,145,0,500,6,0,0
17368,1359,2020-11-18T16:15:54.3121919Z,2020,445,110,286,218,0,3,0,227,0,0,335,159,0,441,8,0,1
17368,31609,2021-06-24T05:35:14.586276Z,2021,377,104,279,173,0,1,0,204,0,0,273,98,0,375,3,0,1
17327,1333,2020-11-18T16:15:54.3081897Z,2012,332,0,234,173,0,27,0,159,0,0,332,98,0,305,0,0,0
17327,1334,2020-11-18T16:15:54.3081897Z,2013,306,1,226,162,0,25,0,144,0,0,305,80,0,281,0,2,0
17327,1335,2020-11-18T16:15:54.3091902Z,2014,322,14,246,170,0,19,0,152,0,0,308,76,0,303,0,2,0
17327,1336,2020-11-18T16:15:54.3091902Z,2015,326,20,239,178,0,15,0,148,0,0,306,87,0,310,0,2,1
17327,1337,2020-11-18T16:15:54.3091902Z,2016,292,33,87,153,0,8,0,139,0,0,259,205,0,283,0,2,1
17327,1338,2020-11-18T16:15:54.3091902Z,2017,313,47,219,158,0,13,0,155,0,0,266,94,0,299,0,3,1
17327,1339,2020-11-18T16:15:54.3091902Z,2018,305,48,222,144,0,10,0,161,0,0,257,83,0,294,0,5,1
17327,1340,2020-11-18T16:15:54.3101911Z,2019,271,43,207,126,0,10,0,145,0,0,228,64,0,261,0,0,0
17327,1341,2020-11-18T16:15:54.3101911Z,2020,265,63,213,118,0,2,0,147,0,0,202,52,0,263,0,0,0
17327,31608,2021-06-24T05:35:14.5832736Z,2021,250,60,206,120,0,0,0,130,0,0,190,44,0,250,0,0,0
47639,25859,2021-06-24T05:35:10.9876947Z,2021,159,41,132,74,0,2,0,85,0,0,118,27,0,157,0,0,0
47639,6023,2020-11-18T16:16:23.9729678Z,2012,206,1,163,115,0,8,0,91,0,0,205,43,0,198,0,0,0
47639,6024,2020-11-18T16:16:23.9729678Z,2013,179,1,134,89,0,5,0,90,0,0,178,45,0,174,0,1,0
47639,6025,2020-11-18T16:16:23.9739682Z,2014,202,12,151,97,0,6,0,105,0,0,190,51,0,196,0,0,0
47639,6026,2020-11-18T16:16:23.9739682Z,2015,206,14,158,93,0,5,0,113,0,0,192,48,0,201,0,0,0
47639,6027,2020-11-18T16:16:23.9739682Z,2016,196,27,160,94,0,3,2,102,0,0,169,36,0,193,0,1,0
47639,6028,2020-11-18T16:16:23.9739682Z,2017,229,44,183,106,0,9,4,123,0,0,185,46,0,220,0,1,0
47639,6029,2020-11-18T16:16:23.9739682Z,2018,212,38,169,100,0,10,11,112,0,0,174,43,0,202,0,1,0
47639,6030,2020-11-18T16:16:23.9739682Z,2019,194,36,153,81,0,1,0,113,0,0,158,41,0,193,0,0,0
47639,6031,2020-11-18T16:16:23.9749691Z,2020,176,42,131,83,0,2,0,93,0,0,134,45,0,174,0,0,0
55244,31914,2021-06-24T05:35:18.4850712Z,2021,1042,223,724,491,0,6,0,551,0,0,819,318,0,1036,34,3,0
55244,7469,2020-11-18T16:16:33.7114606Z,2012,825,4,582,373,0,3,0,452,0,0,821,243,2,819,0,0,1
55244,7470,2020-11-18T16:16:33.7114606Z,2013,784,3,549,373,0,3,0,411,0,0,781,235,1,779,0,4,1
55244,7471,2020-11-18T16:16:33.7114606Z,2014,750,39,525,377,0,2,0,373,0,0,711,225,0,747,0,4,1
55244,7472,2020-11-18T16:16:33.7124615Z,2015,781,67,542,386,0,5,0,395,0,0,714,239,0,775,0,7,1
55244,7473,2020-11-18T16:16:33.7124615Z,2016,818,117,259,422,0,7,1,396,0,0,701,559,0,810,0,6,1
55244,7474,2020-11-18T16:16:33.7124615Z,2017,898,139,587,459,0,11,2,439,0,0,759,311,1,885,0,8,1
55244,7475,2020-11-18T16:16:33.7124615Z,2018,875,131,572,458,0,7,0,417,0,1,744,303,0,868,8,3,0
55244,7476,2020-11-18T16:16:33.7124615Z,2019,1076,171,729,543,0,5,0,533,0,0,905,347,0,1071,23,4,0
55244,7477,2020-11-18T16:16:33.713462Z,2020,1178,251,763,571,0,6,10,607,0,0,927,415,0,1172,34,3,0
28373,25738,2021-06-24T05:35:08.6880466Z,2021,304,129,250,136,0,5,32,168,0,0,175,54,1,298,4,5,0
28373,3134,2020-11-18T16:16:05.3325409Z,2012,384,0,280,207,0,2,0,177,0,0,384,104,1,380,0,0,1
28373,3135,2020-11-18T16:16:05.3325409Z,2013,339,9,242,187,0,1,0,152,0,0,330,97,1,337,0,2,0
28373,3136,2020-11-18T16:16:05.3335422Z,2014,372,36,294,194,0,2,0,178,0,0,336,78,5,364,0,6,1
28373,3137,2020-11-18T16:16:05.3335422Z,2015,384,32,287,192,0,5,0,192,0,0,352,97,5,373,0,10,1
28373,3138,2020-11-18T16:16:05.3335422Z,2016,625,110,466,287,0,7,11,338,0,0,515,159,7,610,0,10,1
28373,3139,2020-11-18T16:16:05.3335422Z,2017,533,111,398,256,0,8,14,277,0,0,422,135,6,519,0,8,0
28373,3140,2020-11-18T16:16:05.3345427Z,2018,501,108,369,233,0,9,2,268,0,1,393,132,0,492,1,3,0
28373,3141,2020-11-18T16:16:05.3345427Z,2019,364,96,301,163,0,3,38,201,0,1,268,63,0,361,1,4,0
28373,3142,2020-11-18T16:16:05.3345427Z,2020,327,133,252,154,0,3,17,173,0,0,194,75,1,323,3,4,0
28571,25741,2021-06-24T05:35:08.6900471Z,2021,887,274,667,492,0,2,6,395,0,0,613,220,0,885,1,0,0
28571,3195,2020-11-18T16:16:05.347552Z,2012,694,2,455,334,0,2,0,360,0,0,692,239,0,690,0,0,2
28571,3196,2020-11-18T16:16:05.347552Z,2013,840,3,573,430,0,3,0,410,0,0,837,267,0,835,0,2,2
28571,3197,2020-11-18T16:16:05.347552Z,2014,890,70,610,454,0,5,0,436,0,0,820,280,0,884,0,2,1
28571,3198,2020-11-18T16:16:05.3485516Z,2015,885,56,627,458,0,5,0,427,0,0,829,258,0,879,0,2,1
28571,3199,2020-11-18T16:16:05.3485516Z,2016,922,122,507,472,0,15,1,450,0,0,800,415,0,906,0,0,1
28571,3200,2020-11-18T16:16:05.3485516Z,2017,958,151,656,507,0,18,1,451,0,0,807,302,0,940,0,0,0
28571,3201,2020-11-18T16:16:05.7007865Z,2018,955,155,611,509,0,20,0,446,0,0,800,344,0,934,0,1,1
28571,3202,2020-11-18T16:16:05.7017874Z,2019,977,180,670,529,0,9,5,448,0,0,797,307,0,968,1,0,0
28571,3203,2020-11-18T16:16:05.7017874Z,2020,919,272,628,505,0,4,1,414,0,0,647,291,0,915,1,0,0
36053,31743,2021-06-24T05:35:15.4098672Z,2021,397,126,298,197,0,8,0,200,0,0,271,99,0,389,0,1,0
36053,4524,2020-11-18T16:16:13.1937802Z,2012,586,3,367,322,0,27,0,264,0,0,583,219,0,559,0,0,0
36053,4525,2020-11-18T16:16:13.1937802Z,2013,572,8,372,307,0,10,0,265,0,0,564,200,0,562,0,3,0
36053,4526,2020-11-18T16:16:13.1937802Z,2014,563,33,422,316,0,5,0,247,0,0,530,141,0,557,0,1,1
36053,4527,2020-11-18T16:16:13.1937802Z,2015,522,23,394,290,0,7,0,232,0,0,499,128,0,514,0,2,1
36053,4528,2020-11-18T16:16:13.1947806Z,2016,709,78,291,396,0,19,0,313,0,0,631,418,0,688,0,0,2
36053,4529,2020-11-18T16:16:13.1947806Z,2017,623,79,421,345,0,17,1,278,0,0,544,202,0,605,0,1,1
36053,4530,2020-11-18T16:16:13.1947806Z,2018,603,90,438,298,0,14,0,305,0,0,513,165,0,588,0,1,1
36053,4531,2020-11-18T16:16:13.1947806Z,2019,490,102,353,236,0,7,0,254,0,0,388,137,0,483,0,1,0
36053,4532,2020-11-18T16:16:13.1947806Z,2020,415,120,319,203,0,7,15,212,0,0,295,96,0,406,1,1,2
17558,1396,2020-11-18T16:15:54.3282031Z,2012,1345,1,878,589,0,25,0,756,0,0,1344,467,0,1320,0,0,0
17558,1397,2020-11-18T16:15:54.3282031Z,2013,1259,11,869,571,0,12,0,688,0,0,1248,390,0,1247,0,1,0
17558,1398,2020-11-18T16:15:54.3282031Z,2014,1120,74,752,504,0,14,0,616,0,0,1046,368,0,1106,0,0,0
17558,1399,2020-11-18T16:15:54.3292031Z,2015,1136,117,762,538,0,10,0,598,0,0,1019,374,0,1123,0,1,3
17558,1400,2020-11-18T16:15:54.3292031Z,2016,977,177,372,452,0,7,0,525,0,0,800,605,1,967,0,0,2
17558,1401,2020-11-18T16:15:54.7414785Z,2017,1242,214,876,605,0,8,0,637,0,0,1028,366,0,1231,0,0,3
17558,1402,2020-11-18T16:15:54.7414785Z,2018,1270,243,903,640,0,2,1,630,0,0,1027,367,0,1268,0,1,0
17558,1403,2020-11-18T16:15:54.7414785Z,2019,1207,240,895,625,0,8,0,582,0,0,967,312,0,1199,0,1,0
17558,1404,2020-11-18T16:15:54.7414785Z,2020,1161,324,893,595,0,9,0,566,0,0,837,268,0,1151,0,2,1
17558,25610,2021-06-24T05:35:04.6661625Z,2021,1211,388,964,626,0,15,0,585,0,0,823,247,0,1196,1,2,0
17863,1468,2020-11-18T16:15:54.7674968Z,2012,710,1,587,318,0,2,0,392,0,0,709,123,15,692,0,0,1
17863,1469,2020-11-18T16:15:54.7684972Z,2013,659,14,544,310,0,1,0,349,0,0,645,115,4,653,0,0,1
17863,1470,2020-11-18T16:15:54.7684972Z,2014,503,50,403,249,0,0,0,254,0,0,453,100,0,502,0,2,1
17863,1471,2020-11-18T16:15:54.7684972Z,2015,515,51,406,244,0,1,0,271,0,0,464,109,0,514,0,3,0
17863,1472,2020-11-18T16:15:54.7684972Z,2016,525,106,422,239,0,1,0,286,0,0,419,103,0,524,0,5,0
17863,1473,2020-11-18T16:15:54.7684972Z,2017,640,122,509,302,0,1,0,338,0,0,518,131,0,639,0,4,0
17863,1474,2020-11-18T16:15:54.7694972Z,2018,603,105,469,296,0,0,1,307,0,1,498,134,0,603,7,3,0
17863,1475,2020-11-18T16:15:54.7694972Z,2019,546,98,454,263,0,2,1,283,0,0,448,92,0,544,9,2,0
17863,1476,2020-11-18T16:15:54.7694972Z,2020,530,135,403,266,0,3,3,264,0,0,395,127,0,527,11,2,0
17863,31873,2021-06-24T05:35:18.4380377Z,2021,493,126,389,242,0,4,4,251,0,0,367,104,0,489,6,2,0
35766,25799,2021-06-24T05:35:10.8776171Z,2021,840,155,668,432,0,11,1,408,0,0,685,172,0,829,1,3,0
35766,4401,2020-11-18T16:16:12.5703684Z,2012,910,3,620,419,0,10,0,491,0,0,907,290,1,897,0,0,2
35766,4402,2020-11-18T16:16:12.5703684Z,2013,838,11,555,406,0,10,0,432,0,0,827,283,1,826,0,2,1
35766,4403,2020-11-18T16:16:12.5713639Z,2014,902,55,586,433,0,18,0,469,0,0,847,316,1,882,0,1,1
35766,4404,2020-11-18T16:16:12.5713639Z,2015,898,42,614,422,0,12,0,476,0,0,856,284,1,885,0,3,0
35766,4405,2020-11-18T16:16:12.5713639Z,2016,842,94,552,428,0,11,0,414,0,0,748,290,0,831,0,3,0
35766,4406,2020-11-18T16:16:12.5723648Z,2017,757,81,538,387,0,10,0,370,0,0,676,219,0,747,0,2,0
35766,4407,2020-11-18T16:16:12.5723648Z,2018,938,116,659,486,0,11,0,452,0,0,822,279,0,927,0,2,0
35766,4408,2020-11-18T16:16:12.5723648Z,2019,939,127,678,461,0,13,4,478,0,0,812,261,0,926,0,2,0
35766,4409,2020-11-18T16:16:12.5723648Z,2020,872,161,635,427,0,10,0,445,0,0,711,237,0,862,0,1,0
35501,25796,2021-06-24T05:35:10.9076382Z,2021,509,165,398,220,0,8,0,289,0,0,344,111,0,501,2,3,0
35501,4347,2020-11-18T16:16:12.1680973Z,2012,729,1,467,345,0,3,0,384,0,0,728,262,1,724,0,0,1
35501,4348,2020-11-18T16:16:12.1680973Z,2013,679,5,444,348,0,4,0,331,0,0,674,235,1,672,0,2,2
35501,4349,2020-11-18T16:16:12.1680973Z,2014,676,49,449,334,0,8,0,342,0,0,627,227,0,667,0,3,1
35501,4350,2020-11-18T16:16:12.1690987Z,2015,619,59,411,294,0,6,0,325,0,0,560,208,1,612,0,0,0
35501,4351,2020-11-18T16:16:12.1690987Z,2016,542,104,237,245,0,6,1,297,0,0,438,305,2,534,0,0,0
35501,4352,2020-11-18T16:16:12.1690987Z,2017,707,155,479,320,0,11,1,387,0,0,552,228,1,695,0,2,0
35501,4353,2020-11-18T16:16:12.1701004Z,2018,587,96,401,262,0,10,3,325,0,0,491,186,0,577,1,2,0
35501,4354,2020-11-18T16:16:12.1701004Z,2019,533,100,383,242,0,10,1,291,0,0,433,150,1,522,1,2,0
35501,4355,2020-11-18T16:16:12.1701004Z,2020,534,152,399,241,0,10,1,293,0,0,382,135,1,523,1,2,0
28530,25739,2021-06-24T05:35:08.7010562Z,2021,339,116,285,177,0,2,0,162,0,0,223,54,0,337,2,0,0
28530,3159,2020-11-18T16:16:05.3385453Z,2012,222,0,172,113,0,1,0,109,0,0,222,50,0,221,0,0,0
28530,3160,2020-11-18T16:16:05.3385453Z,2013,208,3,162,115,0,0,0,93,0,0,205,46,0,208,0,1,0
28530,3161,2020-11-18T16:16:05.3395458Z,2014,211,33,163,126,0,0,0,85,0,0,178,48,0,211,0,2,0
28530,3162,2020-11-18T16:16:05.3395458Z,2015,224,18,178,140,0,0,0,84,0,0,206,46,0,224,0,0,0
28530,3163,2020-11-18T16:16:05.3395458Z,2016,223,45,69,126,0,0,0,97,0,0,178,154,0,223,0,1,0
28530,3164,2020-11-18T16:16:05.3395458Z,2017,257,64,209,152,0,0,0,105,0,0,193,48,0,257,0,0,0
28530,3165,2020-11-18T16:16:05.3395458Z,2018,314,64,251,189,0,0,18,125,0,0,250,63,0,314,0,0,0
28530,3166,2020-11-18T16:16:05.3405467Z,2019,275,69,220,163,0,0,6,112,0,0,206,55,0,275,2,0,0
28530,3167,2020-11-18T16:16:05.3405467Z,2020,311,111,250,171,0,2,1,140,0,0,200,61,0,309,2,0,0
36384,25807,2021-06-24T05:35:10.9046362Z,2021,479,82,369,254,0,16,0,225,0,0,397,110,0,463,7,1,0
36384,4560,2020-11-18T16:16:13.1937802Z,2016,215,27,87,119,0,10,0,96,0,0,188,128,0,205,0,0,0
36384,4561,2020-11-18T16:16:13.1937802Z,2017,307,49,224,174,0,13,1,133,0,0,258,83,0,294,0,0,0
36384,4562,2020-11-18T16:16:13.1947806Z,2018,458,41,337,249,0,27,1,209,0,0,417,121,1,430,2,0,0
36384,4563,2020-11-18T16:16:13.1947806Z,2019,437,50,327,238,0,20,0,199,0,0,387,110,1,416,4,1,0
36384,4564,2020-11-18T16:16:13.1947806Z,2020,438,68,307,237,0,15,0,201,0,0,370,131,2,421,6,2,0
54445,25908,2021-06-24T05:35:12.8039982Z,2021,439,129,291,209,0,7,14,230,0,0,310,148,0,429,0,0,3
54445,7368,2020-11-18T16:16:33.2411482Z,2017,354,104,232,186,0,4,10,168,0,0,250,122,3,347,0,2,0
54445,7369,2020-11-18T16:16:33.2411482Z,2018,488,117,306,261,0,10,0,227,0,0,371,182,1,476,3,1,1
54445,7370,2020-11-18T16:16:33.2421495Z,2019,469,133,246,232,0,10,27,237,0,0,336,223,0,458,2,0,1
54445,7371,2020-11-18T16:16:33.2421495Z,2020,430,119,263,200,0,10,18,230,0,0,311,167,0,416,0,0,4
12229,25599,2021-06-24T05:35:04.6091218Z,2021,122,44,107,56,0,2,0,66,0,0,78,15,0,120,0,1,0
12229,644,2020-11-18T16:15:50.2364712Z,2012,355,70,342,169,0,7,0,186,0,0,285,13,0,348,0,0,0
12229,645,2020-11-18T16:15:50.237472Z,2013,339,71,325,163,0,11,0,176,0,0,268,14,0,328,0,1,0
12229,646,2020-11-18T16:15:50.237472Z,2014,322,72,280,152,0,7,0,170,0,0,250,42,0,315,0,1,0
12229,647,2020-11-18T16:15:50.237472Z,2015,286,80,228,130,0,7,0,156,0,0,206,58,0,279,0,1,0
12229,648,2020-11-18T16:15:50.237472Z,2016,317,101,118,146,0,8,1,171,0,0,216,199,0,309,0,1,0
12229,649,2020-11-18T16:15:50.237472Z,2017,254,89,247,110,0,7,1,144,0,0,165,7,0,247,0,0,0
12229,650,2020-11-18T16:15:50.2384729Z,2018,195,64,190,93,0,7,0,102,0,0,131,5,0,188,0,1,0
12229,651,2020-11-18T16:15:50.2384729Z,2019,164,78,161,75,0,6,0,89,0,0,86,3,0,158,0,2,0
12229,652,2020-11-18T16:15:50.2384729Z,2020,151,66,151,70,0,7,0,81,0,0,85,0,0,144,0,2,0
32755,31780,2021-06-24T05:35:16.8589062Z,2021,407,120,347,195,0,2,2,212,0,0,287,60,0,404,0,1,1
32755,3981,2020-11-18T16:16:09.8945837Z,2012,443,1,320,214,0,1,0,229,0,0,442,123,0,442,0,0,0
32755,3982,2020-11-18T16:16:09.8945837Z,2013,398,6,317,179,0,1,0,219,0,0,392,81,0,397,0,6,0
32755,3983,2020-11-18T16:16:09.8945837Z,2014,423,30,334,183,0,2,0,240,0,0,393,89,1,420,0,4,0
32755,3984,2020-11-18T16:16:09.8955841Z,2015,519,51,412,231,0,3,0,288,0,0,468,107,1,515,0,2,0
32755,3985,2020-11-18T16:16:09.8955841Z,2016,524,96,381,233,0,4,3,291,0,0,428,143,0,520,0,1,0
32755,3986,2020-11-18T16:16:09.8955841Z,2017,552,92,457,255,0,6,0,297,0,0,460,95,0,546,0,1,0
32755,3987,2020-11-18T16:16:09.8965854Z,2018,470,77,405,230,0,6,0,240,0,0,393,65,0,464,0,0,0
32755,3988,2020-11-18T16:16:09.8965854Z,2019,383,89,318,174,0,3,0,209,0,0,294,65,0,379,0,0,1
32755,3989,2020-11-18T16:16:09.8975868Z,2020,400,109,336,172,0,2,0,228,0,0,291,64,0,397,0,0,1
11502,31593,2021-06-24T05:35:14.5532512Z,2021,498,164,418,221,0,9,0,277,0,0,334,80,0,489,4,2,0
11502,438,2020-11-18T16:15:48.8295364Z,2012,474,59,380,240,0,0,0,234,0,0,415,94,1,473,0,0,0
11502,439,2020-11-18T16:15:48.8305364Z,2013,432,102,347,224,0,0,0,208,0,0,330,85,0,430,0,0,2
11502,440,2020-11-18T16:15:48.8305364Z,2014,461,139,351,224,0,1,0,237,0,0,322,110,0,459,0,1,1
11502,441,2020-11-18T16:15:48.8305364Z,2015,495,151,363,242,0,2,0,253,0,0,344,132,1,491,0,2,1
11502,442,2020-11-18T16:15:48.8315373Z,2016,476,146,246,249,0,0,1,227,0,0,330,230,0,476,0,1,0
11502,443,2020-11-18T16:15:48.8315373Z,2017,471,143,360,243,0,2,1,228,0,0,328,111,0,469,0,1,0
11502,444,2020-11-18T16:15:48.8315373Z,2018,505,139,387,239,0,5,13,266,0,0,366,118,0,500,0,0,0
11502,445,2020-11-18T16:15:48.8315373Z,2019,532,181,416,262,0,5,3,270,0,0,351,116,0,527,0,0,0
11502,446,2020-11-18T16:15:48.8315373Z,2020,500,178,399,230,0,5,0,270,0,0,322,101,0,495,1,1,0
70623,31658,2021-06-24T05:35:15.2407453Z,2021,752,303,580,343,0,10,2,409,0,0,449,172,0,742,3,1,0
70623,9822,2020-11-18T16:16:50.8999241Z,2012,811,9,498,351,0,2,0,460,0,0,802,313,0,809,0,0,0
70623,9823,2020-11-18T16:16:50.8999241Z,2013,813,18,540,365,0,5,0,448,0,0,795,273,1,807,0,0,0
70623,9824,2020-11-18T16:16:50.8999241Z,2014,834,109,548,363,0,8,0,471,0,0,725,286,1,817,0,0,8
70623,9825,2020-11-18T16:16:50.8999241Z,2015,820,96,515,358,0,7,0,462,0,0,724,305,0,800,0,1,13
70623,9826,2020-11-18T16:16:50.9009268Z,2016,774,203,463,331,0,8,9,443,0,0,571,311,1,739,0,1,26
70623,9827,2020-11-18T16:16:50.9009268Z,2017,742,191,489,305,0,11,6,437,0,0,551,253,0,715,0,0,16
70623,9828,2020-11-18T16:16:50.9009268Z,2018,753,179,481,327,0,20,4,426,0,0,574,272,0,720,3,0,13
70623,9829,2020-11-18T16:16:50.9009268Z,2019,688,206,464,288,0,10,4,400,0,0,482,224,0,678,2,1,0
70623,9830,2020-11-18T16:16:50.9019259Z,2020,729,288,521,316,0,11,6,413,0,0,441,208,0,718,2,1,0
77651,10998,2020-11-18T16:16:58.1367521Z,2012,642,88,446,307,0,3,0,335,0,0,554,196,4,634,0,0,1
77651,10999,2020-11-18T16:16:58.1367521Z,2013,635,137,453,316,0,7,0,319,0,0,498,182,5,622,0,2,1
77651,11000,2020-11-18T16:16:58.1377539Z,2014,605,151,439,297,0,9,0,308,0,0,454,166,3,592,0,0,1
77651,11001,2020-11-18T16:16:58.5029972Z,2015,524,124,394,264,0,6,0,260,0,0,400,130,1,516,0,0,1
77651,11002,2020-11-18T16:16:58.5029972Z,2016,366,84,148,181,0,4,0,185,0,0,282,218,0,362,0,1,0
77651,11003,2020-11-18T16:16:58.5029972Z,2017,343,93,249,180,0,4,7,163,0,0,250,94,0,339,0,1,0
77651,11004,2020-11-18T16:16:58.5039985Z,2018,547,128,378,280,0,10,31,267,0,0,419,169,1,536,0,1,0
77651,11005,2020-11-18T16:16:58.5039985Z,2019,611,190,459,289,0,7,39,322,0,0,421,152,1,603,0,2,0
77651,11006,2020-11-18T16:16:58.5039985Z,2020,477,213,378,228,0,7,22,249,0,0,264,99,0,470,0,1,0
77651,31684,2021-06-24T05:35:15.2877788Z,2021,488,226,386,237,0,8,14,251,0,0,262,102,0,480,0,0,0
42770,25833,2021-06-24T05:35:10.9406607Z,2021,175,36,146,85,0,0,0,90,0,0,139,29,0,175,2,0,0
42770,5339,2020-11-18T16:16:19.3358764Z,2012,138,46,104,76,0,3,0,62,0,0,92,34,0,135,0,0,0
42770,5340,2020-11-18T16:16:19.3358764Z,2013,169,60,136,90,0,3,0,79,0,0,109,33,0,166,0,0,0
42770,5341,2020-11-18T16:16:19.3358764Z,2014,175,63,126,90,0,1,0,85,0,0,112,49,0,174,0,0,0
42770,5342,2020-11-18T16:16:19.3358764Z,2015,176,48,139,96,0,0,0,80,0,0,128,37,0,176,0,0,0
42770,5343,2020-11-18T16:16:19.3358764Z,2016,179,49,127,94,0,0,1,85,0,0,130,52,0,179,0,1,0
42770,5344,2020-11-18T16:16:19.3368773Z,2017,176,45,140,93,0,0,1,83,0,0,131,36,0,176,0,1,0
42770,5345,2020-11-18T16:16:19.3368773Z,2018,166,35,124,81,0,0,2,85,0,0,131,42,0,166,2,0,0
42770,5346,2020-11-18T16:16:19.3368773Z,2019,176,38,134,82,0,0,0,94,0,0,138,42,0,176,2,0,0
42770,5347,2020-11-18T16:16:19.3368773Z,2020,160,32,127,77,0,0,0,83,0,0,128,33,0,160,2,0,0
14241,1035,2020-11-18T16:15:52.4899749Z,2012,254,2,192,119,0,1,0,135,0,0,252,62,0,252,0,0,1
14241,1036,2020-11-18T16:15:52.4899749Z,2013,224,4,180,108,0,1,0,116,0,0,220,44,0,222,0,5,1
14241,1037,2020-11-18T16:15:52.4899749Z,2014,297,40,246,139,0,5,0,158,0,0,257,51,0,292,0,2,0
14241,1038,2020-11-18T16:15:52.4899749Z,2015,513,80,430,219,0,8,0,294,0,0,433,83,1,504,0,2,0
14241,1039,2020-11-18T16:15:52.4899749Z,2016,549,148,239,248,0,10,1,301,0,0,401,310,1,538,0,1,0
14241,1040,2020-11-18T16:15:52.4909754Z,2017,461,138,385,204,0,10,0,257,0,0,323,76,2,449,0,2,0
14241,1041,2020-11-18T16:15:52.4909754Z,2018,469,145,389,208,0,0,1,261,0,0,324,80,1,468,0,1,0
14241,1042,2020-11-18T16:15:52.4909754Z,2019,496,181,422,218,0,2,1,278,0,0,315,74,4,490,0,1,0
14241,1043,2020-11-18T16:15:52.4909754Z,2020,390,171,330,177,0,2,0,213,0,0,219,60,1,387,0,0,0
14241,31604,2021-06-24T05:35:14.5782702Z,2021,360,166,321,166,0,4,0,194,0,0,194,39,1,355,0,0,0
61440,25946,2021-06-24T05:35:12.8480298Z,2021,421,135,305,214,0,21,2,207,0,0,286,116,2,396,3,1,2
61440,8198,2020-11-18T16:16:38.6397467Z,2012,235,0,147,102,0,29,0,133,0,0,235,88,2,204,0,0,0
61440,8199,2020-11-18T16:16:38.640749Z,2013,325,2,225,135,0,31,0,190,0,0,323,100,2,292,0,0,0
61440,8200,2020-11-18T16:16:38.640749Z,2014,340,34,253,164,0,35,0,176,0,0,306,87,2,303,0,1,0
61440,8201,2020-11-18T16:16:39.0440168Z,2015,369,31,248,179,0,34,0,190,0,0,338,121,0,335,0,1,0
61440,8202,2020-11-18T16:16:39.0440168Z,2016,346,65,200,160,0,30,1,186,0,0,281,146,0,316,0,0,0
61440,8203,2020-11-18T16:16:39.0440168Z,2017,412,88,264,186,0,33,1,226,0,0,324,148,1,377,0,1,1
61440,8204,2020-11-18T16:16:39.0450181Z,2018,422,75,286,198,0,31,0,224,0,0,347,136,1,385,0,1,5
61440,8205,2020-11-18T16:16:39.0450181Z,2019,443,96,315,222,0,43,13,221,0,0,347,128,2,394,0,2,4
61440,8206,2020-11-18T16:16:39.0450181Z,2020,451,127,314,236,0,32,7,215,0,0,324,137,2,414,1,1,3
69013,31991,2021-06-24T05:35:20.3183862Z,2021,213,57,189,107,0,4,0,106,0,0,156,24,0,209,0,0,0
69013,9276,2020-11-18T16:16:46.7101318Z,2012,372,131,307,189,0,10,0,183,0,0,241,65,1,361,0,0,0
69013,9277,2020-11-18T16:16:46.7101318Z,2013,299,106,243,155,0,7,0,144,0,0,193,56,1,291,0,0,0
69013,9278,2020-11-18T16:16:46.7101318Z,2014,339,121,265,176,0,9,0,163,0,0,218,74,1,329,0,1,0
69013,9279,2020-11-18T16:16:46.7111331Z,2015,298,108,249,148,0,7,0,150,0,0,190,49,0,291,0,0,0
69013,9280,2020-11-18T16:16:46.7111331Z,2016,272,94,235,138,0,4,1,134,0,0,178,37,0,268,0,0,0
69013,9281,2020-11-18T16:16:46.7111331Z,2017,248,86,208,120,0,3,1,128,0,0,162,40,0,245,0,0,0
69013,9282,2020-11-18T16:16:46.7111331Z,2018,246,70,216,126,0,5,3,120,0,0,176,30,1,239,0,0,1
69013,9283,2020-11-18T16:16:46.712134Z,2019,308,102,276,156,0,4,5,152,0,0,206,32,1,302,0,1,1
69013,9284,2020-11-18T16:16:46.712134Z,2020,256,69,230,125,0,5,0,131,0,0,187,26,1,249,0,1,1
61531,31950,2021-06-24T05:35:18.5451138Z,2021,581,13,143,343,0,7,0,238,0,0,568,438,5,567,0,0,2
61531,8259,2020-11-18T16:16:39.0690337Z,2012,485,0,144,254,0,5,0,231,0,0,485,341,2,477,0,0,1
61531,8260,2020-11-18T16:16:39.0700346Z,2013,494,6,147,269,0,10,0,225,0,0,488,347,3,479,0,0,2
61531,8261,2020-11-18T16:16:39.0700346Z,2014,515,11,152,279,0,15,0,236,0,0,504,363,2,497,0,0,1
61531,8262,2020-11-18T16:16:39.0700346Z,2015,587,7,175,328,0,26,0,259,0,0,580,412,2,559,0,0,0
61531,8263,2020-11-18T16:16:39.0710346Z,2016,550,6,116,320,0,28,0,230,0,0,544,434,3,519,0,0,0
61531,8264,2020-11-18T16:16:39.0710346Z,2017,611,9,171,362,0,27,1,249,0,0,602,440,2,582,0,0,0
61531,8265,2020-11-18T16:16:39.0710346Z,2018,566,8,131,327,0,18,0,239,0,0,558,435,1,546,0,0,1
61531,8266,2020-11-18T16:16:39.0710346Z,2019,463,8,104,264,0,14,0,199,0,0,455,359,0,447,0,0,2
61531,8267,2020-11-18T16:16:39.0710346Z,2020,557,12,100,322,0,9,0,235,0,0,545,457,0,546,0,0,2
62166,31958,2021-06-24T05:35:20.2483351Z,2021,600,184,450,302,0,12,7,298,0,0,416,150,0,587,0,0,1
62166,8448,2020-11-18T16:16:40.2168007Z,2012,487,64,320,254,0,5,0,233,0,0,423,167,0,482,0,0,0
62166,8449,2020-11-18T16:16:40.2178007Z,2013,459,94,316,241,0,5,0,218,0,0,365,143,0,454,0,0,0
62166,8450,2020-11-18T16:16:40.2178007Z,2014,506,131,367,267,0,8,0,239,0,0,375,139,2,496,0,0,0
62166,8451,2020-11-18T16:16:40.2178007Z,2015,590,160,423,294,0,10,0,296,0,0,430,167,2,577,0,1,1
62166,8452,2020-11-18T16:16:40.2178007Z,2016,630,176,398,288,0,10,20,342,0,0,454,232,2,618,0,0,0
62166,8453,2020-11-18T16:16:40.2178007Z,2017,529,159,382,247,0,8,20,282,0,0,370,147,0,521,0,0,0
62166,8454,2020-11-18T16:16:40.218802Z,2018,426,136,304,201,0,6,26,225,0,0,290,122,0,420,0,0,0
62166,8455,2020-11-18T16:16:40.218802Z,2019,423,147,310,197,0,10,16,226,0,0,276,113,0,413,0,0,0
62166,8456,2020-11-18T16:16:40.218802Z,2020,554,174,419,271,0,13,12,283,0,0,380,135,0,540,0,0,1
18234,1531,2020-11-18T16:15:55.3628938Z,2012,394,122,287,174,0,4,0,220,0,0,272,107,7,383,0,0,0
18234,1532,2020-11-18T16:15:55.3638956Z,2013,369,117,228,171,0,4,0,198,0,0,252,141,6,359,0,1,0
18234,1533,2020-11-18T16:15:55.3638956Z,2014,340,106,164,161,0,3,0,179,0,0,234,176,5,332,0,0,0
18234,1534,2020-11-18T16:15:55.3638956Z,2015,328,97,202,169,0,4,0,159,0,0,231,126,1,323,0,1,0
18234,1535,2020-11-18T16:15:55.3648965Z,2016,310,91,206,143,0,5,1,167,0,0,219,104,0,305,0,0,0
18234,1536,2020-11-18T16:15:55.3648965Z,2017,331,94,223,173,0,6,1,158,0,0,237,108,0,325,0,1,0
18234,1537,2020-11-18T16:15:55.3648965Z,2018,330,88,237,164,0,7,21,166,0,0,242,93,0,323,0,0,0
18234,1538,2020-11-18T16:15:55.3648965Z,2019,535,186,411,279,0,8,25,256,0,0,349,124,0,527,0,1,0
18234,1539,2020-11-18T16:15:55.3658969Z,2020,499,157,376,260,0,10,0,239,0,0,342,123,0,489,0,0,0
18234,31617,2021-06-24T05:35:14.6132956Z,2021,492,149,404,259,0,10,0,233,0,0,343,88,0,481,0,0,1
24760,2683,2020-11-18T16:16:02.5366732Z,2012,206,69,156,83,0,0,0,123,0,0,137,50,0,206,0,0,0
24760,2684,2020-11-18T16:16:02.5366732Z,2013,161,54,141,60,0,2,0,101,0,0,107,20,0,159,0,9,0
24760,2685,2020-11-18T16:16:02.5366732Z,2014,152,53,138,66,0,3,0,86,0,0,99,14,0,148,0,2,1
24760,2686,2020-11-18T16:16:02.5376737Z,2015,160,69,157,63,0,3,0,97,0,0,91,3,0,157,0,3,0
24760,2687,2020-11-18T16:16:02.5376737Z,2016,126,55,115,51,0,1,1,75,0,0,71,11,1,124,0,1,0
24760,2688,2020-11-18T16:16:02.5376737Z,2017,120,61,113,39,0,2,0,81,0,0,59,7,0,118,0,1,0
24760,2689,2020-11-18T16:16:02.5376737Z,2018,123,72,116,47,0,0,8,76,0,0,51,7,0,122,0,0,1
24760,2690,2020-11-18T16:16:02.5376737Z,2019,119,72,109,56,0,0,2,63,0,0,47,10,0,119,0,0,0
24760,2691,2020-11-18T16:16:02.538675Z,2020,133,78,114,54,0,2,0,79,0,0,55,19,2,129,0,0,0
24760,31723,2021-06-24T05:35:15.3828463Z,2021,142,77,109,55,0,3,0,87,0,0,65,33,1,138,0,0,0
65953,25980,2021-06-24T05:35:14.5032153Z,2021,100,92,64,32,0,1,0,68,0,0,8,36,0,98,0,0,1
65953,9105,2020-11-18T16:16:45.4873149Z,2012,106,71,66,41,0,2,0,65,0,0,35,40,0,104,0,0,0
65953,9106,2020-11-18T16:16:45.4873149Z,2013,106,72,59,42,0,2,0,64,0,0,34,47,0,104,0,0,0
65953,9107,2020-11-18T16:16:45.4883162Z,2014,104,75,60,38,0,1,0,66,0,0,29,44,0,103,0,0,0
65953,9108,2020-11-18T16:16:45.4883162Z,2015,105,71,62,37,0,1,0,68,0,0,34,43,0,104,0,0,0
65953,9109,2020-11-18T16:16:45.4883162Z,2016,87,66,54,31,0,0,0,56,0,0,21,33,0,87,0,0,0
65953,9110,2020-11-18T16:16:45.4883162Z,2017,77,61,46,23,0,0,0,54,0,0,16,31,0,77,0,0,0
65953,9111,2020-11-18T16:16:45.4893158Z,2018,99,81,69,27,0,2,0,72,0,0,18,30,0,96,0,0,1
65953,9112,2020-11-18T16:16:45.4893158Z,2019,105,90,77,35,0,4,0,70,0,0,15,28,0,99,0,0,2
65953,9113,2020-11-18T16:16:45.4893158Z,2020,104,91,65,37,0,2,0,67,0,0,13,39,0,101,0,0,1
10611,135,2020-11-18T16:15:46.3748965Z,2012,75,35,67,12,0,2,0,63,0,0,40,8,0,73,0,0,0
10611,136,2020-11-18T16:15:46.3748965Z,2013,70,37,66,14,0,2,0,56,0,0,33,4,0,68,0,1,0
10611,137,2020-11-18T16:15:46.3748965Z,2014,77,47,72,14,0,2,0,63,0,0,30,5,0,75,0,0,0
10611,138,2020-11-18T16:15:46.3758974Z,2015,71,34,66,17,0,2,0,54,0,0,37,5,0,69,0,0,0
10611,139,2020-11-18T16:15:46.3758974Z,2016,61,45,60,24,0,2,1,37,0,0,16,1,0,59,0,1,0
10611,140,2020-11-18T16:15:46.3758974Z,2017,53,47,52,23,0,1,1,30,0,0,6,1,0,52,0,0,0
10611,141,2020-11-18T16:15:46.3758974Z,2018,71,44,67,23,0,2,1,48,0,0,27,4,0,69,0,0,0
10611,142,2020-11-18T16:15:46.3758974Z,2019,55,41,53,18,0,0,0,37,0,0,14,2,0,55,0,0,0
10611,143,2020-11-18T16:15:46.3758974Z,2020,50,49,50,18,0,0,0,32,0,0,1,0,0,50,0,0,0
10611,25582,2021-06-24T05:35:04.5941104Z,2021,51,49,48,21,0,0,0,30,0,0,2,3,0,51,0,0,0
62968,31970,2021-06-24T05:35:20.2763552Z,2021,413,118,386,211,0,17,0,202,0,0,295,27,0,395,0,0,1
62968,8782,2020-11-18T16:16:42.8485571Z,2012,332,95,249,161,0,9,0,171,0,0,237,83,0,323,0,0,0
62968,8783,2020-11-18T16:16:42.8495571Z,2013,315,96,238,151,0,12,0,164,0,0,219,77,0,303,0,0,0
62968,8784,2020-11-18T16:16:42.8495571Z,2014,271,82,247,127,0,8,0,144,0,0,189,24,0,263,0,0,0
62968,8785,2020-11-18T16:16:42.8495571Z,2015,268,60,243,133,0,6,0,135,0,0,208,25,0,262,0,2,0
62968,8786,2020-11-18T16:16:42.8495571Z,2016,227,56,43,100,0,2,2,127,0,0,171,184,0,225,0,0,0
62968,8787,2020-11-18T16:16:42.8495571Z,2017,255,71,232,107,0,2,0,148,0,0,184,23,0,253,0,0,0
62968,8788,2020-11-18T16:16:42.850558Z,2018,222,64,197,90,0,8,0,132,0,0,158,25,0,214,0,0,0
62968,8789,2020-11-18T16:16:42.850558Z,2019,441,119,382,217,0,18,0,224,0,0,322,59,0,423,0,0,0
62968,8790,2020-11-18T16:16:42.850558Z,2020,433,120,393,220,0,16,0,213,0,0,313,40,0,416,0,0,1
65557,25979,2021-06-24T05:35:14.4992129Z,2021,391,143,357,187,0,10,1,204,0,0,248,34,1,379,1,2,1
65557,9078,2020-11-18T16:16:44.897921Z,2012,245,39,208,116,0,15,0,129,0,0,206,37,0,230,0,0,0
65557,9079,2020-11-18T16:16:44.897921Z,2013,245,54,221,116,0,21,0,129,0,0,191,24,0,224,0,0,0
65557,9080,2020-11-18T16:16:44.897921Z,2014,247,70,209,118,0,16,0,129,0,0,177,38,0,231,0,1,0
65557,9081,2020-11-18T16:16:44.8989223Z,2015,252,74,220,134,0,20,0,118,0,0,178,32,0,232,0,1,0
65557,9082,2020-11-18T16:16:44.8989223Z,2016,374,135,331,178,0,23,2,196,0,0,239,43,0,350,0,0,1
65557,9083,2020-11-18T16:16:44.8989223Z,2017,405,137,354,185,0,27,3,220,0,0,268,51,0,377,0,1,1
65557,9084,2020-11-18T16:16:44.8999232Z,2018,387,127,338,181,0,15,4,206,0,0,260,49,0,372,1,1,0
65557,9085,2020-11-18T16:16:44.8999232Z,2019,411,149,374,205,0,11,2,206,0,0,262,37,0,400,1,3,0
65557,9086,2020-11-18T16:16:44.8999232Z,2020,393,144,355,190,0,11,0,203,0,0,249,38,0,381,1,2,1
24612,2623,2020-11-18T16:16:02.5066532Z,2012,342,119,254,163,0,1,0,179,0,0,223,88,0,340,0,0,1
24612,2624,2020-11-18T16:16:02.5066532Z,2013,317,108,240,158,0,1,0,159,0,0,209,77,0,316,0,0,0
24612,2625,2020-11-18T16:16:02.5066532Z,2014,334,110,227,172,0,2,0,162,0,0,224,107,0,332,0,0,0
24612,2626,2020-11-18T16:16:02.5066532Z,2015,346,112,240,178,0,1,0,168,0,0,234,106,0,345,0,0,0
24612,2627,2020-11-18T16:16:02.5066532Z,2016,355,118,179,192,0,1,6,163,0,0,237,176,0,354,0,0,0
24612,2628,2020-11-18T16:16:02.5066532Z,2017,280,94,198,146,0,3,5,134,0,0,186,82,0,277,0,0,0
24612,2629,2020-11-18T16:16:02.5076545Z,2018,285,80,202,143,0,3,0,142,0,0,205,83,0,282,0,0,0
24612,2630,2020-11-18T16:16:02.5076545Z,2019,267,76,207,122,0,1,21,145,0,2,191,60,0,266,0,0,0
24612,2631,2020-11-18T16:16:02.5076545Z,2020,278,62,214,135,0,2,9,143,0,0,216,64,0,274,0,0,2
24612,31721,2021-06-24T05:35:15.3818467Z,2021,271,63,228,134,0,3,7,137,0,0,208,43,0,266,0,0,2
71365,10189,2020-11-18T16:16:53.2955248Z,2012,378,133,298,184,0,7,0,194,0,0,245,80,0,371,0,0,0
71365,10190,2020-11-18T16:16:53.2955248Z,2013,311,119,224,151,0,6,0,160,0,0,192,87,0,305,0,0,0
71365,10191,2020-11-18T16:16:53.2955248Z,2014,341,132,282,168,0,9,0,173,0,0,209,59,0,332,0,2,0
71365,10192,2020-11-18T16:16:53.2955248Z,2015,422,166,372,209,0,12,0,213,0,0,256,50,0,410,0,3,0
71365,10193,2020-11-18T16:16:53.2965257Z,2016,352,146,211,174,0,10,1,178,0,0,206,141,0,342,0,1,0
71365,10194,2020-11-18T16:16:53.2965257Z,2017,333,154,292,164,0,10,0,169,0,0,179,41,0,322,0,0,1
71365,10195,2020-11-18T16:16:53.2965257Z,2018,369,156,331,178,0,12,29,191,0,0,213,38,0,356,0,0,1
71365,10196,2020-11-18T16:16:53.2965257Z,2019,366,165,329,175,0,10,7,191,0,0,201,37,0,355,0,0,1
71365,10197,2020-11-18T16:16:53.2975257Z,2020,324,149,287,146,0,7,8,178,0,0,175,37,0,316,0,0,1
71365,31669,2021-06-24T05:35:15.2537544Z,2021,295,134,264,131,0,7,7,164,0,0,161,31,0,287,0,0,1
28548,3168,2020-11-18T16:16:05.3395458Z,2012,525,141,416,261,0,4,0,264,0,0,384,109,1,520,0,0,0
28548,3169,2020-11-18T16:16:05.3405467Z,2013,522,153,409,261,0,7,0,261,0,0,369,113,1,513,0,7,1
28548,3170,2020-11-18T16:16:05.3405467Z,2014,497,148,344,240,0,9,0,257,0,0,349,153,0,488,0,2,0
28548,3171,2020-11-18T16:16:05.3405467Z,2015,507,140,386,249,0,5,0,258,0,0,367,121,0,500,0,2,2
28548,3172,2020-11-18T16:16:05.3405467Z,2016,524,159,387,273,0,11,15,251,0,0,365,137,0,511,0,4,2
28548,3173,2020-11-18T16:16:05.3405467Z,2017,549,174,382,279,0,9,13,270,0,0,375,167,0,539,0,1,1
28548,3174,2020-11-18T16:16:05.3415471Z,2018,600,174,424,314,0,8,21,286,0,0,426,176,0,590,1,2,2
28548,31741,2021-06-24T05:35:15.4108668Z,2021,550,195,440,297,0,12,29,253,0,0,355,110,0,535,0,0,3
28548,3175,2020-11-18T16:16:05.3415471Z,2019,621,206,489,324,0,7,18,297,0,0,415,132,0,613,1,0,1
28548,3176,2020-11-18T16:16:05.3415471Z,2020,594,206,458,297,0,12,56,297,0,0,388,136,0,581,1,0,1
70011,25640,2021-06-24T05:35:04.6921816Z,2021,256,98,196,103,0,5,1,153,0,0,158,60,0,248,1,0,3
70011,9398,2020-11-18T16:16:48.1380859Z,2012,314,104,285,141,0,7,0,173,0,0,210,29,3,300,0,0,4
70011,9399,2020-11-18T16:16:48.1390863Z,2013,276,84,235,128,0,4,0,148,0,0,192,41,2,267,0,3,3
70011,9400,2020-11-18T16:16:48.1390863Z,2014,298,79,224,137,0,5,0,161,0,0,219,74,1,289,0,1,3
70011,9401,2020-11-18T16:16:48.5043301Z,2015,288,82,223,143,0,3,0,145,0,0,206,65,1,283,0,2,1
70011,9402,2020-11-18T16:16:48.5043301Z,2016,271,84,223,124,0,2,0,147,0,0,187,48,1,268,0,3,0
70011,9403,2020-11-18T16:16:48.505331Z,2017,293,102,253,133,0,1,3,160,0,0,191,40,1,291,0,1,0
70011,9404,2020-11-18T16:16:48.505331Z,2018,323,112,257,140,0,4,4,183,0,0,211,66,0,318,1,0,1
70011,9405,2020-11-18T16:16:48.505331Z,2019,291,114,254,124,0,4,4,167,0,0,177,37,0,286,1,1,1
70011,9406,2020-11-18T16:16:48.505331Z,2020,274,106,233,104,0,5,1,170,0,0,168,41,0,268,1,0,1
27383,25733,2021-06-24T05:35:08.6840428Z,2021,356,129,293,163,0,4,2,193,0,0,227,63,0,352,5,0,0
27383,3029,2020-11-18T16:16:04.728138Z,2012,396,139,227,180,0,6,0,216,0,0,257,169,0,390,0,0,0
27383,3030,2020-11-18T16:16:04.728138Z,2013,343,119,199,158,0,3,0,185,0,0,224,144,0,340,0,2,0
27383,3031,2020-11-18T16:16:04.728138Z,2014,295,119,198,142,0,7,0,153,0,0,176,97,0,288,0,0,0
27383,3032,2020-11-18T16:16:04.728138Z,2015,247,101,171,121,0,7,0,126,0,0,146,76,0,240,0,1,0
27383,3033,2020-11-18T16:16:04.728138Z,2016,207,88,158,105,0,7,16,102,0,0,119,49,0,200,0,1,0
27383,3034,2020-11-18T16:16:04.729138Z,2017,212,88,166,109,0,4,10,103,0,0,124,46,0,208,0,0,0
27383,3035,2020-11-18T16:16:04.729138Z,2018,189,67,145,101,0,5,37,88,0,0,122,44,0,184,2,0,0
27383,3036,2020-11-18T16:16:04.729138Z,2019,449,163,317,230,0,6,72,219,0,0,286,132,0,443,8,0,0
27383,3037,2020-11-18T16:16:04.729138Z,2020,385,140,305,187,0,3,29,198,0,0,245,80,0,382,7,0,0
12633,31636,2021-06-24T05:35:14.6413148Z,2021,240,64,200,110,0,0,0,130,0,0,176,40,0,240,1,0,0
12633,793,2020-11-18T16:15:50.9259304Z,2012,184,43,126,85,0,1,0,99,0,0,141,58,0,183,0,0,0
12633,794,2020-11-18T16:15:50.9259304Z,2013,185,42,126,86,0,0,0,99,0,0,143,59,0,185,0,2,0
12633,795,2020-11-18T16:15:50.9259304Z,2014,203,42,129,95,0,0,0,108,0,0,161,74,0,203,0,2,0
12633,796,2020-11-18T16:15:50.9259304Z,2015,193,43,134,99,0,0,0,94,0,0,150,59,0,193,0,2,0
12633,797,2020-11-18T16:15:50.9269308Z,2016,180,40,119,78,0,0,0,102,0,0,140,61,0,180,0,1,0
12633,798,2020-11-18T16:15:50.9269308Z,2017,188,46,147,87,0,1,0,101,0,0,142,41,0,187,0,0,0
12633,799,2020-11-18T16:15:50.9269308Z,2018,221,56,172,93,0,0,0,128,0,0,165,49,0,221,1,0,0
12633,800,2020-11-18T16:15:50.9269308Z,2019,220,63,171,106,0,2,0,114,0,0,157,49,0,218,1,0,0
12633,801,2020-11-18T16:15:51.3061839Z,2020,216,62,169,104,0,2,0,112,0,0,154,47,0,214,0,0,0
26500,2981,2020-11-18T16:16:04.3008515Z,2012,362,81,254,184,0,5,0,178,0,0,281,108,28,329,0,0,0
26500,2982,2020-11-18T16:16:04.3018528Z,2013,311,85,267,164,0,5,0,147,0,0,226,44,28,278,0,0,0
26500,2983,2020-11-18T16:16:04.3018528Z,2014,319,86,216,172,0,4,0,147,0,0,233,103,26,289,0,0,0
26500,2984,2020-11-18T16:16:04.3018528Z,2015,310,76,219,160,0,6,0,150,0,0,234,91,19,285,0,0,0
26500,2985,2020-11-18T16:16:04.3018528Z,2016,266,79,161,142,0,4,2,124,0,0,187,105,15,246,0,0,1
26500,2986,2020-11-18T16:16:04.3028533Z,2017,281,87,212,134,0,4,3,147,0,0,194,69,14,263,0,0,0
26500,2987,2020-11-18T16:16:04.3028533Z,2018,286,83,224,134,0,4,10,152,0,0,203,62,2,279,0,0,1
26500,2988,2020-11-18T16:16:04.3028533Z,2019,415,145,322,182,0,8,4,233,0,0,270,93,2,404,0,0,1
26500,2989,2020-11-18T16:16:04.3038542Z,2020,356,123,318,165,0,9,1,191,0,0,233,38,1,345,0,0,1
26500,31732,2021-06-24T05:35:15.403862Z,2021,301,99,251,145,0,3,0,156,0,0,202,50,1,296,0,0,1
51862,31889,2021-06-24T05:35:18.4610549Z,2021,344,113,305,158,0,2,0,186,0,0,231,39,0,339,0,0,3
51862,6614,2020-11-18T16:16:28.2207993Z,2012,360,125,311,172,0,0,0,188,0,0,235,49,0,360,0,0,0
51862,6615,2020-11-18T16:16:28.2218024Z,2013,365,130,311,162,0,0,0,203,0,0,235,54,0,365,0,0,0
51862,6616,2020-11-18T16:16:28.2218024Z,2014,323,110,247,138,0,2,0,185,0,0,213,76,0,321,0,0,0
51862,6617,2020-11-18T16:16:28.2218024Z,2015,311,109,270,138,0,2,0,173,0,0,202,41,0,309,0,0,0
51862,6618,2020-11-18T16:16:28.2218024Z,2016,265,96,212,115,0,4,0,150,0,0,169,53,0,259,0,0,2
51862,6619,2020-11-18T16:16:28.2218024Z,2017,252,86,219,120,0,1,6,132,0,0,166,33,0,249,0,0,2
51862,6620,2020-11-18T16:16:28.222802Z,2018,239,77,210,114,0,2,9,125,0,0,162,29,0,236,0,0,1
51862,6621,2020-11-18T16:16:28.222802Z,2019,407,130,331,194,0,4,9,213,0,0,277,76,2,398,0,0,3
51862,6622,2020-11-18T16:16:28.222802Z,2020,392,126,341,182,0,3,27,210,0,0,266,51,0,387,0,0,2
35899,25802,2021-06-24T05:35:10.8936286Z,2021,223,72,201,96,0,6,22,127,0,0,151,22,1,215,1,2,1
35899,4461,2020-11-18T16:16:12.5873746Z,2012,249,30,192,137,0,0,0,112,0,0,219,57,0,249,0,0,0
35899,4462,2020-11-18T16:16:12.5873746Z,2013,241,51,184,127,0,2,0,114,0,0,190,57,0,239,0,3,0
35899,4463,2020-11-18T16:16:12.5873746Z,2014,240,62,185,120,0,2,0,120,0,0,178,55,0,238,0,1,0
35899,4464,2020-11-18T16:16:12.5883755Z,2015,262,69,206,130,0,1,0,132,0,0,193,56,1,260,0,2,0
35899,4465,2020-11-18T16:16:12.5883755Z,2016,220,67,182,102,0,1,0,118,0,0,153,38,0,219,0,1,0
35899,4466,2020-11-18T16:16:12.5893764Z,2017,201,75,176,82,0,8,6,119,0,0,126,25,1,192,0,6,0
35899,4467,2020-11-18T16:16:12.5893764Z,2018,283,93,252,127,0,12,19,156,0,0,190,31,1,270,0,3,0
35899,4468,2020-11-18T16:16:12.5893764Z,2019,258,88,229,119,0,10,20,139,0,0,170,29,1,247,0,3,0
35899,4469,2020-11-18T16:16:12.5903764Z,2020,252,79,220,114,0,7,0,138,0,0,173,32,1,244,0,2,0
61564,25950,2021-06-24T05:35:12.8710452Z,2021,443,172,385,201,0,27,1,242,0,0,271,58,0,414,10,0,2
61564,8286,2020-11-18T16:16:39.0810417Z,2012,356,46,303,166,0,28,0,190,0,0,310,53,0,326,0,0,2
61564,8287,2020-11-18T16:16:39.0810417Z,2013,366,72,322,188,0,28,0,178,0,0,294,44,0,338,0,0,0
61564,8288,2020-11-18T16:16:39.0810417Z,2014,396,99,343,198,0,25,0,198,0,0,297,53,2,369,0,0,0
61564,8289,2020-11-18T16:16:39.0810417Z,2015,411,116,361,215,0,31,0,196,0,0,295,50,2,378,0,0,0
61564,8290,2020-11-18T16:16:39.0820431Z,2016,396,144,299,206,0,28,3,190,0,0,252,97,0,368,0,0,0
61564,8291,2020-11-18T16:16:39.0820431Z,2017,383,150,326,186,0,17,3,197,0,0,233,57,0,364,0,0,2
61564,8292,2020-11-18T16:16:39.0820431Z,2018,433,176,361,211,0,19,2,222,0,0,257,72,0,413,5,0,1
61564,8293,2020-11-18T16:16:39.0830431Z,2019,456,171,391,203,0,25,1,253,0,0,285,65,0,427,10,0,4
61564,8294,2020-11-18T16:16:39.0830431Z,2020,404,149,348,186,0,17,1,218,0,0,255,56,1,384,13,1,2
