PartitionKey,RowKey,Timestamp,AcademicYear,All,Disabilities,EconomicallyDisadvantaged,Female,FosterCare,Grade,HispanicNOTPuertoRican,Homeless,Male,Migrants,MilitaryParent,NOTDisabilities,NOTEconomicallyDisadvantaged,OtherOrigin,PuertoRican,Section504,SpanishLearners,WhiteNOTHispanic
35295,2320,2020-11-18T16:20:55.7241811Z,2019,57,13,47,32,0,6to,0,0,25,0,0,44,10,0,57,0,0,0
35295,2321,2020-11-18T16:20:55.7241811Z,2019,66,15,54,45,0,7mo,2,0,21,0,0,51,12,0,63,0,1,1
35295,2322,2020-11-18T16:20:55.7241811Z,2019,80,16,67,41,0,8vo,2,0,39,0,0,64,13,0,78,1,0,0
35295,2323,2020-11-18T16:20:55.7241811Z,2019,7,6,7,2,0,Sin Grado,0,0,5,0,0,1,0,0,7,0,0,0
35295,32327,2021-06-24T13:18:23.2741379Z,2021,54,9,42,28,0,6to,2,0,26,0,0,45,12,0,52,0,0,0
35295,32328,2021-06-24T13:18:23.2741379Z,2021,64,8,46,30,0,7mo,6,0,34,0,0,56,18,0,58,0,1,0
35295,32329,2021-06-24T13:18:23.2751388Z,2021,61,11,44,34,0,8vo,1,0,27,0,0,50,17,0,60,0,0,0
35295,32330,2021-06-24T13:18:23.2751388Z,2021,5,5,4,1,0,Sin Grado,0,0,4,0,0,0,1,0,5,0,0,0
35295,8332,2020-11-18T16:21:51.3963044Z,2020,68,9,58,32,0,6to,6,0,36,0,0,59,10,0,62,0,1,0
35295,8333,2020-11-18T16:21:51.3963044Z,2020,68,16,55,37,0,7mo,3,0,31,0,0,52,13,0,65,0,0,0
35295,8334,2020-11-18T16:21:51.3963044Z,2020,59,13,46,42,0,8vo,3,0,17,0,0,46,13,0,55,0,0,1
35295,8335,2020-11-18T16:21:51.3973053Z,2020,5,5,5,0,0,Sin Grado,0,0,5,0,0,0,0,0,5,0,0,0
74864,11541,2020-11-18T16:22:11.3065826Z,2020,124,47,103,51,0,6to,2,1,73,0,0,77,21,1,121,0,1,0
74864,11542,2020-11-18T16:22:11.3065826Z,2020,139,37,111,64,0,7mo,1,2,75,0,0,102,28,0,138,0,1,0
74864,11543,2020-11-18T16:22:11.3065826Z,2020,147,40,116,78,0,8vo,3,0,69,0,0,107,31,0,144,0,0,0
74864,11544,2020-11-18T16:22:11.3065826Z,2020,33,32,31,2,0,Sin Grado,0,0,31,0,0,1,2,0,33,0,1,0
74864,35563,2021-06-24T13:18:46.5908636Z,2021,112,39,94,48,0,6to,3,0,64,0,0,73,18,1,108,0,1,0
74864,35564,2021-06-24T13:18:46.5908636Z,2021,120,42,96,55,0,7mo,2,0,65,0,0,78,24,0,118,0,0,0
74864,35565,2021-06-24T13:18:46.5908636Z,2021,135,37,105,66,0,8vo,1,1,69,0,0,98,30,0,134,0,1,0
74864,35566,2021-06-24T13:18:46.5908636Z,2021,28,28,22,1,0,Sin Grado,1,1,27,0,0,0,6,0,27,0,1,0
74864,5533,2020-11-18T16:21:16.1788201Z,2019,149,47,118,70,0,6to,2,0,79,0,0,102,31,0,147,0,1,0
74864,5534,2020-11-18T16:21:16.1788201Z,2019,147,44,112,73,0,7mo,2,1,74,0,0,103,35,0,145,0,1,0
74864,5535,2020-11-18T16:21:16.1798206Z,2019,150,49,111,79,0,8vo,2,1,71,0,0,101,39,0,148,1,0,0
74864,5536,2020-11-18T16:21:16.1798206Z,2019,38,38,37,3,0,Sin Grado,0,5,35,0,0,0,1,0,38,0,0,0
20578,1021,2020-11-18T16:20:43.8002279Z,2019,58,17,43,27,0,1ro,0,0,31,0,0,41,15,0,58,0,0,0
20578,1022,2020-11-18T16:20:43.8012292Z,2019,68,18,47,35,0,2do,2,3,33,0,0,50,21,0,65,0,0,1
20578,1023,2020-11-18T16:20:43.8012292Z,2019,87,31,63,46,0,3ro,1,1,41,0,0,56,24,0,86,0,0,0
20578,1024,2020-11-18T16:20:43.8012292Z,2019,86,41,60,41,0,4to,3,0,45,0,0,45,26,0,83,0,1,0
20578,1025,2020-11-18T16:20:43.8012292Z,2019,59,23,40,27,0,5to,2,0,32,0,0,36,19,0,56,0,0,1
20578,1026,2020-11-18T16:20:43.8012292Z,2019,44,11,29,24,0,K,0,0,20,0,0,33,15,0,43,0,0,1
20578,1027,2020-11-18T16:20:43.8022288Z,2019,23,22,20,8,0,Sin Grado,1,0,15,0,0,1,3,0,22,0,0,0
20578,31020,2021-06-24T13:18:12.0580976Z,2021,65,19,54,35,0,1ro,1,0,30,0,0,46,11,0,64,0,0,0
20578,31021,2021-06-24T13:18:12.0590968Z,2021,55,13,40,31,0,2do,0,0,24,0,0,42,15,0,55,0,0,0
20578,31022,2021-06-24T13:18:12.0590968Z,2021,72,16,56,34,0,3ro,0,0,38,0,0,56,16,0,72,0,0,0
20578,31023,2021-06-24T13:18:12.0590968Z,2021,80,24,60,42,0,4to,3,0,38,0,0,56,20,0,77,1,0,0
20578,31024,2021-06-24T13:18:12.0600977Z,2021,72,23,57,42,0,5to,1,0,30,0,0,49,15,0,71,0,0,0
20578,31025,2021-06-24T13:18:12.0600977Z,2021,72,18,61,36,0,K,0,0,36,0,0,54,11,0,72,0,0,0
20578,31026,2021-06-24T13:18:12.0610986Z,2021,21,21,17,12,0,Sin Grado,1,0,9,0,0,0,4,0,20,0,0,0
20578,7024,2020-11-18T16:21:43.6291258Z,2020,54,12,44,29,0,1ro,0,0,25,0,0,42,10,0,54,0,0,0
20578,7025,2020-11-18T16:21:43.6291258Z,2020,63,14,47,29,0,2do,0,0,34,0,0,49,16,0,63,0,0,0
20578,7026,2020-11-18T16:21:43.6291258Z,2020,73,20,55,36,0,3ro,3,0,37,0,0,53,18,0,70,0,0,0
20578,7027,2020-11-18T16:21:43.6301276Z,2020,78,24,59,42,0,4to,1,0,36,0,0,54,19,0,77,0,0,0
20578,7028,2020-11-18T16:21:43.6311267Z,2020,84,35,65,44,0,5to,2,0,40,0,0,49,19,0,82,0,1,0
20578,7029,2020-11-18T16:21:43.6311267Z,2020,57,14,42,29,0,K,0,0,28,0,0,43,15,0,57,0,0,0
20578,7030,2020-11-18T16:21:43.6311267Z,2020,23,23,19,10,0,Sin Grado,1,0,13,0,0,0,4,0,22,0,0,0
15784,30644,2021-06-24T13:18:10.6480845Z,2021,112,22,78,62,0,10mo,3,1,50,0,0,90,34,0,109,1,0,0
15784,30645,2021-06-24T13:18:10.6490855Z,2021,98,19,72,55,0,11mo,0,0,43,0,0,79,26,0,98,0,0,0
15784,30646,2021-06-24T13:18:10.6490855Z,2021,83,19,59,48,0,12mo,0,1,35,0,0,64,24,0,83,2,0,0
15784,30647,2021-06-24T13:18:10.6490855Z,2021,91,14,65,50,0,9no,0,0,41,0,0,77,26,0,90,0,0,1
15784,646,2020-11-18T16:20:41.1824864Z,2019,92,21,53,53,0,10mo,0,1,39,0,0,71,39,0,92,2,0,0
15784,647,2020-11-18T16:20:41.1834877Z,2019,107,18,71,71,0,11mo,1,1,36,0,0,89,36,0,106,4,0,0
15784,648,2020-11-18T16:20:41.1844868Z,2019,116,0,69,70,0,12mo,1,0,46,0,0,116,47,0,115,0,0,0
15784,649,2020-11-18T16:20:41.1844868Z,2019,117,22,74,66,0,9no,1,1,51,0,0,95,43,0,116,0,0,0
15784,6646,2020-11-18T16:21:40.7532108Z,2020,106,20,69,58,0,10mo,1,0,48,0,0,86,37,0,105,0,0,0
15784,6647,2020-11-18T16:21:40.7532108Z,2020,85,19,51,48,0,11mo,0,0,37,0,0,66,34,0,85,2,0,0
15784,6648,2020-11-18T16:21:40.7542108Z,2020,104,17,70,69,0,12mo,1,0,35,0,0,87,34,0,103,4,0,0
15784,6649,2020-11-18T16:21:40.7542108Z,2020,112,22,70,63,0,9no,3,0,49,0,0,90,42,0,109,1,0,0
52357,33568,2021-06-24T13:18:33.4094117Z,2021,20,7,18,9,0,1ro,0,0,11,0,0,13,2,0,20,0,0,0
52357,33569,2021-06-24T13:18:33.4094117Z,2021,19,8,17,6,0,2do,2,0,13,0,0,11,2,0,17,0,0,0
52357,33570,2021-06-24T13:18:33.4104131Z,2021,38,15,35,20,0,3ro,1,0,18,0,0,23,3,0,37,0,0,0
52357,33571,2021-06-24T13:18:33.4104131Z,2021,30,15,25,15,0,4to,1,0,15,0,0,15,5,0,29,0,0,0
52357,33572,2021-06-24T13:18:33.4104131Z,2021,28,11,27,12,0,5to,0,0,16,0,0,17,1,0,28,0,0,0
52357,33573,2021-06-24T13:18:33.4114136Z,2021,22,5,21,13,0,K,0,0,9,0,0,17,1,0,20,0,0,2
52357,33574,2021-06-24T13:18:33.4114136Z,2021,8,8,8,4,0,Sin Grado,0,0,4,0,0,0,0,0,8,0,0,0
52357,3544,2020-11-18T16:21:03.269215Z,2019,59,23,57,30,1,1ro,0,1,29,0,0,36,2,0,59,0,0,0
52357,3545,2020-11-18T16:21:03.269215Z,2019,45,18,40,19,3,2do,2,4,26,0,0,27,5,0,43,0,0,0
52357,3546,2020-11-18T16:21:03.269215Z,2019,45,17,45,22,0,3ro,1,0,23,0,0,28,0,0,44,0,0,0
52357,3547,2020-11-18T16:21:03.2702149Z,2019,39,14,36,18,0,4to,0,0,21,0,0,25,3,0,39,0,0,0
52357,3548,2020-11-18T16:21:03.2702149Z,2019,40,9,39,18,0,5to,2,0,22,0,0,31,1,0,37,0,0,1
52357,3549,2020-11-18T16:21:03.2702149Z,2019,29,6,25,14,1,K,10,1,15,0,0,23,4,0,19,0,0,0
52357,3550,2020-11-18T16:21:03.2702149Z,2019,9,7,9,3,0,Sin Grado,1,0,6,0,0,2,0,0,8,0,0,0
52357,9563,2020-11-18T16:21:59.0914364Z,2020,31,10,30,15,0,1ro,10,0,16,0,0,21,1,0,20,0,0,1
52357,9564,2020-11-18T16:21:59.0914364Z,2020,52,20,50,27,0,2do,1,2,25,0,0,32,2,0,51,0,0,0
52357,9565,2020-11-18T16:21:59.0914364Z,2020,36,16,31,19,0,3ro,1,3,17,0,0,20,5,0,34,0,0,1
52357,9566,2020-11-18T16:21:59.0924359Z,2020,37,17,37,17,0,4to,0,0,20,0,0,20,0,0,37,0,0,0
52357,9567,2020-11-18T16:21:59.0924359Z,2020,28,10,26,14,0,5to,0,0,14,0,0,18,2,0,28,0,0,0
52357,9568,2020-11-18T16:21:59.0924359Z,2020,28,5,26,13,0,K,1,1,15,0,0,23,2,0,27,0,0,0
52357,9569,2020-11-18T16:21:59.0924359Z,2020,11,8,10,4,0,Sin Grado,1,1,7,0,0,3,1,0,10,0,0,0
61598,10313,2020-11-18T16:22:03.7065126Z,2020,20,4,18,13,0,1ro,0,0,7,0,0,16,2,0,19,0,0,1
61598,10314,2020-11-18T16:22:03.7065126Z,2020,19,4,15,11,0,2do,1,1,8,0,0,15,4,0,18,0,0,0
61598,10315,2020-11-18T16:22:03.7065126Z,2020,21,3,18,10,0,3ro,0,0,11,0,0,18,3,0,21,0,0,0
61598,10316,2020-11-18T16:22:03.707513Z,2020,14,3,11,3,0,4to,2,0,11,0,0,11,3,0,12,0,0,0
61598,10317,2020-11-18T16:22:03.707513Z,2020,16,7,13,10,0,5to,1,0,6,0,0,9,3,0,15,0,0,0
61598,10318,2020-11-18T16:22:03.707513Z,2020,21,7,18,14,0,K,1,0,7,0,0,14,3,0,20,0,0,0
61598,10319,2020-11-18T16:22:03.708513Z,2020,14,2,11,7,0,PK,0,0,7,0,0,12,3,0,14,0,0,0
61598,10320,2020-11-18T16:22:03.708513Z,2020,5,5,5,1,0,Sin Grado,0,0,4,0,0,0,0,0,5,0,0,0
61598,34328,2021-06-24T13:18:38.6101412Z,2021,21,8,18,14,0,1ro,1,0,7,0,0,13,3,0,20,0,0,0
61598,34329,2021-06-24T13:18:38.6101412Z,2021,19,4,16,8,0,2do,0,0,11,0,0,15,3,0,19,0,0,0
61598,34330,2021-06-24T13:18:38.6101412Z,2021,18,4,16,10,0,3ro,1,0,8,0,0,14,2,0,17,0,0,0
61598,34331,2021-06-24T13:18:38.6111425Z,2021,23,4,21,10,0,4to,0,0,13,0,0,19,2,0,22,0,0,1
61598,34332,2021-06-24T13:18:38.6111425Z,2021,14,2,10,2,0,5to,1,0,12,0,0,12,4,0,13,0,0,0
61598,34333,2021-06-24T13:18:38.6111425Z,2021,19,4,14,11,0,K,0,0,8,0,0,15,5,0,19,0,0,0
61598,34334,2021-06-24T13:18:38.6111425Z,2021,14,4,9,8,0,PK,0,0,6,0,0,10,5,0,14,0,0,0
61598,34335,2021-06-24T13:18:38.612143Z,2021,5,5,4,1,0,Sin Grado,0,0,4,0,0,0,1,0,5,0,0,0
61598,4300,2020-11-18T16:21:09.0410614Z,2019,21,3,18,13,0,1ro,1,1,8,0,0,18,3,0,20,0,0,0
61598,4301,2020-11-18T16:21:09.6844878Z,2019,21,2,15,11,0,2do,0,0,10,0,0,19,6,0,21,0,0,0
61598,4302,2020-11-18T16:21:09.6844878Z,2019,13,4,12,4,0,3ro,1,0,9,0,0,9,1,0,12,0,0,0
61598,4303,2020-11-18T16:21:09.6844878Z,2019,15,8,13,9,0,4to,0,0,6,0,0,7,2,0,15,0,0,0
61598,4304,2020-11-18T16:21:09.6854878Z,2019,22,8,19,10,0,5to,1,0,12,0,0,14,3,0,21,0,0,0
61598,4305,2020-11-18T16:21:09.6854878Z,2019,20,4,18,11,0,K,0,0,9,0,0,16,2,0,20,0,0,0
61598,4306,2020-11-18T16:21:09.6854878Z,2019,16,2,15,11,0,PK,0,0,5,0,0,14,1,0,16,0,0,0
61598,4307,2020-11-18T16:21:09.6854878Z,2019,6,6,5,2,0,Sin Grado,0,0,4,0,0,0,1,0,6,0,0,0
27714,1660,2020-11-18T16:20:48.2632052Z,2019,52,21,42,27,0,1ro,0,2,25,0,0,31,10,0,52,0,0,0
27714,1661,2020-11-18T16:20:48.2632052Z,2019,64,18,49,28,0,2do,2,0,36,0,0,46,15,0,60,0,2,2
27714,1662,2020-11-18T16:20:48.2632052Z,2019,59,24,47,32,0,3ro,1,0,27,0,0,35,12,0,58,0,0,0
27714,1663,2020-11-18T16:20:48.2632052Z,2019,59,13,47,26,0,4to,1,0,33,0,0,46,12,0,58,1,0,0
27714,1664,2020-11-18T16:20:48.2632052Z,2019,51,13,40,27,0,5to,0,0,24,0,0,38,11,0,51,1,0,0
27714,1665,2020-11-18T16:20:48.2642065Z,2019,38,11,31,18,0,K,0,0,20,0,0,27,7,0,38,0,0,0
27714,1666,2020-11-18T16:20:48.2642065Z,2019,14,2,13,7,0,PK,0,0,7,0,0,12,1,0,14,0,0,0
27714,1667,2020-11-18T16:20:48.2642065Z,2019,4,2,4,1,0,Sin Grado,0,0,3,0,0,2,0,0,4,0,1,0
27714,31662,2021-06-24T13:18:16.1190086Z,2021,37,7,36,19,0,1ro,2,0,18,0,0,30,1,0,34,0,0,1
27714,31663,2021-06-24T13:18:16.1190086Z,2021,37,11,31,17,0,2do,0,0,20,0,0,26,6,0,37,0,0,0
27714,31664,2021-06-24T13:18:16.1200087Z,2021,49,17,46,26,0,3ro,1,0,23,0,0,32,3,0,48,0,1,0
27714,31665,2021-06-24T13:18:16.1200087Z,2021,58,15,49,26,0,4to,0,0,32,0,0,43,9,0,58,0,1,0
27714,31666,2021-06-24T13:18:16.1200087Z,2021,51,19,42,32,0,5to,1,0,19,0,0,32,9,0,50,0,0,0
27714,31667,2021-06-24T13:18:16.1210092Z,2021,37,5,32,19,0,K,0,0,18,0,0,32,5,0,37,0,0,0
27714,31668,2021-06-24T13:18:16.1210092Z,2021,12,4,11,4,0,PK,0,0,8,0,0,8,1,0,12,0,0,0
27714,31669,2021-06-24T13:18:16.1210092Z,2021,1,1,1,0,0,Sin Grado,0,0,1,0,0,0,0,0,1,0,0,0
27714,7665,2020-11-18T16:21:47.1995041Z,2020,42,12,35,18,0,1ro,0,0,24,0,0,30,7,0,42,0,0,0
27714,7666,2020-11-18T16:21:47.1995041Z,2020,50,16,39,27,0,2do,1,1,23,0,0,34,11,0,48,0,1,1
27714,7667,2020-11-18T16:21:47.1995041Z,2020,61,19,50,27,0,3ro,1,2,34,0,0,42,11,0,59,0,1,1
27714,7668,2020-11-18T16:21:47.1995041Z,2020,54,20,49,35,0,4to,1,0,19,0,0,34,5,0,53,0,0,0
27714,7669,2020-11-18T16:21:47.200505Z,2020,63,14,51,29,0,5to,1,1,34,0,0,49,12,0,62,1,0,0
27714,7670,2020-11-18T16:21:47.200505Z,2020,42,9,34,18,0,K,0,0,24,0,0,33,8,0,41,0,0,1
27714,7671,2020-11-18T16:21:47.200505Z,2020,16,2,12,8,0,PK,0,1,8,0,0,14,4,0,16,0,0,0
27714,7672,2020-11-18T16:21:47.2015059Z,2020,2,0,2,1,0,Sin Grado,0,0,1,0,0,2,0,0,2,0,0,0
26336,1570,2020-11-18T16:20:47.657805Z,2019,56,15,51,22,0,10mo,0,2,34,0,0,41,5,0,56,2,0,0
26336,1571,2020-11-18T16:20:47.657805Z,2019,51,12,48,24,0,11mo,0,1,27,0,0,39,3,0,51,0,0,0
26336,1572,2020-11-18T16:20:47.657805Z,2019,37,0,30,19,0,12mo,2,0,18,0,0,37,7,0,35,0,0,0
26336,1573,2020-11-18T16:20:47.658809Z,2019,42,14,35,11,0,6to,0,0,31,0,0,28,7,1,41,1,1,0
26336,1574,2020-11-18T16:20:47.658809Z,2019,55,17,47,23,0,7mo,0,1,32,0,0,38,8,0,55,0,0,0
26336,1575,2020-11-18T16:20:47.658809Z,2019,51,15,46,34,0,8vo,1,0,17,0,0,36,5,0,50,0,1,0
26336,1576,2020-11-18T16:20:47.6598063Z,2019,45,9,38,28,0,9no,0,1,17,0,0,36,7,0,45,0,0,0
26336,1577,2020-11-18T16:20:47.6598063Z,2019,12,10,11,2,0,Sin Grado,0,1,10,0,0,2,1,0,12,0,0,0
26336,31573,2021-06-24T13:18:15.8438106Z,2021,24,8,18,15,0,10mo,0,0,9,0,0,16,6,0,24,0,0,0
26336,31574,2021-06-24T13:18:15.8448147Z,2021,31,3,25,18,0,11mo,1,0,13,0,0,28,6,0,30,0,0,0
26336,31575,2021-06-24T13:18:15.8448147Z,2021,39,11,31,18,0,12mo,0,0,21,0,0,28,8,0,39,1,0,0
26336,31576,2021-06-24T13:18:15.8448147Z,2021,51,20,45,23,0,6to,1,0,28,0,0,31,6,0,50,0,0,0
26336,31577,2021-06-24T13:18:15.8448147Z,2021,51,12,43,33,0,7mo,1,0,18,0,0,39,8,0,50,0,0,0
26336,31578,2021-06-24T13:18:15.8448147Z,2021,50,16,40,13,0,8vo,1,1,37,0,0,34,10,0,49,1,0,0
26336,31579,2021-06-24T13:18:15.8458134Z,2021,40,6,34,19,0,9no,0,0,21,0,0,34,6,0,40,0,0,0
26336,31580,2021-06-24T13:18:15.8458134Z,2021,13,12,10,3,0,Sin Grado,0,1,10,0,0,1,3,0,13,0,0,0
26336,7576,2020-11-18T16:21:46.3889649Z,2020,38,5,33,24,0,10mo,0,1,14,0,0,33,5,0,38,0,0,0
26336,7577,2020-11-18T16:21:46.3889649Z,2020,49,15,44,22,0,11mo,0,2,27,0,0,34,5,0,49,1,0,0
26336,7578,2020-11-18T16:21:46.3889649Z,2020,50,14,49,24,0,12mo,0,0,26,0,0,36,1,0,50,0,0,0
26336,7579,2020-11-18T16:21:46.3899648Z,2020,54,13,50,37,0,6to,2,3,17,0,0,41,4,1,51,0,0,0
26336,7580,2020-11-18T16:21:46.3899648Z,2020,48,16,44,14,0,7mo,1,1,34,0,0,32,4,0,47,1,0,0
26336,7581,2020-11-18T16:21:46.3899648Z,2020,60,15,54,23,0,8vo,0,3,37,0,0,45,6,1,59,0,0,0
26336,7582,2020-11-18T16:21:46.3899648Z,2020,35,10,32,17,0,9no,1,3,18,0,0,25,3,0,34,0,0,0
26336,7583,2020-11-18T16:21:46.3899648Z,2020,12,12,12,1,0,Sin Grado,0,1,11,0,0,0,0,0,12,0,0,0
78931,11742,2020-11-18T16:22:12.3172577Z,2020,160,52,116,83,0,10mo,4,0,77,0,0,108,44,0,155,0,0,1
78931,11743,2020-11-18T16:22:12.3172577Z,2020,118,37,89,56,0,11mo,2,2,62,0,0,81,29,0,116,0,0,0
78931,11744,2020-11-18T16:22:12.3182581Z,2020,105,25,68,57,0,12mo,0,0,48,0,0,80,37,0,105,0,0,0
78931,11745,2020-11-18T16:22:12.3182581Z,2020,189,66,147,100,0,9no,3,3,89,0,0,123,42,0,186,0,0,0
78931,11746,2020-11-18T16:22:12.3182581Z,2020,10,10,10,5,0,Sin Grado,0,2,5,0,0,0,0,0,10,0,0,0
78931,35764,2021-06-24T13:18:47.7977294Z,2021,181,61,147,100,0,10mo,2,3,81,0,0,120,34,0,179,1,0,0
78931,35765,2021-06-24T13:18:47.7987299Z,2021,163,58,125,87,0,11mo,3,1,76,0,0,105,38,0,159,0,1,1
78931,35766,2021-06-24T13:18:47.7987299Z,2021,108,27,76,56,0,12mo,2,1,52,0,0,81,32,0,106,0,0,0
78931,35767,2021-06-24T13:18:47.7987299Z,2021,170,53,127,91,0,9no,2,4,79,0,0,117,43,0,167,0,0,1
78931,35768,2021-06-24T13:18:47.7987299Z,2021,9,9,8,4,0,Sin Grado,0,1,5,0,0,0,1,0,9,0,0,0
78931,5736,2020-11-18T16:21:17.1514689Z,2019,122,38,84,59,0,10mo,1,0,63,0,0,84,38,0,121,0,0,0
78931,5737,2020-11-18T16:21:17.1514689Z,2019,118,33,78,60,0,11mo,0,0,58,0,0,85,40,0,118,0,0,0
78931,5738,2020-11-18T16:21:17.1514689Z,2019,103,0,63,58,0,12mo,2,0,45,0,0,103,40,1,100,0,0,0
78931,5739,2020-11-18T16:21:17.1514689Z,2019,161,57,112,82,0,9no,5,1,79,0,0,104,49,0,155,0,0,1
78931,5740,2020-11-18T16:21:17.1514689Z,2019,6,4,5,4,0,Sin Grado,0,0,2,0,0,2,1,0,6,0,0,0
71514,11331,2020-11-18T16:22:10.1658205Z,2020,99,18,89,53,0,10mo,4,9,46,0,0,81,10,0,95,1,0,0
71514,11332,2020-11-18T16:22:10.1658205Z,2020,106,38,92,49,0,11mo,3,10,57,0,0,68,14,0,103,1,0,0
71514,11333,2020-11-18T16:22:10.166821Z,2020,86,7,75,43,0,12mo,0,16,43,0,0,79,11,0,85,2,0,1
71514,11334,2020-11-18T16:22:10.166821Z,2020,106,29,96,60,0,9no,2,1,46,0,0,77,10,0,104,1,1,0
71514,35352,2021-06-24T13:18:45.5861436Z,2021,109,32,91,60,0,10mo,2,4,49,0,0,77,18,0,107,1,0,0
71514,35353,2021-06-24T13:18:45.5861436Z,2021,99,24,86,51,0,11mo,4,2,48,0,0,75,13,0,95,0,0,0
71514,35354,2021-06-24T13:18:45.5871445Z,2021,103,42,87,45,0,12mo,3,5,58,0,0,61,16,0,99,1,0,1
71514,35355,2021-06-24T13:18:45.5871445Z,2021,87,30,72,47,0,9no,1,1,40,0,0,57,15,0,85,0,0,1
71514,5326,2020-11-18T16:21:15.0740817Z,2019,105,33,91,48,0,10mo,2,1,57,0,0,72,14,0,103,1,0,0
71514,5327,2020-11-18T16:21:15.0740817Z,2019,94,8,82,50,0,11mo,0,0,44,0,0,86,12,0,93,2,0,1
71514,5328,2020-11-18T16:21:15.0740817Z,2019,121,0,97,67,0,12mo,1,1,54,0,0,121,24,0,120,0,0,0
71514,5329,2020-11-18T16:21:15.0750821Z,2019,110,20,96,57,0,9no,3,1,53,0,0,90,14,0,107,0,0,0
42473,2779,2020-11-18T16:20:58.7632047Z,2019,51,19,48,21,0,1ro,0,0,30,0,0,32,3,0,51,0,1,0
42473,2780,2020-11-18T16:20:58.7632047Z,2019,66,21,62,36,0,2do,1,0,30,0,0,45,4,0,65,0,1,0
42473,2781,2020-11-18T16:20:58.7632047Z,2019,71,26,62,39,0,3ro,0,2,32,0,0,45,9,0,71,0,0,0
42473,2782,2020-11-18T16:20:58.7632047Z,2019,75,24,67,31,1,4to,2,2,44,0,0,51,8,0,73,0,1,0
42473,2783,2020-11-18T16:20:58.7632047Z,2019,80,27,71,30,0,5to,0,0,50,0,0,53,9,0,80,0,0,0
42473,2784,2020-11-18T16:20:58.7642051Z,2019,55,20,50,28,0,K,0,0,27,0,0,35,5,0,55,0,0,0
42473,2785,2020-11-18T16:20:58.7642051Z,2019,37,35,29,8,0,Sin Grado,0,0,29,0,0,2,8,0,37,0,0,0
42473,32785,2021-06-24T13:18:27.2019613Z,2021,54,14,40,32,0,1ro,0,0,22,0,0,40,14,0,54,0,0,0
42473,32786,2021-06-24T13:18:27.2029618Z,2021,56,20,50,31,0,2do,0,0,25,0,0,36,6,1,55,0,0,0
42473,32787,2021-06-24T13:18:27.2029618Z,2021,53,18,46,23,0,3ro,0,0,30,0,0,35,7,0,53,0,0,0
42473,32788,2021-06-24T13:18:27.2029618Z,2021,65,17,54,37,0,4to,1,0,28,0,0,48,11,0,64,0,1,0
42473,32789,2021-06-24T13:18:27.2039627Z,2021,63,28,53,34,0,5to,0,0,29,0,0,35,10,0,63,0,0,0
42473,32790,2021-06-24T13:18:27.2039627Z,2021,36,14,25,15,0,K,0,0,21,0,0,22,11,0,36,0,0,0
42473,32791,2021-06-24T13:18:27.2039627Z,2021,24,24,18,5,0,Sin Grado,0,0,19,0,0,0,6,0,24,0,0,0
42473,8789,2020-11-18T16:21:53.8209208Z,2020,57,23,49,31,0,1ro,0,1,26,0,0,34,8,1,56,0,0,0
42473,8790,2020-11-18T16:21:53.8219212Z,2020,53,16,48,24,0,2do,0,0,29,0,0,37,5,0,53,0,0,0
42473,8791,2020-11-18T16:21:53.8219212Z,2020,63,16,60,35,0,3ro,2,2,28,0,0,47,3,0,61,0,1,0
42473,8792,2020-11-18T16:21:53.8219212Z,2020,73,28,67,40,0,4to,0,1,33,0,0,45,6,0,73,0,0,0
42473,8793,2020-11-18T16:21:53.8219212Z,2020,78,23,69,34,0,5to,2,0,44,0,0,55,9,0,76,0,1,0
42473,8794,2020-11-18T16:21:53.8229217Z,2020,50,10,44,29,0,K,0,0,21,0,0,40,6,0,50,0,0,0
42473,8795,2020-11-18T16:21:53.8229217Z,2020,33,33,27,7,0,Sin Grado,0,0,26,0,0,0,6,0,33,0,0,0
58594,10102,2020-11-18T16:22:02.6958387Z,2020,23,4,20,11,0,1ro,2,0,12,0,0,19,3,0,21,0,0,0
58594,10103,2020-11-18T16:22:02.6968373Z,2020,19,6,11,7,0,2do,0,0,12,0,0,13,8,0,19,0,0,0
58594,10104,2020-11-18T16:22:02.6968373Z,2020,23,8,17,14,0,3ro,0,0,9,0,0,15,6,0,23,0,0,0
58594,10105,2020-11-18T16:22:02.6968373Z,2020,25,8,21,12,0,4to,1,0,13,0,0,17,4,0,24,1,0,0
58594,10106,2020-11-18T16:22:02.6968373Z,2020,26,12,17,10,0,5to,0,0,16,0,0,14,9,0,26,0,0,0
58594,10107,2020-11-18T16:22:02.6978382Z,2020,88,20,61,48,0,6to,2,0,40,0,0,68,27,0,86,0,0,0
58594,10108,2020-11-18T16:22:02.6978382Z,2020,68,15,50,27,0,7mo,0,0,41,0,0,53,18,0,68,0,0,0
58594,10109,2020-11-18T16:22:02.6978382Z,2020,86,18,55,53,0,8vo,0,0,33,0,0,68,31,2,84,0,0,0
58594,10110,2020-11-18T16:22:02.6978382Z,2020,23,1,7,13,0,K,0,0,10,0,0,22,16,0,23,0,0,0
58594,10111,2020-11-18T16:22:02.6978382Z,2020,10,0,0,6,0,PK,0,0,4,0,0,10,10,0,10,0,0,0
58594,10112,2020-11-18T16:22:02.6988386Z,2020,8,8,7,2,0,Sin Grado,1,0,6,0,0,0,1,0,7,0,0,0
58594,34110,2021-06-24T13:18:37.4383011Z,2021,17,2,9,10,0,1ro,0,0,7,0,0,15,8,0,17,0,0,0
58594,34111,2021-06-24T13:18:37.4383011Z,2021,25,7,20,10,0,2do,2,0,15,0,0,18,5,0,23,0,0,0
58594,34112,2021-06-24T13:18:37.4383011Z,2021,26,9,16,10,0,3ro,0,0,16,0,0,17,10,0,26,0,0,0
58594,34113,2021-06-24T13:18:37.4383011Z,2021,17,7,14,8,0,4to,0,0,9,0,0,10,3,0,17,0,0,0
58594,34114,2021-06-24T13:18:37.4383011Z,2021,24,7,21,11,0,5to,1,0,13,0,0,17,3,0,23,1,0,0
58594,34115,2021-06-24T13:18:37.4393025Z,2021,80,26,56,33,0,6to,1,0,47,0,0,54,24,0,79,0,0,0
58594,34116,2021-06-24T13:18:37.4393025Z,2021,83,20,52,45,0,7mo,2,1,38,0,0,63,31,0,81,0,0,0
58594,34117,2021-06-24T13:18:37.4393025Z,2021,64,14,49,26,0,8vo,0,1,38,0,0,50,15,0,64,0,0,0
58594,34118,2021-06-24T13:18:37.4403034Z,2021,17,2,7,11,0,K,0,0,6,0,0,15,10,0,17,0,0,0
58594,34119,2021-06-24T13:18:37.4403034Z,2021,9,0,5,6,0,PK,0,0,3,0,0,9,4,0,9,0,0,0
58594,34120,2021-06-24T13:18:37.4403034Z,2021,6,6,4,1,0,Sin Grado,1,0,5,0,0,0,2,0,5,0,0,0
58594,4084,2020-11-18T16:21:07.3169119Z,2019,15,4,9,5,0,1ro,0,0,10,0,0,11,6,0,15,0,0,0
58594,4085,2020-11-18T16:21:07.3169119Z,2019,19,6,12,10,0,2do,0,0,9,0,0,13,7,0,19,0,0,0
58594,4086,2020-11-18T16:21:07.3169119Z,2019,20,7,16,10,0,3ro,0,1,10,0,0,13,4,0,20,1,0,0
58594,4087,2020-11-18T16:21:07.3169119Z,2019,20,8,12,8,0,4to,0,0,12,0,0,12,8,0,20,0,0,0
58594,4088,2020-11-18T16:21:07.3169119Z,2019,26,8,21,11,0,5to,1,1,15,0,0,18,5,0,25,0,0,0
58594,4089,2020-11-18T16:21:07.3179128Z,2019,67,11,47,28,0,6to,0,2,39,0,0,56,20,0,67,0,0,0
58594,4090,2020-11-18T16:21:07.3179128Z,2019,98,21,63,60,0,7mo,0,1,38,0,0,77,35,2,96,0,0,0
58594,4091,2020-11-18T16:21:07.3179128Z,2019,85,14,51,50,0,8vo,1,1,35,0,0,71,34,0,84,2,0,0
58594,4092,2020-11-18T16:21:07.3179128Z,2019,12,1,10,4,0,K,3,0,8,0,0,11,2,0,9,0,0,0
58594,4093,2020-11-18T16:21:07.3179128Z,2019,14,1,6,6,0,PK,0,0,8,0,0,13,8,0,14,0,0,0
58594,4094,2020-11-18T16:21:07.3179128Z,2019,10,10,10,4,0,Sin Grado,1,0,6,0,0,0,0,0,9,0,0,0
32375,2035,2020-11-18T16:20:53.9009627Z,2019,15,2,12,5,0,10mo,0,0,10,0,0,13,3,0,15,0,0,0
32375,2036,2020-11-18T16:20:53.9009627Z,2019,6,0,4,1,0,11mo,0,0,5,0,0,6,2,0,6,0,0,0
32375,2037,2020-11-18T16:20:53.9019636Z,2019,5,0,5,1,0,12mo,0,0,4,0,0,5,0,0,4,0,0,1
32375,2038,2020-11-18T16:20:53.9019636Z,2019,3,2,3,1,0,1ro,0,0,2,0,0,1,0,0,3,0,0,0
32375,2039,2020-11-18T16:20:53.9019636Z,2019,10,2,7,8,0,2do,0,0,2,0,0,8,3,0,10,0,0,0
32375,2040,2020-11-18T16:20:53.9029636Z,2019,11,5,9,4,0,3ro,1,0,7,0,0,6,2,0,10,0,0,0
32375,2041,2020-11-18T16:20:53.9029636Z,2019,11,6,10,5,0,4to,1,0,6,0,0,5,1,0,10,0,0,0
32375,2042,2020-11-18T16:20:53.9029636Z,2019,5,2,4,1,0,5to,0,0,4,0,0,3,1,0,5,0,0,0
32375,2043,2020-11-18T16:20:53.9029636Z,2019,17,3,14,4,0,6to,0,0,13,0,0,14,3,0,17,0,0,0
32375,2044,2020-11-18T16:20:53.9039645Z,2019,13,8,12,0,0,7mo,0,1,13,0,0,5,1,0,12,0,0,1
32375,2045,2020-11-18T16:20:53.9039645Z,2019,8,1,6,5,0,8vo,0,0,3,0,0,7,2,0,8,0,0,0
32375,2046,2020-11-18T16:20:53.9039645Z,2019,12,4,9,8,0,9no,1,1,4,0,0,8,3,0,10,0,0,1
32375,32044,2021-06-24T13:18:20.0938579Z,2021,7,1,5,5,0,10mo,0,0,2,0,0,6,2,0,6,0,0,1
32375,32045,2021-06-24T13:18:20.0938579Z,2021,5,1,4,4,0,11mo,0,0,1,0,0,4,1,0,4,0,0,1
32375,32046,2021-06-24T13:18:20.0938579Z,2021,8,1,6,2,0,12mo,0,0,6,0,0,7,2,0,8,0,0,0
32375,32047,2021-06-24T13:18:20.0948588Z,2021,12,4,9,8,0,4to,1,0,4,0,0,8,3,0,11,0,0,0
32375,32048,2021-06-24T13:18:20.0948588Z,2021,10,3,10,5,0,5to,1,0,5,0,0,7,0,0,9,0,0,0
32375,32049,2021-06-24T13:18:20.0948588Z,2021,10,2,8,6,0,6to,0,0,4,0,0,8,2,0,9,0,0,1
32375,32050,2021-06-24T13:18:20.0958593Z,2021,12,5,12,3,0,7mo,1,0,9,0,0,7,0,0,11,0,0,0
32375,32051,2021-06-24T13:18:20.0958593Z,2021,13,6,8,4,0,8vo,0,0,9,0,0,7,5,0,12,0,0,1
32375,32052,2021-06-24T13:18:20.0958593Z,2021,9,5,8,2,0,9no,1,0,7,0,0,4,1,0,8,0,0,0
32375,8048,2020-11-18T16:21:49.5680857Z,2020,8,1,7,6,0,10mo,1,0,2,0,0,7,1,0,7,0,0,0
32375,8049,2020-11-18T16:21:49.5680857Z,2020,14,3,12,4,0,11mo,0,0,10,0,0,11,2,0,14,0,0,0
32375,8050,2020-11-18T16:21:49.5680857Z,2020,3,0,1,0,0,12mo,0,0,3,0,0,3,2,0,3,0,0,0
32375,8051,2020-11-18T16:21:49.5690866Z,2020,1,0,1,0,0,2do,0,0,1,0,0,1,0,0,1,0,0,0
32375,8052,2020-11-18T16:21:49.5690866Z,2020,5,1,5,4,0,3ro,0,0,1,0,0,4,0,0,5,0,0,0
32375,8053,2020-11-18T16:21:49.5690866Z,2020,8,3,8,2,0,4to,0,0,6,0,0,5,0,0,8,0,0,0
32375,8054,2020-11-18T16:21:49.5700879Z,2020,13,5,12,6,0,5to,1,0,7,0,0,8,1,0,11,0,0,1
32375,8055,2020-11-18T16:21:49.5700879Z,2020,9,5,7,2,0,6to,0,0,7,0,0,4,2,0,9,0,0,0
32375,8056,2020-11-18T16:21:49.5700879Z,2020,14,4,12,4,0,7mo,0,0,10,0,0,10,2,0,14,0,0,0
32375,8057,2020-11-18T16:21:49.5700879Z,2020,8,6,7,0,0,8vo,0,0,8,0,0,2,1,0,8,0,0,0
32375,8058,2020-11-18T16:21:49.5710884Z,2020,9,1,8,5,0,9no,0,0,4,0,0,8,1,0,8,0,0,1
74807,11534,2020-11-18T16:22:11.3065826Z,2020,88,34,74,43,0,1ro,0,0,45,0,0,54,14,0,88,0,0,0
74807,11535,2020-11-18T16:22:11.3065826Z,2020,68,19,59,29,0,2do,0,0,39,0,0,49,9,0,68,0,0,0
74807,11536,2020-11-18T16:22:11.3075839Z,2020,80,26,70,41,0,3ro,1,0,39,0,0,54,10,0,79,0,0,0
74807,11537,2020-11-18T16:22:11.3075839Z,2020,90,30,79,40,0,4to,2,0,50,0,0,60,11,0,88,0,0,0
74807,11538,2020-11-18T16:22:11.3075839Z,2020,90,27,77,42,0,5to,3,0,48,0,0,63,13,0,87,0,0,0
74807,11539,2020-11-18T16:22:11.3075839Z,2020,70,23,57,40,0,K,3,0,30,0,0,47,13,1,66,0,0,0
74807,11540,2020-11-18T16:22:11.3075839Z,2020,19,18,16,3,0,Sin Grado,0,0,16,0,0,1,3,1,18,0,0,0
74807,35556,2021-06-24T13:18:46.5868607Z,2021,62,19,59,35,0,1ro,2,0,27,0,0,43,3,0,60,0,0,0
74807,35557,2021-06-24T13:18:46.5878616Z,2021,76,31,73,35,0,2do,0,0,41,0,0,45,3,0,76,0,0,0
74807,35558,2021-06-24T13:18:46.5878616Z,2021,66,19,59,27,0,3ro,0,0,39,0,0,47,7,0,66,0,0,0
74807,35559,2021-06-24T13:18:46.5878616Z,2021,78,23,70,38,0,4to,1,0,40,0,0,55,8,0,77,0,0,0
74807,35560,2021-06-24T13:18:46.5878616Z,2021,85,28,82,39,0,5to,2,0,46,0,0,57,3,0,83,0,0,0
74807,35561,2021-06-24T13:18:46.588863Z,2021,66,11,62,36,0,K,1,0,30,0,0,55,4,0,65,0,0,0
74807,35562,2021-06-24T13:18:46.588863Z,2021,16,16,13,4,0,Sin Grado,0,0,12,0,0,0,3,0,16,0,0,0
74807,5526,2020-11-18T16:21:16.1798206Z,2019,92,37,78,34,0,1ro,0,0,58,0,0,55,14,0,92,0,0,0
74807,5527,2020-11-18T16:21:16.1798206Z,2019,83,26,73,40,0,2do,0,0,43,0,0,57,10,0,83,0,0,0
74807,5528,2020-11-18T16:21:16.1798206Z,2019,98,33,84,44,0,3ro,2,0,54,0,0,65,14,0,96,0,0,0
74807,5529,2020-11-18T16:21:16.1808201Z,2019,98,32,82,42,0,4to,3,0,56,0,0,66,16,0,95,0,0,0
74807,5530,2020-11-18T16:21:16.1808201Z,2019,99,34,80,38,0,5to,0,1,61,0,0,65,19,0,99,0,1,0
74807,5531,2020-11-18T16:21:16.1808201Z,2019,77,29,66,46,0,K,0,0,31,0,0,48,11,0,77,0,0,0
74807,5532,2020-11-18T16:21:16.1808201Z,2019,18,18,16,2,0,Sin Grado,0,0,16,0,0,0,2,0,18,0,0,0
50740,3303,2020-11-18T16:21:02.1254498Z,2019,55,18,48,24,0,6to,2,0,31,0,0,37,7,0,53,0,0,0
50740,3304,2020-11-18T16:21:02.1254498Z,2019,70,21,59,35,0,7mo,0,0,35,0,0,49,11,0,70,0,1,0
50740,3305,2020-11-18T16:21:02.1254498Z,2019,85,24,72,45,0,8vo,0,0,40,0,0,61,13,0,85,2,2,0
50740,3306,2020-11-18T16:21:02.1264507Z,2019,16,13,15,3,0,Sin Grado,0,0,13,0,0,3,1,0,16,0,0,0
50740,33329,2021-06-24T13:18:31.5550823Z,2021,49,18,41,22,0,6to,0,0,27,0,0,31,8,0,49,0,0,0
50740,33330,2021-06-24T13:18:31.5550823Z,2021,55,15,50,26,0,7mo,1,4,29,0,0,40,5,0,54,1,0,0
50740,33331,2021-06-24T13:18:31.5560832Z,2021,38,7,34,16,0,8vo,0,1,22,0,0,31,4,0,38,0,0,0
50740,33332,2021-06-24T13:18:31.5560832Z,2021,11,11,10,6,0,Sin Grado,0,2,5,0,0,0,1,0,11,0,0,0
50740,9323,2020-11-18T16:21:57.9906998Z,2020,59,15,54,30,0,6to,1,5,29,0,0,44,5,0,58,1,0,0
50740,9324,2020-11-18T16:21:57.9906998Z,2020,54,15,49,23,0,7mo,1,6,31,0,0,39,5,0,53,0,0,0
50740,9325,2020-11-18T16:21:57.9906998Z,2020,58,17,48,31,0,8vo,1,5,27,0,0,41,10,0,57,0,1,0
50740,9326,2020-11-18T16:21:57.9917007Z,2020,14,13,12,8,0,Sin Grado,0,1,6,0,0,1,2,0,14,0,0,0
66019,10749,2020-11-18T16:22:06.0230589Z,2020,82,27,74,37,0,6to,0,2,45,0,0,55,8,0,82,0,0,0
66019,10750,2020-11-18T16:22:06.0230589Z,2020,111,30,98,57,0,7mo,4,2,54,0,0,81,13,0,107,1,0,0
66019,10751,2020-11-18T16:22:06.0240616Z,2020,105,38,91,62,0,8vo,0,3,43,0,0,67,14,0,105,1,0,0
66019,10752,2020-11-18T16:22:06.0240616Z,2020,40,39,36,9,0,Sin Grado,1,2,31,0,0,1,4,0,39,0,0,0
66019,34766,2021-06-24T13:18:41.4791987Z,2021,91,25,81,51,0,6to,1,1,40,0,0,66,10,0,90,0,0,0
66019,34767,2021-06-24T13:18:41.4791987Z,2021,83,21,69,42,0,7mo,0,0,41,0,0,62,14,0,83,0,0,0
66019,34768,2021-06-24T13:18:41.4791987Z,2021,112,32,94,59,0,8vo,4,1,53,0,0,80,18,0,108,1,0,0
66019,34769,2021-06-24T13:18:41.4791987Z,2021,58,56,51,17,0,Sin Grado,0,1,41,0,0,2,7,0,58,0,0,0
66019,4740,2020-11-18T16:21:11.9069725Z,2019,106,24,87,53,0,6to,7,2,53,0,0,82,19,0,99,0,0,0
66019,4741,2020-11-18T16:21:11.9069725Z,2019,98,31,83,60,0,7mo,0,4,38,0,0,67,15,0,98,0,0,0
66019,4742,2020-11-18T16:21:11.9079725Z,2019,118,34,102,59,0,8vo,1,1,59,0,0,84,16,0,116,0,0,1
66019,4743,2020-11-18T16:21:11.9079725Z,2019,18,15,16,6,0,Sin Grado,0,1,12,0,0,3,2,0,18,0,0,0
62984,10568,2020-11-18T16:22:04.9263268Z,2020,102,34,96,45,0,10mo,8,0,57,0,0,68,6,0,94,0,0,0
62984,10569,2020-11-18T16:22:04.9263268Z,2020,68,22,61,42,0,11mo,9,0,26,0,0,46,7,0,59,0,0,0
62984,10570,2020-11-18T16:22:04.9263268Z,2020,58,7,52,24,0,12mo,6,1,34,0,0,51,6,0,52,0,0,0
62984,10571,2020-11-18T16:22:04.9263268Z,2020,84,28,79,38,0,9no,7,0,46,0,0,56,5,0,77,0,0,0
62984,10572,2020-11-18T16:22:04.9273272Z,2020,58,53,53,20,0,Sin Grado,1,0,38,0,0,5,5,0,57,0,0,0
62984,34582,2021-06-24T13:18:40.2453137Z,2021,88,28,74,39,0,10mo,7,0,49,0,0,60,14,0,81,0,0,0
62984,34583,2021-06-24T13:18:40.2453137Z,2021,88,28,81,43,0,11mo,9,0,45,0,0,60,7,0,79,0,0,0
62984,34584,2021-06-24T13:18:40.2453137Z,2021,56,20,48,37,0,12mo,7,0,19,0,0,36,8,0,49,0,0,0
62984,34585,2021-06-24T13:18:40.2463151Z,2021,50,12,37,26,0,9no,7,0,24,0,0,38,13,0,43,0,0,0
62984,34586,2021-06-24T13:18:40.2463151Z,2021,58,55,48,19,0,Sin Grado,2,0,39,0,0,3,10,0,56,0,0,0
62984,4557,2020-11-18T16:21:10.8362577Z,2019,114,36,105,66,0,10mo,13,0,48,0,0,78,9,0,101,0,0,0
62984,4558,2020-11-18T16:21:10.8372577Z,2019,83,12,75,41,0,11mo,14,0,42,0,0,71,8,0,69,0,0,0
62984,4559,2020-11-18T16:21:10.8372577Z,2019,64,1,57,38,0,12mo,11,0,26,0,0,63,7,0,53,0,0,0
62984,4560,2020-11-18T16:21:10.8372577Z,2019,120,40,110,49,0,9no,15,0,71,0,0,80,10,0,105,0,0,0
62984,4561,2020-11-18T16:21:10.8372577Z,2019,67,42,62,20,0,Sin Grado,0,2,47,0,0,25,5,0,67,0,0,0
14340,30557,2021-06-24T13:18:10.3838955Z,2021,82,35,76,36,0,10mo,0,0,46,0,0,47,6,0,82,0,0,0
14340,30558,2021-06-24T13:18:10.3838955Z,2021,68,28,62,40,0,11mo,0,0,28,0,0,40,6,0,68,0,0,0
14340,30559,2021-06-24T13:18:10.384896Z,2021,80,24,72,35,0,12mo,0,0,45,0,0,56,8,0,80,2,0,0
14340,30560,2021-06-24T13:18:10.384896Z,2021,91,36,82,39,0,9no,0,0,52,0,0,55,9,0,91,2,1,0
14340,560,2020-11-18T16:20:40.7732118Z,2019,97,32,84,43,0,10mo,1,0,54,0,0,65,13,0,96,2,0,0
14340,561,2020-11-18T16:20:40.7732118Z,2019,104,29,82,56,0,11mo,4,0,48,0,0,75,22,0,100,5,0,0
14340,562,2020-11-18T16:20:40.7732118Z,2019,104,0,85,56,0,12mo,2,0,48,0,0,104,19,0,102,3,0,0
14340,563,2020-11-18T16:20:40.7742136Z,2019,78,30,69,39,0,9no,0,0,39,0,0,48,9,0,78,0,0,0
14340,6559,2020-11-18T16:21:40.354944Z,2020,75,32,66,41,0,10mo,1,0,34,0,0,43,9,0,74,0,0,0
14340,6560,2020-11-18T16:21:40.3559444Z,2020,89,27,75,42,0,11mo,1,0,47,0,0,62,14,0,88,2,0,0
14340,6561,2020-11-18T16:21:40.3559444Z,2020,96,27,75,52,0,12mo,3,0,44,0,0,69,21,0,93,5,0,0
14340,6562,2020-11-18T16:21:40.3559444Z,2020,78,35,68,35,0,9no,0,1,43,0,0,43,10,0,78,0,0,0
71449,11304,2020-11-18T16:22:10.1638192Z,2020,19,7,17,9,0,1ro,0,3,10,0,0,12,2,0,19,0,0,0
71449,11305,2020-11-18T16:22:10.1638192Z,2020,19,4,18,10,0,2do,0,3,9,0,0,15,1,0,19,0,0,0
71449,11306,2020-11-18T16:22:10.1638192Z,2020,27,11,25,13,0,3ro,0,6,14,0,0,16,2,0,27,0,0,0
71449,11307,2020-11-18T16:22:10.1638192Z,2020,18,10,17,7,0,4to,1,5,11,0,0,8,1,0,17,0,0,0
71449,11308,2020-11-18T16:22:10.164821Z,2020,18,7,18,12,0,5to,0,3,6,0,0,11,0,0,18,0,0,0
71449,11309,2020-11-18T16:22:10.164821Z,2020,27,10,26,15,0,K,0,4,12,0,0,17,1,0,27,0,0,0
71449,11310,2020-11-18T16:22:10.164821Z,2020,26,26,22,4,0,Sin Grado,1,4,22,0,0,0,4,0,25,0,0,0
71449,35325,2021-06-24T13:18:45.5641287Z,2021,23,11,23,10,0,1ro,0,5,13,0,0,12,0,0,23,0,0,0
71449,35326,2021-06-24T13:18:45.5651283Z,2021,18,6,18,11,0,2do,0,3,7,0,0,12,0,0,18,0,0,0
71449,35327,2021-06-24T13:18:45.5651283Z,2021,21,6,20,10,0,3ro,0,4,11,0,0,15,1,0,21,0,0,0
71449,35328,2021-06-24T13:18:45.5651283Z,2021,25,10,25,12,0,4to,0,4,13,0,0,15,0,0,25,0,0,0
71449,35329,2021-06-24T13:18:45.5651283Z,2021,19,11,19,7,0,5to,1,4,12,0,0,8,0,0,18,0,0,0
71449,35330,2021-06-24T13:18:45.5651283Z,2021,25,10,23,12,0,K,0,5,13,0,0,15,2,0,25,0,0,0
71449,35331,2021-06-24T13:18:45.5661306Z,2021,24,24,23,2,0,Sin Grado,1,3,22,0,0,0,1,0,22,0,0,1
71449,5299,2020-11-18T16:21:14.4936958Z,2019,22,5,21,10,0,1ro,0,3,12,0,0,17,1,0,22,0,0,0
71449,5300,2020-11-18T16:21:14.4946989Z,2019,24,8,22,11,0,2do,0,5,13,0,0,16,2,0,24,0,0,0
71449,5301,2020-11-18T16:21:15.0680777Z,2019,19,8,17,9,0,3ro,0,4,10,0,0,11,2,0,19,0,0,0
71449,5302,2020-11-18T16:21:15.069079Z,2019,22,10,22,13,0,4to,0,4,9,0,0,12,0,0,22,0,0,0
71449,5303,2020-11-18T16:21:15.069079Z,2019,17,8,15,11,0,5to,1,4,6,0,0,9,2,0,16,0,0,0
71449,5304,2020-11-18T16:21:15.069079Z,2019,26,10,22,13,0,K,0,3,13,0,0,16,4,0,26,0,0,0
71449,5305,2020-11-18T16:21:15.069079Z,2019,27,26,23,5,0,Sin Grado,1,1,22,0,0,1,4,0,26,0,0,0
63172,10630,2020-11-18T16:22:05.3396022Z,2020,49,11,47,25,0,1ro,2,0,24,0,0,38,2,0,47,0,0,0
63172,10631,2020-11-18T16:22:05.3396022Z,2020,43,15,43,19,0,2do,1,0,24,0,0,28,0,0,42,0,0,0
63172,10632,2020-11-18T16:22:05.3396022Z,2020,39,18,37,19,0,3ro,3,0,20,0,0,21,2,0,36,0,0,0
63172,10633,2020-11-18T16:22:05.3396022Z,2020,42,11,40,22,0,4to,1,0,20,0,0,31,2,0,41,0,0,0
63172,10634,2020-11-18T16:22:05.3396022Z,2020,37,16,32,20,0,5to,3,0,17,0,0,21,5,1,33,0,1,0
63172,10635,2020-11-18T16:22:05.3406039Z,2020,48,14,44,18,0,K,1,0,30,0,0,34,4,0,47,0,0,0
63172,10636,2020-11-18T16:22:05.3406039Z,2020,14,14,14,5,0,Sin Grado,1,0,9,0,0,0,0,0,12,0,0,1
63172,34646,2021-06-24T13:18:41.0919216Z,2021,47,11,42,20,0,1ro,3,0,27,0,0,36,5,0,44,0,0,0
63172,34647,2021-06-24T13:18:41.0919216Z,2021,49,13,41,26,0,2do,3,0,23,0,0,36,8,0,46,0,0,0
63172,34648,2021-06-24T13:18:41.0919216Z,2021,42,13,38,20,0,3ro,4,0,22,0,0,29,4,0,38,0,0,0
63172,34649,2021-06-24T13:18:41.0919216Z,2021,32,15,27,13,0,4to,2,0,19,0,0,17,5,0,30,0,0,0
63172,34650,2021-06-24T13:18:41.0919216Z,2021,42,10,38,22,0,5to,4,0,20,0,0,32,4,0,38,0,0,0
63172,34651,2021-06-24T13:18:41.0929217Z,2021,32,7,20,18,0,K,0,0,14,0,0,25,12,0,32,0,0,0
63172,34652,2021-06-24T13:18:41.0929217Z,2021,10,10,9,1,0,Sin Grado,0,0,9,0,0,0,1,0,10,0,0,0
63172,4619,2020-11-18T16:21:11.2505331Z,2019,48,16,48,21,0,1ro,1,0,27,0,0,32,0,0,47,0,0,0
63172,4620,2020-11-18T16:21:11.2515336Z,2019,51,23,49,23,0,2do,3,0,28,0,0,28,2,0,48,0,0,0
63172,4621,2020-11-18T16:21:11.2515336Z,2019,44,14,43,24,0,3ro,1,0,20,0,0,30,1,0,42,0,0,1
63172,4622,2020-11-18T16:21:11.2515336Z,2019,43,15,38,23,0,4to,3,0,20,0,0,28,5,1,39,0,1,0
63172,4623,2020-11-18T16:21:11.2515336Z,2019,50,22,47,24,0,5to,2,0,26,0,0,28,3,0,48,0,0,0
63172,4624,2020-11-18T16:21:11.2515336Z,2019,51,12,46,33,0,K,1,0,18,0,0,39,5,0,50,0,0,0
63172,4625,2020-11-18T16:21:11.2515336Z,2019,13,12,13,5,0,Sin Grado,0,0,8,0,0,1,0,0,13,0,0,0
31542,1973,2020-11-18T16:20:53.403633Z,2019,73,9,51,35,0,10mo,0,4,38,0,0,64,22,0,73,1,0,0
31542,1974,2020-11-18T16:20:53.404633Z,2019,91,18,73,55,0,11mo,2,9,36,0,0,73,18,0,89,3,0,0
31542,1975,2020-11-18T16:20:53.404633Z,2019,84,0,64,38,0,12mo,0,7,46,0,0,84,20,0,84,0,0,0
31542,1976,2020-11-18T16:20:53.404633Z,2019,72,25,63,29,0,9no,1,4,43,0,0,47,9,0,71,1,0,0
31542,31981,2021-06-24T13:18:18.6928533Z,2021,82,18,70,39,0,10mo,2,10,43,0,0,64,12,0,80,1,0,0
31542,31982,2021-06-24T13:18:18.6928533Z,2021,73,23,65,31,0,11mo,1,2,42,0,0,50,8,0,72,1,0,0
31542,31983,2021-06-24T13:18:18.6928533Z,2021,67,9,56,33,0,12mo,1,2,34,0,0,58,11,0,66,1,0,0
31542,31984,2021-06-24T13:18:18.6928533Z,2021,52,18,44,25,0,9no,0,3,27,0,0,34,8,0,52,0,0,0
31542,7985,2020-11-18T16:21:49.1398005Z,2020,79,27,68,29,0,10mo,1,0,50,0,0,52,11,0,78,1,0,0
31542,7986,2020-11-18T16:21:49.1398005Z,2020,64,8,49,32,0,11mo,0,0,32,0,0,56,15,0,64,1,0,0
31542,7987,2020-11-18T16:21:49.1398005Z,2020,85,15,62,50,0,12mo,2,0,35,0,0,70,23,0,83,4,0,0
31542,7988,2020-11-18T16:21:49.1398005Z,2020,83,19,71,38,0,9no,3,0,45,0,0,64,12,0,80,1,1,0
32979,2133,2020-11-18T16:20:54.5654066Z,2019,100,31,82,50,0,6to,1,0,50,0,0,69,18,0,99,0,0,0
32979,2134,2020-11-18T16:20:54.5654066Z,2019,136,44,120,74,0,7mo,2,0,62,0,0,92,16,0,134,1,1,0
32979,2135,2020-11-18T16:20:54.5654066Z,2019,138,35,111,74,0,8vo,1,1,64,0,0,103,27,0,137,0,0,0
32979,32140,2021-06-24T13:18:20.8914296Z,2021,84,24,75,39,0,6to,0,0,45,0,0,60,9,0,84,0,0,0
32979,32141,2021-06-24T13:18:20.8914296Z,2021,108,26,91,56,0,7mo,3,0,52,0,0,82,17,0,105,1,0,0
32979,32142,2021-06-24T13:18:20.8914296Z,2021,108,33,84,53,0,8vo,3,0,55,0,0,75,24,0,105,0,0,0
32979,8146,2020-11-18T16:21:50.2205215Z,2020,118,28,105,59,0,6to,4,0,59,0,0,90,13,0,114,1,0,0
32979,8147,2020-11-18T16:21:50.2205215Z,2020,116,37,100,56,0,7mo,1,0,60,0,0,79,16,0,115,0,0,0
32979,8148,2020-11-18T16:21:50.221522Z,2020,110,32,96,66,0,8vo,0,0,44,0,0,78,14,0,110,1,0,0
20065,30869,2021-06-24T13:18:11.4626691Z,2021,16,5,14,8,0,1ro,0,0,8,0,0,11,2,0,16,0,0,0
20065,30870,2021-06-24T13:18:11.46367Z,2021,28,11,25,10,0,2do,0,0,18,0,0,17,3,0,28,0,0,0
20065,30871,2021-06-24T13:18:11.46367Z,2021,14,3,13,6,0,3ro,0,0,8,0,0,11,1,0,14,0,0,0
20065,30872,2021-06-24T13:18:11.46367Z,2021,16,4,13,8,0,4to,0,1,8,0,0,12,3,0,16,0,0,0
20065,30873,2021-06-24T13:18:11.4646705Z,2021,26,12,23,15,0,5to,0,0,11,0,0,14,3,0,26,1,0,0
20065,30874,2021-06-24T13:18:11.4646705Z,2021,15,2,12,9,0,K,0,0,6,0,0,13,3,0,15,0,0,0
20065,6873,2020-11-18T16:21:42.0530728Z,2020,25,10,23,8,0,1ro,0,0,17,0,0,15,2,0,25,0,0,0
20065,6874,2020-11-18T16:21:42.0530728Z,2020,16,4,12,7,0,2do,0,0,9,0,0,12,4,0,16,0,0,0
20065,6875,2020-11-18T16:21:42.0530728Z,2020,13,4,10,7,0,3ro,0,0,6,0,0,9,3,0,13,0,0,0
20065,6876,2020-11-18T16:21:42.0540737Z,2020,25,11,20,15,0,4to,0,0,10,0,0,14,5,0,25,1,0,0
20065,6877,2020-11-18T16:21:42.0540737Z,2020,29,15,22,15,0,5to,0,0,14,0,0,14,7,0,29,0,0,0
20065,6878,2020-11-18T16:21:42.0540737Z,2020,18,5,17,9,0,K,0,0,9,0,0,13,1,0,18,0,0,0
20065,872,2020-11-18T16:20:42.6504608Z,2019,17,5,13,8,0,1ro,0,0,9,0,0,12,4,0,17,0,0,0
20065,873,2020-11-18T16:20:42.6504608Z,2019,14,6,11,7,0,2do,0,2,7,0,0,8,3,0,14,0,0,0
20065,874,2020-11-18T16:20:42.6504608Z,2019,27,11,23,16,0,3ro,0,0,11,0,0,16,4,0,27,1,0,0
20065,875,2020-11-18T16:20:42.6504608Z,2019,37,18,27,21,0,4to,0,0,16,0,0,19,10,0,37,0,0,0
20065,876,2020-11-18T16:20:42.6514616Z,2019,28,18,20,10,0,5to,0,0,18,0,0,10,8,0,28,0,0,0
20065,877,2020-11-18T16:20:42.6514616Z,2019,30,10,25,10,0,K,0,2,20,0,0,20,5,0,30,0,0,0
53330,33689,2021-06-24T13:18:33.6956174Z,2021,18,4,17,9,0,1ro,0,1,9,0,0,14,1,0,18,0,0,0
53330,33690,2021-06-24T13:18:33.6956174Z,2021,18,3,14,7,0,2do,0,1,11,0,0,15,4,0,18,0,0,0
53330,33691,2021-06-24T13:18:33.6966179Z,2021,14,7,11,5,0,3ro,0,0,9,0,0,7,3,0,14,0,0,0
53330,33692,2021-06-24T13:18:33.6966179Z,2021,19,9,16,6,0,4to,0,0,13,0,0,10,3,0,19,0,0,0
53330,33693,2021-06-24T13:18:33.6966179Z,2021,21,6,18,11,0,5to,0,0,10,0,0,15,3,0,21,0,0,0
53330,33694,2021-06-24T13:18:33.6976188Z,2021,18,4,15,9,0,K,0,0,9,0,0,14,3,0,18,0,0,0
53330,3664,2020-11-18T16:21:04.3309201Z,2019,16,7,15,5,0,1ro,0,1,11,0,0,9,1,0,16,0,0,0
53330,3665,2020-11-18T16:21:04.3319209Z,2019,16,6,14,6,0,2do,0,2,10,0,0,10,2,0,16,0,0,0
53330,3666,2020-11-18T16:21:04.3319209Z,2019,20,7,17,11,0,3ro,0,0,9,0,0,13,3,0,20,0,0,0
53330,3667,2020-11-18T16:21:04.3319209Z,2019,14,3,10,7,0,4to,0,0,7,0,0,11,4,0,14,0,0,0
53330,3668,2020-11-18T16:21:04.3329218Z,2019,17,6,15,10,0,5to,0,2,7,0,0,11,2,0,17,0,0,0
53330,3669,2020-11-18T16:21:04.3329218Z,2019,14,3,9,5,0,K,0,1,9,0,0,11,5,0,14,0,0,0
53330,3670,2020-11-18T16:21:04.3329218Z,2019,4,4,4,2,0,Sin Grado,0,0,2,0,0,0,0,0,4,0,0,0
53330,9683,2020-11-18T16:21:59.5057127Z,2020,17,3,11,7,0,1ro,0,1,10,0,0,14,6,0,17,0,0,0
53330,9684,2020-11-18T16:21:59.5067131Z,2020,15,8,14,5,0,2do,0,1,10,0,0,7,1,0,15,0,0,0
53330,9685,2020-11-18T16:21:59.5067131Z,2020,16,8,14,6,0,3ro,0,2,10,0,0,8,2,0,16,0,0,0
53330,9686,2020-11-18T16:21:59.5067131Z,2020,21,7,17,12,0,4to,0,0,9,0,0,14,4,0,21,0,0,0
53330,9687,2020-11-18T16:21:59.5067131Z,2020,15,5,11,7,0,5to,0,0,8,0,0,10,4,0,15,0,0,0
53330,9688,2020-11-18T16:21:59.507714Z,2020,15,4,12,8,0,K,0,0,7,0,0,11,3,0,15,0,0,0
71530,11343,2020-11-18T16:22:10.177829Z,2020,59,18,57,27,0,1ro,2,4,32,0,0,41,2,0,57,0,0,0
71530,11344,2020-11-18T16:22:10.177829Z,2020,60,18,54,29,0,2do,1,3,31,0,0,42,6,0,59,0,0,0
71530,11345,2020-11-18T16:22:10.177829Z,2020,60,18,52,33,0,3ro,5,4,27,0,0,42,8,0,55,0,1,0
71530,11346,2020-11-18T16:22:10.177829Z,2020,70,24,62,32,0,4to,3,6,38,0,0,46,8,0,67,0,0,0
71530,11347,2020-11-18T16:22:10.1788317Z,2020,69,24,56,28,0,5to,2,5,41,0,0,45,13,0,67,0,0,0
71530,11348,2020-11-18T16:22:10.1788317Z,2020,80,24,65,39,0,6to,0,4,41,0,0,56,15,0,80,0,0,0
71530,11349,2020-11-18T16:22:10.1798294Z,2020,72,22,60,36,0,7mo,1,2,36,0,0,50,12,0,71,0,0,0
71530,11350,2020-11-18T16:22:10.1798294Z,2020,60,21,49,25,0,8vo,0,2,35,0,0,39,11,0,60,0,0,0
71530,11351,2020-11-18T16:22:10.1798294Z,2020,50,14,47,25,0,K,0,5,25,0,0,36,3,0,50,0,0,0
71530,11352,2020-11-18T16:22:10.1808308Z,2020,26,26,22,8,0,Sin Grado,0,3,18,0,0,0,4,0,26,0,0,0
71530,35364,2021-06-24T13:18:45.5951507Z,2021,44,13,42,20,0,1ro,1,0,24,0,0,31,2,0,43,0,0,0
71530,35365,2021-06-24T13:18:45.5951507Z,2021,63,20,61,31,0,2do,2,0,32,0,0,43,2,0,61,0,0,0
71530,35366,2021-06-24T13:18:45.5961516Z,2021,57,17,52,27,0,3ro,1,0,30,0,0,40,5,0,56,0,0,0
71530,35367,2021-06-24T13:18:45.5961516Z,2021,68,22,60,39,0,4to,6,0,29,0,0,46,8,0,62,0,1,0
71530,35368,2021-06-24T13:18:45.5961516Z,2021,70,30,61,29,0,5to,2,0,41,0,0,40,9,0,68,0,0,0
71530,35369,2021-06-24T13:18:45.5961516Z,2021,74,24,63,27,0,6to,1,0,47,0,0,50,11,0,73,0,0,0
71530,35370,2021-06-24T13:18:45.5971521Z,2021,82,23,67,40,0,7mo,0,0,42,0,0,59,15,0,82,0,0,0
71530,35371,2021-06-24T13:18:45.5971521Z,2021,69,22,58,36,0,8vo,1,0,33,0,0,47,11,0,68,0,0,0
71530,35372,2021-06-24T13:18:45.5971521Z,2021,37,10,33,22,0,K,0,0,15,0,0,27,4,0,37,0,0,0
71530,35373,2021-06-24T13:18:45.5971521Z,2021,26,26,22,7,0,Sin Grado,0,0,19,0,0,0,4,0,26,0,0,0
71530,5337,2020-11-18T16:21:15.0800857Z,2019,64,22,59,30,0,1ro,1,0,34,0,0,42,5,0,63,0,0,0
71530,5338,2020-11-18T16:21:15.0800857Z,2019,67,24,58,36,0,2do,6,0,31,0,0,43,9,0,61,0,1,0
71530,5339,2020-11-18T16:21:15.0810857Z,2019,64,19,56,30,0,3ro,1,1,34,0,0,45,8,0,63,0,0,0
71530,5340,2020-11-18T16:21:15.0810857Z,2019,70,28,56,31,0,4to,2,0,39,0,0,42,14,0,68,0,0,0
71530,5341,2020-11-18T16:21:15.0810857Z,2019,78,24,63,36,0,5to,0,0,42,0,0,54,15,0,78,0,0,0
71530,5342,2020-11-18T16:21:15.0820875Z,2019,76,22,64,38,0,6to,2,0,38,0,0,54,12,0,74,0,0,0
71530,5343,2020-11-18T16:21:15.0820875Z,2019,66,27,55,29,0,7mo,0,0,37,0,0,39,11,0,66,0,0,0
71530,5344,2020-11-18T16:21:15.0820875Z,2019,53,14,49,32,0,8vo,1,0,21,0,0,39,4,0,52,0,0,0
71530,5345,2020-11-18T16:21:15.0820875Z,2019,49,11,46,20,0,K,0,0,29,0,0,38,3,0,49,0,0,0
71530,5346,2020-11-18T16:21:15.0830875Z,2019,29,28,25,10,0,Sin Grado,0,0,19,0,0,1,4,0,29,0,0,0
17467,30718,2021-06-24T13:18:11.1794658Z,2021,35,14,32,17,0,1ro,0,0,18,0,0,21,3,0,35,0,0,0
17467,30719,2021-06-24T13:18:11.1794658Z,2021,50,16,44,21,0,2do,3,0,29,0,0,34,6,0,47,0,0,0
17467,30720,2021-06-24T13:18:11.1794658Z,2021,41,12,36,20,0,3ro,1,0,21,0,0,29,5,0,40,0,0,0
17467,30721,2021-06-24T13:18:11.1804667Z,2021,60,23,55,25,0,4to,1,0,35,0,0,37,5,0,59,1,0,0
17467,30722,2021-06-24T13:18:11.1804667Z,2021,48,17,45,25,0,5to,1,0,23,0,0,31,3,0,47,1,1,0
17467,30723,2021-06-24T13:18:11.1804667Z,2021,45,16,43,17,0,K,1,0,28,0,0,29,2,0,44,0,0,0
17467,30724,2021-06-24T13:18:11.1814672Z,2021,19,19,15,7,0,Sin Grado,1,0,12,0,0,0,4,0,18,0,0,0
17467,6720,2020-11-18T16:21:41.4326602Z,2020,54,19,44,23,0,1ro,2,0,31,0,0,35,10,0,52,0,0,0
17467,6721,2020-11-18T16:21:41.4326602Z,2020,44,13,37,18,0,2do,1,0,26,0,0,31,7,0,43,0,0,0
17467,6722,2020-11-18T16:21:41.4336624Z,2020,65,22,56,29,0,3ro,1,0,36,0,0,43,9,0,64,1,0,0
17467,6723,2020-11-18T16:21:41.4336624Z,2020,46,12,41,24,0,4to,0,0,22,0,0,34,5,0,46,1,0,0
17467,6724,2020-11-18T16:21:41.4336624Z,2020,56,23,44,26,0,5to,0,0,30,0,0,33,12,0,56,0,0,0
17467,6725,2020-11-18T16:21:41.434662Z,2020,49,17,43,21,0,K,1,0,28,0,0,32,6,0,48,0,0,0
17467,6726,2020-11-18T16:21:41.434662Z,2020,23,23,17,10,0,Sin Grado,1,0,13,0,0,0,6,0,22,0,0,0
17467,719,2020-11-18T16:20:42.1071001Z,2019,44,14,40,17,0,1ro,1,0,27,0,0,30,4,0,43,0,0,0
17467,720,2020-11-18T16:20:42.1071001Z,2019,72,28,61,27,0,2do,1,0,45,0,1,44,11,0,71,1,0,0
17467,721,2020-11-18T16:20:42.108101Z,2019,46,10,38,27,0,3ro,0,0,19,0,0,36,8,0,46,1,0,0
17467,722,2020-11-18T16:20:42.108101Z,2019,58,26,47,26,0,4to,0,2,32,0,0,32,11,0,58,0,0,0
17467,723,2020-11-18T16:20:42.108101Z,2019,59,25,49,28,0,5to,0,1,31,0,0,34,10,0,59,0,0,0
17467,724,2020-11-18T16:20:42.108101Z,2019,55,19,45,26,0,K,4,0,29,0,0,36,10,0,51,0,0,0
17467,725,2020-11-18T16:20:42.108101Z,2019,14,14,12,4,0,Sin Grado,0,0,10,0,0,0,2,0,14,0,0,0
62661,10476,2020-11-18T16:22:04.1538107Z,2020,19,7,18,11,0,1ro,0,0,8,0,0,12,1,0,19,0,0,0
62661,10477,2020-11-18T16:22:04.1548116Z,2020,18,4,17,7,0,2do,0,0,11,0,0,14,1,0,18,0,0,0
62661,10478,2020-11-18T16:22:04.1548116Z,2020,11,1,10,4,0,3ro,1,0,7,0,0,10,1,0,10,0,1,0
62661,10479,2020-11-18T16:22:04.1548116Z,2020,22,9,19,15,0,4to,0,0,7,0,0,13,3,0,22,0,0,0
62661,10480,2020-11-18T16:22:04.1548116Z,2020,19,10,19,10,0,5to,0,0,9,0,0,9,0,0,19,0,0,0
62661,10481,2020-11-18T16:22:04.1558125Z,2020,27,11,23,14,0,6to,0,0,13,0,0,16,4,0,26,0,0,1
62661,10482,2020-11-18T16:22:04.1558125Z,2020,33,5,30,15,0,7mo,4,0,18,0,0,28,3,0,29,0,1,0
62661,10483,2020-11-18T16:22:04.1558125Z,2020,43,16,38,21,0,8vo,4,1,22,0,0,27,5,0,39,0,0,0
62661,10484,2020-11-18T16:22:04.1568125Z,2020,13,4,9,4,0,K,0,0,9,0,0,9,4,0,13,0,0,0
62661,10485,2020-11-18T16:22:04.1568125Z,2020,25,25,22,6,0,Sin Grado,0,0,19,0,0,0,3,0,25,0,0,0
62661,34489,2021-06-24T13:18:39.4987784Z,2021,15,3,12,8,0,1ro,0,0,7,0,0,12,3,0,15,0,0,0
62661,34490,2021-06-24T13:18:39.4987784Z,2021,18,3,16,13,0,2do,0,0,5,0,0,15,2,0,18,0,0,0
62661,34491,2021-06-24T13:18:39.4987784Z,2021,18,5,17,7,0,3ro,0,0,11,0,0,13,1,0,18,0,0,0
62661,34492,2021-06-24T13:18:39.4987784Z,2021,15,3,14,9,0,4to,0,0,6,0,0,12,1,0,15,0,0,0
62661,34493,2021-06-24T13:18:39.4997798Z,2021,23,10,19,14,0,5to,0,0,9,0,0,13,4,0,23,0,0,0
62661,34494,2021-06-24T13:18:39.4997798Z,2021,39,16,36,23,0,6to,1,0,16,0,0,23,3,0,38,0,0,0
62661,34495,2021-06-24T13:18:39.4997798Z,2021,31,10,26,15,0,7mo,0,0,16,0,0,21,5,0,30,0,0,1
62661,34496,2021-06-24T13:18:39.4997798Z,2021,32,5,30,14,0,8vo,4,0,18,0,0,27,2,0,28,0,0,0
62661,34497,2021-06-24T13:18:39.5007802Z,2021,16,4,16,4,0,K,0,0,12,0,0,12,0,0,16,0,0,0
62661,34498,2021-06-24T13:18:39.5007802Z,2021,51,51,44,17,0,Sin Grado,0,0,34,0,0,0,7,0,51,0,0,0
62661,4465,2020-11-18T16:21:10.1477974Z,2019,21,0,14,10,0,12mo,1,0,11,0,0,21,7,0,20,0,0,0
62661,4466,2020-11-18T16:21:10.1487978Z,2019,33,12,31,11,0,1ro,1,0,22,0,0,21,2,0,32,0,0,0
62661,4467,2020-11-18T16:21:10.1487978Z,2019,21,4,19,12,0,2do,2,0,9,0,0,17,2,0,19,0,1,0
62661,4468,2020-11-18T16:21:10.1487978Z,2019,32,10,29,21,0,3ro,0,0,11,0,0,22,3,0,32,0,0,0
62661,4469,2020-11-18T16:21:10.1487978Z,2019,22,8,20,15,0,4to,0,0,7,0,0,14,2,0,22,0,0,0
62661,4470,2020-11-18T16:21:10.1497987Z,2019,25,12,22,13,0,5to,1,0,12,0,0,13,3,0,24,0,0,0
62661,4471,2020-11-18T16:21:10.1497987Z,2019,52,15,45,27,0,6to,4,0,25,0,0,37,7,1,47,0,1,0
62661,4472,2020-11-18T16:21:10.1497987Z,2019,59,19,51,27,0,7mo,4,1,32,0,0,40,8,0,55,0,0,0
62661,4473,2020-11-18T16:21:10.1507996Z,2019,32,11,26,16,0,8vo,1,0,16,0,0,21,6,0,31,0,0,0
62661,4474,2020-11-18T16:21:10.1507996Z,2019,18,8,14,10,0,K,1,0,8,0,0,10,4,0,17,0,0,0
62661,4475,2020-11-18T16:21:10.1507996Z,2019,25,25,24,7,0,Sin Grado,0,0,18,0,0,0,1,0,25,0,0,0
62679,10486,2020-11-18T16:22:04.1538107Z,2020,14,6,13,10,0,1ro,1,0,4,0,0,8,1,0,13,0,0,0
62679,10487,2020-11-18T16:22:04.1538107Z,2020,18,10,18,11,0,2do,1,0,7,0,0,8,0,0,17,0,0,0
62679,10488,2020-11-18T16:22:04.1538107Z,2020,13,2,12,9,0,3ro,0,0,4,0,0,11,1,0,13,0,0,0
62679,10489,2020-11-18T16:22:04.1538107Z,2020,11,6,10,6,0,4to,1,0,5,0,0,5,1,0,10,0,0,0
62679,10490,2020-11-18T16:22:04.1548116Z,2020,12,4,11,6,0,5to,1,0,6,0,0,8,1,0,11,0,0,0
62679,10491,2020-11-18T16:22:04.1548116Z,2020,12,1,11,8,0,K,0,0,4,0,0,11,1,0,12,0,0,0
62679,10492,2020-11-18T16:22:04.1548116Z,2020,8,8,8,3,0,Sin Grado,1,0,5,0,0,0,0,0,7,0,0,0
62679,34499,2021-06-24T13:18:39.4917736Z,2021,13,3,12,7,0,1ro,0,0,6,0,0,10,1,0,13,0,0,0
62679,34500,2021-06-24T13:18:40.173262Z,2021,15,8,11,11,0,2do,1,0,4,0,0,7,4,0,14,0,0,0
62679,34501,2021-06-24T13:18:40.173262Z,2021,19,9,19,10,0,3ro,1,0,9,0,0,10,0,0,18,0,0,0
62679,34502,2021-06-24T13:18:40.173262Z,2021,12,4,10,7,0,4to,0,0,5,0,0,8,2,0,12,0,0,0
62679,34503,2021-06-24T13:18:40.1742625Z,2021,9,4,9,5,0,5to,1,0,4,0,0,5,0,0,8,0,0,0
62679,34504,2021-06-24T13:18:40.1742625Z,2021,12,4,10,4,0,K,0,0,8,0,0,8,2,0,12,0,0,0
62679,34505,2021-06-24T13:18:40.1742625Z,2021,8,8,8,3,0,Sin Grado,1,0,5,0,0,0,0,0,7,0,0,0
62679,4476,2020-11-18T16:21:10.1447965Z,2019,25,15,25,13,0,1ro,3,4,12,0,0,10,0,0,22,0,0,0
62679,4477,2020-11-18T16:21:10.1447965Z,2019,17,2,15,6,0,2do,0,0,11,0,0,15,2,0,17,0,0,0
62679,4478,2020-11-18T16:21:10.1457965Z,2019,16,8,15,8,0,3ro,1,2,8,0,0,8,1,0,15,0,0,0
62679,4479,2020-11-18T16:21:10.1457965Z,2019,15,4,13,8,0,4to,1,0,7,0,0,11,2,0,14,0,0,0
62679,4480,2020-11-18T16:21:10.1457965Z,2019,15,4,11,8,0,5to,2,1,7,0,0,11,4,0,13,0,0,0
62679,4481,2020-11-18T16:21:10.146796Z,2019,8,3,7,5,0,K,0,1,3,0,0,5,1,0,8,0,0,0
62679,4482,2020-11-18T16:21:10.146796Z,2019,10,10,10,3,0,Sin Grado,1,0,7,0,0,0,0,0,9,0,0,0
26013,1555,2020-11-18T16:20:47.6507996Z,2019,94,32,68,45,0,10mo,1,2,49,0,0,62,26,0,93,0,0,0
26013,1556,2020-11-18T16:20:47.6507996Z,2019,91,24,69,41,0,11mo,3,0,50,0,0,67,22,0,88,0,0,0
26013,1557,2020-11-18T16:20:47.651801Z,2019,141,0,101,71,0,12mo,3,0,70,0,0,141,40,0,138,0,1,0
26013,1558,2020-11-18T16:20:47.651801Z,2019,56,19,39,26,0,9no,0,1,30,0,0,37,17,0,56,0,0,0
26013,31558,2021-06-24T13:18:15.8308011Z,2021,81,31,60,36,0,10mo,0,1,45,0,0,50,21,0,81,0,0,0
26013,31559,2021-06-24T13:18:15.8308011Z,2021,57,18,42,22,0,11mo,0,0,35,0,0,39,15,0,57,0,0,0
26013,31560,2021-06-24T13:18:15.8308011Z,2021,92,24,57,49,0,12mo,1,1,43,0,0,68,35,0,91,0,0,0
26013,31561,2021-06-24T13:18:15.8318024Z,2021,43,17,39,15,0,9no,0,0,28,0,0,26,4,0,43,0,0,0
26013,7561,2020-11-18T16:21:46.3749547Z,2020,59,21,46,22,0,10mo,1,1,37,0,0,38,13,0,58,0,0,0
26013,7562,2020-11-18T16:21:46.3759556Z,2020,97,29,62,52,0,11mo,1,0,45,0,0,68,35,0,96,0,0,0
26013,7563,2020-11-18T16:21:46.3759556Z,2020,86,24,66,39,0,12mo,1,0,47,0,0,62,20,0,85,0,0,0
26013,7564,2020-11-18T16:21:46.3759556Z,2020,80,31,69,38,0,9no,1,0,42,0,0,49,11,0,79,0,0,0
40493,2586,2020-11-18T16:20:57.6454645Z,2019,55,19,54,23,0,1ro,0,0,32,0,0,36,1,1,54,0,0,0
40493,2587,2020-11-18T16:20:57.6454645Z,2019,52,12,50,25,0,2do,1,1,27,0,0,40,2,0,51,0,0,0
40493,2588,2020-11-18T16:20:57.6454645Z,2019,42,15,41,20,0,3ro,1,0,22,0,0,27,1,0,41,0,1,0
40493,2589,2020-11-18T16:20:57.6454645Z,2019,48,16,45,20,0,4to,0,1,28,0,0,32,3,0,48,0,1,0
40493,2590,2020-11-18T16:20:57.646465Z,2019,51,20,46,26,0,5to,0,0,25,0,0,31,5,0,51,0,0,0
40493,2591,2020-11-18T16:20:57.646465Z,2019,1,0,1,0,0,6to,0,0,1,0,0,1,0,0,1,0,0,0
40493,2592,2020-11-18T16:20:57.646465Z,2019,43,5,41,24,0,K,0,0,19,0,0,38,2,0,43,0,0,0
40493,2593,2020-11-18T16:20:57.6474654Z,2019,19,15,16,4,1,Sin Grado,0,2,15,0,0,4,3,0,19,0,0,0
40493,32594,2021-06-24T13:18:25.2425563Z,2021,41,10,38,22,0,1ro,1,0,19,0,0,31,3,0,40,0,0,0
40493,32595,2021-06-24T13:18:25.2435572Z,2021,48,17,41,24,0,2do,0,0,24,0,0,31,7,0,48,0,0,0
40493,32596,2021-06-24T13:18:25.2435572Z,2021,43,12,41,20,0,3ro,1,0,23,0,0,31,2,1,41,0,0,0
40493,32597,2021-06-24T13:18:25.2435572Z,2021,52,14,48,28,0,4to,0,1,24,0,0,38,4,0,52,0,0,0
40493,32598,2021-06-24T13:18:25.2435572Z,2021,36,11,34,15,0,5to,1,0,21,0,0,25,2,0,35,0,0,0
40493,32599,2021-06-24T13:18:25.2435572Z,2021,42,12,39,19,0,K,0,0,23,0,0,30,3,0,42,0,0,0
40493,32600,2021-06-24T13:18:26.1612146Z,2021,9,9,9,1,0,Sin Grado,0,0,8,0,0,0,0,0,9,0,0,0
40493,8598,2020-11-18T16:21:52.6541414Z,2020,49,11,47,25,0,1ro,0,0,24,0,0,38,2,0,49,0,0,0
40493,8599,2020-11-18T16:21:52.6541414Z,2020,42,12,41,18,0,2do,0,0,24,0,0,30,1,1,41,0,0,0
40493,8600,2020-11-18T16:21:52.6541414Z,2020,51,16,49,25,0,3ro,1,0,26,0,0,35,2,0,50,0,0,0
40493,8601,2020-11-18T16:21:53.0343958Z,2020,38,13,37,14,0,4to,1,0,24,0,0,25,1,0,37,0,1,0
40493,8602,2020-11-18T16:21:53.0343958Z,2020,41,13,39,19,0,5to,0,0,22,0,0,28,2,0,41,0,0,0
40493,8603,2020-11-18T16:21:53.0353967Z,2020,47,9,45,22,0,K,0,0,25,0,0,38,2,0,47,0,0,0
40493,8604,2020-11-18T16:21:53.0353967Z,2020,17,16,14,5,0,Sin Grado,0,1,12,0,0,1,3,0,17,0,0,0
30270,1796,2020-11-18T16:20:48.8756116Z,2019,141,23,99,88,0,10mo,2,0,53,0,0,118,42,1,138,10,0,0
30270,1797,2020-11-18T16:20:48.8756116Z,2019,128,18,91,59,0,11mo,1,0,69,0,0,110,37,1,126,10,0,0
30270,1798,2020-11-18T16:20:48.8756116Z,2019,128,0,85,74,0,12mo,1,0,54,0,0,128,43,0,127,0,0,0
30270,1799,2020-11-18T16:20:48.8756116Z,2019,129,31,96,72,0,9no,1,0,57,0,0,98,33,0,128,3,0,0
30270,31799,2021-06-24T13:18:17.5060027Z,2021,127,31,105,70,0,10mo,0,0,57,0,0,96,22,1,126,6,0,0
30270,31800,2021-06-24T13:18:17.7411711Z,2021,125,24,101,68,0,11mo,0,0,57,0,0,101,24,0,125,3,0,0
30270,31801,2021-06-24T13:18:17.7411711Z,2021,130,24,101,83,0,12mo,2,0,47,0,0,106,29,1,127,9,0,0
30270,31802,2021-06-24T13:18:17.7421725Z,2021,122,28,93,54,0,9no,2,0,68,0,0,94,29,0,120,2,1,0
30270,7802,2020-11-18T16:21:48.4603455Z,2020,122,25,89,65,0,10mo,1,0,57,0,0,97,33,0,121,3,0,0
30270,7803,2020-11-18T16:21:48.4613464Z,2020,136,22,96,85,0,11mo,2,0,51,0,0,114,40,1,133,10,0,0
30270,7804,2020-11-18T16:21:48.4613464Z,2020,112,18,72,58,0,12mo,1,0,54,0,0,94,40,1,110,10,0,0
30270,7805,2020-11-18T16:21:48.4613464Z,2020,122,33,89,69,0,9no,0,1,53,0,0,89,33,1,121,7,0,0
52985,33655,2021-06-24T13:18:33.6816073Z,2021,31,4,27,16,0,1ro,0,4,15,0,0,27,4,0,30,0,0,1
52985,33656,2021-06-24T13:18:33.6816073Z,2021,27,11,22,12,0,2do,1,3,15,0,0,16,5,0,26,1,0,0
52985,33657,2021-06-24T13:18:33.6816073Z,2021,35,15,32,20,0,3ro,0,2,15,0,0,20,3,0,34,0,0,1
52985,33658,2021-06-24T13:18:33.6826078Z,2021,12,4,12,8,0,4to,0,1,4,0,0,8,0,0,12,0,0,0
52985,33659,2021-06-24T13:18:33.6826078Z,2021,27,12,25,11,0,5to,0,2,16,0,0,15,2,0,27,1,0,0
52985,33660,2021-06-24T13:18:33.6826078Z,2021,23,5,14,17,0,K,0,4,6,0,0,18,9,0,23,0,0,0
52985,33661,2021-06-24T13:18:33.6826078Z,2021,3,3,3,2,0,Sin Grado,0,0,1,0,0,0,0,0,3,0,0,0
52985,3630,2020-11-18T16:21:04.3249174Z,2019,42,20,38,22,0,1ro,1,1,20,0,0,22,4,0,40,0,0,1
52985,3631,2020-11-18T16:21:04.3249174Z,2019,17,9,17,9,0,2do,0,0,8,0,0,8,0,0,17,0,0,0
52985,3632,2020-11-18T16:21:04.325917Z,2019,32,14,29,16,0,3ro,0,3,16,0,0,18,3,0,32,1,0,0
52985,3633,2020-11-18T16:21:04.325917Z,2019,31,9,24,16,0,4to,2,5,15,0,0,22,7,0,29,0,1,0
52985,3634,2020-11-18T16:21:04.325917Z,2019,24,8,21,13,0,5to,2,4,11,0,0,16,3,0,22,0,1,0
52985,3635,2020-11-18T16:21:04.325917Z,2019,29,7,24,17,0,K,0,1,12,0,0,22,5,0,29,1,0,0
52985,3636,2020-11-18T16:21:04.3269174Z,2019,4,4,4,1,0,Sin Grado,0,0,3,0,0,0,0,0,4,0,0,0
52985,9649,2020-11-18T16:21:59.495706Z,2020,33,17,30,18,0,1ro,0,0,15,0,0,16,3,0,33,1,0,0
52985,9650,2020-11-18T16:21:59.4967056Z,2020,31,11,29,17,0,2do,0,0,14,0,0,20,2,0,30,0,0,1
52985,9651,2020-11-18T16:21:59.4967056Z,2020,14,4,12,9,0,3ro,0,0,5,0,0,10,2,0,14,0,0,0
52985,9652,2020-11-18T16:21:59.4967056Z,2020,29,14,25,15,0,4to,0,0,14,0,0,15,4,0,29,1,0,0
52985,9653,2020-11-18T16:21:59.497706Z,2020,32,7,28,19,0,5to,1,1,13,0,0,25,4,0,31,0,1,0
52985,9654,2020-11-18T16:21:59.497706Z,2020,32,5,3,17,0,K,0,0,15,0,0,27,29,0,31,0,0,1
52985,9655,2020-11-18T16:21:59.497706Z,2020,9,8,9,1,0,Sin Grado,0,0,8,0,0,1,0,0,9,0,0,0
70672,11102,2020-11-18T16:22:08.3155852Z,2020,10,3,9,7,0,1ro,0,1,3,0,0,7,1,0,10,0,0,0
70672,11103,2020-11-18T16:22:08.3155852Z,2020,12,6,11,7,0,2do,0,0,5,0,0,6,1,0,12,0,0,0
70672,11104,2020-11-18T16:22:08.3155852Z,2020,14,6,11,8,0,3ro,0,0,6,0,0,8,3,0,14,0,0,0
70672,11105,2020-11-18T16:22:08.3165852Z,2020,11,2,10,5,0,4to,0,0,6,0,0,9,1,0,11,0,0,0
70672,11106,2020-11-18T16:22:08.3165852Z,2020,17,2,14,4,0,5to,1,0,13,0,0,15,3,0,16,0,0,0
70672,11107,2020-11-18T16:22:08.3165852Z,2020,20,8,16,5,0,6to,0,1,15,0,0,12,4,0,20,0,0,0
70672,11108,2020-11-18T16:22:08.3175861Z,2020,7,2,7,2,0,7mo,0,0,5,0,0,5,0,0,7,0,0,0
70672,11109,2020-11-18T16:22:08.3175861Z,2020,19,9,15,9,0,8vo,0,0,10,0,0,10,4,0,19,0,0,0
70672,11110,2020-11-18T16:22:08.3175861Z,2020,13,2,11,5,0,K,0,0,8,0,0,11,2,0,13,0,0,0
70672,11111,2020-11-18T16:22:08.3185866Z,2020,13,13,11,3,0,Sin Grado,0,6,10,0,0,0,2,0,13,0,0,0
70672,35123,2021-06-24T13:18:44.4873557Z,2021,7,2,6,3,0,1ro,0,0,4,0,0,5,1,0,7,0,0,0
70672,35124,2021-06-24T13:18:44.4873557Z,2021,12,2,10,8,0,2do,0,0,4,0,0,10,2,0,12,0,0,0
70672,35125,2021-06-24T13:18:44.4873557Z,2021,10,3,7,7,0,3ro,0,0,3,0,0,7,3,0,10,0,0,0
70672,35126,2021-06-24T13:18:44.4883566Z,2021,15,7,12,6,0,4to,0,0,9,0,0,8,3,0,15,0,0,0
70672,35127,2021-06-24T13:18:44.4883566Z,2021,14,5,14,7,0,5to,0,0,7,0,0,9,0,0,14,0,0,0
70672,35128,2021-06-24T13:18:44.4883566Z,2021,23,5,20,6,0,6to,1,0,17,0,0,18,3,0,22,0,0,0
70672,35129,2021-06-24T13:18:44.4883566Z,2021,21,10,15,4,0,7mo,0,1,17,0,0,11,6,0,21,0,0,0
70672,35130,2021-06-24T13:18:44.4883566Z,2021,10,4,7,2,0,8vo,0,0,8,0,0,6,3,0,10,0,0,0
70672,35131,2021-06-24T13:18:44.4893571Z,2021,12,5,12,5,0,K,0,0,7,0,0,7,0,0,12,0,0,0
70672,35132,2021-06-24T13:18:44.4893571Z,2021,8,8,8,2,0,Sin Grado,0,2,6,0,0,0,0,0,8,0,0,0
70672,5096,2020-11-18T16:21:13.4429993Z,2019,12,4,11,8,0,1ro,1,0,4,0,0,8,1,0,11,0,0,0
70672,5097,2020-11-18T16:21:13.4439984Z,2019,14,7,11,8,0,2do,1,0,6,0,0,7,3,0,13,0,0,0
70672,5098,2020-11-18T16:21:13.4439984Z,2019,8,2,7,5,0,3ro,0,0,3,0,0,6,1,0,8,0,0,0
70672,5099,2020-11-18T16:21:13.4439984Z,2019,16,3,13,4,0,4to,0,0,12,0,0,13,3,0,16,0,0,0
70672,5100,2020-11-18T16:21:13.4439984Z,2019,19,6,12,7,0,5to,0,1,12,0,0,13,7,0,19,0,0,0
70672,5101,2020-11-18T16:21:14.0133775Z,2019,8,3,7,4,0,6to,0,1,4,0,0,5,1,0,8,0,0,0
70672,5102,2020-11-18T16:21:14.0133775Z,2019,20,10,16,9,0,7mo,1,1,11,0,0,10,4,0,19,0,0,0
70672,5103,2020-11-18T16:21:14.0143779Z,2019,21,10,20,8,0,8vo,0,0,13,0,0,11,1,0,21,0,0,0
70672,5104,2020-11-18T16:21:14.0143779Z,2019,15,2,12,10,0,K,0,0,5,0,0,13,3,0,15,0,0,0
70672,5105,2020-11-18T16:21:14.0143779Z,2019,6,4,6,1,0,Sin Grado,1,2,5,0,0,2,0,0,5,0,1,0
54940,33827,2021-06-24T13:18:35.7290759Z,2021,16,8,13,6,0,1ro,0,0,10,0,0,8,3,0,16,0,0,0
54940,33828,2021-06-24T13:18:35.7300764Z,2021,13,5,12,8,0,2do,0,0,5,0,0,8,1,0,13,0,0,0
54940,33829,2021-06-24T13:18:35.7300764Z,2021,12,6,12,4,0,3ro,0,0,8,0,0,6,0,0,12,0,0,0
54940,33830,2021-06-24T13:18:35.7300764Z,2021,20,14,20,4,0,4to,0,0,16,0,0,6,0,0,20,0,0,0
54940,33831,2021-06-24T13:18:35.7300764Z,2021,26,10,22,14,0,5to,0,0,12,0,0,16,4,0,26,0,0,0
54940,33832,2021-06-24T13:18:35.7300764Z,2021,21,5,12,9,0,K,0,0,12,0,0,16,9,0,21,0,0,0
54940,3804,2020-11-18T16:21:05.560739Z,2019,26,14,10,13,0,1ro,0,1,13,0,0,12,16,0,26,0,0,0
54940,3805,2020-11-18T16:21:05.560739Z,2019,38,17,29,13,0,2do,0,2,25,0,0,21,9,0,38,0,0,0
54940,3806,2020-11-18T16:21:05.560739Z,2019,46,12,40,23,0,3ro,2,4,23,0,0,34,6,0,44,0,0,0
54940,3807,2020-11-18T16:21:05.5617395Z,2019,51,21,43,21,0,4to,1,1,30,0,0,30,8,0,50,0,0,0
54940,3808,2020-11-18T16:21:05.5617395Z,2019,47,17,42,23,0,5to,1,4,24,0,0,30,5,0,46,0,0,0
54940,3809,2020-11-18T16:21:05.5617395Z,2019,27,9,0,16,0,K,0,0,11,0,0,18,27,0,27,0,0,0
54940,9821,2020-11-18T16:22:00.5103834Z,2020,17,6,16,10,0,1ro,0,1,7,0,0,11,1,0,17,0,0,0
54940,9822,2020-11-18T16:22:00.5103834Z,2020,20,8,15,10,0,2do,0,1,10,0,0,12,5,0,20,0,0,0
54940,9823,2020-11-18T16:22:00.5113838Z,2020,24,15,23,7,0,3ro,0,1,17,0,0,9,1,0,23,0,0,1
54940,9824,2020-11-18T16:22:00.5113838Z,2020,27,11,25,15,0,4to,0,3,12,0,0,16,2,0,27,0,0,0
54940,9825,2020-11-18T16:22:00.5113838Z,2020,37,18,32,14,0,5to,1,3,23,0,0,19,5,0,36,0,0,0
54940,9826,2020-11-18T16:22:00.5113838Z,2020,19,5,18,11,0,K,0,2,8,0,0,14,1,0,19,0,0,0
69039,10835,2020-11-18T16:22:06.5313985Z,2020,77,28,71,32,0,6to,1,1,45,0,0,49,6,0,76,0,0,0
69039,10836,2020-11-18T16:22:06.5323994Z,2020,102,31,91,54,0,7mo,3,0,48,0,0,71,11,0,99,0,0,0
69039,10837,2020-11-18T16:22:06.5323994Z,2020,136,52,107,70,0,8vo,3,0,66,0,0,84,29,0,133,0,0,0
69039,10838,2020-11-18T16:22:06.5323994Z,2020,11,11,10,3,0,Sin Grado,0,0,8,0,0,0,1,0,11,0,0,0
69039,34856,2021-06-24T13:18:42.560975Z,2021,55,12,51,25,0,6to,0,0,30,0,0,43,4,0,54,0,0,1
69039,34857,2021-06-24T13:18:42.5619751Z,2021,102,39,92,48,0,7mo,3,0,54,0,0,63,10,0,99,0,0,0
69039,34858,2021-06-24T13:18:42.5619751Z,2021,92,27,84,50,0,8vo,3,0,42,0,0,65,8,0,89,0,0,0
69039,34859,2021-06-24T13:18:42.5619751Z,2021,8,8,8,3,0,Sin Grado,0,0,5,0,0,0,0,0,8,0,0,0
69039,4828,2020-11-18T16:21:12.3812889Z,2019,121,33,109,57,0,6to,4,0,64,0,0,88,12,0,117,0,0,0
69039,4829,2020-11-18T16:21:12.3812889Z,2019,139,54,113,72,0,7mo,2,0,67,0,0,85,26,0,137,0,0,0
69039,4830,2020-11-18T16:21:12.3812889Z,2019,167,55,136,73,0,8vo,2,1,94,0,0,112,31,0,165,2,0,0
69039,4831,2020-11-18T16:21:12.3822898Z,2019,10,9,9,3,0,Sin Grado,0,0,7,0,0,1,1,0,10,0,0,0
17186,30673,2021-06-24T13:18:10.665097Z,2021,107,23,89,52,0,6to,0,2,55,0,0,84,18,0,107,0,0,0
17186,30674,2021-06-24T13:18:10.665097Z,2021,118,39,87,65,0,7mo,0,3,53,0,0,79,31,0,118,0,0,0
17186,30675,2021-06-24T13:18:10.665097Z,2021,117,27,82,38,0,8vo,0,1,79,0,0,90,35,0,117,0,0,0
17186,30676,2021-06-24T13:18:10.665097Z,2021,6,6,6,1,0,Sin Grado,0,0,5,0,0,0,0,0,6,0,0,0
17186,6675,2020-11-18T16:21:40.7602152Z,2020,123,38,91,63,0,6to,1,1,60,0,0,85,32,0,122,0,0,0
17186,6676,2020-11-18T16:21:40.7602152Z,2020,117,29,81,41,0,7mo,0,1,76,0,0,88,36,0,117,0,0,0
17186,6677,2020-11-18T16:21:40.7602152Z,2020,117,33,81,58,0,8vo,0,1,59,0,0,84,36,0,117,0,0,0
17186,6678,2020-11-18T16:21:40.7602152Z,2020,5,5,5,2,0,Sin Grado,0,0,3,0,0,0,0,0,5,0,0,0
17186,675,2020-11-18T16:20:41.1974962Z,2019,112,25,76,39,0,6to,0,1,73,0,0,87,36,0,112,0,0,0
17186,676,2020-11-18T16:20:41.1974962Z,2019,119,37,89,61,0,7mo,0,4,58,0,0,82,30,0,119,0,0,0
17186,677,2020-11-18T16:20:41.1974962Z,2019,112,20,77,53,0,8vo,0,1,59,0,0,92,35,0,112,2,0,0
17186,678,2020-11-18T16:20:41.1984966Z,2019,6,6,6,2,0,Sin Grado,0,0,4,0,0,0,0,0,6,0,0,0
61853,10375,2020-11-18T16:22:03.7255246Z,2020,83,24,72,42,0,10mo,1,2,41,0,0,59,11,0,82,0,0,0
61853,10376,2020-11-18T16:22:03.7255246Z,2020,90,12,75,48,0,11mo,3,0,42,0,0,78,15,0,87,0,0,0
61853,10377,2020-11-18T16:22:03.726526Z,2020,123,27,104,67,0,12mo,4,2,56,0,0,96,19,0,119,0,0,0
61853,10378,2020-11-18T16:22:03.726526Z,2020,69,16,53,33,0,6to,1,3,36,0,0,53,16,0,68,0,0,0
61853,10379,2020-11-18T16:22:03.726526Z,2020,78,21,63,35,0,7mo,2,5,43,0,0,57,15,0,76,0,0,0
61853,10380,2020-11-18T16:22:03.727526Z,2020,81,25,67,42,0,8vo,1,4,39,0,0,56,14,0,80,0,0,0
61853,10381,2020-11-18T16:22:03.727526Z,2020,73,20,58,27,0,9no,0,4,46,0,0,53,15,0,73,0,0,0
61853,10382,2020-11-18T16:22:03.727526Z,2020,2,2,2,1,0,Sin Grado,0,0,1,0,0,0,0,0,2,0,0,0
61853,34390,2021-06-24T13:18:38.6341588Z,2021,79,17,62,30,0,10mo,1,2,49,0,0,62,17,0,78,0,0,0
61853,34391,2021-06-24T13:18:38.6351593Z,2021,71,18,62,38,0,11mo,2,2,33,0,0,53,9,0,69,0,0,0
61853,34392,2021-06-24T13:18:38.6351593Z,2021,86,9,73,46,0,12mo,3,0,40,0,0,77,13,0,83,0,0,0
61853,34393,2021-06-24T13:18:38.6351593Z,2021,80,22,65,34,0,6to,1,0,46,0,0,58,15,0,79,0,0,0
61853,34394,2021-06-24T13:18:38.6351593Z,2021,81,16,67,46,0,7mo,1,3,35,0,0,65,14,0,80,0,0,0
61853,34395,2021-06-24T13:18:38.6361607Z,2021,82,23,70,37,0,8vo,2,1,45,0,0,59,12,0,80,0,0,0
61853,34396,2021-06-24T13:18:38.6361607Z,2021,93,30,77,48,0,9no,1,5,45,0,0,63,16,0,92,0,0,0
61853,34397,2021-06-24T13:18:38.6361607Z,2021,8,8,6,3,0,Sin Grado,1,1,5,0,0,0,2,0,7,0,0,0
61853,4362,2020-11-18T16:21:09.7045006Z,2019,104,14,89,56,0,10mo,2,4,48,0,0,90,15,0,102,1,0,0
61853,4363,2020-11-18T16:21:09.7045006Z,2019,127,26,106,67,0,11mo,4,6,60,0,0,101,21,0,123,0,0,0
61853,4364,2020-11-18T16:21:09.7055011Z,2019,115,0,86,67,0,12mo,0,5,48,0,0,115,29,1,114,1,1,0
61853,4365,2020-11-18T16:21:09.7055011Z,2019,76,17,60,31,0,6to,3,3,45,0,0,59,16,0,73,0,0,0
61853,4366,2020-11-18T16:21:09.7055011Z,2019,71,18,61,41,0,7mo,1,2,30,0,0,53,10,0,70,0,0,0
61853,4367,2020-11-18T16:21:09.7055011Z,2019,50,13,43,17,0,8vo,0,2,33,0,0,37,7,0,50,0,0,0
61853,4368,2020-11-18T16:21:09.7055011Z,2019,74,22,59,39,0,9no,1,4,35,0,0,52,15,0,73,0,0,0
61853,4369,2020-11-18T16:21:09.7065019Z,2019,9,8,9,3,0,Sin Grado,0,0,6,0,0,1,0,0,9,0,0,0
12740,30417,2021-06-24T13:18:09.4872526Z,2021,21,6,19,6,0,1ro,0,0,15,0,0,15,2,0,21,0,0,0
12740,30418,2021-06-24T13:18:09.4882531Z,2021,19,7,19,9,0,2do,0,0,10,0,0,12,0,0,19,0,0,0
12740,30419,2021-06-24T13:18:09.4882531Z,2021,18,7,16,10,0,3ro,0,0,8,0,0,11,2,0,18,0,1,0
12740,30420,2021-06-24T13:18:09.4882531Z,2021,33,17,29,21,0,4to,0,0,12,0,0,16,4,0,33,1,0,0
12740,30421,2021-06-24T13:18:09.4892545Z,2021,17,6,12,7,0,5to,0,0,10,0,0,11,5,0,17,2,0,0
12740,30422,2021-06-24T13:18:09.4892545Z,2021,28,11,23,13,0,6to,0,0,15,0,0,17,5,0,28,0,0,0
12740,30423,2021-06-24T13:18:09.4892545Z,2021,26,10,25,15,0,7mo,0,0,11,0,0,16,1,0,26,1,1,0
12740,30424,2021-06-24T13:18:09.490255Z,2021,20,8,19,9,0,8vo,0,0,11,0,0,12,1,0,20,0,0,0
12740,30425,2021-06-24T13:18:09.490255Z,2021,18,4,16,11,0,K,0,0,7,0,0,14,2,0,18,0,0,0
12740,30426,2021-06-24T13:18:09.490255Z,2021,10,10,10,4,0,Sin Grado,0,0,6,0,0,0,0,0,10,0,0,0
12740,419,2020-11-18T16:20:40.0627372Z,2019,18,7,16,10,0,1ro,0,0,8,0,0,11,2,0,18,0,1,0
12740,420,2020-11-18T16:20:40.0627372Z,2019,35,15,31,22,0,2do,0,0,13,0,0,20,4,0,35,1,0,0
12740,421,2020-11-18T16:20:40.0627372Z,2019,23,8,18,13,0,3ro,0,0,10,0,0,15,5,0,23,2,1,0
12740,422,2020-11-18T16:20:40.0627372Z,2019,26,10,21,15,0,4to,0,4,11,0,1,16,5,0,26,0,1,0
12740,423,2020-11-18T16:20:40.0637381Z,2019,25,10,18,12,0,5to,0,1,13,0,0,15,7,0,25,1,0,0
12740,424,2020-11-18T16:20:40.0637381Z,2019,19,7,18,10,0,6to,0,0,9,0,0,12,1,0,19,0,0,0
12740,425,2020-11-18T16:20:40.0637381Z,2019,27,6,21,16,0,7mo,0,1,11,0,0,21,6,0,27,1,1,0
12740,426,2020-11-18T16:20:40.0637381Z,2019,22,7,20,10,0,8vo,0,2,12,0,0,15,2,0,22,0,0,0
12740,427,2020-11-18T16:20:40.0637381Z,2019,25,11,21,15,0,K,0,0,10,0,0,14,4,0,25,0,0,0
12740,428,2020-11-18T16:20:40.0647381Z,2019,23,22,23,5,0,Sin Grado,0,2,18,0,0,1,0,0,23,0,0,0
12740,6420,2020-11-18T16:21:39.661481Z,2020,17,6,17,11,0,1ro,0,0,6,0,0,11,0,0,17,0,0,0
12740,6421,2020-11-18T16:21:39.661481Z,2020,16,7,14,9,0,2do,0,0,7,0,0,9,2,0,16,0,1,0
12740,6422,2020-11-18T16:21:39.661481Z,2020,35,17,33,23,0,3ro,0,0,12,0,0,18,2,0,35,2,0,0
12740,6423,2020-11-18T16:21:39.6624814Z,2020,14,2,10,9,0,4to,0,0,5,0,0,12,4,0,14,2,0,0
12740,6424,2020-11-18T16:21:39.6624814Z,2020,25,8,20,11,0,5to,0,0,14,0,0,17,5,0,25,0,0,0
12740,6425,2020-11-18T16:21:39.6624814Z,2020,23,9,18,14,0,6to,0,0,9,0,0,14,5,0,23,1,0,0
12740,6426,2020-11-18T16:21:39.6624814Z,2020,18,6,17,10,0,7mo,0,0,8,0,0,12,1,0,18,0,0,0
12740,6427,2020-11-18T16:21:39.6624814Z,2020,26,6,21,14,0,8vo,0,0,12,0,0,20,5,0,26,1,0,0
12740,6428,2020-11-18T16:21:39.6634836Z,2020,19,4,17,5,0,K,0,0,14,0,0,15,2,0,19,0,0,0
12740,6429,2020-11-18T16:21:39.6634836Z,2020,26,26,25,7,0,Sin Grado,1,2,19,0,0,0,1,0,25,0,0,0
71886,11455,2020-11-18T16:22:10.5740933Z,2020,108,38,95,50,0,6to,2,0,58,0,0,70,13,0,106,0,1,0
71886,11456,2020-11-18T16:22:10.575095Z,2020,147,44,139,64,0,7mo,1,1,83,0,0,103,8,0,146,0,0,0
71886,11457,2020-11-18T16:22:10.575095Z,2020,119,27,108,67,0,8vo,3,0,52,0,0,92,11,0,116,0,0,0
71886,11458,2020-11-18T16:22:10.575095Z,2020,15,15,15,3,0,Sin Grado,0,0,12,0,0,0,0,0,15,0,0,0
71886,35476,2021-06-24T13:18:46.2476181Z,2021,103,33,96,50,0,6to,2,1,53,0,0,70,7,0,101,1,0,0
71886,35477,2021-06-24T13:18:46.2476181Z,2021,112,42,97,51,0,7mo,3,1,61,0,0,70,15,0,109,0,1,0
71886,35478,2021-06-24T13:18:46.2486195Z,2021,133,42,107,60,0,8vo,0,0,73,0,0,91,26,0,133,0,0,0
71886,35479,2021-06-24T13:18:46.2486195Z,2021,11,11,11,3,0,Sin Grado,0,0,8,0,0,0,0,0,11,0,0,0
71886,5446,2020-11-18T16:21:15.4803535Z,2019,138,44,122,64,0,6to,1,1,74,0,0,94,16,0,137,0,0,0
71886,5447,2020-11-18T16:21:15.4803535Z,2019,151,34,137,72,0,7mo,2,0,79,0,0,117,14,0,149,0,1,0
71886,5448,2020-11-18T16:21:15.4803535Z,2019,148,34,131,76,0,8vo,4,0,72,0,0,114,17,0,144,0,0,0
71886,5449,2020-11-18T16:21:15.4813531Z,2019,29,24,27,11,0,Sin Grado,1,2,18,0,0,5,2,0,28,0,0,0
55483,33847,2021-06-24T13:18:35.7530932Z,2021,76,19,64,38,0,1ro,0,0,38,0,0,57,12,0,76,0,0,0
55483,33848,2021-06-24T13:18:35.7530932Z,2021,98,28,87,58,0,2do,0,0,40,0,0,70,11,0,98,0,0,0
55483,33849,2021-06-24T13:18:35.7530932Z,2021,85,23,70,37,0,3ro,0,0,48,0,0,62,15,0,84,0,0,1
55483,33850,2021-06-24T13:18:35.7540937Z,2021,89,29,70,40,0,4to,1,0,49,0,0,60,19,0,88,0,0,0
55483,33851,2021-06-24T13:18:35.7540937Z,2021,80,24,67,40,0,5to,0,0,40,0,0,56,13,0,80,0,1,0
55483,33852,2021-06-24T13:18:35.7540937Z,2021,65,8,60,43,0,K,0,0,22,0,0,57,5,0,65,0,0,0
55483,33853,2021-06-24T13:18:35.7540937Z,2021,18,1,16,10,0,PK,0,0,8,0,0,17,2,0,18,0,0,0
55483,3824,2020-11-18T16:21:05.5717461Z,2019,81,22,57,38,0,1ro,1,0,43,0,1,59,24,0,80,0,0,0
55483,3825,2020-11-18T16:21:05.5717461Z,2019,105,30,74,45,0,2do,2,0,60,0,0,75,31,3,100,0,0,0
55483,3826,2020-11-18T16:21:05.5717461Z,2019,94,34,68,44,0,3ro,1,0,50,0,1,60,26,0,93,0,3,0
55483,3827,2020-11-18T16:21:05.5727466Z,2019,97,28,70,54,0,4to,2,0,43,0,0,69,27,0,95,0,1,0
55483,3828,2020-11-18T16:21:05.5727466Z,2019,123,24,83,74,0,5to,2,0,49,0,0,99,40,0,121,3,0,0
55483,3829,2020-11-18T16:21:05.5727466Z,2019,91,21,73,54,0,K,0,0,37,0,0,70,18,0,91,0,0,0
55483,3830,2020-11-18T16:21:05.5737475Z,2019,17,1,14,6,0,PK,0,0,11,0,0,16,3,0,16,0,0,1
55483,9841,2020-11-18T16:22:00.5243927Z,2020,108,26,90,63,0,1ro,0,1,45,0,0,82,18,0,108,0,0,0
55483,9842,2020-11-18T16:22:00.5253932Z,2020,101,30,73,46,0,2do,0,0,55,0,0,71,28,0,100,0,0,1
55483,9843,2020-11-18T16:22:00.5253932Z,2020,110,40,77,48,0,3ro,1,0,62,0,0,70,33,2,107,0,0,0
55483,9844,2020-11-18T16:22:00.5253932Z,2020,93,29,64,45,0,4to,0,0,48,0,0,64,29,0,93,0,1,0
55483,9845,2020-11-18T16:22:00.5253932Z,2020,97,27,67,52,0,5to,2,1,45,0,0,70,30,1,93,0,1,1
55483,9846,2020-11-18T16:22:00.5253932Z,2020,88,23,61,41,0,K,0,0,47,0,0,65,27,0,86,0,0,2
55483,9847,2020-11-18T16:22:00.5263936Z,2020,20,1,1,13,0,PK,0,0,7,0,0,19,19,0,20,0,0,0
10637,30067,2021-06-24T13:18:05.9156918Z,2021,32,7,27,15,0,1ro,1,0,17,0,0,25,5,0,31,0,0,0
10637,30068,2021-06-24T13:18:05.9156918Z,2021,11,2,8,4,0,2do,0,0,7,0,0,9,3,0,11,0,0,0
10637,30069,2021-06-24T13:18:05.9166923Z,2021,22,6,20,14,0,3ro,0,0,8,0,0,16,2,0,22,0,0,0
10637,30070,2021-06-24T13:18:05.9166923Z,2021,24,7,18,13,0,4to,0,0,11,0,0,17,6,0,24,1,0,0
10637,30071,2021-06-24T13:18:05.9166923Z,2021,14,5,11,9,0,5to,0,0,5,0,0,9,3,0,14,0,0,0
10637,30072,2021-06-24T13:18:05.9166923Z,2021,14,4,12,7,0,6to,0,0,7,0,0,10,2,0,14,1,0,0
10637,30073,2021-06-24T13:18:05.9166923Z,2021,27,6,24,13,0,7mo,0,0,14,0,0,21,3,0,27,0,0,0
10637,30074,2021-06-24T13:18:05.9176937Z,2021,12,7,11,3,0,8vo,0,0,9,0,0,5,1,0,12,0,0,0
10637,30075,2021-06-24T13:18:05.9176937Z,2021,18,6,13,6,0,K,1,0,12,0,0,12,5,0,17,0,0,0
10637,30076,2021-06-24T13:18:05.9176937Z,2021,9,9,7,3,0,Sin Grado,0,0,6,0,0,0,2,0,9,0,0,0
10637,6068,2020-11-18T16:21:37.6981695Z,2020,13,1,11,4,0,1ro,0,0,9,0,0,12,2,0,13,0,0,0
10637,6069,2020-11-18T16:21:37.6981695Z,2020,23,6,23,15,0,2do,0,0,8,0,0,17,0,0,23,0,0,0
10637,6070,2020-11-18T16:21:37.6981695Z,2020,22,8,20,11,0,3ro,0,0,11,0,0,14,2,0,22,0,0,0
10637,6071,2020-11-18T16:21:37.6981695Z,2020,15,4,14,8,0,4to,1,0,7,0,0,11,1,0,14,0,0,0
10637,6072,2020-11-18T16:21:37.6981695Z,2020,16,5,15,6,0,5to,1,0,10,0,0,11,1,0,15,0,0,0
10637,6073,2020-11-18T16:21:37.6991699Z,2020,27,7,25,13,0,6to,0,0,14,0,0,20,2,0,27,0,0,0
10637,6074,2020-11-18T16:21:37.6991699Z,2020,14,8,13,5,0,7mo,0,0,9,0,0,6,1,0,14,0,0,0
10637,6075,2020-11-18T16:21:37.6991699Z,2020,22,7,22,12,0,8vo,0,0,10,0,0,15,0,0,22,0,0,0
10637,6076,2020-11-18T16:21:37.6991699Z,2020,34,7,32,12,0,K,0,0,22,0,0,27,2,0,34,0,0,0
10637,6077,2020-11-18T16:21:37.6991699Z,2020,12,12,10,5,0,Sin Grado,0,0,7,0,0,0,2,0,12,0,0,0
10637,67,2020-11-18T16:20:36.7004974Z,2019,25,5,24,16,0,1ro,0,0,9,0,0,20,1,0,25,0,0,0
10637,68,2020-11-18T16:20:36.7004974Z,2019,27,13,25,12,0,2do,0,0,15,0,0,14,2,0,27,0,0,0
10637,69,2020-11-18T16:20:36.7014983Z,2019,14,4,13,6,0,3ro,1,0,8,0,0,10,1,0,13,0,0,0
10637,70,2020-11-18T16:20:36.7014983Z,2019,15,5,14,6,0,4to,1,0,9,0,0,10,1,0,14,0,0,0
10637,71,2020-11-18T16:20:36.7014983Z,2019,21,5,20,12,0,5to,0,0,9,0,0,16,1,0,21,0,0,0
10637,72,2020-11-18T16:20:36.7014983Z,2019,15,8,14,6,0,6to,0,1,9,0,0,7,1,0,15,0,0,0
10637,73,2020-11-18T16:20:36.7014983Z,2019,19,6,18,10,0,7mo,0,0,9,0,0,13,1,0,19,0,0,0
10637,74,2020-11-18T16:20:36.7024992Z,2019,22,5,19,12,0,8vo,0,0,10,0,0,17,3,0,22,0,0,0
10637,75,2020-11-18T16:20:36.7024992Z,2019,14,2,12,7,0,K,0,0,7,0,0,12,2,0,14,0,0,0
10637,76,2020-11-18T16:20:36.7024992Z,2019,10,10,7,3,0,Sin Grado,0,2,7,0,0,0,3,0,10,0,0,0
51342,33396,2021-06-24T13:18:31.5770985Z,2021,37,21,30,14,0,1ro,0,0,23,0,0,16,7,0,37,0,0,0
51342,33397,2021-06-24T13:18:31.5770985Z,2021,33,9,28,18,0,2do,1,0,15,0,0,24,5,0,32,0,0,0
51342,33398,2021-06-24T13:18:31.5770985Z,2021,40,13,29,19,0,3ro,1,0,21,0,0,27,11,0,39,0,0,0
51342,33399,2021-06-24T13:18:31.5780986Z,2021,37,8,27,17,0,4to,1,0,20,0,0,29,10,0,36,0,0,0
51342,33400,2021-06-24T13:18:32.440718Z,2021,39,10,29,21,0,5to,0,0,18,0,0,29,10,0,39,0,0,0
51342,33401,2021-06-24T13:18:32.440718Z,2021,37,8,33,15,0,K,0,0,22,0,0,29,4,0,37,0,0,0
51342,33402,2021-06-24T13:18:32.4417181Z,2021,3,2,3,1,0,Sin Grado,0,0,2,0,0,1,0,0,3,0,0,0
51342,3371,2020-11-18T16:21:02.1474658Z,2019,47,16,32,19,0,1ro,0,0,28,0,0,31,15,0,47,0,0,0
51342,3372,2020-11-18T16:21:02.1474658Z,2019,39,7,24,19,0,2do,0,0,20,0,0,32,15,1,38,0,0,0
51342,3373,2020-11-18T16:21:02.1474658Z,2019,42,10,33,20,0,3ro,1,0,22,0,0,32,9,0,41,0,0,0
51342,3374,2020-11-18T16:21:02.1484658Z,2019,48,14,39,19,0,4to,1,0,29,0,0,34,9,0,47,0,0,0
51342,3375,2020-11-18T16:21:02.1484658Z,2019,49,10,33,26,0,5to,0,0,23,0,0,39,16,0,49,0,0,0
51342,3376,2020-11-18T16:21:02.1484658Z,2019,46,20,37,23,0,K,0,0,23,0,0,26,9,0,46,0,0,0
51342,3377,2020-11-18T16:21:02.1494667Z,2019,14,11,7,2,0,Sin Grado,0,0,12,0,0,3,7,0,14,0,0,0
51342,9391,2020-11-18T16:21:58.0137162Z,2020,33,9,26,19,0,1ro,2,0,14,0,0,24,7,0,31,0,0,0
51342,9392,2020-11-18T16:21:58.0137162Z,2020,38,10,24,18,0,2do,0,0,20,0,0,28,14,0,38,0,0,0
51342,9393,2020-11-18T16:21:58.0147158Z,2020,34,8,23,14,0,3ro,0,0,20,0,0,26,11,0,34,0,0,0
51342,9394,2020-11-18T16:21:58.0147158Z,2020,34,8,25,17,0,4to,0,0,17,0,0,26,9,0,34,0,0,0
51342,9395,2020-11-18T16:21:58.0147158Z,2020,40,12,29,18,0,5to,1,0,22,0,0,28,11,0,39,0,0,0
51342,9396,2020-11-18T16:21:58.0147158Z,2020,39,20,29,13,0,K,0,0,26,0,0,19,10,0,39,0,0,0
51342,9397,2020-11-18T16:21:58.0157162Z,2020,9,8,8,3,0,Sin Grado,0,0,6,0,0,1,1,0,9,0,0,0
17772,30766,2021-06-24T13:18:11.1974787Z,2021,173,70,141,72,0,10mo,4,0,101,0,0,103,32,0,166,0,0,3
17772,30767,2021-06-24T13:18:11.1974787Z,2021,183,46,132,90,0,11mo,0,0,93,0,0,137,51,0,183,0,0,0
17772,30768,2021-06-24T13:18:11.1974787Z,2021,160,40,118,88,0,12mo,0,1,72,0,0,120,42,0,160,0,0,0
17772,30769,2021-06-24T13:18:11.1974787Z,2021,191,60,151,99,0,9no,1,1,92,0,0,131,40,0,189,0,0,1
17772,6769,2020-11-18T16:21:41.4436677Z,2020,190,50,142,94,0,10mo,2,0,96,0,0,140,48,0,188,0,0,0
17772,6770,2020-11-18T16:21:41.4436677Z,2020,176,46,135,98,0,11mo,1,0,78,0,0,130,41,0,175,0,0,0
17772,6771,2020-11-18T16:21:41.4446681Z,2020,180,44,115,88,0,12mo,1,0,92,0,0,136,65,0,179,0,1,0
17772,6772,2020-11-18T16:21:41.4446681Z,2020,180,71,150,76,0,9no,4,0,104,0,0,109,30,0,175,0,0,1
17772,768,2020-11-18T16:20:42.1161063Z,2019,179,46,134,94,0,10mo,0,1,85,0,0,133,45,0,179,0,0,0
17772,769,2020-11-18T16:20:42.1161063Z,2019,192,45,123,89,0,11mo,0,2,103,0,0,147,69,0,192,0,1,0
17772,770,2020-11-18T16:20:42.1161063Z,2019,164,0,122,74,0,12mo,2,1,90,0,0,164,42,1,161,0,0,0
17772,771,2020-11-18T16:20:42.1161063Z,2019,190,56,139,84,0,9no,1,1,106,0,0,134,51,0,189,0,0,0
40139,2514,2020-11-18T16:20:57.6264511Z,2019,38,10,33,19,0,1ro,1,0,19,0,0,28,5,0,37,0,0,0
40139,2515,2020-11-18T16:20:57.6264511Z,2019,31,6,27,13,0,2do,2,0,18,0,0,25,4,0,29,0,0,0
40139,2516,2020-11-18T16:20:57.6274529Z,2019,43,14,33,17,0,3ro,1,0,26,0,0,29,10,1,41,0,0,0
40139,2517,2020-11-18T16:20:57.6274529Z,2019,45,6,32,25,0,4to,1,0,20,0,0,39,13,0,44,0,0,0
40139,2518,2020-11-18T16:20:57.6274529Z,2019,52,17,37,32,0,5to,1,0,20,0,0,35,15,0,51,0,0,0
40139,2519,2020-11-18T16:20:57.6284525Z,2019,36,7,28,16,0,K,0,0,20,0,1,29,8,0,36,0,0,0
40139,2520,2020-11-18T16:20:57.6284525Z,2019,17,4,13,11,0,PK,0,0,6,0,0,13,4,0,17,0,0,0
40139,32522,2021-06-24T13:18:25.2195396Z,2021,28,9,24,16,0,1ro,0,0,12,0,0,19,4,1,27,0,0,0
40139,32523,2021-06-24T13:18:25.2195396Z,2021,29,10,28,11,0,2do,0,0,18,0,0,19,1,0,29,0,0,0
40139,32524,2021-06-24T13:18:25.2205405Z,2021,35,11,28,20,0,3ro,0,0,15,0,0,24,7,0,35,0,0,0
40139,32525,2021-06-24T13:18:25.2205405Z,2021,38,9,29,18,0,4to,1,0,20,0,0,29,9,0,37,0,0,0
40139,32526,2021-06-24T13:18:25.2205405Z,2021,39,15,30,16,0,5to,0,0,23,0,0,24,9,1,38,0,0,0
40139,32527,2021-06-24T13:18:25.2205405Z,2021,26,6,22,8,0,K,0,0,18,0,0,20,4,0,26,0,0,0
40139,32528,2021-06-24T13:18:25.2215414Z,2021,16,4,14,8,0,PK,0,0,8,0,0,12,2,0,16,0,0,0
40139,8527,2020-11-18T16:21:52.6261222Z,2020,29,7,24,14,0,1ro,0,0,15,0,0,22,5,0,29,0,0,0
40139,8528,2020-11-18T16:21:52.6261222Z,2020,26,6,21,17,0,2do,0,0,9,0,0,20,5,0,26,0,0,0
40139,8529,2020-11-18T16:21:52.6261222Z,2020,29,7,25,11,0,3ro,1,0,18,0,0,22,4,0,28,0,0,0
40139,8530,2020-11-18T16:21:52.6261222Z,2020,36,13,27,12,0,4to,0,0,24,0,0,23,9,1,35,0,0,0
40139,8531,2020-11-18T16:21:52.6271231Z,2020,42,7,29,26,0,5to,1,0,16,0,0,35,13,0,41,0,0,0
40139,8532,2020-11-18T16:21:52.6271231Z,2020,34,12,24,17,0,K,1,0,17,0,0,22,10,0,33,0,0,0
40139,8533,2020-11-18T16:21:52.6271231Z,2020,15,0,11,7,0,PK,0,0,8,0,0,15,4,0,15,0,0,0
33647,2176,2020-11-18T16:20:54.6074342Z,2019,65,16,46,25,0,1ro,1,0,40,0,0,49,19,0,64,0,0,0
33647,2177,2020-11-18T16:20:54.6084351Z,2019,65,18,46,38,0,2do,1,0,27,0,0,47,19,0,64,0,0,0
33647,2178,2020-11-18T16:20:54.6084351Z,2019,62,14,40,39,0,3ro,1,0,23,0,0,48,22,0,61,0,0,0
33647,2179,2020-11-18T16:20:54.6084351Z,2019,59,11,41,30,0,4to,0,0,29,0,0,48,18,0,59,0,0,0
33647,2180,2020-11-18T16:20:54.6084351Z,2019,68,11,52,31,0,5to,0,0,37,0,0,57,16,0,68,0,0,0
33647,2181,2020-11-18T16:20:54.6084351Z,2019,1,0,1,0,0,6to,0,0,1,0,0,1,0,0,1,0,0,0
33647,2182,2020-11-18T16:20:54.6094355Z,2019,50,10,43,20,0,K,1,0,30,0,0,40,7,0,49,0,0,0
33647,2183,2020-11-18T16:20:54.6094355Z,2019,13,13,10,1,0,Sin Grado,0,0,12,0,0,0,3,0,13,0,0,0
33647,32182,2021-06-24T13:18:20.9304582Z,2021,66,13,50,29,0,1ro,0,0,37,0,0,53,16,0,66,0,0,0
33647,32183,2021-06-24T13:18:20.9314587Z,2021,70,21,53,32,0,2do,0,0,38,0,0,49,17,0,70,0,0,0
33647,32184,2021-06-24T13:18:20.9314587Z,2021,76,15,61,38,0,3ro,1,0,38,0,0,61,15,0,75,0,0,0
33647,32185,2021-06-24T13:18:20.9314587Z,2021,63,11,50,36,0,4to,1,0,27,0,0,52,13,0,62,0,0,0
33647,32186,2021-06-24T13:18:20.9314587Z,2021,70,12,54,42,0,5to,1,0,28,0,0,58,16,0,69,0,0,0
33647,32187,2021-06-24T13:18:20.9324597Z,2021,75,26,65,37,0,K,0,0,38,0,0,49,10,0,75,0,0,0
33647,32188,2021-06-24T13:18:20.9324597Z,2021,12,1,9,8,0,PK,0,0,4,0,0,11,3,0,12,0,0,0
33647,32189,2021-06-24T13:18:20.9324597Z,2021,13,12,10,3,0,Sin Grado,0,0,10,0,0,1,3,0,13,0,0,0
33647,8188,2020-11-18T16:21:50.2675527Z,2020,65,20,49,29,0,1ro,0,0,36,0,0,45,16,0,65,0,0,0
33647,8189,2020-11-18T16:21:50.2675527Z,2020,75,15,57,33,0,2do,1,0,42,0,0,60,18,0,74,0,0,0
33647,8190,2020-11-18T16:21:50.2675527Z,2020,58,15,42,35,0,3ro,1,0,23,0,0,43,16,0,57,0,0,0
33647,8191,2020-11-18T16:21:50.268554Z,2020,67,13,42,41,0,4to,1,0,26,0,0,54,25,0,66,0,0,0
33647,8192,2020-11-18T16:21:50.268554Z,2020,65,13,42,30,0,5to,0,0,35,0,0,52,23,0,65,0,0,0
33647,8193,2020-11-18T16:21:50.268554Z,2020,69,12,57,36,0,K,0,0,33,0,0,57,12,0,69,0,0,0
33647,8194,2020-11-18T16:21:50.268554Z,2020,16,3,12,9,0,PK,0,0,7,0,0,13,4,0,16,0,0,0
33647,8195,2020-11-18T16:21:50.268554Z,2020,15,15,10,3,0,Sin Grado,0,0,12,0,0,0,5,0,15,0,0,0
61580,10307,2020-11-18T16:22:03.6995072Z,2020,52,12,49,25,0,1ro,2,4,27,0,0,40,3,0,50,0,0,0
61580,10308,2020-11-18T16:22:03.7005081Z,2020,49,16,48,22,0,2do,5,8,27,0,0,33,1,0,44,0,0,0
61580,10309,2020-11-18T16:22:03.7005081Z,2020,32,7,30,16,0,3ro,5,4,16,0,0,25,2,0,27,0,0,0
61580,10310,2020-11-18T16:22:03.7005081Z,2020,42,12,41,21,0,4to,8,8,21,0,0,30,1,0,34,0,0,0
61580,10311,2020-11-18T16:22:03.7015086Z,2020,55,11,48,32,0,5to,13,5,23,0,0,44,7,0,42,0,0,0
61580,10312,2020-11-18T16:22:03.7015086Z,2020,40,13,39,22,0,K,2,3,18,0,0,27,1,0,38,0,0,0
61580,34322,2021-06-24T13:18:38.6081397Z,2021,45,13,45,22,0,1ro,2,0,23,0,0,32,0,0,43,0,0,0
61580,34323,2021-06-24T13:18:38.6081397Z,2021,45,11,42,21,0,2do,2,0,24,0,0,34,3,0,43,0,0,0
61580,34324,2021-06-24T13:18:38.6081397Z,2021,51,15,49,22,0,3ro,5,0,29,0,0,36,2,0,46,0,0,0
61580,34325,2021-06-24T13:18:38.6081397Z,2021,30,8,28,15,0,4to,3,0,15,0,0,22,2,0,27,0,0,0
61580,34326,2021-06-24T13:18:38.6091407Z,2021,43,12,42,21,0,5to,9,0,22,0,0,31,1,0,34,0,0,0
61580,34327,2021-06-24T13:18:38.6091407Z,2021,38,6,38,19,0,K,1,0,19,0,0,32,0,0,37,0,0,0
61580,4293,2020-11-18T16:21:09.0440631Z,2019,48,12,47,25,0,1ro,0,3,23,0,0,36,1,0,47,0,0,1
61580,4294,2020-11-18T16:21:09.0440631Z,2019,47,16,43,26,0,2do,9,5,21,0,0,31,4,0,37,0,0,1
61580,4295,2020-11-18T16:21:09.0450649Z,2019,45,17,44,20,0,3ro,7,3,25,0,0,28,1,0,38,0,0,0
61580,4296,2020-11-18T16:21:09.0450649Z,2019,65,18,58,35,0,4to,15,4,30,0,0,47,7,0,50,0,0,0
61580,4297,2020-11-18T16:21:09.0450649Z,2019,72,13,67,33,0,5to,8,3,39,0,0,59,5,0,64,0,0,0
61580,4298,2020-11-18T16:21:09.0460653Z,2019,1,0,0,1,0,6to,0,0,0,0,0,1,1,0,1,0,0,0
61580,4299,2020-11-18T16:21:09.0460653Z,2019,53,11,48,25,0,K,1,1,28,0,0,42,5,0,52,0,0,0
46672,3082,2020-11-18T16:21:00.3482626Z,2019,56,22,42,31,0,1ro,1,1,25,0,0,34,14,0,55,0,1,0
46672,3083,2020-11-18T16:21:00.3482626Z,2019,48,13,37,29,0,2do,0,0,19,0,0,35,11,0,47,0,3,1
46672,3084,2020-11-18T16:21:00.3482626Z,2019,47,14,44,26,0,3ro,2,0,21,0,0,33,3,0,45,0,1,0
46672,3085,2020-11-18T16:21:00.3492649Z,2019,45,21,40,21,0,4to,0,0,24,0,0,24,5,1,44,0,1,0
46672,3086,2020-11-18T16:21:00.3492649Z,2019,54,28,47,29,0,5to,3,0,25,0,0,26,7,0,50,0,1,1
46672,3087,2020-11-18T16:21:00.3492649Z,2019,66,25,57,32,0,6to,2,0,34,0,0,41,9,0,64,0,1,0
46672,3088,2020-11-18T16:21:00.3502644Z,2019,74,26,52,34,0,7mo,0,0,40,0,0,48,22,0,74,0,1,0
46672,3089,2020-11-18T16:21:00.3502644Z,2019,83,36,73,43,0,8vo,1,0,40,0,0,47,10,0,82,1,1,0
46672,3090,2020-11-18T16:21:00.3502644Z,2019,46,13,39,24,0,K,0,0,22,0,0,33,7,1,45,0,0,0
46672,3091,2020-11-18T16:21:00.3512657Z,2019,7,6,7,0,0,Sin Grado,0,0,7,0,0,1,0,0,7,0,0,0
46672,33093,2021-06-24T13:18:29.8408529Z,2021,56,15,52,34,0,1ro,2,0,22,0,0,41,4,0,53,0,0,1
46672,33094,2021-06-24T13:18:29.8418542Z,2021,40,11,35,20,0,2do,0,0,20,0,0,29,5,1,39,0,0,0
46672,33095,2021-06-24T13:18:29.8418542Z,2021,48,14,41,24,0,3ro,1,0,24,0,0,34,7,0,47,0,2,0
46672,33096,2021-06-24T13:18:29.8418542Z,2021,52,22,42,29,0,4to,0,0,23,0,0,30,10,0,52,0,1,0
46672,33097,2021-06-24T13:18:29.8428547Z,2021,48,18,39,24,0,5to,1,0,24,0,0,30,9,0,47,0,0,0
46672,33098,2021-06-24T13:18:29.8428547Z,2021,47,20,41,21,0,6to,0,0,26,0,0,27,6,0,47,0,0,0
46672,33099,2021-06-24T13:18:29.8428547Z,2021,64,25,55,31,0,7mo,2,0,33,0,0,39,9,0,61,0,1,1
46672,33100,2021-06-24T13:18:30.2951786Z,2021,60,24,56,30,0,8vo,3,0,30,0,0,36,4,0,57,0,0,0
46672,33101,2021-06-24T13:18:30.2951786Z,2021,41,10,36,22,0,K,1,2,19,0,0,31,5,0,40,0,0,0
46672,33102,2021-06-24T13:18:30.2951786Z,2021,3,2,1,1,0,Sin Grado,0,0,2,0,0,1,2,0,3,0,0,0
46672,9096,2020-11-18T16:21:55.4460073Z,2020,43,13,37,24,0,1ro,0,0,19,0,0,30,6,1,42,0,0,0
46672,9097,2020-11-18T16:21:55.4460073Z,2020,50,17,39,25,0,2do,1,0,25,0,0,33,11,0,49,0,2,0
46672,9098,2020-11-18T16:21:55.4460073Z,2020,50,15,39,30,0,3ro,1,0,20,0,0,35,11,0,49,0,2,0
46672,9099,2020-11-18T16:21:55.4470073Z,2020,43,15,37,21,0,4to,1,0,22,0,0,28,6,0,42,0,0,0
46672,9100,2020-11-18T16:21:55.4470073Z,2020,39,16,32,18,0,5to,0,0,21,0,0,23,7,1,38,0,1,0
46672,9101,2020-11-18T16:21:56.1214569Z,2020,62,26,55,29,0,6to,3,0,33,0,0,36,7,0,59,0,1,0
46672,9102,2020-11-18T16:21:56.1214569Z,2020,58,24,53,31,0,7mo,2,1,27,0,0,34,5,0,56,0,0,0
46672,9103,2020-11-18T16:21:56.1214569Z,2020,79,34,61,29,0,8vo,0,1,50,0,0,45,18,0,79,0,1,0
46672,9104,2020-11-18T16:21:56.1224582Z,2020,57,14,54,29,0,K,0,0,28,0,0,43,3,0,57,0,0,0
46672,9105,2020-11-18T16:21:56.1224582Z,2020,7,6,4,1,0,Sin Grado,0,0,6,0,0,1,3,0,7,0,0,0
26492,1578,2020-11-18T16:20:47.6598063Z,2019,38,18,32,14,0,10mo,1,0,24,0,0,20,6,0,37,0,0,0
26492,1579,2020-11-18T16:20:47.6598063Z,2019,17,10,12,10,0,11mo,0,0,7,0,0,7,5,0,17,0,0,0
26492,1580,2020-11-18T16:20:47.6598063Z,2019,18,0,15,5,0,12mo,0,0,13,0,0,18,3,0,18,0,0,0
26492,1581,2020-11-18T16:20:47.6608072Z,2019,45,19,34,30,0,6to,1,0,15,0,0,26,11,0,44,0,1,0
26492,1582,2020-11-18T16:20:47.6608072Z,2019,54,29,47,26,0,7mo,0,0,28,0,0,25,7,0,54,0,0,0
26492,1583,2020-11-18T16:20:47.6608072Z,2019,43,12,33,21,0,8vo,1,0,22,0,0,31,10,0,42,0,0,0
26492,1584,2020-11-18T16:20:47.6608072Z,2019,27,14,23,16,0,9no,0,0,11,0,0,13,4,0,27,0,0,0
26492,1585,2020-11-18T16:20:47.6618081Z,2019,108,84,98,25,0,Sin Grado,5,2,83,0,0,24,10,0,103,0,2,0
26492,31581,2021-06-24T13:18:15.8458134Z,2021,43,18,36,19,0,10mo,1,0,24,0,0,25,7,0,42,0,0,0
26492,31582,2021-06-24T13:18:15.8458134Z,2021,21,10,17,11,0,11mo,0,0,10,0,0,11,4,0,21,0,0,0
26492,31583,2021-06-24T13:18:15.8458134Z,2021,31,12,22,12,0,12mo,1,0,19,0,0,19,9,0,30,0,0,0
26492,31584,2021-06-24T13:18:15.8458134Z,2021,20,14,18,9,0,6to,0,1,11,0,0,6,2,0,20,0,0,0
26492,31585,2021-06-24T13:18:15.8468134Z,2021,28,16,23,16,0,7mo,0,3,12,0,0,12,5,0,28,0,0,0
26492,31586,2021-06-24T13:18:15.8468134Z,2021,51,19,38,32,0,8vo,1,0,19,0,0,32,13,0,50,0,1,0
26492,31587,2021-06-24T13:18:15.8468134Z,2021,52,26,38,23,0,9no,0,0,29,0,0,26,14,0,52,0,0,0
26492,31588,2021-06-24T13:18:15.8468134Z,2021,127,124,101,29,0,Sin Grado,4,0,98,0,0,3,26,0,123,0,1,0
26492,7584,2020-11-18T16:21:46.3919666Z,2020,23,10,20,12,0,10mo,0,0,11,0,0,13,3,0,23,0,0,0
26492,7585,2020-11-18T16:21:46.3919666Z,2020,31,14,26,12,0,11mo,1,0,19,0,0,17,5,0,30,0,0,0
26492,7586,2020-11-18T16:21:46.3919666Z,2020,8,4,4,5,0,12mo,0,0,3,0,0,4,4,0,8,0,0,0
26492,7587,2020-11-18T16:21:46.3929666Z,2020,30,18,28,18,0,6to,0,0,12,0,0,12,2,0,30,0,0,0
26492,7588,2020-11-18T16:21:46.3929666Z,2020,50,19,37,32,0,7mo,1,1,18,0,0,31,13,0,49,0,1,0
26492,7589,2020-11-18T16:21:46.3929666Z,2020,55,26,47,25,0,8vo,0,0,30,0,0,29,8,0,55,0,0,0
26492,7590,2020-11-18T16:21:46.3929666Z,2020,45,20,37,19,0,9no,1,1,26,0,0,25,8,0,44,0,0,0
26492,7591,2020-11-18T16:21:46.393967Z,2020,110,105,101,25,0,Sin Grado,3,0,85,0,0,5,9,0,107,0,1,0
28522,1715,2020-11-18T16:20:48.851596Z,2019,181,16,95,104,0,10mo,1,0,77,0,0,165,86,0,180,0,0,0
28522,1716,2020-11-18T16:20:48.851596Z,2019,121,7,72,66,0,11mo,3,0,55,0,0,114,49,0,118,0,0,0
28522,1717,2020-11-18T16:20:48.8525973Z,2019,145,0,75,91,0,12mo,2,1,54,0,0,145,70,0,143,0,0,0
28522,1718,2020-11-18T16:20:48.8525973Z,2019,253,25,153,145,0,9no,2,1,108,0,0,228,100,0,251,0,1,0
28522,31717,2021-06-24T13:18:17.1287324Z,2021,241,27,161,129,0,10mo,1,0,112,0,0,214,80,0,240,0,0,0
28522,31718,2021-06-24T13:18:17.1287324Z,2021,221,13,151,125,0,11mo,2,0,96,0,0,208,70,0,219,0,0,0
28522,31719,2021-06-24T13:18:17.1297334Z,2021,168,14,111,98,0,12mo,1,0,70,0,0,154,57,0,167,0,0,0
28522,31720,2021-06-24T13:18:17.1297334Z,2021,170,21,123,89,0,9no,3,0,81,0,0,149,47,0,167,0,2,0
28522,7720,2020-11-18T16:21:47.9059761Z,2020,236,19,126,138,0,10mo,2,0,98,0,0,217,110,0,234,0,0,0
28522,7721,2020-11-18T16:21:47.9059761Z,2020,172,18,101,99,0,11mo,1,0,73,0,0,154,71,0,171,0,0,0
28522,7722,2020-11-18T16:21:47.9059761Z,2020,114,7,61,62,0,12mo,3,1,52,0,0,107,53,0,111,0,0,0
28522,7723,2020-11-18T16:21:47.9059761Z,2020,246,30,143,131,0,9no,1,1,115,0,0,216,103,0,245,0,0,0
15438,30612,2021-06-24T13:18:10.6390792Z,2021,43,5,35,21,0,1ro,0,0,22,0,0,38,8,0,43,0,0,0
15438,30613,2021-06-24T13:18:10.6400792Z,2021,44,8,39,21,0,2do,1,0,23,0,0,36,5,0,43,0,0,0
15438,30614,2021-06-24T13:18:10.6400792Z,2021,45,8,33,22,0,3ro,0,0,23,0,0,37,12,0,45,0,0,0
15438,30615,2021-06-24T13:18:10.6410797Z,2021,60,26,52,26,0,4to,0,0,34,0,0,34,8,0,60,0,0,0
15438,30616,2021-06-24T13:18:10.6410797Z,2021,44,10,38,19,0,5to,2,0,25,0,0,34,6,0,42,0,0,0
15438,30617,2021-06-24T13:18:10.6420825Z,2021,47,10,44,20,0,K,1,1,27,0,0,37,3,0,46,0,0,0
15438,30618,2021-06-24T13:18:10.6420825Z,2021,7,7,5,1,0,Sin Grado,0,0,6,0,0,0,2,0,7,0,0,0
15438,614,2020-11-18T16:20:41.1734792Z,2019,42,9,31,26,0,1ro,1,0,16,0,0,33,11,0,41,0,0,0
15438,615,2020-11-18T16:20:41.1734792Z,2019,51,14,44,20,0,2do,1,0,31,0,0,37,7,0,50,0,0,0
15438,616,2020-11-18T16:20:41.1744828Z,2019,48,19,41,18,0,3ro,1,0,30,0,0,29,7,0,47,0,0,0
15438,617,2020-11-18T16:20:41.1744828Z,2019,45,14,37,24,0,4to,1,0,21,0,0,31,8,0,44,0,0,0
15438,618,2020-11-18T16:20:41.1744828Z,2019,59,18,51,31,0,5to,4,0,28,0,0,41,8,0,55,0,1,0
15438,619,2020-11-18T16:20:41.175481Z,2019,46,10,40,21,0,K,1,0,25,0,0,36,6,0,45,0,0,0
15438,620,2020-11-18T16:20:41.175481Z,2019,12,12,12,3,0,Sin Grado,0,0,9,0,0,0,0,0,12,0,0,0
15438,6614,2020-11-18T16:21:40.7472068Z,2020,41,9,36,19,0,1ro,1,0,22,0,0,32,5,0,40,0,0,0
15438,6615,2020-11-18T16:21:40.7472068Z,2020,45,9,31,24,0,2do,1,0,21,0,0,36,14,0,44,0,0,0
15438,6616,2020-11-18T16:21:40.7472068Z,2020,62,19,48,27,0,3ro,1,0,35,0,0,43,14,0,61,0,1,0
15438,6617,2020-11-18T16:21:40.7482072Z,2020,41,13,34,16,0,4to,2,0,25,0,0,28,7,0,39,0,0,0
15438,6618,2020-11-18T16:21:40.7482072Z,2020,45,13,36,27,0,5to,1,0,18,0,0,32,9,0,44,0,0,0
15438,6619,2020-11-18T16:21:40.7482072Z,2020,48,11,33,19,0,K,1,0,29,0,0,37,15,0,46,0,0,1
15438,6620,2020-11-18T16:21:40.7482072Z,2020,13,13,13,3,0,Sin Grado,0,0,10,0,0,0,0,0,13,0,0,0
40527,2601,2020-11-18T16:20:58.0527337Z,2019,47,8,34,25,0,1ro,0,2,22,0,0,39,13,0,47,0,0,0
40527,2602,2020-11-18T16:20:58.0537346Z,2019,73,8,50,35,0,2do,4,5,38,0,1,65,23,0,69,1,1,0
40527,2603,2020-11-18T16:20:58.0537346Z,2019,64,13,40,45,0,3ro,2,2,19,0,0,51,24,0,62,0,1,0
40527,2604,2020-11-18T16:20:58.0537346Z,2019,50,9,33,27,0,4to,4,1,23,0,0,41,17,1,45,0,0,0
40527,2605,2020-11-18T16:20:58.0547359Z,2019,44,6,27,22,0,5to,1,2,22,0,0,38,17,0,43,0,0,0
40527,2606,2020-11-18T16:20:58.0547359Z,2019,47,6,28,17,0,K,1,2,30,0,0,41,19,0,46,0,0,0
40527,32608,2021-06-24T13:18:26.23827Z,2021,48,11,36,27,0,1ro,2,2,21,0,0,37,12,0,46,0,0,0
40527,32609,2021-06-24T13:18:26.23827Z,2021,45,11,33,12,0,2do,0,1,33,0,0,34,12,0,45,0,0,0
40527,32610,2021-06-24T13:18:26.239271Z,2021,43,8,33,18,0,3ro,1,3,25,0,0,35,10,0,42,0,1,0
40527,32611,2021-06-24T13:18:26.239271Z,2021,71,6,50,38,0,4to,3,4,33,0,0,65,21,0,68,0,1,0
40527,32612,2021-06-24T13:18:26.239271Z,2021,63,12,39,44,0,5to,3,4,19,0,0,51,24,0,60,0,1,0
40527,32613,2021-06-24T13:18:26.239271Z,2021,41,3,33,24,0,K,0,1,17,0,0,38,8,0,41,0,0,0
40527,8612,2020-11-18T16:21:53.0424007Z,2020,54,8,29,19,0,1ro,1,1,35,0,0,46,25,0,52,0,0,1
40527,8613,2020-11-18T16:21:53.0424007Z,2020,45,7,30,22,0,2do,0,2,23,0,0,38,15,0,45,0,0,0
40527,8614,2020-11-18T16:21:53.0424007Z,2020,72,7,48,37,0,3ro,3,3,35,0,0,65,24,0,69,1,1,0
40527,8615,2020-11-18T16:21:53.0424007Z,2020,67,13,35,47,0,4to,3,4,20,0,0,54,32,0,64,0,1,0
40527,8616,2020-11-18T16:21:53.0434012Z,2020,55,9,31,33,0,5to,4,2,22,0,0,46,24,1,50,0,0,0
40527,8617,2020-11-18T16:21:53.0434012Z,2020,50,10,34,27,0,K,1,2,23,0,0,40,16,0,49,0,0,0
55871,33860,2021-06-24T13:18:35.757096Z,2021,36,11,35,23,0,6to,1,1,13,0,0,25,1,0,35,0,0,0
55871,33861,2021-06-24T13:18:35.7580965Z,2021,41,16,40,22,0,7mo,1,0,19,0,0,25,1,0,40,0,0,0
55871,33862,2021-06-24T13:18:35.7580965Z,2021,34,10,33,12,0,8vo,1,0,22,0,0,24,1,0,33,0,0,0
55871,33863,2021-06-24T13:18:35.7580965Z,2021,5,5,5,2,0,Sin Grado,0,0,3,0,0,0,0,0,5,0,0,0
55871,3837,2020-11-18T16:21:05.5697448Z,2019,38,13,35,13,0,6to,1,0,25,0,0,25,3,0,37,0,0,0
55871,3838,2020-11-18T16:21:05.5707457Z,2019,37,12,34,21,0,7mo,1,1,16,0,0,25,3,0,36,0,1,0
55871,3839,2020-11-18T16:21:05.5707457Z,2019,49,13,44,21,0,8vo,3,0,28,0,0,36,5,0,46,0,0,0
55871,3840,2020-11-18T16:21:05.5707457Z,2019,3,2,3,0,0,Sin Grado,0,1,3,0,0,1,0,0,3,0,0,0
55871,9854,2020-11-18T16:22:00.5223909Z,2020,43,16,43,22,0,6to,0,0,21,0,0,27,0,0,43,0,0,0
55871,9855,2020-11-18T16:22:00.5233914Z,2020,38,14,35,14,0,7mo,1,1,24,0,0,24,3,0,37,0,0,0
55871,9856,2020-11-18T16:22:00.5233914Z,2020,34,13,33,19,0,8vo,0,0,15,0,0,21,1,0,34,0,1,0
55871,9857,2020-11-18T16:22:00.5233914Z,2020,6,6,6,1,0,Sin Grado,0,0,5,0,0,0,0,0,6,0,0,0
71738,11416,2020-11-18T16:22:10.5660879Z,2020,41,14,29,25,0,1ro,0,0,16,0,0,27,12,0,41,0,0,0
71738,11417,2020-11-18T16:22:10.5660879Z,2020,36,12,27,19,0,2do,0,0,17,0,0,24,9,0,36,0,1,0
71738,11418,2020-11-18T16:22:10.5660879Z,2020,32,12,26,21,0,3ro,0,0,11,0,0,20,6,0,32,0,0,0
71738,11419,2020-11-18T16:22:10.5660879Z,2020,39,13,32,14,0,4to,0,0,25,0,0,26,7,0,39,0,0,0
71738,11420,2020-11-18T16:22:10.5660879Z,2020,45,11,39,24,0,5to,0,0,21,0,0,34,6,0,44,0,0,1
71738,11421,2020-11-18T16:22:10.5670888Z,2020,2,0,1,2,0,K,1,0,0,0,0,2,1,0,1,0,0,0
71738,11422,2020-11-18T16:22:10.5670888Z,2020,67,17,28,37,0,PK,0,0,30,0,0,50,39,0,67,0,0,0
71738,35438,2021-06-24T13:18:46.2306057Z,2021,26,11,17,15,0,1ro,0,0,11,0,0,15,9,0,26,0,0,0
71738,35439,2021-06-24T13:18:46.2306057Z,2021,35,11,28,21,0,2do,0,0,14,0,0,24,7,1,34,0,0,0
71738,35440,2021-06-24T13:18:46.2306057Z,2021,30,9,25,16,0,3ro,0,0,14,0,0,21,5,0,30,0,1,0
71738,35441,2021-06-24T13:18:46.2316062Z,2021,23,7,18,16,0,4to,0,0,7,0,0,16,5,0,23,0,0,0
71738,35442,2021-06-24T13:18:46.2316062Z,2021,31,11,26,10,0,5to,1,0,21,0,0,20,5,0,30,0,0,0
71738,35443,2021-06-24T13:18:46.2316062Z,2021,28,5,19,14,0,K,0,0,14,0,0,23,9,0,28,0,0,0
71738,35444,2021-06-24T13:18:46.2326076Z,2021,31,1,18,15,0,PK,0,1,16,0,0,30,13,2,29,0,0,0
71738,5408,2020-11-18T16:21:15.4753491Z,2019,45,15,33,20,0,1ro,0,0,25,0,0,30,12,0,45,0,0,0
71738,5409,2020-11-18T16:21:15.4753491Z,2019,47,13,36,32,0,2do,0,2,15,0,0,34,11,0,47,0,1,0
71738,5410,2020-11-18T16:21:15.4753491Z,2019,45,13,35,15,0,3ro,0,0,30,0,0,32,10,0,45,0,0,0
71738,5411,2020-11-18T16:21:15.4753491Z,2019,45,10,41,25,0,4to,0,0,20,0,0,35,4,0,45,0,0,0
71738,5412,2020-11-18T16:21:15.47635Z,2019,30,8,21,11,0,5to,0,0,19,0,0,22,9,0,30,0,0,0
71738,5413,2020-11-18T16:21:15.47635Z,2019,72,19,39,42,0,PK,0,0,30,0,0,53,33,0,72,0,0,0
31054,1898,2020-11-18T16:20:52.490026Z,2019,45,7,41,29,0,1ro,2,0,16,0,0,38,4,0,43,0,0,0
31054,1899,2020-11-18T16:20:52.490026Z,2019,37,9,29,22,0,2do,2,0,15,0,0,28,8,0,35,0,0,0
31054,1900,2020-11-18T16:20:52.490026Z,2019,40,11,38,20,0,3ro,0,1,20,0,0,29,2,0,40,0,0,0
31054,1901,2020-11-18T16:20:53.3916242Z,2019,46,11,43,18,0,4to,2,0,28,0,0,35,3,0,44,0,0,0
31054,1902,2020-11-18T16:20:53.3916242Z,2019,61,12,56,34,0,5to,1,0,27,0,0,49,5,2,58,1,0,0
31054,1903,2020-11-18T16:20:53.3926246Z,2019,75,18,65,31,0,6to,1,1,44,0,0,57,10,3,71,0,1,0
31054,1904,2020-11-18T16:20:53.3926246Z,2019,82,12,70,48,0,7mo,0,1,34,0,0,70,12,1,80,0,1,1
31054,1905,2020-11-18T16:20:53.3926246Z,2019,85,18,67,48,0,8vo,0,0,37,0,0,67,18,0,84,0,1,1
31054,1906,2020-11-18T16:20:53.3936255Z,2019,39,6,37,18,0,K,0,0,21,0,0,33,2,0,39,0,0,0
31054,1907,2020-11-18T16:20:53.3936255Z,2019,15,14,14,7,0,Sin Grado,0,1,8,0,0,1,1,0,15,0,0,0
31054,31903,2021-06-24T13:18:18.6738399Z,2021,23,5,20,10,0,1ro,0,0,13,0,0,18,3,0,23,0,0,0
31054,31904,2021-06-24T13:18:18.6748404Z,2021,47,11,45,20,0,2do,2,0,27,0,0,36,2,0,45,0,0,0
31054,31905,2021-06-24T13:18:18.6748404Z,2021,38,9,33,22,0,3ro,1,0,16,0,0,29,5,0,37,0,0,0
31054,31906,2021-06-24T13:18:18.6748404Z,2021,40,8,35,25,0,4to,5,0,15,0,0,32,5,0,35,0,0,0
31054,31907,2021-06-24T13:18:18.6748404Z,2021,50,16,45,20,0,5to,0,0,30,0,0,34,5,0,50,1,0,0
31054,31908,2021-06-24T13:18:18.6758413Z,2021,78,24,69,28,0,6to,1,0,50,0,0,54,9,0,77,0,0,0
31054,31909,2021-06-24T13:18:18.6758413Z,2021,78,16,71,41,0,7mo,0,0,37,0,0,62,7,1,77,0,0,0
31054,31910,2021-06-24T13:18:18.6758413Z,2021,65,16,58,24,0,8vo,3,0,41,0,0,49,7,0,62,0,0,0
31054,31911,2021-06-24T13:18:18.6768423Z,2021,23,6,19,9,0,K,1,0,14,0,0,17,4,0,22,0,0,0
31054,31912,2021-06-24T13:18:18.6768423Z,2021,13,12,11,5,0,Sin Grado,0,0,8,0,0,1,2,0,13,0,0,0
31054,7906,2020-11-18T16:21:49.1247902Z,2020,46,8,46,22,0,1ro,1,0,24,0,0,38,0,0,44,0,0,1
31054,7907,2020-11-18T16:21:49.1247902Z,2020,39,7,33,25,0,2do,2,0,14,0,0,32,6,0,37,0,0,0
31054,7908,2020-11-18T16:21:49.1247902Z,2020,34,5,25,19,0,3ro,2,0,15,0,0,29,9,0,32,0,0,0
31054,7909,2020-11-18T16:21:49.1247902Z,2020,52,16,49,24,0,4to,0,0,28,0,0,36,3,0,52,0,0,0
31054,7910,2020-11-18T16:21:49.1257902Z,2020,43,11,38,16,0,5to,0,0,27,0,0,32,5,0,43,0,0,0
31054,7911,2020-11-18T16:21:49.1257902Z,2020,75,17,61,37,0,6to,0,0,38,0,0,58,14,1,74,0,0,0
31054,7912,2020-11-18T16:21:49.1257902Z,2020,65,17,57,26,0,7mo,1,0,39,0,0,48,8,0,64,0,0,0
31054,7913,2020-11-18T16:21:49.126792Z,2020,75,9,60,48,0,8vo,1,0,27,0,0,66,15,0,74,0,0,0
31054,7914,2020-11-18T16:21:49.126792Z,2020,28,6,25,12,0,K,0,0,16,0,0,22,3,0,28,0,0,0
31054,7915,2020-11-18T16:21:49.126792Z,2020,11,11,10,6,0,Sin Grado,0,0,5,0,0,0,1,0,11,0,0,0
11023,118,2020-11-18T16:20:37.5560647Z,2019,111,32,78,56,0,6to,0,0,55,0,0,79,33,0,111,1,0,0
11023,119,2020-11-18T16:20:37.5570647Z,2019,122,41,90,60,0,7mo,0,0,62,0,0,81,32,0,122,1,0,0
11023,120,2020-11-18T16:20:37.5570647Z,2019,146,40,108,74,0,8vo,0,1,72,0,0,106,38,0,146,0,0,0
11023,121,2020-11-18T16:20:37.5570647Z,2019,18,17,12,5,0,Sin Grado,1,0,13,0,0,1,6,0,17,0,0,0
11023,30118,2021-06-24T13:18:06.2889588Z,2021,107,40,89,55,0,6to,4,1,52,0,0,67,18,0,103,0,0,0
11023,30119,2021-06-24T13:18:06.2889588Z,2021,111,42,90,53,0,7mo,0,0,58,0,0,69,21,0,111,2,0,0
11023,30120,2021-06-24T13:18:06.2889588Z,2021,104,35,80,53,0,8vo,1,0,51,0,0,69,24,0,103,1,0,0
11023,30121,2021-06-24T13:18:06.2889588Z,2021,9,9,7,2,0,Sin Grado,1,0,7,0,0,0,2,0,8,0,0,0
11023,6119,2020-11-18T16:21:38.2385304Z,2020,122,43,96,58,0,6to,1,1,64,0,0,79,26,0,121,3,0,0
11023,6120,2020-11-18T16:21:38.2395304Z,2020,107,35,77,53,0,7mo,1,0,54,0,0,72,30,0,106,1,0,0
11023,6121,2020-11-18T16:21:38.2395304Z,2020,121,36,90,63,0,8vo,0,0,58,0,0,85,31,0,121,1,0,0
11023,6122,2020-11-18T16:21:38.2395304Z,2020,15,15,11,2,0,Sin Grado,1,0,13,0,0,0,4,0,14,0,0,0
35774,2364,2020-11-18T16:20:55.7371891Z,2019,54,13,41,27,0,1ro,1,0,27,0,0,41,13,0,53,0,0,0
35774,2365,2020-11-18T16:20:55.7371891Z,2019,52,9,41,32,0,2do,1,0,20,0,0,43,11,0,51,0,0,0
35774,2366,2020-11-18T16:20:55.7381895Z,2019,58,20,43,30,0,3ro,2,0,28,0,0,38,15,0,56,0,0,0
35774,2367,2020-11-18T16:20:55.7381895Z,2019,49,20,40,22,0,4to,0,0,27,0,0,29,9,0,49,1,0,0
35774,2368,2020-11-18T16:20:55.7381895Z,2019,49,20,40,24,0,5to,0,0,25,0,0,29,9,0,49,0,0,0
35774,2369,2020-11-18T16:20:55.7391913Z,2019,44,6,37,33,0,K,0,0,11,0,0,38,7,0,44,0,0,0
35774,2370,2020-11-18T16:20:55.7391913Z,2019,16,2,12,9,0,PK,0,0,7,0,0,14,4,0,15,0,0,1
35774,32371,2021-06-24T13:18:23.3491924Z,2021,41,4,34,20,0,1ro,0,0,21,0,0,37,7,0,40,0,0,1
35774,32372,2021-06-24T13:18:23.3491924Z,2021,48,12,43,30,0,2do,1,0,18,0,0,36,5,0,47,0,0,0
35774,32373,2021-06-24T13:18:23.3491924Z,2021,49,9,38,24,0,3ro,0,0,25,0,0,40,11,0,49,1,0,0
35774,32374,2021-06-24T13:18:23.3491924Z,2021,48,7,38,33,0,4to,0,0,15,0,0,41,10,0,48,0,0,0
35774,32375,2021-06-24T13:18:23.3501929Z,2021,53,14,44,28,0,5to,1,0,25,0,0,39,9,0,52,0,1,0
35774,32376,2021-06-24T13:18:23.3501929Z,2021,37,10,33,20,0,K,0,0,17,0,0,27,4,1,36,0,0,0
35774,32377,2021-06-24T13:18:23.3501929Z,2021,15,2,12,6,0,PK,0,0,9,0,0,13,3,0,15,0,0,0
35774,8376,2020-11-18T16:21:51.4103132Z,2020,50,10,42,33,0,1ro,1,0,17,0,0,40,8,0,49,0,0,0
35774,8377,2020-11-18T16:21:51.4113146Z,2020,45,7,30,20,0,2do,0,0,25,0,0,38,15,0,45,1,0,0
35774,8378,2020-11-18T16:21:51.4113146Z,2020,48,9,36,34,0,3ro,0,0,14,0,0,39,12,0,48,0,0,0
35774,8379,2020-11-18T16:21:51.4123145Z,2020,54,16,37,28,0,4to,1,0,26,0,0,38,17,0,53,0,0,0
35774,8380,2020-11-18T16:21:51.4123145Z,2020,39,14,32,20,0,5to,0,0,19,0,0,25,7,0,39,1,0,0
35774,8381,2020-11-18T16:21:51.4123145Z,2020,37,4,26,18,0,K,0,0,19,0,0,33,11,0,36,0,0,1
35774,8382,2020-11-18T16:21:51.4123145Z,2020,16,1,12,9,0,PK,0,0,7,0,0,15,4,0,16,0,0,0
20776,1077,2020-11-18T16:20:43.8172399Z,2019,121,46,102,57,0,6to,1,9,64,0,0,75,19,0,120,0,0,0
20776,1078,2020-11-18T16:20:43.8172399Z,2019,121,42,93,58,0,7mo,0,10,63,0,0,79,28,0,121,0,0,0
20776,1079,2020-11-18T16:20:43.8172399Z,2019,151,53,116,67,0,8vo,0,9,84,0,0,98,35,0,150,0,1,1
20776,1080,2020-11-18T16:20:43.8182395Z,2019,10,10,9,6,0,Sin Grado,0,0,4,0,0,0,1,0,10,0,0,0
20776,31077,2021-06-24T13:18:12.0681039Z,2021,131,37,107,66,0,6to,0,2,65,0,0,94,24,0,131,0,0,0
20776,31078,2021-06-24T13:18:12.0681039Z,2021,140,46,113,70,0,7mo,1,2,70,0,0,94,27,0,139,0,0,0
20776,31079,2021-06-24T13:18:12.0691035Z,2021,131,52,112,62,0,8vo,1,4,69,0,0,79,19,0,130,0,0,0
20776,31080,2021-06-24T13:18:12.0691035Z,2021,9,9,8,2,0,Sin Grado,0,2,7,0,0,0,1,0,9,0,0,0
20776,7081,2020-11-18T16:21:43.6421334Z,2020,148,50,114,70,0,6to,1,1,78,0,0,98,34,0,147,0,0,0
20776,7082,2020-11-18T16:21:43.6431343Z,2020,138,52,111,62,0,7mo,1,4,76,0,0,86,27,0,137,0,0,0
20776,7083,2020-11-18T16:21:43.6431343Z,2020,114,32,87,56,0,8vo,1,6,58,0,0,82,27,0,113,0,0,0
20776,7084,2020-11-18T16:21:43.6431343Z,2020,11,11,10,3,0,Sin Grado,0,2,8,0,0,0,1,0,11,0,0,0
62422,10402,2020-11-18T16:22:04.1287951Z,2020,27,6,24,13,0,1ro,1,0,14,0,0,21,3,0,26,0,0,0
62422,10403,2020-11-18T16:22:04.1297942Z,2020,39,9,34,17,0,2do,2,1,22,0,0,30,5,0,37,0,0,0
62422,10404,2020-11-18T16:22:04.1297942Z,2020,44,16,41,22,0,3ro,4,0,22,0,0,28,3,0,40,0,0,0
62422,10405,2020-11-18T16:22:04.1297942Z,2020,48,16,39,29,0,4to,5,0,19,0,0,32,9,0,43,0,0,0
62422,10406,2020-11-18T16:22:04.1297942Z,2020,54,16,50,31,0,5to,2,0,23,0,0,38,4,0,52,0,0,0
62422,10407,2020-11-18T16:22:04.130796Z,2020,70,21,60,30,0,6to,2,0,40,0,0,49,10,0,68,0,0,0
62422,10408,2020-11-18T16:22:04.130796Z,2020,61,20,53,31,0,7mo,5,0,30,0,0,41,8,0,56,0,0,0
62422,10409,2020-11-18T16:22:04.130796Z,2020,53,9,46,30,0,8vo,3,0,23,0,0,44,7,0,50,0,0,0
62422,10410,2020-11-18T16:22:04.131796Z,2020,40,4,37,23,0,K,0,0,17,0,0,36,3,0,40,0,0,0
62422,10411,2020-11-18T16:22:04.131796Z,2020,4,4,4,0,0,Sin Grado,0,0,4,0,0,0,0,0,4,0,0,0
62422,34417,2021-06-24T13:18:39.4457397Z,2021,44,7,44,26,0,1ro,0,0,18,0,0,37,0,0,44,0,0,0
62422,34418,2021-06-24T13:18:39.4457397Z,2021,24,8,21,13,0,2do,0,0,11,0,0,16,3,0,24,0,0,0
62422,34419,2021-06-24T13:18:39.4467415Z,2021,43,10,42,20,0,3ro,2,0,23,0,0,33,1,0,41,0,0,0
62422,34420,2021-06-24T13:18:39.4467415Z,2021,40,15,36,21,0,4to,1,0,19,0,0,25,4,0,39,0,0,0
62422,34421,2021-06-24T13:18:39.4467415Z,2021,47,14,41,29,0,5to,4,0,18,0,0,33,6,0,43,0,0,0
62422,34422,2021-06-24T13:18:39.447742Z,2021,63,18,58,37,0,6to,4,0,26,0,0,45,5,0,59,0,0,0
62422,34423,2021-06-24T13:18:39.447742Z,2021,67,18,61,29,0,7mo,1,0,38,0,0,49,6,0,66,0,0,0
62422,34424,2021-06-24T13:18:39.447742Z,2021,57,18,55,31,0,8vo,4,0,26,0,0,39,2,0,53,0,0,0
62422,34425,2021-06-24T13:18:39.447742Z,2021,27,2,24,16,0,K,0,0,11,0,0,25,3,0,26,0,0,1
62422,4389,2020-11-18T16:21:09.7145068Z,2019,42,7,38,22,0,1ro,1,1,20,0,0,35,4,0,41,0,0,0
62422,4390,2020-11-18T16:21:09.7155082Z,2019,43,18,39,16,0,2do,2,0,27,0,0,25,4,0,41,0,0,0
62422,4391,2020-11-18T16:21:09.7155082Z,2019,48,15,41,23,0,3ro,4,0,25,0,0,33,7,0,44,0,0,0
62422,4392,2020-11-18T16:21:09.7155082Z,2019,59,22,56,31,0,4to,2,0,28,0,0,37,3,0,57,0,0,0
62422,4393,2020-11-18T16:21:09.7155082Z,2019,48,14,40,22,0,5to,1,2,26,0,0,34,8,0,47,0,0,0
62422,4394,2020-11-18T16:21:09.7155082Z,2019,60,16,50,31,0,6to,6,0,29,0,0,44,10,0,54,0,0,0
62422,4395,2020-11-18T16:21:09.7165082Z,2019,58,10,51,35,0,7mo,3,2,23,0,0,48,7,0,55,0,0,0
62422,4396,2020-11-18T16:21:09.7165082Z,2019,32,6,27,15,0,8vo,1,0,17,0,0,26,5,0,31,0,0,0
62422,4397,2020-11-18T16:21:09.7165082Z,2019,23,2,23,15,0,K,0,0,8,0,0,21,0,0,23,0,0,0
62422,4398,2020-11-18T16:21:09.7165082Z,2019,3,3,3,0,0,Sin Grado,0,0,3,0,0,0,0,0,3,0,0,0
13342,30502,2021-06-24T13:18:10.3768898Z,2021,12,0,9,5,0,1ro,0,0,7,0,0,12,3,0,12,0,0,0
13342,30503,2021-06-24T13:18:10.3778908Z,2021,11,3,10,3,0,2do,0,0,8,0,0,8,1,0,11,0,0,0
13342,30504,2021-06-24T13:18:10.3778908Z,2021,16,1,14,11,0,3ro,0,0,5,0,0,15,2,0,16,0,0,0
13342,30505,2021-06-24T13:18:10.3778908Z,2021,16,4,15,7,0,4to,1,0,9,0,0,12,1,0,15,0,0,0
13342,30506,2021-06-24T13:18:10.3788917Z,2021,13,3,13,5,0,5to,0,0,8,0,0,10,0,0,13,0,0,0
13342,30507,2021-06-24T13:18:10.3788917Z,2021,21,5,21,10,0,6to,0,0,11,0,0,16,0,1,20,0,0,0
13342,30508,2021-06-24T13:18:10.3788917Z,2021,18,5,14,6,0,7mo,1,0,12,0,0,13,4,0,17,0,0,0
13342,30509,2021-06-24T13:18:10.3798927Z,2021,13,3,12,8,0,8vo,0,0,5,0,0,10,1,0,13,0,0,0
13342,30510,2021-06-24T13:18:10.3798927Z,2021,11,2,7,5,0,K,0,0,6,0,0,9,4,0,10,0,0,1
13342,30511,2021-06-24T13:18:10.3798927Z,2021,3,3,3,1,0,Sin Grado,0,0,2,0,0,0,0,0,3,0,0,0
13342,505,2020-11-18T16:20:40.7612038Z,2019,14,2,10,9,0,1ro,0,0,5,0,0,12,4,0,14,0,0,0
13342,506,2020-11-18T16:20:40.7612038Z,2019,14,3,13,6,0,2do,0,0,8,0,0,11,1,0,14,0,0,0
13342,507,2020-11-18T16:20:40.7612038Z,2019,12,3,10,4,0,3ro,0,1,8,0,0,9,2,0,12,0,0,0
13342,508,2020-11-18T16:20:40.7612038Z,2019,14,4,10,7,0,4to,0,1,7,0,0,10,4,0,14,0,0,0
13342,509,2020-11-18T16:20:40.7612038Z,2019,14,4,13,5,0,5to,0,0,9,0,0,10,1,0,14,0,0,0
13342,510,2020-11-18T16:20:40.7622047Z,2019,14,3,11,8,0,6to,0,3,6,0,0,11,3,0,14,0,0,0
13342,511,2020-11-18T16:20:40.7622047Z,2019,15,4,13,5,0,7mo,0,0,10,0,0,11,2,0,15,0,1,0
13342,512,2020-11-18T16:20:40.7622047Z,2019,13,2,10,6,0,8vo,0,3,7,0,0,11,3,0,13,1,0,0
13342,513,2020-11-18T16:20:40.7622047Z,2019,12,3,9,4,0,K,0,0,8,0,0,9,3,0,12,0,0,0
13342,514,2020-11-18T16:20:40.7622047Z,2019,5,5,4,1,0,Sin Grado,0,0,4,0,0,0,1,0,5,0,0,0
13342,6504,2020-11-18T16:21:40.3469386Z,2020,12,4,9,3,0,1ro,0,0,9,0,0,8,3,0,12,0,0,0
13342,6505,2020-11-18T16:21:40.3469386Z,2020,15,2,15,10,0,2do,0,0,5,0,0,13,0,0,15,0,0,0
13342,6506,2020-11-18T16:21:40.3479391Z,2020,16,2,15,8,0,3ro,1,0,8,0,0,14,1,0,15,0,0,0
13342,6507,2020-11-18T16:21:40.3479391Z,2020,11,4,10,3,0,4to,0,0,8,0,0,7,1,0,11,0,0,0
13342,6508,2020-11-18T16:21:40.3479391Z,2020,16,4,14,9,0,5to,0,0,7,0,0,12,2,0,16,0,0,0
13342,6509,2020-11-18T16:21:40.3479391Z,2020,16,4,13,5,0,6to,1,0,11,0,0,12,3,0,15,0,0,0
13342,6510,2020-11-18T16:21:40.3479391Z,2020,14,2,11,9,0,7mo,0,0,5,0,0,12,3,0,14,0,0,0
13342,6511,2020-11-18T16:21:40.3489409Z,2020,15,4,12,5,0,8vo,0,0,10,0,0,11,3,0,15,0,1,0
13342,6512,2020-11-18T16:21:40.3489409Z,2020,13,1,12,6,0,K,0,0,7,0,0,12,1,0,13,0,0,0
13342,6513,2020-11-18T16:21:40.3489409Z,2020,3,3,3,1,0,Sin Grado,0,0,2,0,0,0,0,0,3,0,0,0
30148,1756,2020-11-18T16:20:48.8626035Z,2019,95,21,83,42,0,6to,4,0,53,0,0,74,12,0,91,0,0,0
30148,1757,2020-11-18T16:20:48.8636044Z,2019,111,28,105,60,0,7mo,1,1,51,0,0,83,6,0,110,0,0,0
30148,1758,2020-11-18T16:20:48.8636044Z,2019,108,24,103,53,0,8vo,1,0,55,0,0,84,5,0,107,2,0,0
30148,1759,2020-11-18T16:20:48.8636044Z,2019,18,18,16,8,0,Sin Grado,1,0,10,0,0,0,2,0,17,0,0,0
30148,31759,2021-06-24T13:18:17.231807Z,2021,54,11,48,28,0,6to,1,0,26,0,0,43,6,0,52,0,0,1
30148,31760,2021-06-24T13:18:17.231807Z,2021,86,19,76,44,0,7mo,0,0,42,0,0,67,10,0,86,0,1,0
30148,31761,2021-06-24T13:18:17.2328066Z,2021,84,18,73,43,0,8vo,3,0,41,0,0,66,11,0,80,0,1,1
30148,31762,2021-06-24T13:18:17.2328066Z,2021,16,16,9,7,0,Sin Grado,1,0,9,0,0,0,7,0,15,0,1,0
30148,7762,2020-11-18T16:21:47.9159827Z,2020,79,21,76,41,0,6to,0,0,38,0,0,58,3,0,79,0,1,0
30148,7763,2020-11-18T16:21:47.9159827Z,2020,84,19,77,43,0,7mo,5,0,41,0,0,65,7,0,78,0,1,1
30148,7764,2020-11-18T16:21:47.9169841Z,2020,100,23,91,52,0,8vo,1,0,48,0,0,77,9,0,99,0,0,0
30148,7765,2020-11-18T16:21:47.9169841Z,2020,15,15,14,6,0,Sin Grado,1,0,9,0,0,0,1,0,14,0,0,0
12187,303,2020-11-18T16:20:39.6274467Z,2019,47,22,45,19,0,1ro,1,1,28,0,0,25,2,0,45,0,0,1
12187,30301,2021-06-24T13:18:08.8027622Z,2021,40,16,40,21,0,1ro,0,0,19,0,0,24,0,0,40,0,0,0
12187,30302,2021-06-24T13:18:08.8027622Z,2021,31,11,31,17,0,2do,0,0,14,0,0,20,0,0,31,0,0,0
12187,30303,2021-06-24T13:18:08.8027622Z,2021,41,19,40,18,0,3ro,1,3,23,0,0,22,1,0,40,0,1,0
12187,30304,2021-06-24T13:18:08.8027622Z,2021,28,13,27,14,0,4to,1,1,14,0,0,15,1,0,27,0,0,0
12187,30305,2021-06-24T13:18:08.8037627Z,2021,23,11,23,11,0,5to,0,0,12,0,0,12,0,0,23,0,0,0
12187,30306,2021-06-24T13:18:08.8037627Z,2021,37,13,37,16,0,K,0,1,21,0,0,24,0,0,37,0,0,0
12187,30307,2021-06-24T13:18:08.8037627Z,2021,17,5,16,5,0,PK,0,0,12,0,0,12,1,0,17,0,0,0
12187,30308,2021-06-24T13:18:08.8037627Z,2021,19,19,17,8,0,Sin Grado,0,1,11,0,0,0,2,0,19,0,0,0
12187,304,2020-11-18T16:20:39.6274467Z,2019,32,17,29,17,0,2do,0,0,15,0,0,15,3,0,32,0,0,0
12187,305,2020-11-18T16:20:39.6274467Z,2019,21,12,20,7,0,3ro,0,0,14,0,0,9,1,0,21,0,0,0
12187,306,2020-11-18T16:20:39.6274467Z,2019,30,14,26,19,0,4to,0,0,11,0,0,16,4,0,30,1,0,0
12187,307,2020-11-18T16:20:39.6284494Z,2019,20,9,19,7,0,5to,0,0,13,0,0,11,1,0,20,0,0,0
12187,308,2020-11-18T16:20:39.6284494Z,2019,47,16,46,25,0,K,0,0,22,0,0,31,1,0,47,0,0,0
12187,309,2020-11-18T16:20:39.6284494Z,2019,11,4,11,7,0,PK,0,0,4,0,0,7,0,0,11,0,0,0
12187,310,2020-11-18T16:20:39.6284494Z,2019,27,27,23,10,0,Sin Grado,0,2,17,0,0,0,4,0,26,0,0,1
12187,6304,2020-11-18T16:21:39.231194Z,2020,35,6,34,19,0,1ro,0,0,16,0,0,29,1,0,35,0,0,0
12187,6305,2020-11-18T16:21:39.231194Z,2020,45,20,44,19,0,2do,1,0,26,0,0,25,1,0,44,0,0,0
12187,6306,2020-11-18T16:21:39.2321944Z,2020,30,12,28,15,0,3ro,0,0,15,0,0,18,2,0,30,0,0,0
12187,6307,2020-11-18T16:21:39.2321944Z,2020,24,13,23,10,0,4to,0,0,14,0,0,11,1,0,24,0,0,0
12187,6308,2020-11-18T16:21:39.2321944Z,2020,32,13,31,16,0,5to,0,0,16,0,0,19,1,0,32,1,0,0
12187,6309,2020-11-18T16:21:39.2331944Z,2020,45,14,43,20,0,K,0,0,25,0,0,31,2,0,45,0,0,0
12187,6310,2020-11-18T16:21:39.2331944Z,2020,20,5,17,10,0,PK,0,0,10,0,0,15,3,0,20,0,0,0
12187,6311,2020-11-18T16:21:39.2331944Z,2020,24,23,20,10,0,Sin Grado,0,0,14,0,0,1,4,0,23,0,0,1
71761,11435,2020-11-18T16:22:10.5680892Z,2020,141,43,128,59,0,6to,4,0,82,0,0,98,13,0,136,0,0,1
71761,11436,2020-11-18T16:22:10.5680892Z,2020,125,39,104,60,0,7mo,3,0,65,0,0,86,21,0,121,0,0,1
71761,11437,2020-11-18T16:22:10.5680892Z,2020,174,43,151,93,0,8vo,0,1,81,0,0,131,23,0,174,1,0,0
71761,11438,2020-11-18T16:22:10.5680892Z,2020,50,48,45,17,0,Sin Grado,2,1,33,0,0,2,5,0,48,0,1,0
71761,35457,2021-06-24T13:18:46.2356095Z,2021,140,44,128,71,0,6to,3,1,69,0,0,96,12,0,137,0,0,0
71761,35458,2021-06-24T13:18:46.23661Z,2021,124,38,110,53,0,7mo,4,4,71,0,0,86,14,0,119,0,1,1
71761,35459,2021-06-24T13:18:46.23661Z,2021,121,37,105,62,0,8vo,1,3,59,0,0,84,16,0,119,0,0,1
71761,35460,2021-06-24T13:18:46.23661Z,2021,39,38,37,13,0,Sin Grado,3,4,26,0,0,1,2,0,36,0,1,0
71761,5426,2020-11-18T16:21:15.4733477Z,2019,139,44,120,61,0,6to,1,16,78,0,0,95,19,0,137,0,0,1
71761,5427,2020-11-18T16:21:15.4743482Z,2019,190,50,167,93,0,7mo,2,11,97,0,0,140,23,0,187,1,0,1
71761,5428,2020-11-18T16:21:15.4743482Z,2019,201,42,168,105,0,8vo,3,29,96,0,0,159,33,0,197,0,0,1
71761,5429,2020-11-18T16:21:15.4743482Z,2019,47,41,42,13,0,Sin Grado,2,3,34,0,0,6,5,0,45,0,1,0
40147,2521,2020-11-18T16:20:57.6294534Z,2019,28,8,23,14,0,1ro,0,0,14,0,0,20,5,0,28,0,0,0
40147,2522,2020-11-18T16:20:57.6304538Z,2019,33,11,32,14,0,2do,0,0,19,0,0,22,1,0,33,0,1,0
40147,2523,2020-11-18T16:20:57.6304538Z,2019,35,15,31,15,0,3ro,1,1,20,0,0,20,4,0,34,1,1,0
40147,2524,2020-11-18T16:20:57.6304538Z,2019,55,17,46,21,0,4to,0,0,34,0,0,38,9,0,55,0,0,0
40147,2525,2020-11-18T16:20:57.6304538Z,2019,52,18,44,28,0,5to,1,0,24,0,0,34,8,0,51,2,0,0
40147,2526,2020-11-18T16:20:57.6314556Z,2019,65,26,48,30,0,6to,1,2,35,0,0,39,17,0,64,2,1,0
40147,2527,2020-11-18T16:20:57.6314556Z,2019,85,22,56,37,0,7mo,1,0,48,0,0,63,29,0,84,2,0,0
40147,2528,2020-11-18T16:20:57.6314556Z,2019,115,26,87,61,0,8vo,6,2,54,0,0,89,28,0,109,2,0,0
40147,2529,2020-11-18T16:20:57.6324556Z,2019,37,14,33,15,0,K,0,0,22,0,0,23,4,0,37,0,0,0
40147,2530,2020-11-18T16:20:57.6324556Z,2019,19,3,17,8,0,PK,0,0,11,0,0,16,2,0,19,0,0,0
40147,2531,2020-11-18T16:20:57.6324556Z,2019,2,2,1,0,0,Sin Grado,0,0,2,0,0,0,1,0,2,0,0,0
40147,32529,2021-06-24T13:18:25.2275453Z,2021,32,8,29,12,0,1ro,0,4,20,0,0,24,3,0,31,0,0,1
40147,32530,2021-06-24T13:18:25.2275453Z,2021,37,15,36,17,0,2do,0,2,20,0,0,22,1,0,37,0,0,0
40147,32531,2021-06-24T13:18:25.2275453Z,2021,30,7,26,14,0,3ro,1,0,16,0,0,23,4,0,29,0,0,0
40147,32532,2021-06-24T13:18:25.2275453Z,2021,34,10,32,18,0,4to,1,1,16,0,0,24,2,0,33,0,1,0
40147,32533,2021-06-24T13:18:25.2285458Z,2021,45,15,41,20,0,5to,1,3,25,0,0,30,4,0,44,1,0,0
40147,32534,2021-06-24T13:18:25.2285458Z,2021,62,17,54,27,0,6to,1,1,35,0,0,45,8,0,61,0,0,0
40147,32535,2021-06-24T13:18:25.2285458Z,2021,73,27,66,42,0,7mo,2,3,31,0,0,46,7,0,71,3,0,0
40147,32536,2021-06-24T13:18:25.2285458Z,2021,112,37,88,55,0,8vo,1,8,57,0,0,75,24,0,111,2,1,0
40147,32537,2021-06-24T13:18:25.2295467Z,2021,39,9,37,17,0,K,1,0,22,0,0,30,2,0,38,0,0,0
40147,32538,2021-06-24T13:18:25.2295467Z,2021,15,4,13,8,0,PK,0,0,7,0,0,11,2,0,15,0,0,0
40147,32539,2021-06-24T13:18:25.2295467Z,2021,2,2,2,0,0,Sin Grado,0,0,2,0,0,0,0,0,2,0,0,0
40147,8534,2020-11-18T16:21:52.6271231Z,2020,38,15,36,16,0,1ro,0,1,22,0,0,23,2,0,38,0,0,0
40147,8535,2020-11-18T16:21:52.6271231Z,2020,29,8,24,14,0,2do,1,0,15,0,0,21,5,0,28,0,0,0
40147,8536,2020-11-18T16:21:52.6271231Z,2020,37,10,34,19,0,3ro,0,0,18,0,0,27,3,0,37,0,1,0
40147,8537,2020-11-18T16:21:52.6271231Z,2020,39,13,34,19,0,4to,1,3,20,0,0,26,5,0,38,1,0,0
40147,8538,2020-11-18T16:21:52.6271231Z,2020,62,19,48,26,0,5to,1,2,36,0,0,43,14,0,61,0,0,0
40147,8539,2020-11-18T16:21:52.6281249Z,2020,70,29,54,39,0,6to,2,3,31,0,0,41,16,0,68,3,0,0
40147,8540,2020-11-18T16:21:52.6281249Z,2020,116,39,84,57,0,7mo,1,9,59,0,0,77,32,0,115,2,1,0
40147,8541,2020-11-18T16:21:52.6281249Z,2020,86,19,60,39,0,8vo,1,2,47,0,0,67,26,0,85,2,0,0
40147,8542,2020-11-18T16:21:52.6281249Z,2020,38,5,33,15,0,K,0,5,23,0,0,33,5,0,35,0,0,3
40147,8543,2020-11-18T16:21:52.6281249Z,2020,17,4,12,8,0,PK,0,0,9,0,0,13,5,0,17,0,0,0
40147,8544,2020-11-18T16:21:52.629124Z,2020,2,2,1,0,0,Sin Grado,0,0,2,0,0,0,1,0,2,0,0,0
51185,33374,2021-06-24T13:18:31.5750975Z,2021,7,0,5,3,0,1ro,0,0,4,0,0,7,2,0,7,0,0,0
51185,33375,2021-06-24T13:18:31.576098Z,2021,12,6,8,4,0,2do,0,0,8,0,0,6,4,0,12,0,0,0
51185,33376,2021-06-24T13:18:31.576098Z,2021,15,7,12,4,0,3ro,0,0,11,0,0,8,3,0,15,0,0,0
51185,33377,2021-06-24T13:18:31.576098Z,2021,26,9,21,18,0,4to,1,0,8,0,0,17,5,0,25,0,0,0
51185,33378,2021-06-24T13:18:31.5770985Z,2021,43,11,34,21,0,5to,1,0,22,0,0,32,9,0,42,0,0,0
51185,33379,2021-06-24T13:18:31.5770985Z,2021,51,10,44,28,0,6to,2,0,23,0,0,41,7,0,49,0,0,0
51185,33380,2021-06-24T13:18:31.5770985Z,2021,61,15,52,25,0,7mo,0,0,36,0,0,46,9,0,61,0,0,0
51185,33381,2021-06-24T13:18:31.5770985Z,2021,90,24,68,41,0,8vo,1,1,49,0,0,66,22,0,89,1,0,0
51185,33382,2021-06-24T13:18:31.5780986Z,2021,11,0,3,5,0,K,0,0,6,0,0,11,8,0,11,0,0,0
51185,33383,2021-06-24T13:18:31.5780986Z,2021,28,28,21,6,0,Sin Grado,0,0,22,0,0,0,7,0,28,0,0,0
51185,3349,2020-11-18T16:21:02.1454641Z,2019,14,7,14,4,0,1ro,0,0,10,0,0,7,0,0,14,0,0,0
51185,3350,2020-11-18T16:21:02.1454641Z,2019,16,5,13,8,0,2do,1,0,8,0,0,11,3,0,15,0,0,0
51185,3351,2020-11-18T16:21:02.1454641Z,2019,22,2,20,11,0,3ro,0,0,11,0,0,20,2,0,22,0,0,0
51185,3352,2020-11-18T16:21:02.1454641Z,2019,36,8,35,21,0,4to,1,1,15,0,0,28,1,0,35,0,0,0
51185,3353,2020-11-18T16:21:02.1464645Z,2019,45,13,37,17,0,5to,2,0,28,0,0,32,8,0,43,0,0,0
51185,3354,2020-11-18T16:21:02.1464645Z,2019,91,26,73,44,0,6to,2,2,47,0,0,65,18,0,89,0,0,0
51185,3355,2020-11-18T16:21:02.1474658Z,2019,68,19,55,40,0,7mo,1,0,28,0,0,49,13,0,67,0,0,0
51185,3356,2020-11-18T16:21:02.1474658Z,2019,79,28,69,29,0,8vo,1,1,50,0,0,51,10,0,78,1,0,0
51185,3357,2020-11-18T16:21:02.1474658Z,2019,11,3,8,7,0,K,0,0,4,0,0,8,3,0,11,0,0,0
51185,3358,2020-11-18T16:21:02.1484658Z,2019,30,25,26,7,0,Sin Grado,0,0,23,0,0,5,4,0,30,0,0,0
51185,9369,2020-11-18T16:21:58.0117149Z,2020,15,7,13,7,0,1ro,0,0,8,0,0,8,2,0,14,0,0,1
51185,9370,2020-11-18T16:21:58.0127154Z,2020,14,4,13,4,0,2do,0,0,10,0,0,10,1,0,14,0,0,0
51185,9371,2020-11-18T16:21:58.0127154Z,2020,18,3,15,13,0,3ro,1,0,5,0,0,15,3,0,17,0,0,0
51185,9372,2020-11-18T16:21:58.0127154Z,2020,44,12,40,22,0,4to,1,2,22,0,0,32,4,0,43,0,0,0
51185,9373,2020-11-18T16:21:58.0137162Z,2020,36,7,33,21,0,5to,2,1,15,0,0,29,3,0,34,0,0,0
51185,9374,2020-11-18T16:21:58.0137162Z,2020,64,15,52,28,0,6to,1,3,36,0,0,49,12,0,63,0,0,0
51185,9375,2020-11-18T16:21:58.0137162Z,2020,87,25,70,41,0,7mo,1,5,46,0,0,62,17,0,86,0,0,0
51185,9376,2020-11-18T16:21:58.0137162Z,2020,70,21,60,38,0,8vo,1,1,32,0,0,49,10,0,69,0,0,0
51185,9377,2020-11-18T16:21:58.0147158Z,2020,9,0,9,3,0,K,0,0,6,0,0,9,0,0,9,0,0,0
51185,9378,2020-11-18T16:21:58.0147158Z,2020,41,39,33,7,0,Sin Grado,0,5,34,0,0,2,8,0,41,0,0,0
53363,33695,2021-06-24T13:18:33.6966179Z,2021,18,2,16,9,0,1ro,0,0,9,0,0,16,2,0,18,0,0,0
53363,33696,2021-06-24T13:18:33.6976188Z,2021,37,9,30,18,0,2do,0,0,19,0,0,28,7,0,37,0,0,0
53363,33697,2021-06-24T13:18:33.6976188Z,2021,37,13,31,20,0,3ro,0,0,17,0,0,24,6,0,37,0,0,0
53363,33698,2021-06-24T13:18:33.6976188Z,2021,41,14,36,17,0,4to,0,0,24,0,0,27,5,0,41,0,0,0
53363,33699,2021-06-24T13:18:33.6986198Z,2021,39,15,32,16,0,5to,0,0,23,0,0,24,7,0,39,1,0,0
53363,33700,2021-06-24T13:18:35.2087028Z,2021,23,4,19,15,0,K,0,0,8,0,0,19,4,0,23,0,0,0
53363,33701,2021-06-24T13:18:35.2087028Z,2021,6,6,5,1,0,Sin Grado,0,0,5,0,0,0,1,0,6,0,0,0
53363,3671,2020-11-18T16:21:04.3329218Z,2019,39,9,31,23,0,1ro,0,0,16,0,0,30,8,0,38,0,0,1
53363,3672,2020-11-18T16:21:04.333924Z,2019,54,16,47,22,0,2do,0,0,32,0,1,38,7,0,54,0,0,0
53363,3673,2020-11-18T16:21:04.333924Z,2019,54,20,46,24,0,3ro,0,0,30,0,0,34,8,0,54,1,0,0
53363,3674,2020-11-18T16:21:04.333924Z,2019,39,9,36,25,0,4to,0,0,14,0,0,30,3,0,39,1,0,0
53363,3675,2020-11-18T16:21:04.3349218Z,2019,31,6,24,12,0,5to,0,0,19,0,0,25,7,0,31,0,0,0
53363,3676,2020-11-18T16:21:04.3349218Z,2019,33,6,28,14,0,K,0,0,19,0,0,27,5,0,33,0,0,0
53363,3677,2020-11-18T16:21:04.3349218Z,2019,1,1,1,0,0,Sin Grado,0,0,1,0,0,0,0,0,1,0,0,0
53363,9689,2020-11-18T16:21:59.5137171Z,2020,38,6,34,19,0,1ro,0,1,19,0,0,32,4,0,38,0,0,0
53363,9690,2020-11-18T16:21:59.5137171Z,2020,46,16,36,26,0,2do,0,0,20,0,0,30,10,0,45,0,0,1
53363,9691,2020-11-18T16:21:59.514718Z,2020,49,16,40,21,0,3ro,1,1,28,0,0,33,9,0,48,0,0,0
53363,9692,2020-11-18T16:21:59.514718Z,2020,47,17,33,20,0,4to,0,1,27,0,0,30,14,0,47,1,0,0
53363,9693,2020-11-18T16:21:59.514718Z,2020,38,8,33,25,0,5to,0,0,13,0,0,30,5,0,38,1,0,0
53363,9694,2020-11-18T16:21:59.514718Z,2020,26,3,21,11,0,K,0,0,15,0,0,23,5,0,26,0,0,0
53363,9695,2020-11-18T16:21:59.5157203Z,2020,4,4,3,0,0,Sin Grado,0,0,4,0,0,0,1,0,4,0,0,0
57125,33940,2021-06-24T13:18:36.6497357Z,2021,99,25,82,41,0,10mo,1,0,58,0,0,74,17,0,98,1,1,0
57125,33941,2021-06-24T13:18:36.6497357Z,2021,98,18,70,52,0,11mo,2,0,46,0,0,80,28,0,96,1,0,0
57125,33942,2021-06-24T13:18:36.6497357Z,2021,94,19,68,54,0,12mo,0,0,40,0,0,75,26,1,93,1,0,0
57125,33943,2021-06-24T13:18:36.6497357Z,2021,140,37,115,71,0,9no,2,0,69,0,0,103,25,0,138,0,0,0
57125,33944,2021-06-24T13:18:36.6507362Z,2021,2,2,1,0,0,Sin Grado,0,0,2,0,0,0,1,0,2,0,0,0
57125,3917,2020-11-18T16:21:06.7775518Z,2019,141,26,99,71,0,10mo,2,0,70,0,0,115,42,1,138,2,1,0
57125,3918,2020-11-18T16:21:06.7775518Z,2019,148,23,102,74,0,11mo,3,0,74,0,0,125,46,0,144,2,0,1
57125,3919,2020-11-18T16:21:06.7775518Z,2019,143,0,103,63,0,12mo,2,1,80,0,0,143,40,0,141,0,1,0
57125,3920,2020-11-18T16:21:06.7785523Z,2019,153,38,117,72,0,9no,4,0,81,0,0,115,36,0,149,2,0,0
57125,3921,2020-11-18T16:21:06.7785523Z,2019,5,4,3,3,0,Sin Grado,0,0,2,0,0,1,2,0,5,0,0,0
57125,9934,2020-11-18T16:22:01.5430728Z,2020,114,23,86,57,0,10mo,2,1,57,0,0,91,28,0,112,1,0,0
57125,9935,2020-11-18T16:22:01.5430728Z,2020,109,24,76,61,0,11mo,2,1,48,0,0,85,33,1,106,2,1,0
57125,9936,2020-11-18T16:22:01.5440745Z,2020,138,19,95,68,0,12mo,3,2,70,0,0,119,43,0,134,2,0,1
57125,9937,2020-11-18T16:22:01.5440745Z,2020,113,30,89,47,0,9no,3,0,66,0,0,83,24,1,109,1,0,0
57125,9938,2020-11-18T16:22:01.5440745Z,2020,5,5,3,3,0,Sin Grado,0,0,2,0,0,0,2,0,5,0,0,0
57620,33979,2021-06-24T13:18:36.6657471Z,2021,79,24,62,40,0,10mo,0,0,39,0,0,55,17,0,79,2,1,0
57620,33980,2021-06-24T13:18:36.6657471Z,2021,62,16,48,28,0,11mo,0,0,34,0,0,46,14,0,62,1,0,0
57620,33981,2021-06-24T13:18:36.6657471Z,2021,60,12,47,26,0,12mo,0,0,34,0,0,48,13,0,60,1,0,0
57620,33982,2021-06-24T13:18:36.6667476Z,2021,95,23,73,36,0,9no,3,0,59,0,0,72,22,0,92,0,1,0
57620,3955,2020-11-18T16:21:06.8826218Z,2019,94,24,71,39,0,10mo,1,1,55,0,0,70,23,0,93,1,1,0
57620,3956,2020-11-18T16:21:06.8836227Z,2019,107,20,78,52,0,11mo,1,1,55,0,0,87,29,0,106,5,2,0
57620,3957,2020-11-18T16:21:06.8836227Z,2019,92,0,65,51,0,12mo,0,0,41,0,0,92,27,0,92,0,0,0
57620,3958,2020-11-18T16:21:06.8836227Z,2019,112,31,92,48,0,9no,4,2,64,0,2,81,20,0,108,2,1,0
57620,9972,2020-11-18T16:22:01.5540808Z,2020,74,20,59,35,0,10mo,2,10,39,0,0,54,15,0,72,1,1,0
57620,9973,2020-11-18T16:22:01.5540808Z,2020,76,18,58,32,0,11mo,0,5,44,0,0,58,18,0,76,1,0,0
57620,9974,2020-11-18T16:22:01.5550808Z,2020,95,18,72,49,0,12mo,1,7,46,0,0,77,23,0,94,5,2,0
57620,9975,2020-11-18T16:22:01.5550808Z,2020,89,31,70,42,0,9no,0,8,47,0,0,58,19,0,89,2,4,0
57018,33927,2021-06-24T13:18:36.6457332Z,2021,38,4,35,15,0,1ro,0,0,23,0,0,34,3,0,38,0,0,0
57018,33928,2021-06-24T13:18:36.6457332Z,2021,46,11,42,17,0,2do,0,0,29,0,0,35,4,0,46,0,0,0
57018,33929,2021-06-24T13:18:36.6467333Z,2021,49,19,40,25,0,3ro,0,0,24,0,0,30,9,0,49,0,0,0
57018,33930,2021-06-24T13:18:36.6467333Z,2021,50,17,43,22,0,4to,1,0,28,0,0,33,7,0,49,0,1,0
57018,33931,2021-06-24T13:18:36.6467333Z,2021,55,13,40,23,0,5to,1,0,32,0,0,42,15,0,54,0,0,0
57018,33932,2021-06-24T13:18:36.6467333Z,2021,41,13,28,21,0,K,0,0,20,0,0,28,13,0,40,0,0,1
57018,3904,2020-11-18T16:21:06.7735487Z,2019,59,19,51,28,0,1ro,0,1,31,0,0,40,8,0,59,0,0,0
57018,3905,2020-11-18T16:21:06.7735487Z,2019,52,17,47,23,0,2do,1,4,29,0,0,35,5,0,51,0,1,0
57018,3906,2020-11-18T16:21:06.7735487Z,2019,67,22,57,29,0,3ro,1,4,38,0,0,45,10,0,66,0,0,0
57018,3907,2020-11-18T16:21:06.7735487Z,2019,69,21,55,32,0,4to,1,3,37,0,0,48,14,0,68,0,0,0
57018,3908,2020-11-18T16:21:06.7745496Z,2019,62,13,46,29,0,5to,3,3,33,0,0,49,16,0,59,0,0,0
57018,3909,2020-11-18T16:21:06.7745496Z,2019,51,14,42,24,0,K,0,0,27,0,0,37,9,0,51,0,0,0
57018,9921,2020-11-18T16:22:01.5390701Z,2020,56,12,45,26,0,1ro,0,7,30,0,0,44,11,0,56,0,0,0
57018,9922,2020-11-18T16:22:01.5390701Z,2020,54,17,43,25,0,2do,1,9,29,0,0,37,11,0,53,0,0,0
57018,9923,2020-11-18T16:22:01.5390701Z,2020,60,19,55,29,0,3ro,2,2,31,0,0,41,5,0,58,0,1,0
57018,9924,2020-11-18T16:22:01.5390701Z,2020,61,18,49,26,0,4to,1,4,35,0,0,43,12,0,60,0,0,0
57018,9925,2020-11-18T16:22:01.5390701Z,2020,66,20,51,29,0,5to,2,3,37,0,0,46,15,0,64,0,0,0
57018,9926,2020-11-18T16:22:01.5400719Z,2020,50,5,41,19,0,K,0,3,31,0,0,45,9,0,50,0,0,0
43505,2919,2020-11-18T16:20:59.9029681Z,2019,38,15,36,11,1,1ro,0,1,27,0,0,23,2,0,38,1,0,0
43505,2920,2020-11-18T16:20:59.9029681Z,2019,28,11,26,10,0,2do,0,0,18,0,0,17,2,0,28,0,0,0
43505,2921,2020-11-18T16:20:59.9029681Z,2019,25,11,21,12,1,3ro,0,1,13,0,0,14,4,0,25,0,0,0
43505,2922,2020-11-18T16:20:59.9039672Z,2019,30,7,30,16,1,4to,0,1,14,0,0,23,0,0,30,0,0,0
43505,2923,2020-11-18T16:20:59.9039672Z,2019,42,13,35,20,0,5to,0,0,22,0,0,29,7,0,42,0,2,0
43505,2924,2020-11-18T16:20:59.9039672Z,2019,24,7,22,17,0,K,0,0,7,0,0,17,2,0,24,0,0,0
43505,32928,2021-06-24T13:18:28.8691568Z,2021,26,5,26,14,0,1ro,0,0,12,0,0,21,0,0,26,0,0,0
43505,32929,2021-06-24T13:18:28.8691568Z,2021,18,8,17,6,0,2do,0,0,12,0,0,10,1,0,18,1,0,0
43505,32930,2021-06-24T13:18:28.8701568Z,2021,29,9,28,7,0,3ro,0,0,22,0,0,20,1,0,29,1,0,0
43505,32931,2021-06-24T13:18:28.8701568Z,2021,24,6,21,7,0,4to,0,0,17,0,0,18,3,0,24,0,0,0
43505,32932,2021-06-24T13:18:28.8701568Z,2021,18,7,15,8,0,5to,0,0,10,0,0,11,3,0,18,0,0,0
43505,32933,2021-06-24T13:18:28.8701568Z,2021,24,3,20,11,0,K,0,0,13,0,0,21,4,0,24,0,0,0
43505,8932,2020-11-18T16:21:54.9866989Z,2020,21,9,19,12,0,1ro,1,0,9,0,0,12,2,0,20,1,0,0
43505,8933,2020-11-18T16:21:54.9866989Z,2020,31,12,30,7,0,2do,0,0,24,0,0,19,1,0,31,1,0,0
43505,8934,2020-11-18T16:21:54.9866989Z,2020,24,8,22,7,0,3ro,0,0,17,0,0,16,2,0,24,0,0,0
43505,8935,2020-11-18T16:21:54.9866989Z,2020,17,7,14,8,0,4to,0,0,9,0,0,10,3,0,17,0,0,0
43505,8936,2020-11-18T16:21:54.9866989Z,2020,25,6,24,13,0,5to,0,0,12,0,0,19,1,0,25,0,0,0
43505,8937,2020-11-18T16:21:54.9877002Z,2020,29,3,28,14,0,K,0,0,15,0,0,26,1,0,29,0,0,0
48025,3196,2020-11-18T16:21:01.0407261Z,2019,75,28,64,40,0,1ro,0,3,35,0,0,47,11,0,75,1,1,0
48025,3197,2020-11-18T16:21:01.0407261Z,2019,73,25,64,36,0,2do,0,2,37,0,0,48,9,0,73,0,0,0
48025,3198,2020-11-18T16:21:01.0417265Z,2019,50,20,42,21,0,3ro,0,2,29,0,0,30,8,0,50,0,0,0
48025,3199,2020-11-18T16:21:01.0417265Z,2019,66,22,56,28,0,4to,0,1,38,0,0,44,10,0,66,0,1,0
48025,3200,2020-11-18T16:21:01.0417265Z,2019,54,12,44,32,0,5to,0,0,22,0,0,42,10,0,54,0,0,0
48025,3201,2020-11-18T16:21:01.4249819Z,2019,50,20,40,22,0,K,0,0,28,0,0,30,10,0,50,0,0,0
48025,3202,2020-11-18T16:21:01.4249819Z,2019,42,41,39,10,0,Sin Grado,0,0,32,0,0,1,3,0,42,0,1,0
48025,33221,2021-06-24T13:18:30.8705915Z,2021,34,8,30,16,0,1ro,0,0,18,0,0,26,4,0,34,0,0,0
48025,33222,2021-06-24T13:18:30.8705915Z,2021,42,20,38,21,0,2do,0,0,21,0,0,22,4,0,42,0,0,0
48025,33223,2021-06-24T13:18:30.8715924Z,2021,52,22,44,30,0,3ro,0,0,22,0,0,30,8,0,52,0,0,0
48025,33224,2021-06-24T13:18:30.8715924Z,2021,54,19,45,20,0,4to,1,0,34,0,0,35,9,0,53,0,0,0
48025,33225,2021-06-24T13:18:30.8715924Z,2021,44,17,36,18,0,5to,0,0,26,0,0,27,8,0,44,1,0,0
48025,33226,2021-06-24T13:18:30.8715924Z,2021,37,11,28,17,0,K,0,0,20,0,0,26,9,0,37,0,0,0
48025,33227,2021-06-24T13:18:30.8725929Z,2021,14,14,13,2,0,Sin Grado,0,0,12,0,0,0,1,0,14,0,0,0
48025,9217,2020-11-18T16:21:57.3172532Z,2020,41,20,33,20,0,1ro,0,2,21,0,0,21,8,0,41,0,0,0
48025,9218,2020-11-18T16:21:57.3172532Z,2020,53,21,43,31,0,2do,0,3,22,0,0,32,10,0,53,0,0,0
48025,9219,2020-11-18T16:21:57.3172532Z,2020,54,20,43,24,0,3ro,0,2,30,0,0,34,11,0,54,0,0,0
48025,9220,2020-11-18T16:21:57.3172532Z,2020,33,12,28,10,0,4to,0,3,23,0,0,21,5,0,33,0,0,0
48025,9221,2020-11-18T16:21:57.3182554Z,2020,59,20,48,21,0,5to,0,2,38,0,0,39,11,0,59,0,0,0
48025,9222,2020-11-18T16:21:57.3182554Z,2020,51,9,44,24,0,K,0,3,27,0,0,42,7,0,51,0,0,0
48025,9223,2020-11-18T16:21:57.3182554Z,2020,38,38,34,8,0,Sin Grado,0,0,30,0,0,0,4,0,38,0,1,0
35626,2358,2020-11-18T16:20:55.7291838Z,2019,52,40,45,19,0,Sin Grado,0,0,33,0,0,12,7,0,52,0,0,0
35626,32365,2021-06-24T13:18:23.3371838Z,2021,41,41,34,13,0,Sin Grado,0,1,28,0,0,0,7,0,41,0,0,0
35626,8370,2020-11-18T16:21:51.4043092Z,2020,43,41,33,15,0,Sin Grado,0,0,28,0,0,2,10,0,43,0,0,0
12435,30363,2021-06-24T13:18:08.8457924Z,2021,48,20,39,26,0,1ro,0,3,22,0,0,28,9,0,48,0,0,0
12435,30364,2021-06-24T13:18:08.8457924Z,2021,34,13,31,20,0,2do,0,5,14,0,0,21,3,0,34,0,0,0
12435,30365,2021-06-24T13:18:08.8467938Z,2021,59,24,43,23,0,3ro,0,1,36,0,0,35,16,0,59,0,0,0
12435,30366,2021-06-24T13:18:08.8467938Z,2021,40,17,30,17,0,4to,0,1,23,0,0,23,10,0,40,0,0,0
12435,30367,2021-06-24T13:18:08.8467938Z,2021,44,16,39,22,0,5to,0,0,22,0,0,28,5,0,44,0,0,0
12435,30368,2021-06-24T13:18:08.8467938Z,2021,46,15,38,25,0,K,1,5,21,0,0,31,8,1,44,0,0,0
12435,30369,2021-06-24T13:18:08.8477943Z,2021,11,3,9,8,0,PK,0,0,3,0,0,8,2,0,11,0,0,0
12435,30370,2021-06-24T13:18:08.8477943Z,2021,5,5,4,2,0,Sin Grado,0,0,3,0,0,0,1,0,5,0,0,0
12435,365,2020-11-18T16:20:39.644461Z,2019,48,20,35,22,0,1ro,0,7,26,0,0,28,13,0,48,0,0,0
12435,366,2020-11-18T16:20:39.644461Z,2019,41,19,31,16,0,2do,0,4,25,0,0,22,10,0,41,0,0,0
12435,367,2020-11-18T16:20:39.6454587Z,2019,37,14,27,19,0,3ro,0,0,18,0,0,23,10,0,37,0,0,0
12435,368,2020-11-18T16:20:39.6454587Z,2019,53,15,40,29,0,4to,0,1,24,0,0,38,13,0,53,0,0,0
12435,369,2020-11-18T16:20:39.6454587Z,2019,59,15,41,37,0,5to,0,1,22,0,0,44,18,0,59,0,0,0
12435,370,2020-11-18T16:20:39.6464596Z,2019,34,16,27,21,0,K,0,8,13,0,0,18,7,0,34,0,0,0
12435,371,2020-11-18T16:20:39.6464596Z,2019,15,3,9,9,0,PK,0,2,6,0,0,12,6,0,15,0,0,0
12435,372,2020-11-18T16:20:39.6464596Z,2019,15,14,13,7,0,Sin Grado,0,2,8,0,0,1,2,0,15,0,0,0
12435,6366,2020-11-18T16:21:39.2492074Z,2020,33,14,27,19,0,1ro,0,6,14,0,0,19,6,0,33,0,0,0
12435,6367,2020-11-18T16:21:39.2502074Z,2020,58,22,37,25,0,2do,1,4,33,0,0,36,21,0,57,0,0,0
12435,6368,2020-11-18T16:21:39.2502074Z,2020,42,17,29,18,0,3ro,0,1,24,0,0,25,13,0,42,0,0,0
12435,6369,2020-11-18T16:21:39.2502074Z,2020,44,14,36,22,0,4to,0,0,22,0,0,30,8,0,44,0,0,0
12435,6370,2020-11-18T16:21:39.2512078Z,2020,55,12,46,32,0,5to,0,1,23,0,0,43,9,0,55,0,0,0
12435,6371,2020-11-18T16:21:39.2512078Z,2020,50,14,41,29,0,K,0,5,21,0,0,36,9,0,50,0,0,0
12435,6372,2020-11-18T16:21:39.2512078Z,2020,16,3,8,9,0,PK,0,2,7,0,0,13,8,0,16,0,0,0
12435,6373,2020-11-18T16:21:39.2512078Z,2020,16,16,14,7,0,Sin Grado,0,1,9,0,0,0,2,0,16,0,0,0
43273,2866,2020-11-18T16:20:59.1974944Z,2019,22,5,21,10,0,1ro,0,0,12,0,0,17,1,0,22,0,0,0
43273,2867,2020-11-18T16:20:59.1974944Z,2019,28,7,24,18,0,2do,0,0,10,0,0,21,4,0,28,0,0,0
43273,2868,2020-11-18T16:20:59.1974944Z,2019,22,7,18,9,0,3ro,0,0,13,0,0,15,4,0,22,0,0,0
43273,2869,2020-11-18T16:20:59.1984948Z,2019,32,15,26,17,0,4to,0,0,15,0,0,17,6,0,32,0,0,0
43273,2870,2020-11-18T16:20:59.1984948Z,2019,30,9,23,17,0,5to,0,2,13,0,0,21,7,0,30,0,0,0
43273,2871,2020-11-18T16:20:59.1984948Z,2019,20,7,19,9,0,6to,0,1,11,0,0,13,1,0,20,0,0,0
43273,2872,2020-11-18T16:20:59.1984948Z,2019,32,6,26,16,0,K,0,0,16,0,0,26,6,0,32,0,0,0
43273,2873,2020-11-18T16:20:59.1984948Z,2019,18,6,15,9,0,PK,0,0,9,0,0,12,3,0,18,0,0,0
43273,32874,2021-06-24T13:18:28.2186903Z,2021,18,7,16,11,0,1ro,0,0,7,0,0,11,2,0,18,0,0,0
43273,32875,2021-06-24T13:18:28.2196908Z,2021,26,10,25,13,0,2do,0,0,13,0,0,16,1,0,26,0,0,0
43273,32876,2021-06-24T13:18:28.2196908Z,2021,13,1,9,6,0,3ro,0,0,7,0,0,12,4,0,13,0,0,0
43273,32877,2021-06-24T13:18:28.2196908Z,2021,21,6,17,15,0,4to,0,0,6,0,0,15,4,0,21,0,0,0
43273,32878,2021-06-24T13:18:28.2196908Z,2021,16,4,11,8,0,5to,0,0,8,0,0,12,5,0,16,1,0,0
43273,32879,2021-06-24T13:18:28.2206913Z,2021,20,11,16,9,0,6to,0,0,11,0,0,9,4,0,20,0,0,0
43273,32880,2021-06-24T13:18:28.2206913Z,2021,19,4,13,11,0,K,0,0,8,0,0,15,6,0,19,0,0,0
43273,32881,2021-06-24T13:18:28.2206913Z,2021,18,4,15,9,0,PK,0,0,9,0,0,14,3,0,16,0,0,2
43273,8878,2020-11-18T16:21:54.2472051Z,2020,29,6,23,15,0,1ro,0,0,14,0,0,23,6,0,29,0,0,0
43273,8879,2020-11-18T16:21:54.2472051Z,2020,14,1,12,5,0,2do,0,0,9,0,0,13,2,0,14,0,0,0
43273,8880,2020-11-18T16:21:54.2472051Z,2020,25,6,18,15,0,3ro,0,1,10,0,0,19,7,0,25,0,0,0
43273,8881,2020-11-18T16:21:54.2472051Z,2020,19,5,13,10,0,4to,0,1,9,0,0,14,6,0,19,1,0,0
43273,8882,2020-11-18T16:21:54.248206Z,2020,26,14,19,13,0,5to,0,0,13,0,0,12,7,0,26,0,0,0
43273,8883,2020-11-18T16:21:54.248206Z,2020,32,9,22,15,0,6to,0,1,17,0,0,23,10,0,32,1,0,0
43273,8884,2020-11-18T16:21:54.248206Z,2020,17,7,13,10,0,K,0,0,7,0,0,10,4,0,17,0,0,0
43273,8885,2020-11-18T16:21:54.248206Z,2020,15,3,13,9,0,PK,0,0,6,0,0,12,2,0,15,0,0,0
71654,11385,2020-11-18T16:22:10.1828326Z,2020,119,47,92,59,0,6to,2,0,60,0,0,72,27,0,116,0,0,1
71654,11386,2020-11-18T16:22:10.1828326Z,2020,174,59,129,89,0,7mo,6,0,85,0,0,115,45,0,168,0,1,0
71654,11387,2020-11-18T16:22:10.1828326Z,2020,180,49,132,79,0,8vo,8,0,101,0,0,131,48,0,172,0,1,0
71654,11388,2020-11-18T16:22:10.1838321Z,2020,21,21,17,9,0,Sin Grado,0,0,12,0,0,0,4,0,21,0,0,0
71654,35407,2021-06-24T13:18:46.2205981Z,2021,91,27,78,43,0,6to,3,0,48,0,0,64,13,0,88,0,0,0
71654,35408,2021-06-24T13:18:46.2205981Z,2021,144,54,123,76,0,7mo,2,1,68,0,0,90,21,0,141,0,0,1
71654,35409,2021-06-24T13:18:46.2205981Z,2021,169,59,132,88,0,8vo,6,0,81,0,0,110,37,0,163,0,1,0
71654,35410,2021-06-24T13:18:46.2205981Z,2021,25,25,22,8,0,Sin Grado,0,0,17,0,0,0,3,0,24,0,0,1
71654,5377,2020-11-18T16:21:15.0900937Z,2019,134,44,93,67,0,6to,6,0,67,0,0,90,41,0,128,0,1,0
71654,5378,2020-11-18T16:21:15.0900937Z,2019,191,51,142,85,0,7mo,7,0,106,0,0,140,49,0,184,0,1,0
71654,5379,2020-11-18T16:21:15.0900937Z,2019,182,49,136,93,0,8vo,2,0,89,0,0,133,46,0,180,0,0,0
71654,5380,2020-11-18T16:21:15.0900937Z,2019,21,19,18,8,0,Sin Grado,0,0,13,0,0,2,3,0,21,0,0,0
31120,1919,2020-11-18T16:20:53.3926246Z,2019,32,6,28,13,0,10mo,0,0,19,0,0,26,4,0,32,0,0,0
31120,1920,2020-11-18T16:20:53.3926246Z,2019,32,1,31,17,0,11mo,0,0,15,0,0,31,1,0,32,0,0,0
31120,1921,2020-11-18T16:20:53.3926246Z,2019,28,0,27,18,0,12mo,0,0,10,0,0,28,1,0,28,0,0,0
31120,1922,2020-11-18T16:20:53.3936255Z,2019,40,2,38,25,0,9no,0,0,15,0,0,38,2,1,39,0,0,0
31120,1923,2020-11-18T16:20:53.3936255Z,2019,4,3,3,2,0,Sin Grado,0,0,2,0,0,1,1,0,4,0,0,0
31120,31924,2021-06-24T13:18:18.6738399Z,2021,62,8,55,37,0,10mo,3,0,25,0,0,54,7,1,58,0,0,0
31120,31925,2021-06-24T13:18:18.6738399Z,2021,45,3,42,27,0,11mo,0,0,18,0,0,42,3,1,44,0,0,0
31120,31926,2021-06-24T13:18:18.6738399Z,2021,31,6,29,14,0,12mo,0,0,17,0,0,25,2,0,31,0,0,0
31120,31927,2021-06-24T13:18:18.6738399Z,2021,66,7,58,32,0,6to,0,0,34,0,0,59,8,1,65,0,0,0
31120,31928,2021-06-24T13:18:18.6748404Z,2021,63,15,55,33,0,7mo,0,0,30,0,0,48,8,1,62,0,1,0
31120,31929,2021-06-24T13:18:18.6748404Z,2021,33,5,32,18,0,8vo,1,0,15,0,0,28,1,0,32,0,0,0
31120,31930,2021-06-24T13:18:18.6748404Z,2021,48,12,43,33,0,9no,1,0,15,0,0,36,5,0,47,0,0,0
31120,31931,2021-06-24T13:18:18.6748404Z,2021,24,24,19,11,0,Sin Grado,0,0,13,0,0,0,5,0,24,0,0,0
31120,7927,2020-11-18T16:21:49.1287929Z,2020,42,2,36,27,0,10mo,0,0,15,0,0,40,6,1,41,0,0,0
31120,7928,2020-11-18T16:21:49.1287929Z,2020,37,7,35,15,0,11mo,0,0,22,0,0,30,2,0,37,0,0,0
31120,7929,2020-11-18T16:21:49.1287929Z,2020,31,1,27,18,0,12mo,0,0,13,0,0,30,4,0,31,0,0,0
31120,7930,2020-11-18T16:21:49.1297942Z,2020,63,15,53,31,0,6to,0,0,32,0,0,48,10,1,62,0,1,0
31120,7931,2020-11-18T16:21:49.1297942Z,2020,39,7,36,20,0,7mo,0,0,19,0,0,32,3,0,39,0,0,0
31120,7932,2020-11-18T16:21:49.1297942Z,2020,41,7,37,28,0,8vo,0,0,13,0,0,34,4,0,41,0,0,0
31120,7933,2020-11-18T16:21:49.1297942Z,2020,59,6,55,39,0,9no,2,0,20,0,0,53,4,0,57,0,0,0
31120,7934,2020-11-18T16:21:49.1297942Z,2020,22,22,19,9,0,Sin Grado,0,0,13,0,0,0,3,0,22,0,0,0
53744,33751,2021-06-24T13:18:35.2617402Z,2021,22,5,21,11,0,1ro,1,0,11,0,0,17,1,0,21,0,0,0
53744,33752,2021-06-24T13:18:35.2627416Z,2021,14,3,13,8,0,2do,0,0,6,0,0,11,1,0,14,0,0,0
53744,33753,2021-06-24T13:18:35.2627416Z,2021,22,7,17,13,0,3ro,0,0,9,0,0,15,5,0,22,0,0,0
53744,33754,2021-06-24T13:18:35.2627416Z,2021,23,8,20,16,0,4to,0,0,7,0,0,15,3,0,23,0,0,0
53744,33755,2021-06-24T13:18:35.263742Z,2021,19,6,18,6,0,5to,0,0,13,0,0,13,1,0,19,0,0,0
53744,33756,2021-06-24T13:18:35.263742Z,2021,15,2,14,6,0,K,0,0,9,0,0,13,1,0,15,0,0,0
53744,3728,2020-11-18T16:21:05.1084373Z,2019,27,12,20,12,0,1ro,0,0,15,0,0,15,7,0,27,0,0,0
53744,3729,2020-11-18T16:21:05.1084373Z,2019,22,8,18,15,0,2do,0,0,7,0,0,14,4,0,22,0,1,0
53744,3730,2020-11-18T16:21:05.1084373Z,2019,22,5,19,8,0,3ro,0,0,14,0,0,17,3,0,22,0,0,0
53744,3731,2020-11-18T16:21:05.1084373Z,2019,24,5,20,13,0,4to,0,0,11,0,0,19,4,0,24,0,0,0
53744,3732,2020-11-18T16:21:05.1094373Z,2019,19,5,12,10,0,5to,0,0,9,0,0,14,7,0,19,0,0,0
53744,3733,2020-11-18T16:21:05.1094373Z,2019,17,1,17,7,0,K,0,0,10,0,0,16,0,0,17,0,0,0
53744,9745,2020-11-18T16:22:00.1161195Z,2020,17,3,15,10,0,1ro,0,0,7,0,0,14,2,0,17,0,0,0
53744,9746,2020-11-18T16:22:00.1161195Z,2020,21,7,16,13,0,2do,0,0,8,0,0,14,5,0,21,0,0,0
53744,9747,2020-11-18T16:22:00.1161195Z,2020,26,10,20,16,0,3ro,0,0,10,0,0,16,6,0,26,0,0,0
53744,9748,2020-11-18T16:22:00.1161195Z,2020,21,6,17,8,0,4to,0,0,13,0,0,15,4,0,21,0,0,0
53744,9749,2020-11-18T16:22:00.1171209Z,2020,24,6,20,14,0,5to,1,1,10,0,0,18,4,0,23,0,0,0
53744,9750,2020-11-18T16:22:00.1171209Z,2020,23,3,20,11,0,K,1,0,12,0,0,20,3,0,22,0,0,0
21097,1159,2020-11-18T16:20:44.639788Z,2019,64,24,56,36,0,1ro,1,0,28,0,0,40,8,0,63,0,0,0
21097,1160,2020-11-18T16:20:44.639788Z,2019,55,12,50,33,0,2do,0,0,22,0,0,43,5,0,55,0,0,0
21097,1161,2020-11-18T16:20:44.6407894Z,2019,61,19,54,29,0,3ro,0,0,32,0,0,42,7,0,61,0,0,0
21097,1162,2020-11-18T16:20:44.6407894Z,2019,68,27,55,27,0,4to,0,0,41,0,0,41,13,0,68,0,0,0
21097,1163,2020-11-18T16:20:44.6407894Z,2019,80,32,64,41,0,5to,1,0,39,0,0,48,16,0,79,2,1,0
21097,1164,2020-11-18T16:20:44.6407894Z,2019,52,19,42,29,0,K,0,1,23,0,0,33,10,0,52,0,0,0
21097,1165,2020-11-18T16:20:44.6417894Z,2019,10,10,6,2,0,Sin Grado,0,0,8,0,0,0,4,0,10,0,0,0
21097,31160,2021-06-24T13:18:13.1218588Z,2021,68,15,58,30,0,1ro,0,0,38,0,0,53,10,0,68,0,0,0
21097,31161,2021-06-24T13:18:13.1228598Z,2021,63,21,53,27,0,2do,0,1,36,0,0,42,10,0,63,0,0,0
21097,31162,2021-06-24T13:18:13.1228598Z,2021,76,27,61,42,0,3ro,0,0,34,0,0,49,15,0,76,0,0,0
21097,31163,2021-06-24T13:18:13.1228598Z,2021,50,11,47,28,0,4to,1,1,22,0,0,39,3,0,49,0,1,0
21097,31164,2021-06-24T13:18:13.1228598Z,2021,66,20,53,33,0,5to,0,0,33,0,0,46,13,0,66,0,0,0
21097,31165,2021-06-24T13:18:13.1238602Z,2021,61,7,48,30,0,K,1,0,31,0,0,54,13,0,60,0,0,0
21097,31166,2021-06-24T13:18:13.1238602Z,2021,1,1,1,0,0,Sin Grado,0,0,1,0,0,0,0,0,1,0,0,0
21097,7164,2020-11-18T16:21:44.203509Z,2020,61,21,51,28,0,1ro,0,0,33,0,0,40,10,0,61,0,0,0
21097,7165,2020-11-18T16:21:44.203509Z,2020,73,28,58,42,0,2do,0,0,31,0,0,45,15,0,73,0,0,0
21097,7166,2020-11-18T16:21:44.203509Z,2020,49,13,40,26,0,3ro,0,0,23,0,0,36,9,0,49,0,0,0
21097,7167,2020-11-18T16:21:44.203509Z,2020,61,22,44,28,0,4to,0,0,33,0,0,39,17,0,61,0,0,0
21097,7168,2020-11-18T16:21:44.203509Z,2020,68,26,56,28,0,5to,0,0,40,0,0,42,12,0,68,0,0,0
21097,7169,2020-11-18T16:21:44.2045095Z,2020,60,8,45,30,0,K,0,0,30,0,0,52,15,0,59,0,0,1
21089,1155,2020-11-18T16:20:44.6327836Z,2019,155,55,116,76,0,6to,0,0,79,0,1,100,39,0,155,0,0,0
21089,1156,2020-11-18T16:20:44.6337845Z,2019,146,40,97,81,0,7mo,0,0,65,0,0,106,49,0,146,0,0,0
21089,1157,2020-11-18T16:20:44.6337845Z,2019,147,38,119,83,0,8vo,2,0,64,0,0,109,28,0,145,0,0,0
21089,1158,2020-11-18T16:20:44.6337845Z,2019,20,17,19,3,0,Sin Grado,0,0,17,0,0,3,1,0,20,0,0,0
21089,31156,2021-06-24T13:18:13.0908372Z,2021,93,32,78,41,0,6to,0,0,52,0,0,61,15,0,93,0,0,0
21089,31157,2021-06-24T13:18:13.0918377Z,2021,124,42,106,73,0,7mo,0,0,51,0,0,82,18,0,124,1,1,0
21089,31158,2021-06-24T13:18:13.0928382Z,2021,123,39,91,62,0,8vo,0,0,61,0,0,84,32,0,123,0,0,0
21089,31159,2021-06-24T13:18:13.0928382Z,2021,4,4,3,0,0,Sin Grado,0,0,4,0,0,0,1,0,4,0,0,0
21089,7160,2020-11-18T16:21:44.2005073Z,2020,129,43,106,76,0,6to,1,1,53,0,0,86,23,0,128,1,1,0
21089,7161,2020-11-18T16:21:44.2005073Z,2020,133,48,91,65,0,7mo,0,2,68,0,0,85,42,0,133,0,0,0
21089,7162,2020-11-18T16:21:44.2005073Z,2020,128,32,87,69,0,8vo,0,1,59,0,0,96,41,0,128,0,0,0
21089,7163,2020-11-18T16:21:44.2015077Z,2020,22,18,19,5,0,Sin Grado,1,0,17,0,0,4,3,0,21,0,0,0
20685,1044,2020-11-18T16:20:43.8062323Z,2019,48,27,45,18,0,1ro,0,0,30,0,0,21,3,1,47,0,1,0
20685,1045,2020-11-18T16:20:43.8062323Z,2019,33,17,30,20,0,2do,1,0,13,0,0,16,3,0,32,0,0,0
20685,1046,2020-11-18T16:20:43.8062323Z,2019,32,25,27,14,0,3ro,0,0,18,0,0,7,5,0,32,0,0,0
20685,1047,2020-11-18T16:20:43.8062323Z,2019,32,20,29,17,0,4to,0,0,15,0,0,12,3,1,31,0,0,0
20685,1048,2020-11-18T16:20:43.8072332Z,2019,31,14,29,19,0,5to,0,0,12,0,0,17,2,0,31,0,0,0
20685,1049,2020-11-18T16:20:43.8072332Z,2019,42,20,35,27,0,K,0,0,15,0,0,22,7,0,42,0,0,0
20685,1050,2020-11-18T16:20:43.8072332Z,2019,7,7,6,1,0,Sin Grado,0,0,6,0,0,0,1,0,7,0,0,0
20685,31044,2021-06-24T13:18:12.0681039Z,2021,31,11,28,20,0,1ro,0,0,11,0,0,20,3,0,31,1,0,0
20685,31045,2021-06-24T13:18:12.0681039Z,2021,30,15,30,16,0,2do,0,0,14,0,0,15,0,0,30,0,0,0
20685,31046,2021-06-24T13:18:12.0681039Z,2021,41,23,38,18,0,3ro,0,0,23,0,0,18,3,0,41,0,0,0
20685,31047,2021-06-24T13:18:12.0691035Z,2021,26,13,23,15,0,4to,0,0,11,0,0,13,3,0,26,0,0,0
20685,31048,2021-06-24T13:18:12.0691035Z,2021,22,16,19,11,0,5to,0,0,11,0,0,6,3,0,22,0,0,0
20685,31049,2021-06-24T13:18:12.0701044Z,2021,42,11,31,21,0,K,2,0,21,0,0,31,11,0,39,0,0,1
20685,31050,2021-06-24T13:18:12.0701044Z,2021,10,9,6,0,0,Sin Grado,0,0,10,0,0,1,4,0,10,0,0,0
20685,7048,2020-11-18T16:21:43.645136Z,2020,30,16,28,18,0,1ro,0,0,12,0,0,14,2,0,30,0,0,0
20685,7049,2020-11-18T16:21:43.6461365Z,2020,42,22,41,18,0,2do,0,0,24,0,0,20,1,1,41,0,0,0
20685,7050,2020-11-18T16:21:43.6461365Z,2020,25,14,23,14,0,3ro,0,0,11,0,0,11,2,0,25,0,0,0
20685,7051,2020-11-18T16:21:43.6461365Z,2020,21,17,16,10,0,4to,0,0,11,0,0,4,5,0,21,0,0,0
20685,7052,2020-11-18T16:21:43.6461365Z,2020,28,18,22,13,0,5to,0,0,15,0,0,10,6,1,27,0,0,0
20685,7053,2020-11-18T16:21:43.6471374Z,2020,33,7,30,21,0,K,0,0,12,0,0,26,3,0,33,0,0,0
20685,7054,2020-11-18T16:21:43.6471374Z,2020,9,9,5,1,0,Sin Grado,0,0,8,0,0,0,4,0,9,0,0,0
46656,3074,2020-11-18T16:21:00.3432608Z,2019,116,28,92,57,0,10mo,1,0,59,0,0,88,24,0,115,3,0,0
46656,3075,2020-11-18T16:21:00.3432608Z,2019,86,9,69,41,0,11mo,2,0,45,0,0,77,17,1,83,2,0,0
46656,3076,2020-11-18T16:21:00.3432608Z,2019,100,0,82,48,0,12mo,5,0,52,0,0,100,18,0,95,3,0,0
46656,3077,2020-11-18T16:21:00.3442604Z,2019,176,37,141,77,0,9no,3,0,99,0,0,139,35,0,173,0,1,0
46656,33085,2021-06-24T13:18:29.8338481Z,2021,168,35,130,69,0,10mo,6,0,99,0,0,133,38,0,162,0,0,0
46656,33086,2021-06-24T13:18:29.834849Z,2021,168,32,133,77,0,11mo,3,0,91,0,0,136,35,0,165,0,0,0
46656,33087,2021-06-24T13:18:29.834849Z,2021,110,29,86,54,0,12mo,0,1,56,0,0,81,24,0,110,2,0,0
46656,33088,2021-06-24T13:18:29.834849Z,2021,137,40,104,71,0,9no,2,0,66,0,0,97,33,0,135,0,1,0
46656,9088,2020-11-18T16:21:55.4430041Z,2020,179,41,139,81,0,10mo,2,0,98,0,0,138,40,0,177,0,1,0
46656,9089,2020-11-18T16:21:55.4440046Z,2020,118,28,89,56,0,11mo,1,0,62,0,0,90,29,0,117,3,0,0
46656,9090,2020-11-18T16:21:55.4440046Z,2020,85,8,67,40,0,12mo,4,0,45,0,0,77,18,1,80,2,0,0
46656,9091,2020-11-18T16:21:55.4440046Z,2020,169,45,138,70,0,9no,5,0,99,0,0,124,31,0,164,0,0,0
50492,3268,2020-11-18T16:21:01.4610073Z,2019,76,33,63,40,0,6to,1,1,36,0,0,43,13,0,75,0,0,0
50492,3269,2020-11-18T16:21:01.4610073Z,2019,79,32,57,44,1,7mo,1,2,35,0,0,47,22,0,78,0,0,0
50492,3270,2020-11-18T16:21:01.4610073Z,2019,69,21,49,37,0,8vo,3,2,32,0,0,48,20,0,66,0,1,0
50492,3271,2020-11-18T16:21:01.4620073Z,2019,23,20,22,6,0,Sin Grado,0,1,17,0,0,3,1,0,23,0,0,0
50492,33294,2021-06-24T13:18:30.9036154Z,2021,40,15,37,16,0,6to,0,0,24,0,0,25,3,0,40,0,0,0
50492,33295,2021-06-24T13:18:30.9036154Z,2021,51,20,42,25,0,7mo,1,0,26,0,0,31,9,0,50,0,0,0
50492,33296,2021-06-24T13:18:30.9046168Z,2021,74,30,58,38,0,8vo,1,0,36,0,0,44,16,0,73,0,0,0
50492,33297,2021-06-24T13:18:30.9046168Z,2021,12,12,10,3,0,Sin Grado,0,0,9,0,0,0,2,0,12,0,0,0
50492,9288,2020-11-18T16:21:57.3412687Z,2020,45,18,41,22,0,6to,1,0,23,0,0,27,4,0,44,0,0,0
50492,9289,2020-11-18T16:21:57.3412687Z,2020,72,32,57,36,0,7mo,1,1,36,0,0,40,15,0,71,0,0,0
50492,9290,2020-11-18T16:21:57.3412687Z,2020,71,25,56,40,0,8vo,1,1,31,0,0,46,15,0,70,0,0,0
50492,9291,2020-11-18T16:21:57.3412687Z,2020,19,19,16,6,0,Sin Grado,0,0,13,0,0,0,3,0,19,0,0,0
21105,1166,2020-11-18T16:20:44.6367867Z,2019,177,55,125,73,0,10mo,0,0,104,0,0,122,52,0,177,0,0,0
21105,1167,2020-11-18T16:20:44.6367867Z,2019,152,50,119,68,0,11mo,0,0,84,0,0,102,33,0,152,0,0,0
21105,1168,2020-11-18T16:20:44.6367867Z,2019,177,0,122,81,0,12mo,1,0,96,0,0,177,55,0,176,0,0,0
21105,1169,2020-11-18T16:20:44.6377871Z,2019,189,64,137,90,0,9no,3,0,99,0,0,125,52,0,186,0,1,0
21105,31167,2021-06-24T13:18:13.098843Z,2021,209,66,168,106,0,10mo,2,0,103,0,0,143,41,0,207,0,1,0
21105,31168,2021-06-24T13:18:13.0998435Z,2021,169,52,134,86,0,11mo,1,0,83,0,0,117,35,0,168,0,1,0
21105,31169,2021-06-24T13:18:13.100844Z,2021,152,44,110,70,0,12mo,0,0,82,0,0,108,42,0,152,0,0,0
21105,31170,2021-06-24T13:18:13.100844Z,2021,192,58,157,100,0,9no,1,0,92,0,0,134,35,0,190,1,0,1
21105,7170,2020-11-18T16:21:44.2205202Z,2020,176,57,127,86,0,10mo,0,0,90,0,0,119,49,0,176,0,1,0
21105,7171,2020-11-18T16:21:44.2205202Z,2020,162,48,115,71,0,11mo,0,0,91,0,0,114,47,0,162,0,0,0
21105,7172,2020-11-18T16:21:44.2205202Z,2020,150,53,109,68,0,12mo,0,0,82,0,0,97,41,0,150,0,0,0
21105,7173,2020-11-18T16:21:44.2205202Z,2020,207,61,163,112,0,9no,3,0,95,0,0,146,44,0,204,0,0,0
21105,7174,2020-11-18T16:21:44.2215206Z,2020,4,4,2,0,0,Sin Grado,0,0,4,0,0,0,2,0,4,0,0,0
71290,11249,2020-11-18T16:22:09.5744261Z,2020,18,8,10,10,0,1ro,0,1,8,0,0,10,8,0,18,0,0,0
71290,11250,2020-11-18T16:22:09.5744261Z,2020,9,3,6,5,0,2do,0,2,4,0,0,6,3,0,9,0,0,0
71290,11251,2020-11-18T16:22:09.5744261Z,2020,10,7,6,3,0,3ro,0,1,7,0,0,3,4,0,10,0,1,0
71290,11252,2020-11-18T16:22:09.5754261Z,2020,14,6,7,7,0,4to,0,0,7,0,0,8,7,0,14,0,0,0
71290,11253,2020-11-18T16:22:09.5754261Z,2020,10,6,9,5,0,5to,0,1,5,0,0,4,1,0,10,0,0,0
71290,11254,2020-11-18T16:22:09.5754261Z,2020,19,4,10,9,0,K,0,0,10,0,0,15,9,0,19,0,0,0
71290,11255,2020-11-18T16:22:09.5754261Z,2020,42,3,26,20,0,PK,0,0,22,0,0,39,16,0,42,0,0,0
71290,35270,2021-06-24T13:18:44.8356054Z,2021,19,2,12,9,0,1ro,0,2,10,0,0,17,7,0,19,0,0,0
71290,35271,2021-06-24T13:18:44.8356054Z,2021,15,6,12,7,0,2do,0,1,8,0,0,9,3,0,15,0,0,0
71290,35272,2021-06-24T13:18:44.8356054Z,2021,11,3,11,8,0,3ro,0,1,3,0,0,8,0,0,11,0,0,0
71290,35273,2021-06-24T13:18:44.8366063Z,2021,10,6,10,3,0,4to,0,1,7,0,0,4,0,0,10,0,1,0
71290,35274,2021-06-24T13:18:44.8366063Z,2021,15,7,12,8,0,5to,0,0,7,0,0,8,3,0,15,0,0,0
71290,35275,2021-06-24T13:18:44.8366063Z,2021,27,5,20,15,0,K,1,0,12,0,0,22,7,0,26,0,0,0
71290,35276,2021-06-24T13:18:44.8376068Z,2021,37,2,27,20,0,PK,0,0,17,0,0,35,10,0,37,0,0,0
71290,5244,2020-11-18T16:21:14.4626755Z,2019,20,9,16,8,0,1ro,0,1,12,0,0,11,4,0,20,0,0,0
71290,5245,2020-11-18T16:21:14.4626755Z,2019,16,11,13,7,0,2do,0,0,9,0,0,5,3,0,16,0,1,0
71290,5246,2020-11-18T16:21:14.4626755Z,2019,14,7,8,6,0,3ro,0,0,8,0,0,7,6,0,14,0,0,0
71290,5247,2020-11-18T16:21:14.4636759Z,2019,12,8,11,6,0,4to,0,1,6,0,0,4,1,0,12,0,0,0
71290,5248,2020-11-18T16:21:14.4636759Z,2019,20,7,18,8,0,5to,0,0,12,0,0,13,2,0,20,1,0,0
71290,5249,2020-11-18T16:21:14.4636759Z,2019,16,7,10,10,0,K,0,2,6,0,0,9,6,0,16,0,0,0
71290,5250,2020-11-18T16:21:14.4636759Z,2019,33,3,20,17,0,PK,0,1,16,0,0,30,13,0,33,0,0,0
52696,33611,2021-06-24T13:18:33.6605925Z,2021,336,85,275,174,0,10mo,3,0,162,0,0,251,61,0,333,0,0,0
52696,33612,2021-06-24T13:18:33.6605925Z,2021,302,84,231,163,0,11mo,0,0,139,0,0,218,71,0,302,0,0,0
52696,33613,2021-06-24T13:18:33.6605925Z,2021,308,55,238,152,0,12mo,2,0,156,0,0,253,70,0,306,0,0,0
52696,33614,2021-06-24T13:18:33.6615934Z,2021,353,96,290,189,0,9no,0,0,164,0,0,257,63,0,352,2,1,1
52696,33615,2021-06-24T13:18:33.6615934Z,2021,5,5,5,1,0,Sin Grado,0,0,4,0,0,0,0,0,5,0,0,0
52696,3586,2020-11-18T16:21:03.2832243Z,2019,395,68,296,204,0,10mo,8,0,191,0,0,327,99,0,387,0,0,0
52696,3587,2020-11-18T16:21:03.2832243Z,2019,311,53,221,170,0,11mo,5,2,141,0,0,258,90,0,306,0,0,0
52696,3588,2020-11-18T16:21:03.2842248Z,2019,310,1,208,152,0,12mo,3,1,158,0,0,309,102,0,307,1,0,0
52696,3589,2020-11-18T16:21:03.2842248Z,2019,307,85,230,158,0,9no,3,0,149,0,0,222,77,0,304,0,0,0
52696,3590,2020-11-18T16:21:03.2842248Z,2019,17,12,16,4,0,Sin Grado,0,1,13,0,0,5,1,0,17,0,0,0
52696,9605,2020-11-18T16:21:59.4856989Z,2020,345,90,247,189,0,10mo,2,1,156,0,0,255,98,0,343,0,0,0
52696,9606,2020-11-18T16:21:59.4856989Z,2020,355,64,267,187,0,11mo,4,2,168,0,0,291,88,0,351,0,0,0
52696,9607,2020-11-18T16:21:59.4866993Z,2020,288,52,213,155,0,12mo,4,2,133,0,0,236,75,0,284,0,0,0
52696,9608,2020-11-18T16:21:59.4866993Z,2020,360,92,262,193,0,9no,2,7,167,0,0,268,98,0,358,0,0,0
52696,9609,2020-11-18T16:21:59.4866993Z,2020,20,13,19,4,0,Sin Grado,0,0,16,0,0,7,1,0,20,0,0,0
13391,30521,2021-06-24T13:18:10.3758898Z,2021,32,6,27,9,0,1ro,3,0,23,0,0,26,5,0,29,0,0,0
13391,30522,2021-06-24T13:18:10.3758898Z,2021,28,4,22,14,0,2do,0,0,14,0,0,24,6,0,28,1,0,0
13391,30523,2021-06-24T13:18:10.3768898Z,2021,32,8,26,14,0,3ro,2,0,18,0,0,24,6,0,30,0,0,0
13391,30524,2021-06-24T13:18:10.3768898Z,2021,26,7,21,10,0,4to,0,1,16,0,0,19,5,0,26,1,0,0
13391,30525,2021-06-24T13:18:10.3768898Z,2021,35,5,27,19,0,5to,1,0,16,0,0,30,8,0,34,0,0,0
13391,30526,2021-06-24T13:18:10.3768898Z,2021,39,11,34,18,0,6to,0,0,21,0,0,28,5,0,39,0,0,0
13391,30527,2021-06-24T13:18:10.3778908Z,2021,35,10,28,24,0,7mo,0,2,11,0,0,25,7,0,35,1,0,0
13391,30528,2021-06-24T13:18:10.3778908Z,2021,34,9,28,20,0,8vo,0,1,14,0,0,25,6,0,34,0,0,0
13391,30529,2021-06-24T13:18:10.3778908Z,2021,22,1,13,9,0,K,1,0,13,0,0,21,9,0,21,0,0,0
13391,524,2020-11-18T16:20:40.7682096Z,2019,40,12,29,14,0,1ro,0,1,26,0,0,28,11,0,40,0,0,0
13391,525,2020-11-18T16:20:40.7682096Z,2019,34,10,29,16,0,2do,0,0,18,0,0,24,5,0,34,1,0,0
13391,526,2020-11-18T16:20:40.7692092Z,2019,38,6,29,21,1,3ro,0,1,17,0,0,32,9,0,38,0,0,0
13391,527,2020-11-18T16:20:40.7692092Z,2019,41,8,34,19,0,4to,0,0,22,0,0,33,7,0,41,0,0,0
13391,528,2020-11-18T16:20:40.7692092Z,2019,36,8,27,24,0,5to,0,1,12,0,0,28,9,0,36,1,0,0
13391,529,2020-11-18T16:20:40.7692092Z,2019,41,12,33,20,0,6to,0,0,21,0,0,29,8,0,41,0,0,0
13391,530,2020-11-18T16:20:40.7692092Z,2019,42,4,31,22,0,7mo,0,0,20,0,0,38,11,0,42,0,0,0
13391,531,2020-11-18T16:20:40.7702096Z,2019,36,8,28,17,0,8vo,0,3,19,0,0,28,8,0,36,0,0,0
13391,532,2020-11-18T16:20:40.7702096Z,2019,32,5,24,15,1,K,0,1,17,0,0,27,8,0,32,0,0,0
13391,6523,2020-11-18T16:21:40.3519422Z,2020,31,4,22,17,0,1ro,0,1,14,0,0,27,9,0,31,1,0,0
13391,6524,2020-11-18T16:21:40.3519422Z,2020,34,8,27,14,0,2do,2,1,20,0,0,26,7,0,32,0,0,0
13391,6525,2020-11-18T16:21:40.3519422Z,2020,35,7,29,15,0,3ro,0,3,20,0,0,28,6,0,35,1,0,0
13391,6526,2020-11-18T16:21:40.3519422Z,2020,38,5,27,24,0,4to,1,0,14,0,0,33,11,0,37,0,0,0
13391,6527,2020-11-18T16:21:40.3519422Z,2020,41,11,32,19,0,5to,0,0,22,0,0,30,9,0,41,0,0,0
13391,6528,2020-11-18T16:21:40.3529422Z,2020,38,11,30,26,0,6to,0,2,12,0,0,27,8,0,38,1,0,0
13391,6529,2020-11-18T16:21:40.3529422Z,2020,41,13,34,21,0,7mo,1,1,20,0,0,28,7,0,40,0,0,0
13391,6530,2020-11-18T16:21:40.3529422Z,2020,49,6,34,22,0,8vo,0,1,27,0,0,43,15,0,49,0,0,0
13391,6531,2020-11-18T16:21:40.3529422Z,2020,39,5,33,14,0,K,2,0,25,0,0,34,6,0,37,0,0,0
70409,10984,2020-11-18T16:22:07.2238586Z,2020,58,12,46,32,0,1ro,0,1,26,0,0,46,12,0,58,0,0,0
70409,10985,2020-11-18T16:22:07.2238586Z,2020,51,19,36,21,0,2do,1,2,30,0,0,32,15,0,50,0,0,0
70409,10986,2020-11-18T16:22:07.2238586Z,2020,41,11,29,19,0,3ro,1,0,22,0,0,30,12,0,40,0,0,0
70409,10987,2020-11-18T16:22:07.224859Z,2020,63,24,43,29,0,4to,1,0,34,0,0,39,20,0,62,0,0,0
70409,10988,2020-11-18T16:22:07.224859Z,2020,48,20,38,22,0,5to,1,0,26,0,0,28,10,0,47,0,0,0
70409,10989,2020-11-18T16:22:07.224859Z,2020,11,6,10,5,0,6to,0,0,6,0,0,5,1,0,11,0,0,0
70409,10990,2020-11-18T16:22:07.224859Z,2020,21,6,19,8,0,K,0,0,13,0,0,15,2,0,21,0,0,0
70409,10991,2020-11-18T16:22:07.224859Z,2020,43,6,35,30,0,PK,0,0,13,0,0,37,8,0,42,0,0,1
70409,35005,2021-06-24T13:18:43.6847806Z,2021,34,9,25,18,0,1ro,1,0,16,0,0,25,9,0,33,0,0,0
70409,35006,2021-06-24T13:18:43.6847806Z,2021,61,14,51,31,0,2do,0,0,30,0,0,47,10,0,61,0,0,0
70409,35007,2021-06-24T13:18:43.6857807Z,2021,47,21,38,19,0,3ro,1,0,28,0,0,26,9,0,46,0,0,0
70409,35008,2021-06-24T13:18:43.6857807Z,2021,37,11,31,18,0,4to,1,0,19,0,0,26,6,0,36,0,0,0
70409,35009,2021-06-24T13:18:43.6857807Z,2021,59,22,46,27,0,5to,1,0,32,0,0,37,13,0,58,0,0,0
70409,35010,2021-06-24T13:18:43.6857807Z,2021,9,3,7,3,0,6to,0,0,6,0,0,6,2,0,9,0,0,0
70409,35011,2021-06-24T13:18:43.6857807Z,2021,16,2,13,5,0,K,0,0,11,0,0,14,3,0,15,0,0,1
70409,35012,2021-06-24T13:18:43.6867821Z,2021,51,5,40,34,0,PK,1,0,17,0,0,46,11,0,48,0,0,2
70409,4976,2020-11-18T16:21:13.025719Z,2019,57,22,42,27,0,1ro,0,1,30,0,0,35,15,0,57,0,0,0
70409,4977,2020-11-18T16:21:13.0267194Z,2019,52,14,36,23,0,2do,1,0,29,0,0,38,16,0,51,0,0,0
70409,4978,2020-11-18T16:21:13.0267194Z,2019,67,24,49,29,0,3ro,1,0,38,0,0,43,18,0,66,0,0,0
70409,4979,2020-11-18T16:21:13.0267194Z,2019,52,21,39,24,0,4to,1,0,28,0,0,31,13,0,51,0,0,0
70409,4980,2020-11-18T16:21:13.0267194Z,2019,48,17,36,21,0,5to,0,0,27,0,0,31,12,0,48,0,0,0
70409,4981,2020-11-18T16:21:13.0277203Z,2019,47,15,41,27,0,K,0,1,20,0,0,32,6,0,47,0,0,0
70409,4982,2020-11-18T16:21:13.0277203Z,2019,50,5,29,32,0,PK,1,0,18,0,0,45,21,0,49,0,0,0
33274,2150,2020-11-18T16:20:54.5984297Z,2019,50,10,38,26,0,1ro,2,0,24,0,0,40,12,0,48,0,0,0
33274,2151,2020-11-18T16:20:54.5984297Z,2019,60,15,48,25,0,2do,2,0,35,0,0,45,12,0,58,0,0,0
33274,2152,2020-11-18T16:20:54.5994297Z,2019,57,8,45,41,0,3ro,1,0,16,0,0,49,12,0,56,0,0,0
33274,2153,2020-11-18T16:20:54.5994297Z,2019,69,13,57,38,0,4to,0,0,31,0,0,56,12,0,69,0,0,0
33274,2154,2020-11-18T16:20:54.5994297Z,2019,58,9,48,27,0,5to,1,0,31,0,1,49,10,0,57,1,0,0
33274,2155,2020-11-18T16:20:54.6004302Z,2019,2,0,1,1,0,6to,0,0,1,0,0,2,1,0,2,0,0,0
33274,2156,2020-11-18T16:20:54.6004302Z,2019,64,8,55,33,0,K,3,0,31,0,0,56,9,0,61,0,0,0
33274,32157,2021-06-24T13:18:20.909443Z,2021,64,13,61,38,0,1ro,1,1,26,0,0,51,3,0,63,0,0,0
33274,32158,2021-06-24T13:18:20.909443Z,2021,61,12,54,30,0,2do,3,2,31,0,0,49,7,0,58,0,0,0
33274,32159,2021-06-24T13:18:20.9104434Z,2021,47,12,38,28,0,3ro,2,1,19,0,0,35,9,0,44,0,0,1
33274,32160,2021-06-24T13:18:20.9104434Z,2021,56,15,44,24,0,4to,1,2,32,0,0,41,12,0,55,0,0,0
33274,32161,2021-06-24T13:18:20.9104434Z,2021,62,6,54,43,0,5to,0,0,19,0,0,56,8,0,62,0,0,0
33274,32162,2021-06-24T13:18:20.9104434Z,2021,50,7,42,26,0,K,0,0,24,0,0,43,8,0,50,0,0,0
33274,8163,2020-11-18T16:21:50.2305295Z,2020,55,7,49,28,0,1ro,2,0,27,0,0,48,6,0,53,0,0,0
33274,8164,2020-11-18T16:21:50.2305295Z,2020,42,10,33,23,0,2do,2,0,19,0,0,32,9,0,39,0,0,1
33274,8165,2020-11-18T16:21:50.2305295Z,2020,58,11,43,24,0,3ro,1,0,34,0,0,47,15,0,57,0,0,0
33274,8166,2020-11-18T16:21:50.2315295Z,2020,58,7,47,42,0,4to,0,0,16,0,0,51,11,0,58,0,0,0
33274,8167,2020-11-18T16:21:50.2315295Z,2020,72,14,59,38,0,5to,0,0,34,0,0,58,13,0,72,0,0,0
33274,8168,2020-11-18T16:21:50.2315295Z,2020,60,12,52,35,0,K,2,0,25,0,0,48,8,0,57,0,0,1
67785,10797,2020-11-18T16:22:06.0410705Z,2020,50,5,50,24,0,1ro,2,2,26,0,0,45,0,0,48,0,0,0
67785,10798,2020-11-18T16:22:06.0410705Z,2020,37,8,37,15,0,2do,1,4,22,0,0,29,0,0,34,0,0,2
67785,10799,2020-11-18T16:22:06.0410705Z,2020,33,11,32,16,0,3ro,2,0,17,0,0,22,1,0,31,0,0,0
67785,10800,2020-11-18T16:22:06.0420732Z,2020,55,14,53,20,0,4to,0,2,35,0,0,41,2,0,55,0,0,0
67785,10801,2020-11-18T16:22:06.5203909Z,2020,57,14,56,27,0,5to,4,0,30,0,0,43,1,0,53,0,0,0
67785,10802,2020-11-18T16:22:06.5203909Z,2020,25,9,22,12,0,K,1,1,13,0,0,16,3,0,24,0,0,0
67785,10803,2020-11-18T16:22:06.5213918Z,2020,2,2,2,1,0,Sin Grado,0,0,1,0,0,0,0,0,2,0,0,0
67785,34818,2021-06-24T13:18:42.2907804Z,2021,26,8,25,13,0,1ro,1,1,13,0,0,18,1,0,25,0,0,0
67785,34819,2021-06-24T13:18:42.2907804Z,2021,47,4,43,24,0,2do,1,1,23,0,0,43,4,0,46,0,0,0
67785,34820,2021-06-24T13:18:42.2907804Z,2021,37,11,35,15,0,3ro,1,4,22,0,0,26,2,0,34,0,0,2
67785,34821,2021-06-24T13:18:42.2907804Z,2021,37,12,35,20,0,4to,2,0,17,0,0,25,2,1,34,0,0,0
67785,34822,2021-06-24T13:18:42.2917813Z,2021,55,16,54,20,0,5to,0,1,35,0,0,39,1,0,55,0,0,0
67785,34823,2021-06-24T13:18:42.2917813Z,2021,26,6,15,12,0,K,1,0,14,0,0,20,11,1,23,0,0,1
67785,34824,2021-06-24T13:18:42.2917813Z,2021,3,3,3,1,0,Sin Grado,0,0,2,0,0,0,0,0,3,0,0,0
67785,4789,2020-11-18T16:21:11.9369926Z,2019,42,9,40,22,1,1ro,1,1,20,0,0,33,2,0,40,0,0,1
67785,4790,2020-11-18T16:21:11.9369926Z,2019,39,12,38,20,0,2do,2,0,19,0,0,27,1,0,37,0,0,0
67785,4791,2020-11-18T16:21:11.9369926Z,2019,58,15,56,22,0,3ro,1,0,36,0,0,43,2,0,57,0,0,0
67785,4792,2020-11-18T16:21:11.9369926Z,2019,58,14,57,27,0,4to,4,0,31,0,0,44,1,0,54,0,0,0
67785,4793,2020-11-18T16:21:11.9369926Z,2019,67,28,65,36,0,5to,1,0,31,0,0,39,2,0,65,0,0,1
67785,4794,2020-11-18T16:21:11.9379926Z,2019,2,0,2,1,0,7mo,0,0,1,0,0,2,0,0,2,0,0,0
67785,4795,2020-11-18T16:21:11.9379926Z,2019,27,6,27,14,0,K,0,0,13,0,0,21,0,0,27,0,0,0
67785,4796,2020-11-18T16:21:11.9379926Z,2019,4,2,4,2,0,Sin Grado,0,0,2,0,0,2,0,0,4,0,0,0
67934,10804,2020-11-18T16:22:06.5233927Z,2020,84,35,77,42,0,6to,4,2,42,0,0,49,7,0,79,0,0,1
67934,10805,2020-11-18T16:22:06.5233927Z,2020,103,28,90,50,0,7mo,1,0,53,0,0,75,13,0,102,0,0,0
67934,10806,2020-11-18T16:22:06.5233927Z,2020,82,28,73,48,0,8vo,6,0,34,0,0,54,9,0,76,0,0,0
67934,10807,2020-11-18T16:22:06.5243941Z,2020,33,14,16,11,0,Sin Grado,0,0,22,0,0,19,17,0,33,0,0,0
67934,34825,2021-06-24T13:18:42.2887794Z,2021,84,23,80,40,0,6to,5,0,44,0,0,61,4,0,79,0,0,0
67934,34826,2021-06-24T13:18:42.2887794Z,2021,98,42,93,47,0,7mo,4,0,51,0,0,56,5,0,93,0,0,1
67934,34827,2021-06-24T13:18:42.2887794Z,2021,87,28,83,40,0,8vo,2,0,47,0,0,59,4,0,85,0,0,0
67934,34828,2021-06-24T13:18:42.2897799Z,2021,8,8,8,3,0,Sin Grado,0,0,5,0,0,0,0,0,8,0,0,0
67934,4797,2020-11-18T16:21:11.9369926Z,2019,119,31,107,60,0,6to,4,1,59,0,0,88,12,0,115,0,1,0
67934,4798,2020-11-18T16:21:11.9369926Z,2019,97,32,86,54,0,7mo,7,0,43,0,0,65,11,0,90,0,0,0
67934,4799,2020-11-18T16:21:11.9369926Z,2019,106,22,93,52,0,8vo,3,0,54,0,0,84,13,1,101,0,1,1
67934,4800,2020-11-18T16:21:11.9369926Z,2019,55,19,21,14,0,Sin Grado,0,0,41,0,0,36,34,0,55,0,0,0
67942,10808,2020-11-18T16:22:06.5283967Z,2020,90,22,78,44,0,10mo,4,1,46,0,0,68,12,1,85,0,0,0
67942,10809,2020-11-18T16:22:06.5283967Z,2020,76,19,67,41,0,11mo,0,0,35,0,0,57,9,0,76,0,0,0
67942,10810,2020-11-18T16:22:06.5283967Z,2020,82,14,71,45,0,12mo,1,0,37,0,0,68,11,0,81,0,0,0
67942,10811,2020-11-18T16:22:06.5283967Z,2020,72,16,65,30,0,9no,2,0,42,0,0,56,7,0,70,0,0,0
67942,34829,2021-06-24T13:18:42.2927818Z,2021,79,17,73,36,0,10mo,3,0,43,0,0,62,6,0,76,0,0,0
67942,34830,2021-06-24T13:18:42.2937828Z,2021,47,15,40,21,0,11mo,2,0,26,0,0,32,7,0,45,0,0,0
67942,34831,2021-06-24T13:18:42.2937828Z,2021,63,17,55,35,0,12mo,1,0,28,0,0,46,8,0,62,0,0,0
67942,34832,2021-06-24T13:18:42.2937828Z,2021,59,17,53,34,0,9no,4,0,25,0,0,42,6,0,55,0,0,0
67942,4801,2020-11-18T16:21:12.3732836Z,2019,75,22,68,41,0,10mo,0,1,34,0,0,53,7,0,75,0,0,0
67942,4802,2020-11-18T16:21:12.3732836Z,2019,75,14,68,40,0,11mo,1,2,35,0,0,61,7,0,74,0,0,0
67942,4803,2020-11-18T16:21:12.3742849Z,2019,86,0,70,44,0,12mo,5,4,42,0,0,86,16,0,81,0,0,0
67942,4804,2020-11-18T16:21:12.3742849Z,2019,81,19,72,40,0,9no,3,7,41,0,0,62,9,1,77,0,0,0
56069,33871,2021-06-24T13:18:35.7620994Z,2021,68,30,66,29,0,10mo,0,0,39,0,0,38,2,0,68,0,0,0
56069,33872,2021-06-24T13:18:35.7620994Z,2021,82,26,73,35,0,11mo,0,1,47,0,0,56,9,1,81,2,0,0
56069,33873,2021-06-24T13:18:35.7631003Z,2021,40,16,36,20,0,12mo,0,0,20,0,0,24,4,0,40,0,0,0
56069,33874,2021-06-24T13:18:35.7631003Z,2021,71,29,58,36,0,9no,0,1,35,0,0,42,13,0,71,0,0,0
56069,3848,2020-11-18T16:21:05.5737475Z,2019,75,32,67,28,0,10mo,1,0,47,0,0,43,8,0,74,0,0,0
56069,3849,2020-11-18T16:21:05.5737475Z,2019,63,19,51,27,0,11mo,1,1,36,0,0,44,12,0,62,1,0,0
56069,3850,2020-11-18T16:21:05.5737475Z,2019,92,0,78,43,0,12mo,1,0,49,0,0,92,14,0,91,0,0,0
56069,3851,2020-11-18T16:21:05.5747488Z,2019,93,32,80,45,0,9no,0,1,48,0,0,61,13,1,92,2,1,0
56069,9865,2020-11-18T16:22:00.5273941Z,2020,91,34,73,41,0,10mo,0,6,50,0,0,57,18,1,90,2,1,0
56069,9866,2020-11-18T16:22:00.5273941Z,2020,71,32,61,29,0,11mo,1,1,42,0,0,39,10,0,70,0,0,0
56069,9867,2020-11-18T16:22:00.5273941Z,2020,44,20,36,18,0,12mo,0,3,26,0,0,24,8,0,44,2,0,0
56069,9868,2020-11-18T16:22:00.5273941Z,2020,69,34,61,30,0,9no,0,1,39,0,0,35,8,0,69,0,0,0
75630,11556,2020-11-18T16:22:11.3185901Z,2020,26,8,20,10,0,1ro,0,0,16,0,0,18,6,0,26,0,0,0
75630,11557,2020-11-18T16:22:11.319591Z,2020,19,8,19,13,0,2do,0,0,6,0,0,11,0,0,19,0,0,0
75630,11558,2020-11-18T16:22:11.319591Z,2020,29,10,23,17,0,3ro,0,0,12,0,0,19,6,0,29,0,0,0
75630,11559,2020-11-18T16:22:11.319591Z,2020,16,7,15,6,0,4to,1,0,10,0,0,9,1,0,15,0,1,0
75630,11560,2020-11-18T16:22:11.319591Z,2020,31,10,26,14,0,5to,1,0,17,0,0,21,5,0,30,0,0,0
75630,11561,2020-11-18T16:22:11.319591Z,2020,18,3,14,13,0,K,1,0,5,0,0,15,4,0,17,0,0,0
75630,11562,2020-11-18T16:22:11.3205919Z,2020,26,26,22,14,0,Sin Grado,1,1,12,0,0,0,4,0,25,0,0,0
75630,35579,2021-06-24T13:18:46.6008716Z,2021,23,5,19,13,0,1ro,1,0,10,0,0,18,4,0,22,0,0,0
75630,35580,2021-06-24T13:18:46.6008716Z,2021,24,8,19,11,0,2do,0,0,13,0,0,16,5,0,24,0,0,0
75630,35581,2021-06-24T13:18:46.6008716Z,2021,20,9,17,13,0,3ro,0,0,7,0,0,11,3,0,20,0,0,0
75630,35582,2021-06-24T13:18:46.6018721Z,2021,31,10,25,19,0,4to,0,0,12,0,0,21,6,0,31,0,0,0
75630,35583,2021-06-24T13:18:46.6018721Z,2021,25,11,23,9,0,5to,1,0,16,0,0,14,2,0,23,0,1,1
75630,35584,2021-06-24T13:18:46.6018721Z,2021,16,3,9,7,0,K,1,0,9,0,0,13,7,0,15,0,0,0
75630,35585,2021-06-24T13:18:46.6018721Z,2021,19,18,17,11,0,Sin Grado,1,1,8,0,0,1,2,0,18,0,0,0
75630,5547,2020-11-18T16:21:16.1898277Z,2019,24,7,22,12,0,1ro,0,1,12,0,0,17,2,0,24,0,0,0
75630,5548,2020-11-18T16:21:16.1898277Z,2019,33,14,26,22,0,2do,0,1,11,0,0,19,7,0,33,0,0,0
75630,5549,2020-11-18T16:21:16.1898277Z,2019,20,8,18,6,0,3ro,2,1,14,0,0,12,2,0,18,0,2,0
75630,5550,2020-11-18T16:21:16.1908281Z,2019,32,11,25,14,0,4to,1,1,18,0,0,21,7,0,31,0,0,0
75630,5551,2020-11-18T16:21:16.1908281Z,2019,36,11,28,21,0,5to,1,0,15,0,0,25,8,0,34,2,1,1
75630,5552,2020-11-18T16:21:16.1908281Z,2019,32,12,28,14,0,6to,0,1,18,0,0,20,4,0,32,0,0,0
75630,5553,2020-11-18T16:21:16.1918286Z,2019,28,8,22,14,0,K,0,1,14,0,0,20,6,0,28,0,0,0
75630,5554,2020-11-18T16:21:16.1918286Z,2019,25,25,21,10,0,Sin Grado,1,2,15,0,0,0,4,0,24,0,0,0
45393,3003,2020-11-18T16:21:00.322247Z,2019,50,27,37,24,0,1ro,0,0,26,0,0,23,13,0,50,0,0,0
45393,3004,2020-11-18T16:21:00.322247Z,2019,48,15,36,29,0,2do,0,0,19,0,0,33,12,0,48,0,0,0
45393,3005,2020-11-18T16:21:00.3232466Z,2019,69,26,46,27,0,3ro,2,0,42,0,0,43,23,0,66,0,0,1
45393,3006,2020-11-18T16:21:00.3232466Z,2019,71,29,60,36,0,4to,0,0,35,0,0,42,11,0,71,0,0,0
45393,3007,2020-11-18T16:21:00.3232466Z,2019,70,19,52,32,0,5to,1,0,38,0,0,51,18,0,69,0,0,0
45393,3008,2020-11-18T16:21:00.3232466Z,2019,122,48,100,59,0,6to,0,0,63,0,0,74,22,0,122,0,0,0
45393,3009,2020-11-18T16:21:00.3242466Z,2019,105,33,89,49,0,7mo,3,0,56,0,0,72,16,0,102,0,1,0
45393,3010,2020-11-18T16:21:00.3242466Z,2019,108,39,82,44,0,8vo,0,0,64,0,0,69,26,0,108,0,1,0
45393,3011,2020-11-18T16:21:00.3242466Z,2019,43,7,5,23,0,K,0,0,20,0,0,36,38,0,43,0,0,0
45393,3012,2020-11-18T16:21:00.3242466Z,2019,33,24,26,11,0,Sin Grado,0,0,22,0,0,9,7,0,33,0,1,0
45393,33012,2021-06-24T13:18:29.8048275Z,2021,29,3,27,15,0,1ro,0,2,14,0,0,26,2,0,29,0,0,0
45393,33013,2021-06-24T13:18:29.8058284Z,2021,38,10,29,17,0,2do,0,2,21,0,0,28,9,0,38,0,0,0
45393,33014,2021-06-24T13:18:29.8058284Z,2021,48,24,40,28,0,3ro,0,4,20,0,0,24,8,0,48,0,0,0
45393,33015,2021-06-24T13:18:29.8058284Z,2021,50,16,40,29,0,4to,0,5,21,0,0,34,10,0,50,0,0,0
45393,33016,2021-06-24T13:18:29.8058284Z,2021,72,28,53,31,0,5to,2,0,41,0,0,44,19,0,69,0,0,1
45393,33017,2021-06-24T13:18:29.8068289Z,2021,93,38,81,45,0,6to,0,5,48,0,0,55,12,0,93,0,0,0
45393,33018,2021-06-24T13:18:29.8068289Z,2021,106,35,87,48,0,7mo,1,3,58,0,0,71,19,0,105,0,0,0
45393,33019,2021-06-24T13:18:29.8068289Z,2021,107,42,86,53,0,8vo,0,1,54,0,0,65,21,0,107,0,0,0
45393,33020,2021-06-24T13:18:29.8068289Z,2021,22,4,19,15,0,K,0,0,7,0,0,18,3,0,22,0,0,0
45393,33021,2021-06-24T13:18:29.8068289Z,2021,9,9,8,4,0,Sin Grado,0,0,5,0,0,0,1,0,9,0,0,0
45393,9017,2020-11-18T16:21:55.4249925Z,2020,42,9,31,20,0,1ro,0,0,22,0,0,33,11,0,41,0,0,1
45393,9018,2020-11-18T16:21:55.4259934Z,2020,47,21,39,25,0,2do,0,0,22,0,0,26,8,0,47,0,0,0
45393,9019,2020-11-18T16:21:55.4259934Z,2020,47,15,37,27,0,3ro,0,0,20,0,0,32,10,0,47,0,0,0
45393,9020,2020-11-18T16:21:55.4259934Z,2020,72,28,50,28,0,4to,2,0,44,0,0,44,22,0,69,0,0,1
45393,9021,2020-11-18T16:21:55.4259934Z,2020,67,27,55,32,0,5to,0,0,35,0,0,40,12,0,67,0,0,0
45393,9022,2020-11-18T16:21:55.4259934Z,2020,113,34,86,53,0,6to,1,0,60,0,0,79,27,0,112,0,0,0
45393,9023,2020-11-18T16:21:55.4269943Z,2020,107,43,90,54,0,7mo,0,0,53,0,0,64,17,0,107,0,0,0
45393,9024,2020-11-18T16:21:55.4269943Z,2020,91,24,75,42,0,8vo,2,0,49,0,0,67,16,0,89,0,0,0
45393,9025,2020-11-18T16:21:55.4279952Z,2020,27,4,22,14,0,K,0,0,13,0,0,23,5,0,27,0,0,0
45393,9026,2020-11-18T16:21:55.4279952Z,2020,28,27,22,9,0,Sin Grado,0,0,19,0,0,1,6,0,28,0,0,0
27565,1638,2020-11-18T16:20:48.2521995Z,2019,84,19,45,40,0,10mo,2,1,44,0,0,65,39,0,82,0,0,0
27565,1639,2020-11-18T16:20:48.2521995Z,2019,86,18,49,44,0,11mo,0,0,42,0,0,68,37,0,85,0,1,1
27565,1640,2020-11-18T16:20:48.2521995Z,2019,143,0,76,75,0,12mo,0,0,68,0,0,143,67,0,143,0,0,0
27565,1641,2020-11-18T16:20:48.2531999Z,2019,67,14,41,29,0,9no,0,0,38,0,0,53,26,0,67,0,1,0
27565,31641,2021-06-24T13:18:16.1110024Z,2021,104,28,70,50,0,10mo,1,0,54,0,0,76,34,0,103,0,0,0
27565,31642,2021-06-24T13:18:16.1120038Z,2021,72,18,54,35,0,11mo,0,0,37,0,0,54,18,0,72,0,1,0
27565,31643,2021-06-24T13:18:16.1120038Z,2021,79,13,49,40,0,12mo,0,3,39,0,0,66,30,0,79,0,0,0
27565,31644,2021-06-24T13:18:16.1120038Z,2021,56,20,36,27,0,9no,0,2,29,0,0,36,20,0,56,0,0,0
27565,7644,2020-11-18T16:21:47.1874966Z,2020,86,24,57,40,0,10mo,0,0,46,0,0,62,29,0,85,0,1,1
27565,7645,2020-11-18T16:21:47.188497Z,2020,94,22,53,46,0,11mo,2,1,48,0,0,72,41,0,92,0,0,0
27565,7646,2020-11-18T16:21:47.188497Z,2020,83,15,44,45,0,12mo,0,2,38,0,0,68,39,0,83,0,1,0
27565,7647,2020-11-18T16:21:47.188497Z,2020,108,29,70,53,0,9no,1,2,55,0,0,79,38,0,107,0,0,0
30429,1806,2020-11-18T16:20:52.4690126Z,2019,29,8,23,16,0,1ro,0,0,13,0,0,21,6,0,29,1,0,0
30429,1807,2020-11-18T16:20:52.4700135Z,2019,28,7,23,9,0,2do,0,0,19,0,0,21,5,0,28,0,0,0
30429,1808,2020-11-18T16:20:52.4700135Z,2019,23,11,20,11,0,3ro,0,0,12,0,0,12,3,0,23,0,0,0
30429,1809,2020-11-18T16:20:52.4700135Z,2019,36,14,32,19,0,4to,0,0,17,0,0,22,4,0,36,1,0,0
30429,1810,2020-11-18T16:20:52.4710135Z,2019,21,3,15,10,0,5to,0,0,11,0,0,18,6,0,21,0,0,0
30429,1811,2020-11-18T16:20:52.4710135Z,2019,24,6,22,19,0,K,0,0,5,0,0,18,2,0,24,0,0,0
30429,31809,2021-06-24T13:18:17.7501774Z,2021,24,6,23,7,0,1ro,0,0,17,0,0,18,1,0,24,0,0,0
30429,31810,2021-06-24T13:18:17.7501774Z,2021,21,4,20,17,0,2do,0,0,4,0,0,17,1,0,21,0,0,0
30429,31811,2021-06-24T13:18:17.7501774Z,2021,17,5,13,9,0,3ro,0,0,8,0,0,12,4,0,17,0,0,0
30429,31812,2021-06-24T13:18:17.7501774Z,2021,20,8,18,7,0,4to,1,0,13,0,0,12,2,0,19,0,0,0
30429,31813,2021-06-24T13:18:17.7511787Z,2021,20,7,18,10,0,5to,0,0,10,0,0,13,2,0,20,0,0,0
30429,31814,2021-06-24T13:18:17.7511787Z,2021,15,2,12,6,0,K,0,0,9,0,0,13,3,0,14,0,0,1
30429,7812,2020-11-18T16:21:48.4633482Z,2020,26,5,25,20,0,1ro,0,0,6,0,0,21,1,0,26,0,0,0
30429,7813,2020-11-18T16:21:48.4643486Z,2020,22,6,18,13,0,2do,0,0,9,0,0,16,4,0,22,1,0,0
30429,7814,2020-11-18T16:21:48.4643486Z,2020,28,8,23,10,0,3ro,1,0,18,0,0,20,5,0,27,0,0,0
30429,7815,2020-11-18T16:21:48.4643486Z,2020,22,8,19,12,0,4to,0,0,10,0,0,14,3,0,22,0,0,0
30429,7816,2020-11-18T16:21:48.4643486Z,2020,34,14,29,18,0,5to,0,0,16,0,0,20,5,0,34,1,0,0
30429,7817,2020-11-18T16:21:48.4653499Z,2020,26,5,24,13,0,K,0,0,13,0,0,21,2,0,26,0,0,0
41632,2683,2020-11-18T16:20:58.0807527Z,2019,14,7,12,8,0,1ro,0,0,6,0,0,7,2,0,14,0,0,0
41632,2684,2020-11-18T16:20:58.0807527Z,2019,12,6,10,4,0,2do,0,0,8,0,0,6,2,0,12,0,0,0
41632,2685,2020-11-18T16:20:58.0807527Z,2019,12,6,12,4,0,3ro,0,0,8,0,0,6,0,0,12,0,0,0
41632,2686,2020-11-18T16:20:58.0817536Z,2019,15,4,14,8,0,4to,0,0,7,0,0,11,1,0,15,0,0,0
41632,2687,2020-11-18T16:20:58.0817536Z,2019,8,3,6,3,0,5to,0,0,5,0,0,5,2,0,8,0,0,0
41632,2688,2020-11-18T16:20:58.0817536Z,2019,12,5,12,3,0,6to,0,0,9,0,0,7,0,0,12,0,0,0
41632,2689,2020-11-18T16:20:58.0827536Z,2019,11,4,11,7,0,K,0,0,4,0,0,7,0,0,11,0,0,0
41632,32690,2021-06-24T13:18:26.2963121Z,2021,13,2,13,7,0,1ro,0,0,6,0,0,11,0,0,13,0,0,0
41632,32691,2021-06-24T13:18:26.2973122Z,2021,16,7,16,12,0,2do,0,0,4,0,0,9,0,0,16,0,0,0
41632,32692,2021-06-24T13:18:26.2973122Z,2021,11,4,10,7,0,3ro,0,0,4,0,0,7,1,0,11,0,0,0
41632,32693,2021-06-24T13:18:26.2973122Z,2021,10,4,8,4,0,4to,0,0,6,0,0,6,2,0,10,0,0,0
41632,32694,2021-06-24T13:18:26.2973122Z,2021,13,6,13,5,0,5to,0,0,8,0,0,7,0,0,13,0,0,0
41632,32695,2021-06-24T13:18:26.2973122Z,2021,12,4,10,7,0,6to,0,0,5,0,0,8,2,0,12,0,0,0
41632,32696,2021-06-24T13:18:26.2983131Z,2021,12,3,11,3,0,K,0,0,9,0,0,9,1,0,12,0,0,0
41632,8694,2020-11-18T16:21:53.0734208Z,2020,16,7,16,11,0,1ro,0,0,5,0,0,9,0,0,16,0,0,0
41632,8695,2020-11-18T16:21:53.0734208Z,2020,12,4,10,7,0,2do,0,0,5,0,0,8,2,0,12,0,0,0
41632,8696,2020-11-18T16:21:53.0734208Z,2020,12,5,10,5,0,3ro,0,0,7,0,0,7,2,0,12,0,0,0
41632,8697,2020-11-18T16:21:53.074423Z,2020,12,6,12,4,0,4to,0,0,8,0,0,6,0,0,12,0,0,0
41632,8698,2020-11-18T16:21:53.074423Z,2020,14,4,13,8,0,5to,0,0,6,0,0,10,1,0,14,0,0,0
41632,8699,2020-11-18T16:21:53.074423Z,2020,8,3,6,2,0,6to,0,0,6,0,0,5,2,0,8,0,0,0
41632,8700,2020-11-18T16:21:53.074423Z,2020,15,4,14,6,0,K,0,0,9,0,0,11,1,0,15,0,0,0
70078,10893,2020-11-18T16:22:06.5544141Z,2020,75,14,61,42,0,10mo,1,0,33,0,0,61,14,0,74,0,0,0
70078,10894,2020-11-18T16:22:06.5544141Z,2020,65,15,48,37,0,11mo,1,0,28,0,0,50,17,0,63,0,0,1
70078,10895,2020-11-18T16:22:06.5544141Z,2020,75,10,59,42,0,12mo,2,0,33,0,0,65,16,0,73,1,0,0
70078,10896,2020-11-18T16:22:06.5544141Z,2020,61,15,44,38,0,6to,2,0,23,0,0,46,17,0,59,0,0,0
70078,10897,2020-11-18T16:22:06.5544141Z,2020,72,24,57,33,0,7mo,2,0,39,0,0,48,15,0,70,2,0,0
70078,10898,2020-11-18T16:22:06.5554154Z,2020,80,17,60,42,0,8vo,1,0,38,0,0,63,20,0,79,1,0,0
70078,10899,2020-11-18T16:22:06.5554154Z,2020,99,26,71,61,0,9no,2,0,38,0,0,73,28,0,96,0,0,1
70078,10900,2020-11-18T16:22:06.5554154Z,2020,17,17,14,7,0,Sin Grado,0,0,10,0,0,0,3,0,17,0,1,0
70078,34915,2021-06-24T13:18:43.3195185Z,2021,96,25,71,60,0,10mo,2,0,36,0,0,71,25,0,93,0,0,1
70078,34916,2021-06-24T13:18:43.3195185Z,2021,75,14,55,42,0,11mo,0,0,33,0,0,61,20,0,75,0,0,0
70078,34917,2021-06-24T13:18:43.3205194Z,2021,63,14,40,36,0,12mo,1,0,27,0,0,49,23,0,61,0,0,1
70078,34918,2021-06-24T13:18:43.3205194Z,2021,72,19,49,36,0,6to,0,0,36,0,0,53,23,0,72,1,0,0
70078,34919,2021-06-24T13:18:43.3205194Z,2021,63,14,48,40,0,7mo,2,0,23,0,0,49,15,0,61,0,1,0
70078,34920,2021-06-24T13:18:43.3205194Z,2021,73,23,56,33,0,8vo,2,0,40,0,0,50,17,0,71,2,0,0
70078,34921,2021-06-24T13:18:43.3215204Z,2021,84,19,53,45,0,9no,1,0,39,0,0,65,31,0,83,1,0,0
70078,34922,2021-06-24T13:18:43.3215204Z,2021,19,19,16,7,0,Sin Grado,0,0,12,0,0,0,3,0,19,0,1,0
70078,4885,2020-11-18T16:21:12.4053067Z,2019,69,16,47,39,0,10mo,1,0,30,0,0,53,22,0,67,0,0,1
70078,4886,2020-11-18T16:21:12.4063059Z,2019,78,10,52,45,0,11mo,2,0,33,0,0,68,26,0,76,0,0,0
70078,4887,2020-11-18T16:21:12.4063059Z,2019,69,0,56,35,0,12mo,0,0,34,0,0,69,13,1,68,0,0,0
70078,4888,2020-11-18T16:21:12.4063059Z,2019,79,25,57,36,0,6to,2,0,43,0,0,54,22,0,77,0,0,0
70078,4889,2020-11-18T16:21:12.4063059Z,2019,97,23,68,49,0,7mo,1,0,48,0,0,74,29,0,96,0,0,0
70078,4890,2020-11-18T16:21:12.4073063Z,2019,60,15,42,38,0,8vo,2,0,22,0,0,45,18,0,57,0,0,1
70078,4891,2020-11-18T16:21:12.4073063Z,2019,86,19,64,50,0,9no,1,0,36,0,0,67,22,0,85,0,0,0
70078,4892,2020-11-18T16:21:12.4073063Z,2019,22,22,19,9,0,Sin Grado,0,0,13,0,0,0,3,0,22,0,1,0
33936,2194,2020-11-18T16:20:54.6124387Z,2019,90,27,52,41,0,1ro,4,0,49,0,0,63,38,1,81,0,1,4
33936,2195,2020-11-18T16:20:54.6124387Z,2019,80,30,68,39,0,2do,2,0,41,0,0,50,12,0,77,0,0,1
33936,2196,2020-11-18T16:20:54.6124387Z,2019,72,21,55,33,0,3ro,4,0,39,0,0,51,17,0,66,0,0,2
33936,2197,2020-11-18T16:20:54.6124387Z,2019,59,15,44,29,0,4to,1,0,30,0,0,44,15,0,57,0,0,1
33936,2198,2020-11-18T16:20:54.6134387Z,2019,71,12,59,40,0,5to,0,0,31,0,0,59,12,0,71,0,1,0
33936,2199,2020-11-18T16:20:54.6134387Z,2019,44,11,37,22,0,K,1,0,22,0,0,33,7,0,43,0,0,0
33936,2200,2020-11-18T16:20:54.6134387Z,2019,17,16,11,1,0,Sin Grado,0,0,16,0,0,1,6,0,17,0,0,0
33936,32201,2021-06-24T13:18:21.7430405Z,2021,49,8,46,29,0,1ro,4,1,20,0,0,41,3,0,45,0,0,0
33936,32202,2021-06-24T13:18:21.7430405Z,2021,54,19,50,28,0,2do,0,0,26,0,0,35,4,0,54,0,0,0
33936,32203,2021-06-24T13:18:21.7430405Z,2021,68,22,63,25,0,3ro,3,0,43,0,0,46,5,0,64,0,1,1
33936,32204,2021-06-24T13:18:21.7440419Z,2021,68,16,59,36,0,4to,2,0,32,0,0,52,9,0,64,0,0,2
33936,32205,2021-06-24T13:18:21.7440419Z,2021,55,16,49,28,0,5to,3,0,27,0,0,39,6,0,51,0,0,1
33936,32206,2021-06-24T13:18:21.7440419Z,2021,46,8,40,13,0,K,1,0,33,0,0,38,6,2,43,0,0,0
33936,32207,2021-06-24T13:18:21.7440419Z,2021,6,6,6,1,0,Sin Grado,0,0,5,0,0,0,0,0,6,0,0,0
33936,8206,2020-11-18T16:21:50.6738241Z,2020,56,18,51,27,0,1ro,2,0,29,0,0,38,5,0,54,0,0,0
33936,8207,2020-11-18T16:21:50.674825Z,2020,75,25,67,34,0,2do,4,0,41,0,0,50,8,0,70,0,1,1
33936,8208,2020-11-18T16:21:50.674825Z,2020,67,16,56,34,0,3ro,2,0,33,0,0,51,11,0,63,0,0,2
33936,8209,2020-11-18T16:21:50.674825Z,2020,56,16,46,26,0,4to,3,0,30,0,0,40,10,0,51,0,0,2
33936,8210,2020-11-18T16:21:50.674825Z,2020,47,12,40,23,0,5to,1,0,24,0,0,35,7,0,46,0,0,0
33936,8211,2020-11-18T16:21:50.674825Z,2020,50,7,44,29,0,K,1,0,21,0,0,43,6,0,49,0,0,0
33936,8212,2020-11-18T16:21:50.6758286Z,2020,14,14,13,1,0,Sin Grado,0,0,13,0,0,0,1,0,13,0,0,1
30304,1800,2020-11-18T16:20:52.2498656Z,2019,44,14,36,21,0,1ro,0,0,23,0,0,30,8,0,44,0,0,0
30304,1801,2020-11-18T16:20:52.4660109Z,2019,43,11,36,23,0,2do,0,0,20,0,0,32,7,0,43,0,0,0
30304,1802,2020-11-18T16:20:52.4660109Z,2019,44,13,34,19,0,3ro,0,1,25,0,0,31,10,0,44,0,0,0
30304,1803,2020-11-18T16:20:52.4670113Z,2019,51,15,42,20,0,4to,0,0,31,0,0,36,9,0,51,1,0,0
30304,1804,2020-11-18T16:20:52.4670113Z,2019,52,9,40,25,0,5to,0,0,27,0,0,43,12,0,52,0,0,0
30304,1805,2020-11-18T16:20:52.4670113Z,2019,31,6,28,18,0,K,1,0,13,0,0,25,3,0,30,1,0,0
30304,31803,2021-06-24T13:18:17.7461754Z,2021,43,4,41,29,0,1ro,1,0,14,0,0,39,2,0,42,0,0,0
30304,31804,2021-06-24T13:18:17.7461754Z,2021,48,15,46,24,0,2do,1,0,24,0,0,33,2,0,47,0,0,0
30304,31805,2021-06-24T13:18:17.7461754Z,2021,35,9,34,14,0,3ro,0,0,21,0,0,26,1,0,35,0,0,0
30304,31806,2021-06-24T13:18:17.7471754Z,2021,48,13,44,25,0,4to,0,0,23,0,0,35,4,0,48,0,0,0
30304,31807,2021-06-24T13:18:17.7471754Z,2021,41,9,31,20,0,5to,0,0,21,0,0,32,10,0,41,0,0,0
30304,31808,2021-06-24T13:18:17.7471754Z,2021,47,6,47,23,0,K,0,0,24,0,0,41,0,0,47,0,0,0
30304,7806,2020-11-18T16:21:48.4613464Z,2020,38,14,35,21,0,1ro,1,0,17,0,0,24,3,0,37,1,0,0
30304,7807,2020-11-18T16:21:48.4613464Z,2020,32,8,27,15,0,2do,0,0,17,0,0,24,5,0,32,0,0,0
30304,7808,2020-11-18T16:21:48.4613464Z,2020,43,12,37,25,0,3ro,0,0,18,0,0,31,6,0,43,0,0,0
30304,7809,2020-11-18T16:21:48.4623473Z,2020,44,13,32,21,0,4to,0,0,23,0,0,31,12,0,44,0,0,0
30304,7810,2020-11-18T16:21:48.4623473Z,2020,43,13,37,17,0,5to,0,0,26,0,0,30,6,0,43,1,0,0
30304,7811,2020-11-18T16:21:48.4623473Z,2020,42,5,37,25,0,K,0,0,17,0,0,37,5,0,42,0,0,0
52183,33545,2021-06-24T13:18:33.3913997Z,2021,21,8,19,12,0,1ro,1,0,9,0,0,13,2,0,20,0,0,0
52183,33546,2021-06-24T13:18:33.3923997Z,2021,22,7,21,11,0,2do,0,0,11,0,0,15,1,0,22,0,0,0
52183,33547,2021-06-24T13:18:33.3923997Z,2021,23,11,19,11,0,3ro,2,0,12,0,0,12,4,0,21,0,0,0
52183,33548,2021-06-24T13:18:33.3934002Z,2021,19,9,15,10,0,4to,0,0,9,0,0,10,4,0,19,0,0,0
52183,33549,2021-06-24T13:18:33.3934002Z,2021,25,7,20,11,0,5to,0,0,14,0,0,18,5,0,25,0,0,0
52183,33550,2021-06-24T13:18:33.3934002Z,2021,16,1,15,8,0,K,0,0,8,0,0,15,1,0,16,0,0,0
52183,3520,2020-11-18T16:21:03.2622105Z,2019,22,13,17,7,0,1ro,1,0,15,0,0,9,5,0,21,0,0,0
52183,3521,2020-11-18T16:21:03.2622105Z,2019,20,8,15,13,0,2do,0,0,7,0,0,12,5,0,20,0,0,0
52183,3522,2020-11-18T16:21:03.2632114Z,2019,22,9,19,9,0,3ro,0,0,13,0,0,13,3,0,22,0,0,0
52183,3523,2020-11-18T16:21:03.2632114Z,2019,25,8,18,10,0,4to,0,0,15,0,0,17,7,0,25,0,0,0
52183,3524,2020-11-18T16:21:03.2632114Z,2019,26,7,20,13,0,5to,0,0,13,0,0,19,6,0,26,0,0,0
52183,3525,2020-11-18T16:21:03.2632114Z,2019,26,10,24,10,0,6to,1,0,16,0,0,16,2,0,24,0,0,1
52183,3526,2020-11-18T16:21:03.2642109Z,2019,19,5,17,9,0,K,0,0,10,0,0,14,2,0,19,0,0,0
52183,9540,2020-11-18T16:21:59.0874324Z,2020,20,6,17,8,0,1ro,0,0,12,0,0,14,3,0,20,0,0,0
52183,9541,2020-11-18T16:21:59.0884333Z,2020,23,12,19,8,0,2do,2,0,15,0,0,11,4,0,21,0,0,0
52183,9542,2020-11-18T16:21:59.0884333Z,2020,21,8,19,13,0,3ro,0,0,8,0,0,13,2,0,21,0,0,0
52183,9543,2020-11-18T16:21:59.0884333Z,2020,19,8,13,8,0,4to,0,0,11,0,0,11,6,0,19,0,0,0
52183,9544,2020-11-18T16:21:59.0884333Z,2020,28,9,23,11,0,5to,0,0,17,0,0,19,5,0,28,0,0,0
52183,9545,2020-11-18T16:21:59.0894333Z,2020,22,4,19,15,0,K,1,0,7,0,0,18,3,0,21,0,0,0
70433,11009,2020-11-18T16:22:07.6091137Z,2020,72,27,60,35,0,1ro,2,0,37,0,0,45,12,0,70,0,0,0
70433,11010,2020-11-18T16:22:07.6091137Z,2020,64,25,57,24,0,2do,0,0,40,0,0,39,7,0,64,0,0,0
70433,11011,2020-11-18T16:22:07.6091137Z,2020,52,23,39,28,0,3ro,2,0,24,0,0,29,13,0,50,0,0,0
70433,11012,2020-11-18T16:22:07.6101146Z,2020,60,27,52,33,0,4to,2,0,27,0,0,33,8,0,58,0,0,0
70433,11013,2020-11-18T16:22:07.6101146Z,2020,58,25,45,24,0,5to,0,0,34,0,0,33,13,0,58,0,0,0
70433,11014,2020-11-18T16:22:07.6101146Z,2020,52,17,41,29,0,K,1,0,23,0,0,35,11,0,51,0,0,0
70433,11015,2020-11-18T16:22:07.6101146Z,2020,23,5,17,11,0,PK,0,0,12,0,0,18,6,0,21,0,0,2
70433,35030,2021-06-24T13:18:43.704795Z,2021,57,24,50,26,0,1ro,1,0,31,0,0,33,7,0,56,0,0,0
70433,35031,2021-06-24T13:18:43.704795Z,2021,66,26,59,36,0,2do,3,0,30,0,0,40,7,0,63,0,1,0
70433,35032,2021-06-24T13:18:43.705795Z,2021,64,24,59,25,0,3ro,0,1,39,0,0,40,5,0,63,0,0,1
70433,35033,2021-06-24T13:18:43.705795Z,2021,46,22,39,20,0,4to,2,0,26,0,0,24,7,0,44,0,0,0
70433,35034,2021-06-24T13:18:43.705795Z,2021,62,29,52,34,0,5to,3,0,28,0,0,33,10,0,59,0,0,0
70433,35035,2021-06-24T13:18:43.705795Z,2021,50,14,41,24,0,K,0,1,26,0,0,36,9,0,48,0,0,2
70433,35036,2021-06-24T13:18:43.7067969Z,2021,22,5,15,13,0,PK,0,0,9,0,0,17,7,0,22,0,0,0
70433,5000,2020-11-18T16:21:13.0297221Z,2019,64,23,58,22,0,1ro,0,0,42,0,0,41,6,0,63,0,0,1
70433,5001,2020-11-18T16:21:13.4139788Z,2019,52,23,39,26,0,2do,2,0,26,0,0,29,13,0,50,0,0,0
70433,5002,2020-11-18T16:21:13.4139788Z,2019,62,26,51,36,0,3ro,1,1,26,0,0,36,11,0,60,0,0,1
70433,5003,2020-11-18T16:21:13.4149792Z,2019,53,23,43,24,0,4to,0,1,29,0,0,30,10,0,53,0,0,0
70433,5004,2020-11-18T16:21:13.4149792Z,2019,41,20,35,21,0,5to,0,0,20,0,0,21,6,0,41,0,0,0
70433,5005,2020-11-18T16:21:13.4149792Z,2019,49,12,40,32,0,K,0,0,17,0,0,37,9,0,49,0,0,0
70433,5006,2020-11-18T16:21:13.4149792Z,2019,24,5,19,12,0,PK,1,0,12,0,0,19,5,0,23,0,0,0
33662,2184,2020-11-18T16:20:54.6064346Z,2019,99,38,86,47,0,6to,1,0,52,0,0,61,13,0,98,0,1,0
33662,2185,2020-11-18T16:20:54.6064346Z,2019,98,39,87,37,0,7mo,1,2,61,0,0,59,11,0,97,0,1,0
33662,2186,2020-11-18T16:20:54.6064346Z,2019,99,23,86,58,0,8vo,1,0,41,0,0,76,13,0,98,2,1,0
33662,2187,2020-11-18T16:20:54.6074342Z,2019,11,3,10,2,0,9no,0,0,9,0,0,8,1,0,11,0,0,0
33662,2188,2020-11-18T16:20:54.6074342Z,2019,23,22,23,8,0,Sin Grado,2,0,15,0,0,1,0,0,21,0,0,0
33662,32190,2021-06-24T13:18:20.9564773Z,2021,92,35,84,42,0,6to,3,0,50,0,0,57,8,0,89,1,0,0
33662,32191,2021-06-24T13:18:20.9564773Z,2021,87,30,77,37,0,7mo,2,1,50,0,0,57,10,0,85,0,0,0
33662,32192,2021-06-24T13:18:20.9574769Z,2021,110,38,88,48,0,8vo,1,2,62,0,0,72,22,0,109,0,1,0
33662,32193,2021-06-24T13:18:20.9574769Z,2021,13,13,13,2,0,Sin Grado,0,1,11,0,0,0,0,0,13,0,0,0
33662,8196,2020-11-18T16:21:50.2385335Z,2020,65,22,60,25,0,6to,2,0,40,0,0,43,5,0,63,0,0,0
33662,8197,2020-11-18T16:21:50.2385335Z,2020,112,43,98,48,0,7mo,1,0,64,0,0,69,14,0,111,0,1,0
33662,8198,2020-11-18T16:21:50.2385335Z,2020,84,29,68,40,0,8vo,2,0,44,0,0,55,16,0,82,0,1,0
33662,8199,2020-11-18T16:21:50.239534Z,2020,36,36,34,13,0,Sin Grado,2,0,23,0,0,0,2,0,34,0,0,0
30791,1858,2020-11-18T16:20:52.4810202Z,2019,54,15,45,21,0,1ro,1,0,33,0,0,39,9,0,53,1,0,0
30791,1859,2020-11-18T16:20:52.4810202Z,2019,36,11,27,16,0,2do,0,0,20,0,0,25,9,0,35,0,0,1
30791,1860,2020-11-18T16:20:52.4810202Z,2019,44,9,34,24,0,3ro,0,0,20,0,0,35,10,0,44,1,0,0
30791,1861,2020-11-18T16:20:52.4820216Z,2019,52,15,42,25,0,4to,2,0,27,0,0,37,10,0,50,0,0,0
30791,1862,2020-11-18T16:20:52.4820216Z,2019,53,9,41,26,0,5to,2,0,27,0,0,44,12,0,51,1,0,0
30791,1863,2020-11-18T16:20:52.4820216Z,2019,41,5,2,23,0,K,1,0,18,0,0,36,39,0,40,0,0,0
30791,1864,2020-11-18T16:20:52.4820216Z,2019,8,5,7,4,0,Sin Grado,0,0,4,0,0,3,1,0,8,0,0,0
30791,31863,2021-06-24T13:18:17.7671898Z,2021,38,4,31,18,0,1ro,1,0,20,0,0,34,7,0,36,0,0,1
30791,31864,2021-06-24T13:18:17.7681898Z,2021,43,7,36,23,0,2do,1,0,20,0,0,36,7,0,42,0,0,0
30791,31865,2021-06-24T13:18:17.7681898Z,2021,45,16,33,16,0,3ro,1,0,29,0,0,29,12,0,44,2,0,0
30791,31866,2021-06-24T13:18:17.7681898Z,2021,34,6,29,19,0,4to,0,0,15,0,0,28,5,0,34,0,0,0
30791,31867,2021-06-24T13:18:17.7681898Z,2021,37,7,30,16,0,5to,1,0,21,0,0,30,7,0,36,0,0,0
30791,31868,2021-06-24T13:18:17.7681898Z,2021,19,1,11,9,0,K,0,0,10,0,0,18,8,0,18,0,0,1
30791,31869,2021-06-24T13:18:17.7691908Z,2021,1,1,1,1,0,Sin Grado,0,0,0,0,0,0,0,0,1,0,0,0
30791,7866,2020-11-18T16:21:48.4793584Z,2020,48,8,45,24,0,1ro,1,0,24,0,0,40,3,0,47,0,0,0
30791,7867,2020-11-18T16:21:48.4803602Z,2020,45,13,37,17,0,2do,0,0,28,0,0,32,8,0,45,2,0,0
30791,7868,2020-11-18T16:21:48.4803602Z,2020,37,8,29,20,0,3ro,0,0,17,0,0,29,8,0,37,0,0,0
30791,7869,2020-11-18T16:21:48.4803602Z,2020,47,8,38,25,0,4to,0,0,22,0,0,39,9,0,47,1,0,0
30791,7870,2020-11-18T16:21:48.4803602Z,2020,48,14,39,22,0,5to,0,0,26,0,0,34,9,0,48,0,0,0
30791,7871,2020-11-18T16:21:48.4803602Z,2020,44,3,34,23,0,K,1,0,21,0,0,41,10,0,43,0,0,0
30791,7872,2020-11-18T16:21:48.4813606Z,2020,5,5,5,2,0,Sin Grado,0,0,3,0,0,0,0,0,5,0,0,0
71662,11389,2020-11-18T16:22:10.1858334Z,2020,41,16,35,22,0,1ro,0,0,19,0,0,25,6,0,41,0,0,0
71662,11390,2020-11-18T16:22:10.1868348Z,2020,43,15,36,20,0,2do,1,0,23,0,0,28,7,0,42,0,0,0
71662,11391,2020-11-18T16:22:10.1868348Z,2020,43,14,38,16,0,3ro,2,0,27,0,0,29,5,0,41,0,0,0
71662,11392,2020-11-18T16:22:10.1868348Z,2020,65,21,50,26,0,4to,2,0,39,0,0,44,15,0,63,0,0,0
71662,11393,2020-11-18T16:22:10.1878366Z,2020,46,21,34,23,0,5to,2,0,23,0,0,25,12,0,44,0,0,0
71662,11394,2020-11-18T16:22:10.1878366Z,2020,47,8,34,27,0,K,0,0,20,0,0,39,13,0,47,0,0,0
71662,35411,2021-06-24T13:18:46.2025865Z,2021,38,4,27,23,0,1ro,0,0,15,0,0,34,11,0,38,0,0,0
71662,35412,2021-06-24T13:18:46.2025865Z,2021,40,19,33,19,0,2do,0,0,21,0,0,21,7,0,40,0,0,0
71662,35413,2021-06-24T13:18:46.2035861Z,2021,48,16,43,20,0,3ro,1,0,28,0,0,32,5,0,47,0,0,0
71662,35414,2021-06-24T13:18:46.2035861Z,2021,40,13,36,17,0,4to,1,0,23,0,0,27,4,0,39,0,2,0
71662,35415,2021-06-24T13:18:46.2035861Z,2021,55,17,47,20,0,5to,1,0,35,0,0,38,8,0,54,0,0,0
71662,35416,2021-06-24T13:18:46.2035861Z,2021,37,13,27,16,0,K,0,0,21,0,0,24,10,0,37,0,0,0
71662,5381,2020-11-18T16:21:15.0940973Z,2019,61,25,51,27,0,1ro,1,0,34,0,0,36,10,1,59,0,0,0
71662,5382,2020-11-18T16:21:15.0940973Z,2019,43,14,39,14,0,2do,4,0,29,0,0,29,4,0,39,0,0,0
71662,5383,2020-11-18T16:21:15.0940973Z,2019,69,24,53,34,0,3ro,5,0,35,0,0,45,16,0,64,0,0,0
71662,5384,2020-11-18T16:21:15.0940973Z,2019,41,18,30,21,0,4to,2,0,20,0,0,23,11,0,39,0,0,0
71662,5385,2020-11-18T16:21:15.0940973Z,2019,44,22,34,23,0,5to,1,0,21,0,0,22,10,0,42,0,0,1
71662,5386,2020-11-18T16:21:15.095096Z,2019,40,14,33,18,0,K,0,0,22,0,0,26,7,1,39,0,0,0
56119,33895,2021-06-24T13:18:35.7711056Z,2021,117,26,92,51,0,10mo,1,0,66,0,0,91,25,0,116,0,1,0
56119,33896,2021-06-24T13:18:35.7711056Z,2021,85,22,66,39,0,11mo,5,1,46,0,0,63,19,0,80,0,0,0
56119,33897,2021-06-24T13:18:35.7711056Z,2021,87,14,60,43,0,12mo,1,1,44,0,0,73,27,0,86,0,0,0
56119,33898,2021-06-24T13:18:35.7711056Z,2021,84,20,68,45,0,9no,4,1,39,0,0,64,16,0,80,0,0,0
56119,3872,2020-11-18T16:21:05.5837542Z,2019,87,13,60,43,0,10mo,1,1,44,0,0,74,27,0,86,0,0,0
56119,3873,2020-11-18T16:21:05.5837542Z,2019,102,15,66,62,0,11mo,2,0,40,0,0,87,36,0,99,0,0,1
56119,3874,2020-11-18T16:21:05.5847555Z,2019,91,0,59,56,0,12mo,2,0,35,0,0,91,32,0,89,0,0,0
56119,3875,2020-11-18T16:21:05.5847555Z,2019,112,27,81,51,0,9no,4,0,61,0,0,85,31,0,108,0,0,0
56119,9889,2020-11-18T16:22:00.5313967Z,2020,99,24,67,45,0,10mo,5,0,54,0,0,75,32,0,94,0,0,0
56119,9890,2020-11-18T16:22:00.5313967Z,2020,87,14,57,45,0,11mo,1,0,42,0,0,73,30,0,86,0,0,0
56119,9891,2020-11-18T16:22:00.5313967Z,2020,94,14,69,56,0,12mo,2,0,38,0,0,80,25,0,91,0,0,1
56119,9892,2020-11-18T16:22:00.5313967Z,2020,117,31,86,49,0,9no,0,0,68,0,0,86,31,0,117,0,1,0
30841,1865,2020-11-18T16:20:52.6271183Z,2019,54,16,48,19,0,1ro,0,0,35,0,0,38,6,0,54,0,0,0
30841,1866,2020-11-18T16:20:52.6271183Z,2019,44,10,40,26,0,2do,1,0,18,0,0,34,4,0,43,0,0,0
30841,1867,2020-11-18T16:20:52.6281183Z,2019,42,22,40,19,0,3ro,0,0,23,0,0,20,2,0,41,0,0,1
30841,1868,2020-11-18T16:20:52.6281183Z,2019,51,15,42,22,0,4to,1,0,29,0,0,36,9,0,50,0,0,0
30841,1869,2020-11-18T16:20:52.6281183Z,2019,74,29,62,28,0,5to,0,0,46,0,0,45,12,0,73,0,0,1
30841,1870,2020-11-18T16:20:52.6281183Z,2019,47,14,38,23,0,K,0,0,24,0,0,33,9,0,47,0,0,0
30841,1871,2020-11-18T16:20:52.6281183Z,2019,65,64,50,17,0,Sin Grado,2,2,48,0,0,1,15,0,63,0,0,0
30841,31870,2021-06-24T13:18:17.7701917Z,2021,52,16,46,19,0,1ro,0,1,33,0,0,36,6,0,52,0,0,0
30841,31871,2021-06-24T13:18:17.7711922Z,2021,55,15,45,29,0,2do,0,0,26,0,0,40,10,0,55,0,0,0
30841,31872,2021-06-24T13:18:17.7711922Z,2021,42,12,38,16,0,3ro,0,0,26,0,0,30,4,0,42,0,0,0
30841,31873,2021-06-24T13:18:17.7711922Z,2021,47,15,40,25,0,4to,1,2,22,0,0,32,7,0,46,0,0,0
30841,31874,2021-06-24T13:18:17.7711922Z,2021,49,21,42,27,0,5to,1,0,22,0,0,28,7,0,47,0,0,1
30841,31875,2021-06-24T13:18:17.7711922Z,2021,42,18,27,20,0,K,1,0,22,0,0,24,15,0,41,0,0,0
30841,31876,2021-06-24T13:18:17.7721931Z,2021,53,53,40,17,0,Sin Grado,0,0,36,0,0,0,13,0,53,0,0,0
30841,7873,2020-11-18T16:21:48.4823615Z,2020,56,15,49,27,0,1ro,0,0,29,0,0,41,7,0,56,0,0,0
30841,7874,2020-11-18T16:21:48.4823615Z,2020,51,13,47,18,0,2do,0,2,33,0,0,38,4,0,51,0,0,0
30841,7875,2020-11-18T16:21:48.4833615Z,2020,46,16,42,24,0,3ro,1,1,22,0,0,30,4,0,45,0,0,0
30841,7876,2020-11-18T16:21:48.4833615Z,2020,42,20,38,22,0,4to,0,0,20,0,0,22,4,0,41,0,0,1
30841,7877,2020-11-18T16:21:48.4833615Z,2020,50,15,44,22,0,5to,0,0,28,0,0,35,6,0,50,0,0,0
30841,7878,2020-11-18T16:21:48.4833615Z,2020,50,16,45,19,0,K,1,0,31,0,0,34,5,0,49,0,0,0
30841,7879,2020-11-18T16:21:48.4833615Z,2020,68,68,52,23,0,Sin Grado,0,1,45,0,0,0,16,0,68,0,0,0
24687,1416,2020-11-18T16:20:46.3299177Z,2019,42,9,27,21,0,1ro,0,0,21,0,0,33,15,0,42,0,0,0
24687,1417,2020-11-18T16:20:46.3309186Z,2019,38,9,27,17,0,2do,0,0,21,0,1,29,11,0,37,0,2,1
24687,1418,2020-11-18T16:20:46.3309186Z,2019,45,4,29,24,0,3ro,0,0,21,0,0,41,16,0,45,0,0,0
24687,1419,2020-11-18T16:20:46.3309186Z,2019,40,6,28,23,0,4to,0,0,17,0,0,34,12,0,40,0,0,0
24687,1420,2020-11-18T16:20:46.3309186Z,2019,40,12,24,24,0,5to,0,0,16,0,1,28,16,0,40,0,0,0
24687,1421,2020-11-18T16:20:46.3319191Z,2019,46,10,25,23,0,6to,0,0,23,0,0,36,21,0,46,0,0,0
24687,1422,2020-11-18T16:20:46.3319191Z,2019,50,9,26,28,0,7mo,0,0,22,0,0,41,24,0,49,0,0,1
24687,1423,2020-11-18T16:20:46.3319191Z,2019,21,3,12,11,0,8vo,0,0,10,0,0,18,9,0,21,0,0,0
24687,1424,2020-11-18T16:20:46.3319191Z,2019,41,10,30,18,0,K,0,0,23,0,0,31,11,0,41,0,0,0
24687,1425,2020-11-18T16:20:46.3319191Z,2019,20,5,11,9,0,PK,0,0,11,0,0,15,9,0,20,0,0,0
24687,1426,2020-11-18T16:20:46.3329191Z,2019,2,2,1,0,0,Sin Grado,0,0,2,0,0,0,1,0,2,0,0,0
24687,31417,2021-06-24T13:18:14.9131433Z,2021,42,6,30,23,0,1ro,1,0,19,0,0,36,12,0,41,0,0,0
24687,31418,2021-06-24T13:18:14.9131433Z,2021,42,10,38,19,0,2do,0,0,23,0,0,32,4,0,41,0,0,1
24687,31419,2021-06-24T13:18:14.9131433Z,2021,38,9,29,19,0,3ro,0,0,19,0,0,29,9,0,38,0,0,0
24687,31420,2021-06-24T13:18:14.9131433Z,2021,38,10,31,17,0,4to,2,0,21,0,0,28,7,0,35,0,1,1
24687,31421,2021-06-24T13:18:14.9141442Z,2021,50,4,35,26,0,5to,0,0,24,0,0,46,15,0,50,0,1,0
24687,31422,2021-06-24T13:18:14.9141442Z,2021,49,9,38,30,0,6to,1,0,19,0,0,40,11,0,48,0,1,0
24687,31423,2021-06-24T13:18:14.9141442Z,2021,43,9,30,23,0,7mo,0,0,20,0,0,34,13,0,43,0,0,0
24687,31424,2021-06-24T13:18:14.9141442Z,2021,50,7,35,28,0,8vo,0,0,22,0,0,43,15,0,50,0,0,0
24687,31425,2021-06-24T13:18:14.9151443Z,2021,48,8,41,23,0,K,0,0,25,0,0,40,7,0,48,0,0,0
24687,31426,2021-06-24T13:18:14.9151443Z,2021,16,3,14,10,0,PK,0,0,6,0,0,13,2,0,16,0,0,0
24687,7420,2020-11-18T16:21:45.7595481Z,2020,38,8,29,18,0,1ro,1,0,20,0,0,30,9,0,37,0,0,0
24687,7421,2020-11-18T16:21:45.7595481Z,2020,39,8,25,19,0,2do,1,2,20,0,0,31,14,0,38,0,0,0
24687,7422,2020-11-18T16:21:45.7595481Z,2020,35,10,24,16,0,3ro,2,0,19,0,0,25,11,0,32,0,1,1
24687,7423,2020-11-18T16:21:45.7605499Z,2020,45,5,26,24,0,4to,0,0,21,0,0,40,19,0,45,0,1,0
24687,7424,2020-11-18T16:21:45.7605499Z,2020,43,7,28,27,0,5to,1,0,16,0,0,36,15,0,42,0,1,0
24687,7425,2020-11-18T16:21:45.7605499Z,2020,45,12,28,24,0,6to,0,0,21,0,0,33,17,0,45,0,0,0
24687,7426,2020-11-18T16:21:45.761549Z,2020,51,10,25,27,0,7mo,0,0,24,0,0,41,26,0,51,0,0,0
24687,7427,2020-11-18T16:21:45.761549Z,2020,45,7,20,25,0,8vo,0,0,20,0,0,38,25,0,44,0,0,1
24687,7428,2020-11-18T16:21:45.761549Z,2020,49,7,28,28,0,K,2,0,21,0,0,42,21,0,47,0,0,0
24687,7429,2020-11-18T16:21:45.761549Z,2020,16,1,10,7,0,PK,0,0,9,0,0,15,6,0,16,0,0,0
47613,3144,2020-11-18T16:21:01.0257163Z,2019,49,23,39,28,0,1ro,0,1,21,0,0,26,10,0,49,0,0,0
47613,3145,2020-11-18T16:21:01.0267167Z,2019,58,20,51,34,0,2do,0,0,24,0,0,38,7,0,58,0,0,0
47613,3146,2020-11-18T16:21:01.0267167Z,2019,72,22,66,33,0,3ro,0,2,39,0,0,50,6,0,72,0,1,0
47613,3147,2020-11-18T16:21:01.0267167Z,2019,73,34,67,34,0,4to,2,1,39,0,0,39,6,0,71,0,0,0
47613,3148,2020-11-18T16:21:01.0267167Z,2019,96,38,89,53,0,5to,2,1,43,0,0,58,7,0,94,0,0,0
47613,3149,2020-11-18T16:21:01.0267167Z,2019,35,18,32,15,0,K,0,0,20,0,0,17,3,0,35,0,0,0
47613,3150,2020-11-18T16:21:01.0277181Z,2019,27,26,22,11,0,Sin Grado,0,0,16,0,0,1,5,0,27,0,0,0
47613,33160,2021-06-24T13:18:30.3392115Z,2021,52,23,46,23,0,1ro,0,0,29,0,0,29,6,0,52,0,0,0
47613,33161,2021-06-24T13:18:30.3392115Z,2021,35,16,34,15,0,2do,0,0,20,0,0,19,1,0,34,0,0,1
47613,33162,2021-06-24T13:18:30.340212Z,2021,56,24,52,28,0,3ro,0,1,28,0,0,32,4,0,56,0,0,0
47613,33163,2021-06-24T13:18:30.340212Z,2021,50,16,47,29,0,4to,0,0,21,0,0,34,3,0,50,0,0,0
47613,33164,2021-06-24T13:18:30.340212Z,2021,59,17,56,25,0,5to,0,1,34,0,0,42,3,0,59,0,0,0
47613,33165,2021-06-24T13:18:30.341213Z,2021,42,19,40,16,0,K,0,0,26,0,0,23,2,0,42,0,0,0
47613,33166,2021-06-24T13:18:30.341213Z,2021,21,21,17,9,0,Sin Grado,0,0,12,0,0,0,4,0,21,0,0,0
47613,9158,2020-11-18T16:21:56.1474747Z,2020,35,13,34,16,0,1ro,0,1,19,0,0,22,1,0,34,0,0,1
47613,9159,2020-11-18T16:21:56.1474747Z,2020,58,25,48,29,0,2do,0,1,29,0,0,33,10,0,58,0,0,0
47613,9160,2020-11-18T16:21:56.1474747Z,2020,55,17,49,33,0,3ro,0,0,22,0,0,38,6,0,55,0,0,0
47613,9161,2020-11-18T16:21:56.1484756Z,2020,64,19,54,28,0,4to,0,1,36,0,0,45,10,0,64,0,1,0
47613,9162,2020-11-18T16:21:56.1484756Z,2020,80,36,72,37,0,5to,2,2,43,0,0,44,8,0,78,0,0,0
47613,9163,2020-11-18T16:21:56.1484756Z,2020,47,23,40,19,0,K,0,0,28,0,0,24,7,0,47,0,0,0
47613,9164,2020-11-18T16:21:56.1484756Z,2020,31,30,25,11,0,Sin Grado,0,0,20,0,0,1,6,0,31,0,0,0
20180,30885,2021-06-24T13:18:11.4716758Z,2021,38,11,31,19,0,1ro,0,2,19,0,0,27,7,0,38,0,0,0
20180,30886,2021-06-24T13:18:11.4716758Z,2021,52,17,43,22,0,2do,2,4,30,0,0,35,9,0,50,0,0,0
20180,30887,2021-06-24T13:18:11.4716758Z,2021,54,17,42,32,0,3ro,0,4,22,0,0,37,12,0,54,0,0,0
20180,30888,2021-06-24T13:18:11.4726758Z,2021,59,17,51,34,0,4to,0,3,25,0,0,42,8,0,59,0,0,0
20180,30889,2021-06-24T13:18:11.4726758Z,2021,70,16,59,29,0,5to,0,1,41,0,0,54,11,0,70,0,0,0
20180,30890,2021-06-24T13:18:11.4736772Z,2021,73,24,59,35,0,6to,2,0,38,0,0,49,14,0,71,0,1,0
20180,30891,2021-06-24T13:18:11.4736772Z,2021,63,25,52,34,0,7mo,0,0,29,0,0,38,11,1,62,0,0,0
20180,30892,2021-06-24T13:18:11.4736772Z,2021,82,30,66,36,0,8vo,1,1,46,0,0,52,16,0,81,0,1,0
20180,30893,2021-06-24T13:18:11.4736772Z,2021,49,7,35,26,0,K,1,1,23,0,0,42,14,0,48,0,0,0
20180,30894,2021-06-24T13:18:11.4746777Z,2021,7,7,7,1,0,Sin Grado,0,0,6,0,0,0,0,0,7,0,0,0
20180,6889,2020-11-18T16:21:42.0620786Z,2020,43,13,34,20,0,1ro,2,5,23,0,0,30,9,0,41,0,0,0
20180,6890,2020-11-18T16:21:42.0620786Z,2020,50,13,40,28,0,2do,0,6,22,0,0,37,10,0,50,0,0,0
20180,6891,2020-11-18T16:21:42.0620786Z,2020,55,15,43,33,0,3ro,0,1,22,0,0,40,12,0,55,0,0,0
20180,6892,2020-11-18T16:21:42.063079Z,2020,69,17,50,28,0,4to,1,3,41,0,0,52,19,0,68,0,0,0
20180,6893,2020-11-18T16:21:42.063079Z,2020,62,17,51,28,0,5to,1,3,34,0,0,45,11,0,61,0,0,0
20180,6894,2020-11-18T16:21:42.063079Z,2020,71,25,49,38,0,6to,0,1,33,0,0,46,22,1,70,0,0,0
20180,6895,2020-11-18T16:21:42.063079Z,2020,80,29,58,36,0,7mo,0,1,44,0,0,51,22,0,80,0,1,0
20180,6896,2020-11-18T16:21:42.063079Z,2020,65,23,42,26,0,8vo,0,1,39,0,0,42,23,0,65,0,0,0
20180,6897,2020-11-18T16:21:42.0640803Z,2020,39,8,37,19,0,K,0,2,20,0,0,31,2,0,39,0,0,0
20180,6898,2020-11-18T16:21:42.0640803Z,2020,12,12,12,2,0,Sin Grado,0,3,10,0,0,0,0,0,12,0,0,0
20180,888,2020-11-18T16:20:42.6614678Z,2019,42,17,35,24,0,1ro,0,2,18,0,0,25,7,0,42,0,0,0
20180,889,2020-11-18T16:20:42.6614678Z,2019,50,16,41,28,0,2do,0,0,22,0,0,34,9,0,50,0,0,0
20180,890,2020-11-18T16:20:42.6614678Z,2019,58,17,46,22,0,3ro,1,4,36,0,0,41,12,0,57,0,0,0
20180,891,2020-11-18T16:20:42.6614678Z,2019,52,14,43,22,0,4to,1,2,30,0,0,38,9,1,50,0,0,0
20180,892,2020-11-18T16:20:42.6614678Z,2019,62,21,47,35,0,5to,0,2,27,0,0,41,15,1,61,0,0,0
20180,893,2020-11-18T16:20:42.6624678Z,2019,78,27,59,36,0,6to,0,1,42,0,0,51,19,0,78,0,1,0
20180,894,2020-11-18T16:20:42.6624678Z,2019,66,25,44,27,0,7mo,0,1,39,0,0,41,22,0,66,0,0,0
20180,895,2020-11-18T16:20:42.6624678Z,2019,68,26,55,36,0,8vo,0,1,32,0,0,42,13,0,68,0,0,0
20180,896,2020-11-18T16:20:42.6624678Z,2019,30,4,21,13,0,K,2,0,17,0,0,26,9,0,28,0,0,0
20180,897,2020-11-18T16:20:42.6624678Z,2019,7,7,5,4,0,Sin Grado,0,0,3,0,0,0,2,0,7,0,0,0
35964,2418,2020-11-18T16:20:56.2505322Z,2019,102,21,77,55,0,6to,0,0,47,0,0,81,25,0,102,1,1,0
35964,2419,2020-11-18T16:20:56.2505322Z,2019,100,20,78,55,0,7mo,4,0,45,0,0,80,22,0,96,1,1,0
35964,2420,2020-11-18T16:20:56.2515336Z,2019,117,28,89,56,0,8vo,0,0,61,0,0,89,28,0,116,0,1,1
35964,2421,2020-11-18T16:20:56.2515336Z,2019,17,17,15,7,0,Sin Grado,0,0,10,0,0,0,2,0,17,0,0,0
35964,32425,2021-06-24T13:18:24.7091708Z,2021,84,21,69,37,0,6to,0,0,47,0,0,63,15,0,83,0,1,1
35964,32426,2021-06-24T13:18:24.7091708Z,2021,112,21,93,52,0,7mo,1,0,60,0,0,91,19,0,111,2,0,0
35964,32427,2021-06-24T13:18:24.7091708Z,2021,110,26,84,62,0,8vo,1,0,48,0,0,84,26,0,109,1,1,0
35964,32428,2021-06-24T13:18:24.7101718Z,2021,30,30,25,8,0,Sin Grado,0,0,22,0,0,0,5,0,30,0,0,0
35964,8430,2020-11-18T16:21:51.7925661Z,2020,119,28,95,55,0,6to,1,1,64,0,0,91,24,0,118,2,0,0
35964,8431,2020-11-18T16:21:51.7925661Z,2020,100,21,80,54,0,7mo,1,0,46,0,0,79,20,0,99,1,1,0
35964,8432,2020-11-18T16:21:51.7925661Z,2020,100,20,84,56,0,8vo,2,0,44,0,0,80,16,0,98,2,0,0
35964,8433,2020-11-18T16:21:51.7925661Z,2020,17,17,16,4,0,Sin Grado,0,0,13,0,0,0,1,0,17,0,0,0
66225,10772,2020-11-18T16:22:06.0310643Z,2020,32,13,31,13,0,1ro,1,0,19,0,0,19,1,0,31,0,0,0
66225,10773,2020-11-18T16:22:06.0320661Z,2020,28,8,27,12,0,2do,1,0,16,0,0,20,1,0,27,0,0,0
66225,10774,2020-11-18T16:22:06.0320661Z,2020,23,7,21,13,0,3ro,1,0,10,0,0,16,2,0,22,0,0,0
66225,10775,2020-11-18T16:22:06.0320661Z,2020,23,11,23,15,0,4to,1,0,8,0,0,12,0,0,22,0,0,0
66225,10776,2020-11-18T16:22:06.0330665Z,2020,14,7,12,6,0,5to,1,0,8,0,0,7,2,0,13,0,0,0
66225,10777,2020-11-18T16:22:06.0330665Z,2020,26,13,26,13,0,K,0,0,13,0,0,13,0,0,26,0,0,0
66225,10778,2020-11-18T16:22:06.0330665Z,2020,63,62,58,16,0,Sin Grado,1,0,47,0,0,1,5,0,62,0,0,0
66225,34789,2021-06-24T13:18:41.5042164Z,2021,19,8,19,7,0,1ro,1,0,12,0,0,11,0,0,18,0,0,0
66225,34790,2021-06-24T13:18:41.5042164Z,2021,30,12,29,15,0,2do,1,0,15,0,0,18,1,0,29,0,0,0
66225,34791,2021-06-24T13:18:41.5042164Z,2021,23,9,23,10,0,3ro,1,0,13,0,0,14,0,0,22,0,0,0
66225,34792,2021-06-24T13:18:41.5042164Z,2021,20,6,20,14,0,4to,1,0,6,0,0,14,0,0,19,0,0,0
66225,34793,2021-06-24T13:18:41.5052178Z,2021,19,9,17,12,0,5to,1,0,7,0,0,10,2,0,18,0,0,0
66225,34794,2021-06-24T13:18:41.5052178Z,2021,22,7,22,7,0,K,0,0,15,0,0,15,0,0,22,0,0,0
66225,34795,2021-06-24T13:18:41.5052178Z,2021,30,30,26,8,0,Sin Grado,0,0,22,0,0,0,4,0,30,0,0,0
66225,4764,2020-11-18T16:21:11.917981Z,2019,46,19,46,18,0,1ro,1,0,28,0,0,27,0,0,45,0,0,0
66225,4765,2020-11-18T16:21:11.917981Z,2019,29,10,28,15,0,2do,3,0,14,0,0,19,1,0,26,0,0,0
66225,4766,2020-11-18T16:21:11.9189796Z,2019,29,12,28,15,0,3ro,1,0,14,0,0,17,1,0,28,0,0,0
66225,4767,2020-11-18T16:21:11.9189796Z,2019,28,16,24,14,0,4to,1,0,14,0,0,12,4,0,27,0,0,0
66225,4768,2020-11-18T16:21:11.9189796Z,2019,21,8,20,10,0,5to,0,0,11,0,0,13,1,0,21,0,0,0
66225,4769,2020-11-18T16:21:11.9189796Z,2019,28,8,27,15,0,K,0,0,13,0,0,20,1,0,28,0,0,0
66225,4770,2020-11-18T16:21:11.9189796Z,2019,60,58,54,14,0,Sin Grado,1,0,46,0,0,2,6,0,59,0,0,0
70540,11048,2020-11-18T16:22:07.6281265Z,2020,49,21,41,24,0,1ro,0,0,25,0,0,28,8,0,49,0,0,0
70540,11049,2020-11-18T16:22:07.6281265Z,2020,70,37,57,26,0,2do,2,0,44,0,0,33,13,0,68,0,0,0
70540,11050,2020-11-18T16:22:07.6281265Z,2020,52,24,47,23,0,3ro,2,1,29,0,0,28,5,0,50,0,0,0
70540,11051,2020-11-18T16:22:07.6291274Z,2020,55,27,50,31,0,4to,1,0,24,0,0,28,5,0,54,0,1,0
70540,11052,2020-11-18T16:22:07.6291274Z,2020,69,33,57,36,0,5to,4,1,33,0,0,36,12,0,65,0,1,0
70540,11053,2020-11-18T16:22:07.6291274Z,2020,64,19,52,37,0,K,0,0,27,0,0,45,12,0,64,0,0,0
70540,11054,2020-11-18T16:22:07.6301279Z,2020,11,11,9,2,0,Sin Grado,0,0,9,0,0,0,2,0,11,0,0,0
70540,35069,2021-06-24T13:18:43.7158027Z,2021,61,18,52,38,0,1ro,1,0,23,0,0,43,9,0,60,0,0,0
70540,35070,2021-06-24T13:18:43.7168032Z,2021,43,19,37,23,0,2do,0,0,20,0,0,24,6,0,43,0,0,0
70540,35071,2021-06-24T13:18:43.7168032Z,2021,65,34,56,25,0,3ro,3,0,40,0,0,31,9,0,62,0,0,0
70540,35072,2021-06-24T13:18:43.7168032Z,2021,46,24,43,20,0,4to,1,0,26,0,0,22,3,0,45,0,0,0
70540,35073,2021-06-24T13:18:43.7178036Z,2021,56,28,52,28,0,5to,2,1,28,0,0,28,4,0,54,0,0,0
70540,35074,2021-06-24T13:18:43.7178036Z,2021,48,17,42,18,0,K,0,0,30,0,0,31,6,0,48,0,0,0
70540,35075,2021-06-24T13:18:43.7178036Z,2021,5,5,4,1,0,Sin Grado,0,0,4,0,0,0,1,0,5,0,0,0
70540,5040,2020-11-18T16:21:13.4279881Z,2019,68,33,55,29,0,1ro,2,2,39,0,0,35,13,0,66,0,0,0
70540,5041,2020-11-18T16:21:13.4279881Z,2019,43,17,37,20,0,2do,2,0,23,0,0,26,6,0,41,0,1,0
70540,5042,2020-11-18T16:21:13.4279881Z,2019,60,29,55,30,0,3ro,0,0,30,0,0,31,5,0,60,0,1,0
70540,5043,2020-11-18T16:21:13.4279881Z,2019,59,24,48,32,0,4to,2,0,27,0,0,35,11,0,57,0,1,0
70540,5044,2020-11-18T16:21:13.4289895Z,2019,48,17,35,25,0,5to,2,0,23,0,0,31,13,0,46,0,2,0
70540,5045,2020-11-18T16:21:13.4289895Z,2019,46,20,38,19,0,K,0,1,27,0,0,26,8,0,46,0,0,0
70540,5046,2020-11-18T16:21:13.4289895Z,2019,37,37,33,15,0,Sin Grado,1,0,22,0,0,0,4,0,36,0,0,0
11411,187,2020-11-18T16:20:37.5810802Z,2019,57,22,46,26,0,1ro,0,0,31,0,0,35,11,0,57,0,0,0
11411,188,2020-11-18T16:20:37.5810802Z,2019,58,24,48,27,0,2do,0,0,31,0,0,34,10,0,58,0,0,0
11411,189,2020-11-18T16:20:37.5820819Z,2019,49,17,39,21,0,3ro,0,0,28,0,0,32,10,0,49,0,0,0
11411,190,2020-11-18T16:20:37.5820819Z,2019,70,20,49,33,0,4to,0,0,37,0,0,50,21,0,70,2,0,0
11411,191,2020-11-18T16:20:37.5820819Z,2019,53,18,42,20,0,5to,0,0,33,0,1,35,11,0,53,0,0,0
11411,192,2020-11-18T16:20:37.5820819Z,2019,50,16,41,32,0,K,0,0,18,0,0,34,9,0,50,0,0,0
11411,193,2020-11-18T16:20:37.5830828Z,2019,16,2,8,9,0,PK,0,0,7,0,0,14,8,0,16,0,0,0
11411,30186,2021-06-24T13:18:06.3289884Z,2021,65,18,61,27,0,1ro,1,0,38,0,0,47,4,0,64,0,0,0
11411,30187,2021-06-24T13:18:06.3289884Z,2021,51,16,45,28,0,2do,0,0,23,0,0,35,6,0,51,0,0,0
11411,30188,2021-06-24T13:18:06.3299902Z,2021,45,12,38,22,0,3ro,1,0,23,0,0,33,7,0,44,0,0,0
11411,30189,2021-06-24T13:18:06.3299902Z,2021,53,21,48,19,0,4to,0,0,34,0,0,32,5,0,53,0,0,0
11411,30190,2021-06-24T13:18:06.3299902Z,2021,44,14,41,21,0,5to,0,0,23,0,0,30,3,0,44,0,0,0
11411,30191,2021-06-24T13:18:06.3299902Z,2021,49,11,42,25,0,K,1,0,24,0,0,38,7,0,48,0,0,0
11411,30192,2021-06-24T13:18:06.3309894Z,2021,14,1,11,7,0,PK,0,0,7,0,0,13,3,0,14,0,0,0
11411,6188,2020-11-18T16:21:38.2615451Z,2020,50,14,43,32,0,1ro,0,0,18,0,0,36,7,0,50,0,0,0
11411,6189,2020-11-18T16:21:38.2615451Z,2020,50,14,39,24,0,2do,1,0,26,0,0,36,11,0,49,0,0,0
11411,6190,2020-11-18T16:21:38.2615451Z,2020,61,26,51,24,0,3ro,0,0,37,0,0,35,10,0,61,0,0,0
11411,6191,2020-11-18T16:21:38.2615451Z,2020,49,17,39,20,0,4to,0,0,29,0,0,32,10,0,49,0,0,0
11411,6192,2020-11-18T16:21:38.2625465Z,2020,61,17,44,29,0,5to,0,0,32,0,0,44,17,0,61,2,0,0
11411,6193,2020-11-18T16:21:38.2625465Z,2020,69,16,59,28,0,K,1,0,41,0,0,53,10,0,68,0,0,0
11411,6194,2020-11-18T16:21:38.2625465Z,2020,16,2,12,8,0,PK,1,0,8,0,0,14,4,0,15,0,0,0
30502,1812,2020-11-18T16:20:52.4710135Z,2019,28,12,24,10,0,1ro,0,0,18,0,0,16,4,0,28,1,0,0
30502,1813,2020-11-18T16:20:52.4710135Z,2019,19,8,17,9,0,2do,1,0,10,0,0,11,2,0,18,1,0,0
30502,1814,2020-11-18T16:20:52.4720144Z,2019,35,15,32,13,0,3ro,0,0,22,0,0,20,3,0,35,0,0,0
30502,1815,2020-11-18T16:20:52.4720144Z,2019,24,8,20,14,0,4to,0,0,10,0,0,16,4,0,24,0,0,0
30502,1816,2020-11-18T16:20:52.4720144Z,2019,40,11,34,22,0,5to,2,0,18,0,0,29,6,0,38,0,0,0
30502,1817,2020-11-18T16:20:52.4720144Z,2019,27,5,20,8,0,6to,2,0,19,0,0,22,7,0,25,0,0,0
30502,1818,2020-11-18T16:20:52.4720144Z,2019,18,2,18,11,0,K,0,0,7,0,0,16,0,0,18,0,0,0
30502,1819,2020-11-18T16:20:52.4730144Z,2019,29,4,22,15,0,PK,0,0,14,0,0,25,7,0,29,0,0,0
30502,31815,2021-06-24T13:18:17.7521797Z,2021,15,4,12,7,0,1ro,0,0,8,0,0,11,3,0,15,0,0,0
30502,31816,2021-06-24T13:18:17.7531793Z,2021,25,10,24,12,0,2do,0,0,13,0,0,15,1,0,25,0,0,0
30502,31817,2021-06-24T13:18:17.7531793Z,2021,19,7,16,7,0,3ro,0,0,12,0,0,12,3,0,19,1,0,0
30502,31818,2021-06-24T13:18:17.7531793Z,2021,13,6,11,6,0,4to,1,0,7,0,0,7,2,0,12,1,0,0
30502,31819,2021-06-24T13:18:17.7541829Z,2021,37,15,31,13,0,5to,0,0,24,0,0,22,6,0,37,0,0,0
30502,31820,2021-06-24T13:18:17.7541829Z,2021,30,11,28,17,0,6to,0,0,13,0,0,19,2,0,30,0,0,0
30502,31821,2021-06-24T13:18:17.7541829Z,2021,26,9,19,15,0,K,0,0,11,0,0,17,7,0,26,0,0,0
30502,31822,2021-06-24T13:18:17.7551807Z,2021,30,5,25,15,0,PK,0,0,15,0,0,25,5,0,30,0,0,0
30502,7818,2020-11-18T16:21:48.4683517Z,2020,22,7,21,9,0,1ro,0,0,13,0,0,15,1,0,22,0,0,0
30502,7819,2020-11-18T16:21:48.4683517Z,2020,18,6,14,6,0,2do,0,0,12,0,0,12,4,0,18,1,0,0
30502,7820,2020-11-18T16:21:48.4693531Z,2020,13,6,12,6,0,3ro,1,0,7,0,0,7,1,0,12,1,0,0
30502,7821,2020-11-18T16:21:48.4693531Z,2020,38,14,29,15,0,4to,0,1,23,0,0,24,9,0,38,0,0,0
30502,7822,2020-11-18T16:21:48.4693531Z,2020,23,8,20,13,0,5to,0,0,10,0,0,15,3,0,23,0,0,0
30502,7823,2020-11-18T16:21:48.4693531Z,2020,43,11,40,19,0,6to,2,0,24,0,0,32,3,0,41,0,0,0
30502,7824,2020-11-18T16:21:48.4703531Z,2020,9,2,6,5,0,K,0,1,4,0,0,7,3,0,9,0,0,0
30502,7825,2020-11-18T16:21:48.4703531Z,2020,19,1,15,12,0,PK,0,1,7,0,0,18,4,0,19,0,0,0
57182,33945,2021-06-24T13:18:36.6547395Z,2021,26,6,21,10,0,1ro,0,0,16,0,0,20,5,0,26,0,0,0
57182,33946,2021-06-24T13:18:36.6547395Z,2021,42,18,39,21,0,2do,3,0,21,0,0,24,3,0,39,0,1,0
57182,33947,2021-06-24T13:18:36.65574Z,2021,38,20,32,19,0,3ro,3,0,19,0,0,18,6,0,35,0,0,0
57182,33948,2021-06-24T13:18:36.65574Z,2021,37,13,29,23,0,4to,0,0,14,0,0,24,8,0,37,0,0,0
57182,33949,2021-06-24T13:18:36.65574Z,2021,46,23,41,18,0,5to,3,0,28,0,0,23,5,0,43,0,0,0
57182,33950,2021-06-24T13:18:36.65574Z,2021,22,3,18,10,0,K,0,0,12,0,0,19,4,0,22,0,0,0
57182,3922,2020-11-18T16:21:06.7775518Z,2019,53,29,39,20,0,1ro,4,2,33,0,0,24,14,0,49,0,0,0
57182,3923,2020-11-18T16:21:06.7785523Z,2019,59,27,48,31,0,2do,0,1,28,0,0,32,11,0,59,0,1,0
57182,3924,2020-11-18T16:21:06.7785523Z,2019,56,27,40,24,0,3ro,4,0,32,0,0,29,16,0,52,0,0,0
57182,3925,2020-11-18T16:21:06.7785523Z,2019,60,24,51,31,0,4to,1,0,29,0,0,36,9,0,59,0,0,0
57182,3926,2020-11-18T16:21:06.7785523Z,2019,52,13,40,29,0,5to,2,1,23,0,0,39,12,0,50,1,0,0
57182,3927,2020-11-18T16:21:06.7785523Z,2019,51,18,3,29,0,K,1,1,22,0,0,33,48,0,50,0,0,0
57182,9939,2020-11-18T16:22:01.5440745Z,2020,60,18,53,28,0,1ro,2,4,32,0,0,42,7,0,58,0,0,0
57182,9940,2020-11-18T16:22:01.5440745Z,2020,46,25,38,21,0,2do,4,3,25,0,0,21,8,0,42,0,1,0
57182,9941,2020-11-18T16:22:01.5450741Z,2020,48,19,36,27,0,3ro,0,4,21,0,0,29,12,0,48,0,0,0
57182,9942,2020-11-18T16:22:01.5450741Z,2020,57,29,42,24,0,4to,4,1,33,0,0,28,15,0,53,0,0,0
57182,9943,2020-11-18T16:22:01.5450741Z,2020,54,20,47,30,0,5to,1,1,24,0,0,34,7,0,53,0,0,0
57182,9944,2020-11-18T16:22:01.546075Z,2020,34,8,23,11,0,K,1,3,23,0,0,26,11,0,33,0,0,0
32250,2012,2020-11-18T16:20:53.889956Z,2019,86,15,77,43,0,10mo,2,2,43,0,0,71,9,0,84,0,0,0
32250,2013,2020-11-18T16:20:53.889956Z,2019,79,11,59,36,0,11mo,2,0,43,0,0,68,20,0,77,0,0,0
32250,2014,2020-11-18T16:20:53.8909565Z,2019,76,0,70,36,0,12mo,1,0,40,0,0,76,6,0,75,0,0,0
32250,2015,2020-11-18T16:20:53.8909565Z,2019,66,16,58,25,0,6to,0,0,41,0,0,50,8,0,66,0,1,0
32250,2016,2020-11-18T16:20:53.8909565Z,2019,78,22,69,39,0,7mo,4,0,39,0,0,56,9,0,74,0,0,0
32250,2017,2020-11-18T16:20:53.8919565Z,2019,98,25,86,45,0,8vo,3,0,53,0,0,73,12,1,94,0,1,0
32250,2018,2020-11-18T16:20:53.8919565Z,2019,63,12,53,31,0,9no,0,0,32,0,0,51,10,0,63,0,0,0
32250,32019,2021-06-24T13:18:20.0788483Z,2021,72,17,55,30,0,10mo,2,0,42,0,0,55,17,0,70,0,1,0
32250,32020,2021-06-24T13:18:20.0788483Z,2021,40,8,31,17,0,11mo,0,0,23,0,0,32,9,0,40,0,0,0
32250,32021,2021-06-24T13:18:20.0788483Z,2021,47,11,41,21,0,12mo,0,0,26,0,0,36,6,0,47,0,0,0
32250,32022,2021-06-24T13:18:20.0798488Z,2021,26,11,23,5,0,6to,0,0,21,0,0,15,3,0,26,0,0,0
32250,32023,2021-06-24T13:18:20.0798488Z,2021,33,10,31,11,0,7mo,0,0,22,0,0,23,2,0,33,0,0,0
32250,32024,2021-06-24T13:18:20.0808484Z,2021,60,16,52,23,0,8vo,1,1,37,0,0,44,8,0,59,0,1,0
32250,32025,2021-06-24T13:18:20.0808484Z,2021,55,19,41,27,0,9no,2,0,28,0,0,36,14,0,53,0,0,0
32250,8023,2020-11-18T16:21:49.5560781Z,2020,53,10,48,27,0,10mo,0,0,26,0,0,43,5,0,53,0,0,0
32250,8024,2020-11-18T16:21:49.5560781Z,2020,60,10,54,26,0,11mo,1,0,34,0,0,50,6,0,59,0,0,0
32250,8025,2020-11-18T16:21:49.5570786Z,2020,66,10,52,28,0,12mo,1,0,38,0,0,56,14,0,65,0,0,0
32250,8026,2020-11-18T16:21:49.5570786Z,2020,33,8,28,11,0,6to,0,1,22,0,0,25,5,0,33,0,0,0
32250,8027,2020-11-18T16:21:49.5570786Z,2020,61,18,55,23,0,7mo,0,0,38,0,0,43,6,0,61,0,1,0
32250,8028,2020-11-18T16:21:49.5580803Z,2020,69,21,60,33,0,8vo,2,0,36,0,0,48,9,0,67,0,0,0
32250,8029,2020-11-18T16:21:49.5580803Z,2020,78,22,69,31,0,9no,3,0,47,0,0,56,9,0,75,0,1,0
25049,1490,2020-11-18T16:20:46.3469289Z,2019,54,17,51,23,0,1ro,3,1,31,0,0,37,3,0,51,0,0,0
25049,1491,2020-11-18T16:20:46.3469289Z,2019,45,18,39,19,0,2do,1,2,26,0,0,27,6,0,43,0,1,1
25049,1492,2020-11-18T16:20:46.3469289Z,2019,66,19,60,35,0,3ro,1,3,31,0,0,47,6,0,65,0,0,0
25049,1493,2020-11-18T16:20:46.3479315Z,2019,53,23,44,27,0,4to,1,1,26,0,0,30,9,0,52,0,0,0
25049,1494,2020-11-18T16:20:46.3479315Z,2019,54,20,47,27,0,5to,3,1,27,0,0,34,7,0,51,0,2,0
25049,1495,2020-11-18T16:20:46.3479315Z,2019,38,7,33,21,0,K,1,0,17,0,0,31,5,0,37,0,0,0
25049,1496,2020-11-18T16:20:46.3479315Z,2019,19,18,17,8,0,Sin Grado,1,0,11,0,0,1,2,0,18,0,0,0
25049,31491,2021-06-24T13:18:14.93616Z,2021,44,11,37,19,0,1ro,3,0,25,0,0,33,7,0,41,0,0,0
25049,31492,2021-06-24T13:18:14.93616Z,2021,44,10,40,21,0,2do,1,0,23,0,0,34,4,0,43,0,0,0
25049,31493,2021-06-24T13:18:14.93616Z,2021,45,16,39,18,0,3ro,2,0,27,0,0,29,6,0,43,0,0,0
25049,31494,2021-06-24T13:18:14.93616Z,2021,36,13,32,17,0,4to,2,0,19,0,0,23,4,0,33,0,1,1
25049,31495,2021-06-24T13:18:14.93616Z,2021,61,17,54,33,0,5to,1,0,28,0,0,44,7,0,60,0,0,0
25049,31496,2021-06-24T13:18:14.93716Z,2021,35,8,21,19,0,K,1,0,16,0,0,27,14,0,34,0,0,0
25049,31497,2021-06-24T13:18:14.93716Z,2021,20,20,15,7,0,Sin Grado,3,0,13,0,0,0,5,0,17,0,0,0
25049,7494,2020-11-18T16:21:45.7805618Z,2020,52,16,40,28,0,1ro,2,0,24,0,0,36,12,0,50,0,0,0
25049,7495,2020-11-18T16:21:45.7805618Z,2020,47,14,44,17,0,2do,1,1,30,0,0,33,3,0,46,0,0,0
25049,7496,2020-11-18T16:21:45.7815631Z,2020,33,13,29,15,0,3ro,1,1,18,0,0,20,4,0,31,0,1,1
25049,7497,2020-11-18T16:21:45.7815631Z,2020,63,18,58,34,0,4to,1,0,29,0,0,45,5,0,62,0,0,0
25049,7498,2020-11-18T16:21:45.7815631Z,2020,49,23,39,27,0,5to,0,1,22,0,0,26,10,0,49,0,0,0
25049,7499,2020-11-18T16:21:45.7825636Z,2020,38,10,32,15,0,K,2,0,23,0,0,28,6,0,36,0,0,0
25049,7500,2020-11-18T16:21:45.7825636Z,2020,24,24,21,10,0,Sin Grado,1,1,14,0,0,0,3,0,23,0,0,0
34793,2273,2020-11-18T16:20:55.0217109Z,2019,57,4,53,27,0,1ro,0,0,30,0,0,53,4,0,57,0,0,0
34793,2274,2020-11-18T16:20:55.0217109Z,2019,87,10,80,45,0,2do,0,0,42,0,0,77,7,0,87,0,0,0
34793,2275,2020-11-18T16:20:55.0227118Z,2019,62,8,57,30,0,3ro,0,0,32,0,0,54,5,0,62,0,0,0
34793,2276,2020-11-18T16:20:55.0227118Z,2019,52,3,49,24,0,4to,0,0,28,0,0,49,3,0,52,0,0,0
34793,2277,2020-11-18T16:20:55.0227118Z,2019,55,11,47,26,0,5to,0,0,29,0,0,44,8,0,55,0,0,0
34793,2278,2020-11-18T16:20:55.0227118Z,2019,66,2,61,36,0,K,0,0,30,0,0,64,5,0,66,0,0,0
34793,2279,2020-11-18T16:20:55.0227118Z,2019,7,7,5,1,0,Sin Grado,0,0,6,0,0,0,2,0,7,0,0,0
34793,32280,2021-06-24T13:18:21.7680586Z,2021,41,2,37,18,0,1ro,0,0,23,0,0,39,4,0,41,0,0,0
34793,32281,2021-06-24T13:18:21.7680586Z,2021,49,2,46,28,0,2do,1,0,21,0,0,47,3,0,48,0,0,0
34793,32282,2021-06-24T13:18:21.7680586Z,2021,68,13,62,33,0,3ro,0,0,35,0,0,55,6,0,68,0,0,0
34793,32283,2021-06-24T13:18:21.7690614Z,2021,74,9,67,38,0,4to,0,0,36,0,0,65,7,0,74,0,0,0
34793,32284,2021-06-24T13:18:21.7690614Z,2021,54,8,48,29,0,5to,0,0,25,0,0,46,6,0,54,0,0,0
34793,32285,2021-06-24T13:18:21.7690614Z,2021,42,3,39,15,0,K,0,0,27,0,0,39,3,0,42,0,0,0
34793,32286,2021-06-24T13:18:21.7690614Z,2021,10,10,9,2,0,Sin Grado,0,0,8,0,0,0,1,0,10,0,0,0
34793,8285,2020-11-18T16:21:50.7058464Z,2020,51,3,47,28,0,1ro,2,0,23,0,0,48,4,0,49,0,0,0
34793,8286,2020-11-18T16:21:50.7058464Z,2020,69,13,66,32,0,2do,1,0,37,0,0,56,3,0,68,0,0,0
34793,8287,2020-11-18T16:21:50.7058464Z,2020,80,6,73,41,0,3ro,0,0,39,0,0,74,7,0,80,0,0,0
34793,8288,2020-11-18T16:21:50.7068464Z,2020,57,8,53,32,0,4to,0,0,25,0,0,49,4,0,57,0,0,0
34793,8289,2020-11-18T16:21:50.7068464Z,2020,54,4,52,28,0,5to,0,0,26,0,0,50,2,0,54,0,0,0
34793,8290,2020-11-18T16:21:50.7068464Z,2020,49,0,48,22,0,K,0,0,27,0,0,49,1,0,49,0,0,0
34793,8291,2020-11-18T16:21:50.7068464Z,2020,5,5,4,1,0,Sin Grado,0,0,4,0,0,0,1,0,5,0,0,0
61572,10300,2020-11-18T16:22:03.1361311Z,2020,103,16,32,66,0,10mo,1,0,37,0,0,87,71,0,102,1,0,0
61572,10301,2020-11-18T16:22:03.6905015Z,2020,101,10,33,73,0,11mo,3,0,28,0,0,91,68,0,98,2,0,0
61572,10302,2020-11-18T16:22:03.6915014Z,2020,100,15,36,67,0,12mo,1,0,33,0,0,85,64,0,98,6,0,1
61572,10303,2020-11-18T16:22:03.6915014Z,2020,24,2,11,16,0,6to,0,0,8,0,0,22,13,1,23,2,0,0
61572,10304,2020-11-18T16:22:03.6915014Z,2020,67,3,15,50,0,7mo,2,0,17,0,0,64,52,0,65,0,0,0
61572,10305,2020-11-18T16:22:03.6925037Z,2020,78,12,27,53,0,8vo,3,0,25,0,0,66,51,0,74,3,0,1
61572,10306,2020-11-18T16:22:03.6925037Z,2020,96,13,25,78,0,9no,3,0,18,0,0,83,71,0,92,2,0,1
61572,34315,2021-06-24T13:18:38.6021359Z,2021,103,12,30,83,0,10mo,3,1,20,0,0,91,73,0,99,2,0,1
61572,34316,2021-06-24T13:18:38.6021359Z,2021,100,16,30,64,0,11mo,1,0,36,0,0,84,70,0,99,1,0,0
61572,34317,2021-06-24T13:18:38.6021359Z,2021,100,10,35,72,0,12mo,3,0,28,0,0,90,65,0,97,2,0,0
61572,34318,2021-06-24T13:18:38.6031364Z,2021,40,5,24,28,0,6to,1,0,12,0,0,35,16,0,39,0,0,0
61572,34319,2021-06-24T13:18:38.6031364Z,2021,61,7,26,42,0,7mo,3,0,19,0,0,54,35,1,57,2,0,0
61572,34320,2021-06-24T13:18:38.6031364Z,2021,78,5,22,57,0,8vo,2,0,21,0,0,73,56,0,75,0,0,1
61572,34321,2021-06-24T13:18:38.6031364Z,2021,92,13,38,64,0,9no,3,0,28,0,0,79,54,0,88,3,0,1
61572,4286,2020-11-18T16:21:09.0430631Z,2019,117,10,37,83,0,10mo,4,0,34,0,0,107,80,0,113,2,0,0
61572,4287,2020-11-18T16:21:09.0440631Z,2019,101,15,37,67,0,11mo,1,0,34,0,0,86,64,0,99,6,0,1
61572,4288,2020-11-18T16:21:09.0440631Z,2019,106,0,37,75,0,12mo,1,0,31,0,0,106,69,0,105,0,0,0
61572,4289,2020-11-18T16:21:09.0440631Z,2019,52,5,16,38,0,6to,1,0,14,0,0,47,36,0,51,0,0,0
61572,4290,2020-11-18T16:21:09.0440631Z,2019,73,15,26,50,0,7mo,3,0,23,0,0,58,47,0,69,3,0,1
61572,4291,2020-11-18T16:21:09.0440631Z,2019,98,13,28,72,0,8vo,3,0,26,0,0,85,70,0,94,1,0,1
61572,4292,2020-11-18T16:21:09.0450649Z,2019,103,15,31,65,0,9no,2,0,38,0,0,88,72,0,101,1,0,0
23887,1399,2020-11-18T16:20:45.9026325Z,2019,119,88,109,26,0,Sin Grado,1,3,93,0,0,31,10,0,118,0,2,0
23887,31400,2021-06-24T13:18:14.8851227Z,2021,72,72,64,21,0,Sin Grado,1,3,51,0,0,0,8,0,71,0,1,0
23887,7403,2020-11-18T16:21:45.7415375Z,2020,84,84,74,22,0,Sin Grado,1,3,62,0,0,0,10,0,83,0,2,0
73494,11492,2020-11-18T16:22:10.5881026Z,2020,100,100,94,22,0,Sin Grado,2,3,78,0,0,0,6,0,98,0,0,0
73494,35514,2021-06-24T13:18:46.5588411Z,2021,92,90,84,23,0,Sin Grado,2,6,69,0,0,2,8,0,90,0,0,0
73494,5482,2020-11-18T16:21:15.4873571Z,2019,115,73,110,26,0,Sin Grado,0,8,89,0,0,42,5,0,115,0,0,0
61366,10207,2020-11-18T16:22:03.1091142Z,2020,145,143,103,49,0,Sin Grado,4,10,96,0,0,2,42,1,140,0,1,0
61366,34223,2021-06-24T13:18:38.0387317Z,2021,176,167,135,65,0,Sin Grado,3,14,111,0,0,9,41,0,173,2,0,0
61366,4192,2020-11-18T16:21:08.013378Z,2019,133,91,116,38,0,Sin Grado,1,10,95,0,0,42,17,1,131,0,1,0
30167,1760,2020-11-18T16:20:48.8636044Z,2019,51,0,9,22,0,10mo,0,0,29,0,0,51,42,0,51,0,0,0
30167,1761,2020-11-18T16:20:48.8636044Z,2019,45,0,22,24,0,11mo,0,0,21,0,0,45,23,0,45,0,0,0
30167,1762,2020-11-18T16:20:48.8646049Z,2019,56,0,17,29,0,12mo,0,0,27,0,0,56,39,0,56,0,0,0
30167,1763,2020-11-18T16:20:48.8646049Z,2019,56,1,19,31,0,9no,0,0,25,0,0,55,37,0,55,0,0,1
30167,31763,2021-06-24T13:18:17.23781Z,2021,40,2,14,27,0,10mo,2,0,13,0,0,38,26,0,38,0,0,0
30167,31764,2021-06-24T13:18:17.23781Z,2021,59,2,28,35,0,11mo,0,0,24,0,0,57,31,0,58,0,0,1
30167,31765,2021-06-24T13:18:17.23781Z,2021,48,0,18,22,0,12mo,0,0,26,0,0,48,30,0,48,0,0,0
30167,31766,2021-06-24T13:18:17.23781Z,2021,36,1,14,18,0,9no,0,0,18,0,0,35,22,0,36,0,0,0
30167,7766,2020-11-18T16:21:47.9169841Z,2020,62,1,23,36,0,10mo,0,0,26,0,0,61,39,0,61,0,0,1
30167,7767,2020-11-18T16:21:47.9169841Z,2020,48,0,8,22,0,11mo,0,0,26,0,0,48,40,0,48,0,0,0
30167,7768,2020-11-18T16:21:47.9169841Z,2020,45,0,20,25,0,12mo,0,0,20,0,0,45,25,0,45,0,0,0
30167,7769,2020-11-18T16:21:47.9169841Z,2020,28,1,8,18,0,9no,2,0,10,0,0,27,20,0,26,0,0,0
44560,2982,2020-11-18T16:20:59.9159747Z,2019,67,0,15,35,0,10mo,1,0,32,0,0,67,52,0,66,0,0,0
44560,2983,2020-11-18T16:20:59.9159747Z,2019,26,0,6,19,0,11mo,1,0,7,0,0,26,20,0,25,0,0,0
44560,2984,2020-11-18T16:20:59.9169752Z,2019,83,0,21,44,0,12mo,0,0,39,0,0,83,62,0,83,0,0,0
44560,2985,2020-11-18T16:20:59.9169752Z,2019,61,1,23,34,0,9no,0,0,27,0,0,60,38,0,61,0,0,0
44560,32991,2021-06-24T13:18:28.9191931Z,2021,83,0,23,42,0,10mo,3,0,41,0,0,83,60,0,80,0,0,0
44560,32992,2021-06-24T13:18:28.9191931Z,2021,78,1,27,40,0,11mo,0,0,38,0,0,77,51,0,78,0,0,0
44560,32993,2021-06-24T13:18:28.9191931Z,2021,21,0,5,12,0,12mo,0,0,9,0,0,21,16,0,21,0,0,0
44560,32994,2021-06-24T13:18:28.9201931Z,2021,53,2,21,29,0,9no,2,0,24,0,0,51,32,0,51,0,0,0
44560,8996,2020-11-18T16:21:55.00271Z,2020,74,1,31,41,0,10mo,0,0,33,0,0,73,43,0,74,0,0,0
44560,8997,2020-11-18T16:21:55.00271Z,2020,18,1,4,10,0,11mo,0,0,8,0,0,17,14,0,18,0,0,0
44560,8998,2020-11-18T16:21:55.00271Z,2020,82,0,20,51,0,12mo,1,0,31,0,0,82,62,1,80,0,0,0
44560,8999,2020-11-18T16:21:55.00271Z,2020,70,1,21,38,0,9no,1,0,32,0,0,69,49,0,69,0,1,0
54862,33814,2021-06-24T13:18:35.7240726Z,2021,75,1,35,39,0,10mo,1,0,36,0,0,74,40,0,74,0,0,0
54862,33815,2021-06-24T13:18:35.7240726Z,2021,53,3,22,30,0,11mo,0,0,23,0,0,50,31,1,51,0,0,1
54862,33816,2021-06-24T13:18:35.7250726Z,2021,50,0,26,30,0,12mo,1,0,20,0,0,50,24,0,49,0,0,0
54862,33817,2021-06-24T13:18:35.7250726Z,2021,62,1,17,37,0,9no,1,0,25,0,0,61,45,0,61,0,0,0
54862,3791,2020-11-18T16:21:05.1314525Z,2019,77,2,29,46,0,10mo,0,0,31,0,0,75,48,0,77,0,0,0
54862,3792,2020-11-18T16:21:05.1324534Z,2019,27,0,9,10,0,11mo,0,0,17,0,0,27,18,0,27,0,0,0
54862,3793,2020-11-18T16:21:05.1324534Z,2019,38,0,14,19,0,12mo,0,0,19,0,0,38,24,0,38,0,0,0
54862,3794,2020-11-18T16:21:05.1324534Z,2019,84,4,27,56,0,9no,1,0,28,0,0,80,57,1,81,0,0,1
54862,9808,2020-11-18T16:22:00.5063798Z,2020,66,3,21,42,0,10mo,1,0,24,0,0,63,45,1,63,0,0,1
54862,9809,2020-11-18T16:22:00.5073807Z,2020,46,1,19,23,0,11mo,0,0,23,0,0,45,27,0,46,0,0,0
54862,9810,2020-11-18T16:22:00.5073807Z,2020,30,0,9,15,0,12mo,0,0,15,0,0,30,21,0,30,0,0,0
54862,9811,2020-11-18T16:22:00.5073807Z,2020,79,3,22,42,0,9no,1,0,37,0,0,76,57,0,78,0,0,0
45310,3002,2020-11-18T16:21:00.3142408Z,2019,128,87,115,21,0,Sin Grado,1,0,107,0,0,41,13,0,127,0,1,0
45310,33011,2021-06-24T13:18:29.7968217Z,2021,107,106,95,29,0,Sin Grado,3,0,78,0,0,1,12,0,104,0,1,0
45310,9016,2020-11-18T16:21:55.4159868Z,2020,107,103,95,22,0,Sin Grado,2,0,85,0,0,4,12,0,105,0,2,0
42572,2786,2020-11-18T16:20:58.7812167Z,2019,30,8,25,15,0,1ro,1,2,15,0,0,22,5,0,29,0,0,0
42572,2787,2020-11-18T16:20:58.7812167Z,2019,26,7,20,13,0,2do,0,1,13,0,0,19,6,0,26,1,0,0
42572,2788,2020-11-18T16:20:58.7812167Z,2019,17,5,14,9,0,3ro,1,4,8,0,0,12,3,0,16,2,0,0
42572,2789,2020-11-18T16:20:58.7822167Z,2019,33,9,29,11,0,4to,1,2,22,0,0,24,4,0,32,0,0,0
42572,2790,2020-11-18T16:20:58.7822167Z,2019,22,8,17,8,0,5to,0,1,14,0,0,14,5,0,22,0,0,0
42572,2791,2020-11-18T16:20:58.7822167Z,2019,28,8,23,11,0,K,1,2,17,0,0,20,5,0,27,0,0,0
42572,2792,2020-11-18T16:20:58.7822167Z,2019,17,5,15,9,0,PK,0,0,8,0,0,12,2,0,17,0,0,0
42572,32792,2021-06-24T13:18:27.212969Z,2021,24,5,21,14,0,1ro,1,1,10,0,0,19,3,0,23,0,0,0
42572,32793,2021-06-24T13:18:27.212969Z,2021,36,8,29,11,0,2do,0,3,25,0,0,28,7,0,36,0,0,0
42572,32794,2021-06-24T13:18:27.212969Z,2021,35,9,30,16,0,3ro,1,3,19,0,0,26,5,0,34,0,0,0
42572,32795,2021-06-24T13:18:27.2139695Z,2021,30,10,19,18,0,4to,0,3,12,0,0,20,11,0,30,1,0,0
42572,32796,2021-06-24T13:18:27.2139695Z,2021,21,5,18,12,0,5to,0,2,9,0,0,16,3,0,21,2,0,0
42572,32797,2021-06-24T13:18:27.2139695Z,2021,35,10,30,17,0,K,1,0,18,0,0,25,5,0,34,0,0,0
42572,32798,2021-06-24T13:18:27.2149704Z,2021,18,3,14,7,0,PK,0,0,11,0,0,15,4,0,18,0,0,0
42572,8796,2020-11-18T16:21:53.8219212Z,2020,29,7,22,7,0,1ro,0,2,22,0,0,22,7,0,29,0,0,0
42572,8797,2020-11-18T16:21:53.8219212Z,2020,26,7,20,12,0,2do,1,1,14,0,0,19,6,0,25,0,0,0
42572,8798,2020-11-18T16:21:53.8219212Z,2020,28,9,17,17,0,3ro,0,4,11,0,0,19,11,0,28,1,0,0
42572,8799,2020-11-18T16:21:53.8219212Z,2020,15,4,13,8,0,4to,0,3,7,0,0,11,2,0,15,2,0,0
42572,8800,2020-11-18T16:21:53.8229217Z,2020,31,10,27,9,0,5to,1,5,22,0,0,21,4,0,30,0,0,0
42572,8801,2020-11-18T16:21:54.2061784Z,2020,24,5,19,15,0,K,0,1,9,0,0,19,5,0,24,0,0,0
42572,8802,2020-11-18T16:21:54.2061784Z,2020,31,6,25,18,0,PK,1,0,13,0,0,25,6,0,29,0,0,1
23259,1362,2020-11-18T16:20:45.8966294Z,2019,35,16,32,18,0,1ro,0,0,17,0,0,19,3,0,35,0,0,0
23259,1363,2020-11-18T16:20:45.8976289Z,2019,38,16,30,18,0,2do,1,0,20,0,0,22,8,0,37,0,0,0
23259,1364,2020-11-18T16:20:45.8976289Z,2019,41,10,32,20,0,3ro,1,0,21,0,0,31,9,0,40,0,0,0
23259,1365,2020-11-18T16:20:45.8976289Z,2019,45,15,35,24,0,4to,0,0,21,0,0,30,10,0,45,0,0,0
23259,1366,2020-11-18T16:20:45.8976289Z,2019,43,19,35,19,0,5to,0,0,24,0,0,24,8,0,43,0,0,0
23259,1367,2020-11-18T16:20:45.8986303Z,2019,26,6,17,13,0,K,0,0,13,0,0,20,9,0,25,0,0,1
23259,1368,2020-11-18T16:20:45.8986303Z,2019,5,5,5,2,0,Sin Grado,0,0,3,0,0,0,0,0,5,0,0,0
23259,31364,2021-06-24T13:18:14.6019199Z,2021,11,3,9,7,0,1ro,0,0,4,0,0,8,2,0,11,0,0,0
23259,31365,2021-06-24T13:18:14.6019199Z,2021,19,3,15,11,0,2do,0,1,8,0,0,16,4,0,19,0,0,0
23259,31366,2021-06-24T13:18:14.6019199Z,2021,23,6,19,11,0,3ro,0,0,12,0,0,17,4,0,23,0,0,0
23259,31367,2021-06-24T13:18:14.6019199Z,2021,32,12,27,16,0,4to,0,2,16,0,0,20,5,0,32,0,0,0
23259,31368,2021-06-24T13:18:14.6019199Z,2021,30,4,25,16,0,5to,1,0,14,0,0,26,5,0,29,0,0,0
23259,31369,2021-06-24T13:18:14.6029204Z,2021,17,6,10,10,0,K,0,2,7,0,0,11,7,0,17,0,0,0
23259,7367,2020-11-18T16:21:45.3452711Z,2020,22,3,18,13,0,1ro,0,0,9,0,0,19,4,0,22,0,0,0
23259,7368,2020-11-18T16:21:45.3452711Z,2020,29,9,25,14,0,2do,0,0,15,0,0,20,4,0,29,0,0,0
23259,7369,2020-11-18T16:21:45.3452711Z,2020,38,14,27,18,0,3ro,1,2,20,0,0,24,11,0,37,0,0,0
23259,7370,2020-11-18T16:21:45.3462733Z,2020,37,8,28,18,0,4to,1,1,19,0,0,29,9,0,36,0,0,0
23259,7371,2020-11-18T16:21:45.3462733Z,2020,42,14,32,23,0,5to,0,2,19,0,0,28,10,0,42,0,0,0
23259,7372,2020-11-18T16:21:45.3462733Z,2020,19,4,15,8,0,K,0,0,11,0,0,15,4,0,19,0,0,0
20727,1061,2020-11-18T16:20:43.8102355Z,2019,24,9,22,7,0,1ro,1,0,17,0,0,15,2,0,23,0,0,0
20727,1062,2020-11-18T16:20:43.8102355Z,2019,42,14,35,26,0,2do,0,0,16,0,0,28,7,0,42,0,0,0
20727,1063,2020-11-18T16:20:43.8102355Z,2019,40,16,39,15,0,3ro,1,0,25,0,0,24,1,0,39,0,0,0
20727,1064,2020-11-18T16:20:43.811235Z,2019,31,12,29,17,0,4to,0,0,14,0,0,19,2,0,31,0,0,0
20727,1065,2020-11-18T16:20:43.811235Z,2019,31,14,25,14,0,5to,0,1,17,0,0,17,6,0,31,0,0,0
20727,1066,2020-11-18T16:20:43.811235Z,2019,27,6,20,14,0,K,0,0,13,0,0,21,7,0,27,0,0,0
20727,31061,2021-06-24T13:18:12.0731068Z,2021,23,6,19,11,0,1ro,0,0,12,0,0,17,4,0,23,0,0,0
20727,31062,2021-06-24T13:18:12.0741077Z,2021,29,7,26,16,0,2do,0,0,13,0,0,22,3,0,29,0,0,0
20727,31063,2021-06-24T13:18:12.0741077Z,2021,24,7,22,9,0,3ro,1,0,15,0,0,17,2,0,23,0,0,0
20727,31064,2021-06-24T13:18:12.0741077Z,2021,41,13,37,23,0,4to,0,0,18,0,0,28,4,0,41,0,0,0
20727,31065,2021-06-24T13:18:12.0751082Z,2021,29,10,28,10,0,5to,0,0,19,0,0,19,1,0,29,0,0,0
20727,31066,2021-06-24T13:18:12.0751082Z,2021,26,3,24,10,0,K,0,1,16,0,0,23,2,0,26,0,0,0
20727,7065,2020-11-18T16:21:43.639132Z,2020,29,7,22,16,0,1ro,0,0,13,0,0,22,7,0,29,0,0,0
20727,7066,2020-11-18T16:21:43.639132Z,2020,24,9,23,11,0,2do,1,0,13,0,0,15,1,0,23,0,0,0
20727,7067,2020-11-18T16:21:43.639132Z,2020,42,14,34,24,0,3ro,0,0,18,0,0,28,8,0,42,0,0,0
20727,7068,2020-11-18T16:21:43.6401338Z,2020,30,10,29,11,0,4to,0,0,19,0,0,20,1,0,30,0,0,0
20727,7069,2020-11-18T16:21:43.6401338Z,2020,28,11,25,12,0,5to,0,0,16,0,0,17,3,0,28,0,0,0
20727,7070,2020-11-18T16:21:43.6401338Z,2020,24,5,20,13,0,K,0,0,11,0,0,19,4,0,24,0,0,0
28100,1685,2020-11-18T16:20:48.2722114Z,2019,24,10,24,13,0,1ro,1,0,11,0,0,14,0,0,23,0,0,0
28100,1686,2020-11-18T16:20:48.2722114Z,2019,23,7,22,11,0,2do,0,2,12,0,0,16,1,0,23,0,0,0
28100,1687,2020-11-18T16:20:48.2722114Z,2019,30,6,28,16,0,3ro,0,0,14,0,0,24,2,0,30,0,0,0
28100,1688,2020-11-18T16:20:48.2722114Z,2019,25,8,21,13,0,4to,0,0,12,0,0,17,4,0,25,1,0,0
28100,1689,2020-11-18T16:20:48.2732122Z,2019,33,13,30,15,0,5to,2,0,18,0,0,20,3,0,31,0,0,0
28100,1690,2020-11-18T16:20:48.2732122Z,2019,20,11,18,9,0,K,0,0,11,0,0,9,2,0,20,0,0,0
28100,1691,2020-11-18T16:20:48.2732122Z,2019,26,26,23,6,0,Sin Grado,0,4,20,0,0,0,3,0,26,0,0,0
28100,31687,2021-06-24T13:18:16.127013Z,2021,23,8,23,8,0,1ro,0,0,15,0,0,15,0,0,23,0,0,0
28100,31688,2021-06-24T13:18:16.1280135Z,2021,17,10,16,6,0,2do,0,0,11,0,0,7,1,0,17,0,0,0
28100,31689,2021-06-24T13:18:16.1280135Z,2021,20,8,18,10,0,3ro,1,1,10,0,0,12,2,0,19,0,0,0
28100,31690,2021-06-24T13:18:16.1290144Z,2021,23,7,19,11,0,4to,0,0,12,0,0,16,4,0,23,0,0,0
28100,31691,2021-06-24T13:18:16.1290144Z,2021,31,10,26,14,0,5to,0,0,17,0,0,21,5,0,31,0,0,0
28100,31692,2021-06-24T13:18:16.1300154Z,2021,10,5,6,3,0,K,0,0,7,0,0,5,4,0,10,0,0,0
28100,31693,2021-06-24T13:18:16.1300154Z,2021,23,23,18,5,0,Sin Grado,0,0,18,0,0,0,5,0,23,0,0,0
28100,7690,2020-11-18T16:21:47.2105117Z,2020,15,8,15,8,0,1ro,0,1,7,0,0,7,0,0,15,0,0,0
28100,7691,2020-11-18T16:21:47.2105117Z,2020,24,9,21,13,0,2do,1,1,11,0,0,15,3,0,23,0,0,0
28100,7692,2020-11-18T16:21:47.2105117Z,2020,21,5,19,10,0,3ro,0,0,11,0,0,16,2,0,21,0,0,0
28100,7693,2020-11-18T16:21:47.2115113Z,2020,31,10,28,14,0,4to,0,2,17,0,0,21,3,0,31,0,0,0
28100,7694,2020-11-18T16:21:47.2115113Z,2020,22,6,17,13,0,5to,0,1,9,0,0,16,5,0,22,1,0,0
28100,7695,2020-11-18T16:21:47.2115113Z,2020,23,8,22,8,0,K,0,0,15,0,0,15,1,0,23,0,0,0
28100,7696,2020-11-18T16:21:47.2115113Z,2020,28,28,26,6,0,Sin Grado,0,3,22,0,0,0,2,0,28,0,0,0
21493,1198,2020-11-18T16:20:44.6437907Z,2019,44,12,41,24,0,1ro,1,0,20,0,0,32,3,0,43,2,0,0
21493,1199,2020-11-18T16:20:44.644792Z,2019,46,12,39,24,0,2do,1,1,22,0,0,34,7,0,45,0,1,0
21493,1200,2020-11-18T16:20:44.644792Z,2019,36,13,30,15,0,3ro,1,0,21,0,0,23,6,0,35,0,0,0
21493,1201,2020-11-18T16:20:45.0770835Z,2019,41,12,39,16,0,4to,2,0,25,0,0,29,2,0,39,0,0,0
21493,1202,2020-11-18T16:20:45.0770835Z,2019,38,8,28,24,0,5to,1,0,14,0,0,30,10,0,37,0,0,0
21493,1203,2020-11-18T16:20:45.0770835Z,2019,32,8,27,16,0,6to,1,0,16,0,0,24,5,0,31,0,0,0
21493,1204,2020-11-18T16:20:45.0770835Z,2019,40,8,32,13,0,7mo,1,0,27,0,0,32,8,0,39,0,0,0
21493,1205,2020-11-18T16:20:45.0770835Z,2019,57,19,50,29,0,8vo,2,0,28,0,0,38,7,0,55,0,0,0
21493,1206,2020-11-18T16:20:45.0780813Z,2019,24,6,22,13,0,K,3,0,11,0,0,18,2,0,21,0,0,0
21493,1207,2020-11-18T16:20:45.0780813Z,2019,31,31,29,8,0,Sin Grado,0,0,23,0,0,0,2,0,31,0,0,0
21493,31199,2021-06-24T13:18:13.1248625Z,2021,29,4,27,13,0,1ro,0,0,16,0,0,25,2,0,29,0,0,0
21493,31200,2021-06-24T13:18:13.9884798Z,2021,21,8,18,12,0,2do,1,0,9,0,0,13,3,0,20,0,0,0
21493,31201,2021-06-24T13:18:13.9884798Z,2021,36,12,34,21,0,3ro,0,0,15,0,0,24,2,0,36,2,0,0
21493,31202,2021-06-24T13:18:13.9884798Z,2021,47,12,42,23,0,4to,1,0,24,0,0,35,5,0,46,0,1,0
21493,31203,2021-06-24T13:18:13.9894807Z,2021,38,10,33,14,0,5to,0,0,24,0,0,28,5,0,38,1,0,0
21493,31204,2021-06-24T13:18:13.9894807Z,2021,46,17,44,16,0,6to,0,0,30,0,0,29,2,0,46,0,0,0
21493,31205,2021-06-24T13:18:13.9894807Z,2021,47,14,39,26,0,7mo,2,0,21,0,0,33,8,0,45,0,0,0
21493,31206,2021-06-24T13:18:13.9894807Z,2021,33,7,28,15,0,8vo,1,0,18,0,0,26,5,0,32,0,0,0
21493,31207,2021-06-24T13:18:13.9904817Z,2021,32,8,26,14,0,K,0,0,18,0,0,24,6,0,32,0,0,0
21493,31208,2021-06-24T13:18:13.9904817Z,2021,43,41,40,12,0,Sin Grado,1,2,31,0,0,2,3,0,42,0,0,0
21493,7203,2020-11-18T16:21:44.5867644Z,2020,24,8,21,13,0,1ro,1,0,11,0,0,16,3,0,23,0,0,0
21493,7204,2020-11-18T16:21:44.5867644Z,2020,41,10,35,24,0,2do,0,0,17,0,0,31,6,0,41,2,0,0
21493,7205,2020-11-18T16:21:44.5877662Z,2020,45,11,38,23,0,3ro,1,0,22,0,0,34,7,0,44,0,1,0
21493,7206,2020-11-18T16:21:44.5877662Z,2020,36,11,30,14,0,4to,0,0,22,0,0,25,6,0,36,0,0,0
21493,7207,2020-11-18T16:21:44.5877662Z,2020,37,12,31,13,0,5to,1,0,24,0,0,25,6,0,36,0,0,0
21493,7208,2020-11-18T16:21:44.5887662Z,2020,49,15,38,26,0,6to,1,0,23,0,0,34,11,0,48,0,0,0
21493,7209,2020-11-18T16:21:44.5887662Z,2020,38,11,32,18,0,7mo,1,0,20,0,0,27,6,0,37,0,0,0
21493,7210,2020-11-18T16:21:44.5887662Z,2020,41,11,33,13,0,8vo,0,0,28,0,0,30,8,0,41,0,0,0
21493,7211,2020-11-18T16:21:44.5897671Z,2020,29,4,24,13,0,K,0,0,16,0,0,25,5,0,29,0,0,0
21493,7212,2020-11-18T16:21:44.5897671Z,2020,37,37,33,7,0,Sin Grado,0,0,30,0,0,0,4,0,37,0,0,0
74237,11517,2020-11-18T16:22:11.3005781Z,2020,23,3,21,11,0,1ro,0,0,12,0,0,20,2,0,23,0,0,0
74237,11518,2020-11-18T16:22:11.301579Z,2020,25,10,20,11,0,2do,0,0,14,0,0,15,5,0,25,0,0,0
74237,11519,2020-11-18T16:22:11.301579Z,2020,29,12,25,12,0,3ro,0,1,17,0,0,17,4,0,29,0,0,0
74237,11520,2020-11-18T16:22:11.301579Z,2020,26,13,22,12,0,4to,0,0,14,0,0,13,4,0,26,0,0,0
74237,11521,2020-11-18T16:22:11.301579Z,2020,36,15,34,15,0,5to,0,0,21,0,0,21,2,0,36,0,0,0
74237,11522,2020-11-18T16:22:11.301579Z,2020,59,16,54,36,0,6to,1,1,23,0,0,43,5,0,58,1,0,0
74237,11523,2020-11-18T16:22:11.3025799Z,2020,48,17,38,19,0,7mo,0,0,29,0,0,31,10,0,48,0,0,0
74237,11524,2020-11-18T16:22:11.3025799Z,2020,63,17,58,29,0,8vo,0,1,34,0,0,46,5,0,63,0,0,0
74237,11525,2020-11-18T16:22:11.3025799Z,2020,19,3,13,10,0,K,0,0,9,0,0,16,6,0,19,0,0,0
74237,11526,2020-11-18T16:22:11.3025799Z,2020,15,15,15,4,0,Sin Grado,0,0,11,0,0,0,0,0,15,0,0,0
74237,35539,2021-06-24T13:18:46.5788554Z,2021,17,5,13,8,0,1ro,0,0,9,0,0,12,4,0,17,0,0,0
74237,35540,2021-06-24T13:18:46.5788554Z,2021,24,6,24,11,0,2do,0,0,13,0,0,18,0,0,24,0,0,0
74237,35541,2021-06-24T13:18:46.5798559Z,2021,25,7,22,11,0,3ro,0,0,14,0,0,18,3,0,25,0,0,0
74237,35542,2021-06-24T13:18:46.5798559Z,2021,30,15,27,13,0,4to,0,0,17,0,0,15,3,0,30,0,0,0
74237,35543,2021-06-24T13:18:46.5798559Z,2021,29,14,27,14,0,5to,0,0,15,0,0,15,2,0,29,0,0,0
74237,35544,2021-06-24T13:18:46.5798559Z,2021,44,17,39,23,0,6to,0,0,21,0,0,27,5,0,44,0,0,0
74237,35545,2021-06-24T13:18:46.5808573Z,2021,60,18,55,37,0,7mo,1,0,23,0,0,42,5,0,59,1,0,0
74237,35546,2021-06-24T13:18:46.5808573Z,2021,50,19,44,20,0,8vo,0,0,30,0,0,31,6,0,50,0,0,0
74237,35547,2021-06-24T13:18:46.5808573Z,2021,17,3,15,11,0,K,0,0,6,0,0,14,2,0,17,0,0,0
74237,35548,2021-06-24T13:18:46.5818573Z,2021,15,15,14,3,0,Sin Grado,0,0,12,0,0,0,1,0,15,0,0,0
74237,5509,2020-11-18T16:21:16.1778192Z,2019,24,8,21,10,0,1ro,0,0,14,0,0,16,3,0,24,0,0,0
74237,5510,2020-11-18T16:21:16.1778192Z,2019,31,12,27,14,0,2do,0,0,17,0,0,19,4,0,31,0,0,0
74237,5511,2020-11-18T16:21:16.1788201Z,2019,26,13,21,13,0,3ro,0,0,13,0,0,13,5,0,26,0,0,0
74237,5512,2020-11-18T16:21:16.1798206Z,2019,32,13,29,15,0,4to,0,0,17,0,0,19,3,0,32,0,0,0
74237,5513,2020-11-18T16:21:16.1798206Z,2019,46,17,42,26,0,5to,1,0,20,0,0,29,4,0,45,0,0,0
74237,5514,2020-11-18T16:21:16.1798206Z,2019,55,21,46,22,0,6to,0,0,33,0,0,34,9,0,55,0,0,0
74237,5515,2020-11-18T16:21:16.1808201Z,2019,68,22,65,29,0,7mo,0,0,39,0,0,46,3,0,68,0,0,0
74237,5516,2020-11-18T16:21:16.1808201Z,2019,53,20,48,27,0,8vo,0,0,26,0,0,33,5,0,53,0,0,0
74237,5517,2020-11-18T16:21:16.1808201Z,2019,24,5,19,12,0,K,0,0,12,0,0,19,5,0,24,0,0,0
74237,5518,2020-11-18T16:21:16.1808201Z,2019,17,16,16,4,0,Sin Grado,0,0,13,0,0,1,1,0,17,0,0,0
23143,1355,2020-11-18T16:20:45.8946267Z,2019,40,19,34,19,0,1ro,0,4,21,0,0,21,6,0,40,0,0,0
23143,1356,2020-11-18T16:20:45.895629Z,2019,27,11,20,15,0,2do,0,1,12,0,0,16,7,0,27,0,0,0
23143,1357,2020-11-18T16:20:45.895629Z,2019,26,11,25,11,0,3ro,0,3,15,0,0,15,1,0,26,0,0,0
23143,1358,2020-11-18T16:20:45.895629Z,2019,33,12,25,19,0,4to,1,4,14,0,0,21,8,0,32,0,0,0
23143,1359,2020-11-18T16:20:45.8966294Z,2019,31,5,26,19,0,5to,0,2,12,0,0,26,5,0,31,0,0,0
23143,1360,2020-11-18T16:20:45.8966294Z,2019,24,11,22,10,0,K,0,2,14,0,0,13,2,0,24,0,0,0
23143,1361,2020-11-18T16:20:45.8966294Z,2019,12,12,11,2,0,Sin Grado,0,2,10,0,0,0,1,0,12,0,0,0
23143,31357,2021-06-24T13:18:14.6019199Z,2021,39,9,36,20,0,1ro,2,1,19,0,0,30,3,0,37,0,0,0
23143,31358,2021-06-24T13:18:14.6019199Z,2021,18,4,14,11,0,2do,0,0,7,0,0,14,4,0,18,0,0,0
23143,31359,2021-06-24T13:18:14.6019199Z,2021,43,21,38,17,0,3ro,1,3,26,0,0,22,5,0,42,0,1,0
23143,31360,2021-06-24T13:18:14.6029204Z,2021,27,12,24,15,0,4to,0,0,12,0,0,15,3,0,27,0,0,0
23143,31361,2021-06-24T13:18:14.6029204Z,2021,35,15,28,13,0,5to,0,0,22,0,0,20,7,0,35,0,0,0
23143,31362,2021-06-24T13:18:14.6029204Z,2021,25,5,23,8,0,K,0,0,17,0,0,20,2,0,25,0,0,0
23143,31363,2021-06-24T13:18:14.6029204Z,2021,19,19,16,4,0,Sin Grado,0,0,15,0,0,0,3,0,19,0,0,0
23143,7360,2020-11-18T16:21:45.3442706Z,2020,23,7,20,13,0,1ro,0,2,10,0,0,16,3,0,23,0,0,0
23143,7361,2020-11-18T16:21:45.3442706Z,2020,41,17,36,18,0,2do,0,4,23,0,0,24,5,0,41,0,0,0
23143,7362,2020-11-18T16:21:45.3452711Z,2020,29,12,23,16,0,3ro,0,3,13,0,0,17,6,0,29,0,0,0
23143,7363,2020-11-18T16:21:45.3452711Z,2020,31,14,28,11,0,4to,0,1,20,0,0,17,3,0,31,0,0,0
23143,7364,2020-11-18T16:21:45.3452711Z,2020,33,10,28,18,0,5to,1,3,15,0,0,23,5,0,32,0,0,0
23143,7365,2020-11-18T16:21:45.3452711Z,2020,46,11,39,23,0,K,2,5,23,0,0,35,7,0,44,0,0,0
23143,7366,2020-11-18T16:21:45.3462733Z,2020,21,21,21,5,0,Sin Grado,0,1,16,0,0,0,0,0,21,0,0,0
42911,2814,2020-11-18T16:20:59.171477Z,2019,25,9,20,8,0,1ro,2,0,17,0,0,16,5,0,22,1,1,1
42911,2815,2020-11-18T16:20:59.171477Z,2019,32,12,29,22,0,2do,1,0,10,0,0,20,3,0,31,0,0,0
42911,2816,2020-11-18T16:20:59.171477Z,2019,32,12,27,7,0,3ro,1,0,25,0,0,20,5,0,31,0,1,0
42911,2817,2020-11-18T16:20:59.171477Z,2019,35,9,28,12,0,4to,1,0,23,0,0,26,7,0,34,0,1,0
42911,2818,2020-11-18T16:20:59.171477Z,2019,34,14,24,12,0,5to,2,0,22,0,0,20,10,0,30,1,1,2
42911,2819,2020-11-18T16:20:59.1724779Z,2019,29,8,24,11,0,K,3,0,18,0,0,21,5,0,26,0,0,0
42911,2820,2020-11-18T16:20:59.1724779Z,2019,10,10,8,2,0,Sin Grado,0,0,8,0,0,0,2,0,10,0,0,0
42911,32820,2021-06-24T13:18:28.1896689Z,2021,36,8,33,17,0,1ro,1,0,19,0,0,28,3,0,34,0,0,1
42911,32821,2021-06-24T13:18:28.1896689Z,2021,37,15,33,10,0,2do,3,0,27,0,0,22,4,0,33,0,2,1
42911,32822,2021-06-24T13:18:28.1896689Z,2021,22,6,17,10,0,3ro,2,0,12,0,0,16,5,0,20,1,0,0
42911,32823,2021-06-24T13:18:28.1896689Z,2021,33,8,27,19,0,4to,1,0,14,0,0,25,6,0,31,0,0,1
42911,32824,2021-06-24T13:18:28.1906707Z,2021,21,8,15,3,0,5to,1,0,18,0,0,13,6,0,20,0,1,0
42911,32825,2021-06-24T13:18:28.1906707Z,2021,30,11,25,12,0,6to,1,0,18,0,0,19,5,0,29,0,1,0
42911,32826,2021-06-24T13:18:28.1906707Z,2021,29,4,25,12,0,K,0,0,17,0,0,25,4,0,29,0,0,0
42911,32827,2021-06-24T13:18:28.1906707Z,2021,4,4,2,2,0,Sin Grado,0,0,2,0,0,0,2,0,4,0,1,0
42911,8824,2020-11-18T16:21:54.2161846Z,2020,41,15,35,16,0,1ro,6,1,25,0,0,26,6,0,33,0,2,2
42911,8825,2020-11-18T16:21:54.2171855Z,2020,25,7,23,11,0,2do,2,0,14,0,0,18,2,0,23,1,0,0
42911,8826,2020-11-18T16:21:54.2171855Z,2020,37,11,30,21,0,3ro,1,2,16,0,0,26,7,0,35,0,0,1
42911,8827,2020-11-18T16:21:54.2171855Z,2020,25,11,18,6,0,4to,1,0,19,0,0,14,7,0,24,0,1,0
42911,8828,2020-11-18T16:21:54.2171855Z,2020,36,12,28,12,0,5to,0,0,24,0,0,24,8,0,36,0,1,0
42911,8829,2020-11-18T16:21:54.2171855Z,2020,36,14,29,11,0,6to,2,1,25,0,0,22,7,0,32,1,1,2
42911,8830,2020-11-18T16:21:54.2181859Z,2020,39,5,37,22,0,K,2,0,17,0,0,34,2,0,37,0,0,0
42911,8831,2020-11-18T16:21:54.2181859Z,2020,6,6,4,2,0,Sin Grado,0,0,4,0,0,0,2,0,6,0,1,0
52886,33635,2021-06-24T13:18:33.672602Z,2021,40,11,34,19,0,1ro,0,7,21,0,0,29,6,0,39,0,0,1
52886,33636,2021-06-24T13:18:33.6736021Z,2021,31,8,26,17,0,2do,0,5,14,0,0,23,5,0,31,0,0,0
52886,33637,2021-06-24T13:18:33.6736021Z,2021,39,14,34,21,0,3ro,0,0,18,0,0,25,5,0,39,0,0,0
52886,33638,2021-06-24T13:18:33.6746025Z,2021,34,9,30,14,0,4to,1,2,20,0,0,25,4,0,33,0,0,0
52886,33639,2021-06-24T13:18:33.6746025Z,2021,33,12,31,17,0,5to,2,3,16,0,0,21,2,0,30,0,0,1
52886,33640,2021-06-24T13:18:33.6746025Z,2021,35,9,33,12,0,K,1,2,23,0,0,26,2,0,34,0,0,0
52886,33641,2021-06-24T13:18:33.675603Z,2021,4,4,4,3,0,Sin Grado,0,1,1,0,0,0,0,0,4,0,0,0
52886,3610,2020-11-18T16:21:04.3169117Z,2019,43,16,36,21,0,1ro,1,4,22,0,0,27,7,0,42,0,0,0
52886,3611,2020-11-18T16:21:04.3169117Z,2019,35,10,31,14,0,2do,2,4,21,0,0,25,4,0,33,0,0,0
52886,3612,2020-11-18T16:21:04.3169117Z,2019,30,12,27,15,0,3ro,1,4,15,0,0,18,3,0,29,0,0,0
52886,3613,2020-11-18T16:21:04.3179121Z,2019,50,18,46,25,0,4to,0,1,25,0,0,32,4,0,50,0,0,0
52886,3614,2020-11-18T16:21:04.3179121Z,2019,38,7,34,18,0,5to,3,4,20,0,0,31,4,0,35,0,2,0
52886,3615,2020-11-18T16:21:04.3179121Z,2019,30,7,24,20,0,K,0,2,10,0,0,23,6,0,30,0,0,0
52886,3616,2020-11-18T16:21:04.3179121Z,2019,7,7,5,5,0,Sin Grado,0,0,2,0,0,0,2,0,7,0,0,0
52886,9629,2020-11-18T16:21:59.4927038Z,2020,32,7,25,20,0,1ro,0,5,12,0,0,25,7,0,32,0,0,0
52886,9630,2020-11-18T16:21:59.4927038Z,2020,36,13,30,17,0,2do,0,3,19,0,0,23,6,0,36,0,0,0
52886,9631,2020-11-18T16:21:59.4927038Z,2020,34,9,28,15,0,3ro,1,3,19,0,0,25,6,0,33,0,0,0
52886,9632,2020-11-18T16:21:59.4937051Z,2020,31,12,28,15,0,4to,0,4,16,0,0,19,3,0,30,0,0,1
52886,9633,2020-11-18T16:21:59.4937051Z,2020,50,18,47,24,0,5to,0,6,26,0,0,32,3,0,50,0,0,0
52886,9634,2020-11-18T16:21:59.4937051Z,2020,47,12,39,20,0,K,0,7,27,0,0,35,8,0,46,0,0,1
52886,9635,2020-11-18T16:21:59.4937051Z,2020,5,5,4,4,0,Sin Grado,0,1,1,0,0,0,1,0,5,0,0,0
58503,10094,2020-11-18T16:22:01.9583486Z,2020,111,37,82,53,0,10mo,2,2,58,0,0,74,29,0,109,1,0,0
58503,10095,2020-11-18T16:22:01.9593491Z,2020,66,26,44,31,0,11mo,1,1,35,0,0,40,22,0,65,0,0,0
58503,10096,2020-11-18T16:22:01.9593491Z,2020,77,31,55,28,0,12mo,0,1,49,0,0,46,22,0,77,4,0,0
58503,10097,2020-11-18T16:22:01.9593491Z,2020,107,40,80,45,0,9no,0,2,62,0,0,67,27,0,107,0,0,0
58503,34102,2021-06-24T13:18:37.4202886Z,2021,110,36,88,49,0,10mo,0,2,61,0,0,74,22,0,110,0,0,0
58503,34103,2021-06-24T13:18:37.4212891Z,2021,102,34,74,51,0,11mo,1,2,51,0,0,68,28,0,101,1,0,0
58503,34104,2021-06-24T13:18:37.4212891Z,2021,65,26,49,31,0,12mo,1,0,34,0,0,39,16,0,64,0,0,0
58503,34105,2021-06-24T13:18:37.4212891Z,2021,118,44,101,74,0,9no,6,0,44,0,0,74,17,0,112,1,2,0
58503,4076,2020-11-18T16:21:07.3049057Z,2019,71,26,50,34,0,10mo,1,1,37,0,0,45,21,0,70,0,0,0
58503,4077,2020-11-18T16:21:07.3059043Z,2019,82,29,64,32,0,11mo,0,1,50,0,0,53,18,0,82,4,0,0
58503,4078,2020-11-18T16:21:07.3059043Z,2019,62,0,44,30,0,12mo,0,3,32,0,0,62,18,0,62,0,0,0
58503,4079,2020-11-18T16:21:07.3059043Z,2019,113,37,88,50,0,9no,1,2,63,0,0,76,25,0,112,1,0,0
70425,11002,2020-11-18T16:22:07.6111151Z,2020,29,8,27,17,0,1ro,3,0,12,0,0,21,2,0,25,0,0,1
70425,11003,2020-11-18T16:22:07.6111151Z,2020,29,6,24,13,0,2do,1,0,16,0,0,23,5,0,28,0,0,0
70425,11004,2020-11-18T16:22:07.6111151Z,2020,24,5,22,13,0,3ro,2,0,11,0,0,19,2,0,21,0,0,1
70425,11005,2020-11-18T16:22:07.6121155Z,2020,36,11,29,19,0,4to,1,0,17,0,0,25,7,0,35,1,0,0
70425,11006,2020-11-18T16:22:07.6121155Z,2020,29,13,19,14,0,5to,0,1,15,0,0,16,10,0,29,0,0,0
70425,11007,2020-11-18T16:22:07.6121155Z,2020,23,9,20,10,0,K,1,0,13,0,0,14,3,0,21,0,0,1
70425,11008,2020-11-18T16:22:07.6131168Z,2020,25,25,19,2,0,Sin Grado,0,0,23,0,0,0,6,0,25,0,0,0
70425,35023,2021-06-24T13:18:43.704795Z,2021,25,9,22,13,0,1ro,2,0,12,0,0,16,3,0,23,0,0,0
70425,35024,2021-06-24T13:18:43.704795Z,2021,32,11,31,22,0,2do,2,0,10,0,0,21,1,0,30,0,0,0
70425,35025,2021-06-24T13:18:43.704795Z,2021,35,10,31,14,0,3ro,1,0,21,0,0,25,4,0,34,1,0,0
70425,35026,2021-06-24T13:18:43.705795Z,2021,24,10,23,12,0,4to,4,0,12,0,0,14,1,0,20,0,0,0
70425,35027,2021-06-24T13:18:43.705795Z,2021,34,11,29,16,0,5to,1,0,18,0,0,23,5,0,33,1,0,0
70425,35028,2021-06-24T13:18:43.705795Z,2021,37,12,33,18,0,K,1,0,19,0,0,25,4,0,36,0,0,0
70425,35029,2021-06-24T13:18:43.705795Z,2021,30,30,25,3,0,Sin Grado,1,0,27,0,0,0,5,0,29,0,0,0
70425,4993,2020-11-18T16:21:13.0327239Z,2019,25,5,23,14,0,1ro,0,0,11,0,0,20,2,0,25,0,0,0
70425,4994,2020-11-18T16:21:13.0327239Z,2019,22,6,21,11,0,2do,0,0,11,0,0,16,1,0,22,0,0,0
70425,4995,2020-11-18T16:21:13.0337243Z,2019,31,8,25,17,0,3ro,0,0,14,0,0,23,6,0,31,1,0,0
70425,4996,2020-11-18T16:21:13.0337243Z,2019,28,12,19,15,0,4to,0,0,13,0,0,16,9,0,28,0,0,0
70425,4997,2020-11-18T16:21:13.0337243Z,2019,27,10,20,13,0,5to,1,0,14,0,0,17,7,0,26,0,0,0
70425,4998,2020-11-18T16:21:13.0337243Z,2019,23,7,21,13,0,K,2,0,10,0,0,16,2,0,21,0,0,0
70425,4999,2020-11-18T16:21:13.0337243Z,2019,23,23,17,3,0,Sin Grado,0,0,20,0,0,0,6,0,23,0,0,0
32714,2104,2020-11-18T16:20:54.5614034Z,2019,50,9,38,25,0,1ro,0,1,25,0,0,41,12,0,50,0,0,0
32714,2105,2020-11-18T16:20:54.5614034Z,2019,46,11,36,29,0,2do,0,2,17,0,0,35,10,0,46,0,0,0
32714,2106,2020-11-18T16:20:54.5624043Z,2019,43,10,35,26,0,3ro,1,1,17,0,0,33,8,0,42,0,0,0
32714,2107,2020-11-18T16:20:54.5624043Z,2019,45,11,35,19,0,4to,2,2,26,0,0,34,10,0,43,0,0,0
32714,2108,2020-11-18T16:20:54.5624043Z,2019,42,12,34,22,0,5to,0,2,20,0,0,30,8,0,42,0,0,0
32714,2109,2020-11-18T16:20:54.5624043Z,2019,40,10,34,26,0,K,0,2,14,0,0,30,6,0,40,0,0,0
32714,2110,2020-11-18T16:20:54.5634048Z,2019,4,4,3,3,0,Sin Grado,0,0,1,0,0,0,1,0,4,0,0,0
32714,32110,2021-06-24T13:18:20.8854262Z,2021,40,7,35,22,0,1ro,0,0,18,0,0,33,5,0,40,0,0,0
32714,32111,2021-06-24T13:18:20.8854262Z,2021,42,9,38,27,0,2do,3,0,15,0,0,33,4,0,39,0,0,0
32714,32112,2021-06-24T13:18:20.8854262Z,2021,41,8,38,18,0,3ro,1,0,23,0,0,33,3,0,39,0,0,1
32714,32113,2021-06-24T13:18:20.8854262Z,2021,43,10,39,25,0,4to,3,0,18,0,0,33,4,0,40,0,0,0
32714,32114,2021-06-24T13:18:20.8864267Z,2021,35,7,28,24,0,5to,1,0,11,0,0,28,7,0,34,0,0,0
32714,32115,2021-06-24T13:18:20.8864267Z,2021,41,10,39,17,0,K,1,0,24,0,0,31,2,0,40,0,0,0
32714,32116,2021-06-24T13:18:20.8864267Z,2021,8,8,7,5,0,Sin Grado,0,1,3,0,0,0,1,0,8,0,0,0
32714,8116,2020-11-18T16:21:50.2165188Z,2020,40,10,35,25,0,1ro,0,1,15,0,0,30,5,0,40,0,0,0
32714,8117,2020-11-18T16:21:50.2165188Z,2020,47,8,35,24,0,2do,0,1,23,0,0,39,12,0,46,0,0,1
32714,8118,2020-11-18T16:21:50.2165188Z,2020,42,10,38,26,0,3ro,0,3,16,0,0,32,4,0,42,0,0,0
32714,8119,2020-11-18T16:21:50.2165188Z,2020,35,8,31,22,0,4to,0,1,13,0,0,27,4,0,35,0,0,0
32714,8120,2020-11-18T16:21:50.2165188Z,2020,47,10,37,19,0,5to,1,1,28,0,0,37,10,0,46,0,0,0
32714,8121,2020-11-18T16:21:50.2175193Z,2020,41,7,32,21,0,K,0,1,20,0,0,34,9,0,41,0,0,0
32714,8122,2020-11-18T16:21:50.2175193Z,2020,9,9,6,6,0,Sin Grado,0,1,3,0,0,0,3,0,9,0,0,0
76562,11668,2020-11-18T16:22:11.73587Z,2020,12,3,11,4,0,1ro,0,0,8,0,0,9,1,0,12,0,0,0
76562,11669,2020-11-18T16:22:11.73587Z,2020,32,14,27,12,0,2do,1,0,20,0,0,18,5,0,31,0,0,0
76562,11670,2020-11-18T16:22:11.7368709Z,2020,21,3,20,11,0,3ro,1,0,10,0,0,18,1,0,20,0,0,0
76562,11671,2020-11-18T16:22:11.7368709Z,2020,41,24,34,17,0,4to,0,0,24,0,0,17,7,0,41,0,0,0
76562,11672,2020-11-18T16:22:11.7368709Z,2020,27,12,23,8,0,5to,0,0,19,0,0,15,4,0,27,0,0,0
76562,11673,2020-11-18T16:22:11.7368709Z,2020,49,15,45,22,0,6to,0,0,27,0,0,34,4,0,49,0,0,0
76562,11674,2020-11-18T16:22:11.7378709Z,2020,36,14,33,20,0,7mo,0,0,16,0,0,22,3,0,36,0,0,0
76562,11675,2020-11-18T16:22:11.7378709Z,2020,31,7,27,15,0,8vo,1,0,16,0,0,24,4,0,30,0,0,0
76562,11676,2020-11-18T16:22:11.7388709Z,2020,38,12,33,17,0,K,1,0,21,0,0,26,5,0,37,0,0,0
76562,11677,2020-11-18T16:22:11.7388709Z,2020,5,5,4,1,0,Sin Grado,0,0,4,0,0,0,1,0,5,0,0,0
76562,35691,2021-06-24T13:18:47.4494801Z,2021,32,10,29,17,0,1ro,0,0,15,0,0,22,3,0,32,0,0,0
76562,35692,2021-06-24T13:18:47.4504806Z,2021,16,2,15,5,0,2do,0,0,11,0,0,14,1,0,16,0,0,0
76562,35693,2021-06-24T13:18:47.4504806Z,2021,41,14,36,20,0,3ro,1,0,21,0,0,27,5,0,40,0,0,0
76562,35694,2021-06-24T13:18:47.4504806Z,2021,24,4,23,11,0,4to,1,0,13,0,0,20,1,0,23,0,0,0
76562,35695,2021-06-24T13:18:47.4504806Z,2021,46,25,37,20,0,5to,1,0,26,0,0,21,9,0,45,0,0,0
76562,35696,2021-06-24T13:18:47.4504806Z,2021,44,18,42,22,0,6to,0,0,22,0,0,26,2,0,44,0,0,0
76562,35697,2021-06-24T13:18:47.4514811Z,2021,57,16,52,26,0,7mo,0,0,31,0,0,41,5,0,57,0,1,0
76562,35698,2021-06-24T13:18:47.4514811Z,2021,36,13,34,20,0,8vo,0,0,16,0,0,23,2,0,36,0,0,0
76562,35699,2021-06-24T13:18:47.4514811Z,2021,25,12,23,10,0,K,0,0,15,0,0,13,2,0,25,0,0,0
76562,35700,2021-06-24T13:18:47.7066643Z,2021,9,9,8,1,0,Sin Grado,0,0,8,0,0,0,1,0,9,0,0,0
76562,5661,2020-11-18T16:21:16.6231173Z,2019,26,13,20,8,0,1ro,1,0,18,0,0,13,6,0,25,0,0,0
76562,5662,2020-11-18T16:21:16.6241178Z,2019,19,6,18,10,0,2do,0,0,9,0,0,13,1,0,19,0,0,0
76562,5663,2020-11-18T16:21:16.6241178Z,2019,36,18,27,18,0,3ro,0,0,18,0,0,18,9,0,36,0,0,0
76562,5664,2020-11-18T16:21:16.6241178Z,2019,22,9,18,6,0,4to,0,0,16,0,0,13,4,0,22,0,0,0
76562,5665,2020-11-18T16:21:16.6251178Z,2019,23,7,22,12,0,5to,0,0,11,0,0,16,1,0,23,0,0,0
76562,5666,2020-11-18T16:21:16.6251178Z,2019,34,13,33,16,0,6to,1,0,18,0,0,21,1,0,33,0,0,0
76562,5667,2020-11-18T16:21:16.6251178Z,2019,26,7,22,14,0,7mo,2,0,12,0,0,19,4,0,24,0,0,0
76562,5668,2020-11-18T16:21:16.6251178Z,2019,25,10,21,13,0,8vo,0,0,12,0,0,15,4,0,25,0,0,0
76562,5669,2020-11-18T16:21:16.6261196Z,2019,14,4,13,4,0,K,0,0,10,0,0,10,1,0,14,0,0,0
76562,5670,2020-11-18T16:21:16.6261196Z,2019,7,7,4,1,0,Sin Grado,0,0,6,0,0,0,3,0,7,0,0,0
51334,33391,2021-06-24T13:18:31.5750975Z,2021,23,10,22,12,0,1ro,0,0,11,0,0,13,1,0,22,0,0,1
51334,33392,2021-06-24T13:18:31.576098Z,2021,31,13,27,13,0,2do,0,0,18,0,0,18,4,0,31,0,0,0
51334,33393,2021-06-24T13:18:31.576098Z,2021,29,5,24,18,0,3ro,0,0,11,0,0,24,5,0,29,1,0,0
51334,33394,2021-06-24T13:18:31.576098Z,2021,21,5,19,10,0,K,0,0,11,0,0,16,2,0,21,0,0,0
51334,33395,2021-06-24T13:18:31.5770985Z,2021,14,14,11,4,0,Sin Grado,0,0,10,0,0,0,3,0,14,0,0,0
51334,3366,2020-11-18T16:21:02.1434623Z,2019,44,10,41,22,0,1ro,0,0,22,0,0,34,3,0,44,1,0,0
51334,3367,2020-11-18T16:21:02.1444632Z,2019,30,13,27,18,0,2do,0,0,12,0,0,17,3,0,30,1,0,0
51334,3368,2020-11-18T16:21:02.1444632Z,2019,28,10,18,12,0,3ro,2,0,16,0,0,18,10,0,26,0,0,0
51334,3369,2020-11-18T16:21:02.1444632Z,2019,26,3,21,10,0,K,0,0,16,0,0,23,5,0,26,0,0,0
51334,3370,2020-11-18T16:21:02.1444632Z,2019,41,39,33,13,0,Sin Grado,0,0,28,0,0,2,8,0,41,0,0,0
51334,9386,2020-11-18T16:21:58.0107136Z,2020,38,13,32,17,0,1ro,0,1,21,0,0,25,6,0,38,0,0,0
51334,9387,2020-11-18T16:21:58.0117149Z,2020,35,9,33,20,0,2do,0,0,15,0,0,26,2,0,35,1,0,0
51334,9388,2020-11-18T16:21:58.0117149Z,2020,24,12,22,13,0,3ro,0,0,11,0,0,12,2,0,24,1,0,0
51334,9389,2020-11-18T16:21:58.0117149Z,2020,25,9,23,13,0,K,1,0,12,0,0,16,2,0,23,0,0,1
51334,9390,2020-11-18T16:21:58.0117149Z,2020,15,14,13,5,0,Sin Grado,1,0,10,0,0,1,2,0,14,0,0,0
58263,10074,2020-11-18T16:22:01.9553464Z,2020,64,14,52,28,0,1ro,0,0,36,0,0,50,12,0,64,0,0,0
58263,10075,2020-11-18T16:22:01.9553464Z,2020,65,26,52,34,0,2do,0,1,31,0,0,39,13,0,65,0,0,0
58263,10076,2020-11-18T16:22:01.9553464Z,2020,46,18,34,25,0,3ro,0,0,21,0,0,28,12,0,46,0,0,0
58263,10077,2020-11-18T16:22:01.9563473Z,2020,55,19,41,27,0,4to,0,0,28,0,0,36,14,0,55,0,0,0
58263,10078,2020-11-18T16:22:01.9563473Z,2020,52,18,42,27,0,5to,0,0,25,0,0,34,10,0,52,0,0,0
58263,10079,2020-11-18T16:22:01.9563473Z,2020,67,16,51,35,0,K,0,0,32,0,0,51,16,0,67,0,0,0
58263,10080,2020-11-18T16:22:01.9563473Z,2020,16,3,9,12,0,PK,0,0,4,0,0,13,7,0,16,0,0,0
58263,10081,2020-11-18T16:22:01.9563473Z,2020,7,7,7,3,0,Sin Grado,0,0,4,0,0,0,0,0,7,0,0,0
58263,34082,2021-06-24T13:18:36.9929829Z,2021,55,10,45,30,0,1ro,0,0,25,0,0,45,10,0,55,0,0,0
58263,34083,2021-06-24T13:18:36.9929829Z,2021,57,13,50,25,0,2do,0,0,32,0,0,44,7,0,57,0,0,0
58263,34084,2021-06-24T13:18:36.9929829Z,2021,58,19,50,33,0,3ro,1,1,25,0,0,39,8,0,57,0,0,0
58263,34085,2021-06-24T13:18:36.9929829Z,2021,49,21,41,27,0,4to,0,0,22,0,0,28,8,0,49,0,0,0
58263,34086,2021-06-24T13:18:36.993983Z,2021,60,22,48,27,0,5to,1,0,33,0,0,38,12,0,59,0,0,0
58263,34087,2021-06-24T13:18:36.993983Z,2021,68,18,52,31,0,K,0,0,37,0,0,50,16,0,68,0,0,0
58263,34088,2021-06-24T13:18:36.993983Z,2021,16,2,11,9,0,PK,0,0,7,0,0,14,5,0,16,0,0,0
58263,34089,2021-06-24T13:18:36.9949834Z,2021,6,6,6,3,0,Sin Grado,0,0,3,0,0,0,0,0,6,0,0,0
58263,4056,2020-11-18T16:21:07.3079066Z,2019,64,27,56,33,0,1ro,0,1,31,0,0,37,8,0,64,0,0,0
58263,4057,2020-11-18T16:21:07.3079066Z,2019,47,17,38,28,0,2do,0,0,19,0,0,30,9,0,47,0,0,0
58263,4058,2020-11-18T16:21:07.3079066Z,2019,58,21,44,27,0,3ro,0,0,31,0,0,37,14,0,58,0,0,0
58263,4059,2020-11-18T16:21:07.3089061Z,2019,54,19,41,26,0,4to,0,0,28,0,0,35,13,0,54,0,0,0
58263,4060,2020-11-18T16:21:07.3089061Z,2019,52,6,31,32,0,5to,0,0,20,0,0,46,21,0,52,0,0,0
58263,4061,2020-11-18T16:21:07.3089061Z,2019,70,12,53,31,0,K,0,0,39,0,0,58,17,0,70,0,0,0
58263,4062,2020-11-18T16:21:07.3089061Z,2019,16,5,0,9,0,PK,0,0,7,0,0,11,16,0,16,0,0,0
58263,4063,2020-11-18T16:21:07.3089061Z,2019,12,12,12,4,0,Sin Grado,0,0,8,0,0,0,0,0,12,0,0,0
17673,30738,2021-06-24T13:18:11.1874711Z,2021,54,18,44,31,0,1ro,0,0,23,0,0,36,10,0,54,0,0,0
17673,30739,2021-06-24T13:18:11.188472Z,2021,41,17,37,17,0,2do,0,0,24,0,0,24,4,0,41,0,0,0
17673,30740,2021-06-24T13:18:11.188472Z,2021,48,14,41,29,0,3ro,1,0,19,0,0,34,7,0,47,0,0,0
17673,30741,2021-06-24T13:18:11.189473Z,2021,71,27,57,33,0,4to,3,0,38,0,0,44,14,0,68,0,0,0
17673,30742,2021-06-24T13:18:11.189473Z,2021,45,17,38,19,0,5to,1,0,26,0,0,28,7,0,44,0,0,0
17673,30743,2021-06-24T13:18:11.1904735Z,2021,45,6,32,19,0,K,0,0,26,0,0,39,13,0,44,0,0,1
17673,30744,2021-06-24T13:18:11.1904735Z,2021,9,9,9,3,0,Sin Grado,0,0,6,0,0,0,0,0,9,0,0,0
17673,6740,2020-11-18T16:21:41.4416686Z,2020,48,14,40,20,0,1ro,0,0,28,0,0,34,8,0,48,0,0,0
17673,6741,2020-11-18T16:21:41.4416686Z,2020,59,21,46,32,0,2do,2,0,27,0,0,38,13,0,57,0,0,0
17673,6742,2020-11-18T16:21:41.4416686Z,2020,78,26,63,38,0,3ro,4,1,40,0,0,52,15,0,74,0,0,0
17673,6743,2020-11-18T16:21:41.4426668Z,2020,59,23,45,30,0,4to,3,1,29,0,0,36,14,0,56,0,0,0
17673,6744,2020-11-18T16:21:41.4426668Z,2020,49,13,36,24,0,5to,2,0,25,0,0,36,13,0,47,0,0,0
17673,6745,2020-11-18T16:21:41.4426668Z,2020,69,15,55,40,0,K,1,0,29,0,0,54,14,0,68,0,0,0
17673,6746,2020-11-18T16:21:41.4426668Z,2020,18,0,17,9,0,PK,0,0,9,0,0,18,1,0,18,0,0,0
17673,6747,2020-11-18T16:21:41.4426668Z,2020,14,14,12,6,0,Sin Grado,0,0,8,0,0,0,2,0,14,0,0,0
17673,739,2020-11-18T16:20:42.1121032Z,2019,64,23,54,35,0,1ro,2,0,29,0,0,41,10,0,62,0,0,0
17673,740,2020-11-18T16:20:42.1131045Z,2019,82,32,69,37,0,2do,4,0,45,0,0,50,13,0,78,0,0,0
17673,741,2020-11-18T16:20:42.1131045Z,2019,68,23,55,37,0,3ro,3,0,31,0,0,45,13,0,65,0,0,0
17673,742,2020-11-18T16:20:42.1131045Z,2019,56,14,44,30,0,4to,2,0,26,0,0,42,12,0,54,0,0,0
17673,743,2020-11-18T16:20:42.1131045Z,2019,58,20,49,25,0,5to,2,0,33,0,0,38,9,0,56,3,0,0
17673,744,2020-11-18T16:20:42.1131045Z,2019,51,12,42,27,0,K,0,0,24,0,0,39,9,0,51,0,0,0
17673,745,2020-11-18T16:20:42.1141054Z,2019,31,3,24,16,0,PK,0,0,15,0,0,28,7,0,31,0,0,0
17673,746,2020-11-18T16:20:42.1141054Z,2019,15,14,12,4,0,Sin Grado,0,0,11,0,0,1,3,0,15,0,0,0
71639,11370,2020-11-18T16:22:10.1818317Z,2020,24,7,15,12,0,1ro,0,0,12,0,0,17,9,0,24,0,0,0
71639,11371,2020-11-18T16:22:10.1818317Z,2020,26,9,20,14,0,2do,1,1,12,0,0,17,6,0,25,0,0,0
71639,11372,2020-11-18T16:22:10.1818317Z,2020,33,9,24,11,0,3ro,0,0,22,0,0,24,9,0,33,0,0,0
71639,11373,2020-11-18T16:22:10.1818317Z,2020,30,16,19,15,0,4to,0,0,15,0,0,14,11,0,30,0,0,0
71639,11374,2020-11-18T16:22:10.1828326Z,2020,43,14,29,22,0,5to,0,0,21,0,0,29,14,0,43,0,0,0
71639,11375,2020-11-18T16:22:10.1828326Z,2020,37,12,26,20,0,6to,0,0,17,0,0,25,11,0,37,0,0,0
71639,11376,2020-11-18T16:22:10.1838321Z,2020,16,4,9,9,0,K,0,0,7,0,0,12,7,0,16,0,0,0
71639,11377,2020-11-18T16:22:10.1838321Z,2020,31,5,18,17,0,PK,1,0,14,0,0,26,13,0,30,0,0,0
71639,35391,2021-06-24T13:18:45.6041569Z,2021,23,6,20,12,0,1ro,0,0,11,0,0,17,3,0,23,0,0,0
71639,35392,2021-06-24T13:18:45.6051583Z,2021,25,8,19,12,0,2do,0,1,13,0,0,17,6,0,25,0,0,0
71639,35393,2021-06-24T13:18:45.6051583Z,2021,26,9,21,12,0,3ro,0,0,14,0,0,17,5,0,26,0,0,0
71639,35394,2021-06-24T13:18:45.6051583Z,2021,34,11,23,13,0,4to,0,0,21,0,0,23,11,0,34,0,0,0
71639,35395,2021-06-24T13:18:45.6061584Z,2021,26,12,18,13,0,5to,0,0,13,0,0,14,8,0,26,0,0,0
71639,35396,2021-06-24T13:18:45.6061584Z,2021,43,13,36,20,0,6to,0,0,23,0,0,30,7,0,43,0,0,0
71639,35397,2021-06-24T13:18:45.6061584Z,2021,1,0,1,0,0,7mo,0,0,1,0,0,1,0,0,1,0,0,0
71639,35398,2021-06-24T13:18:45.6071593Z,2021,18,3,12,10,0,K,1,1,8,0,0,15,6,0,17,0,0,0
71639,35399,2021-06-24T13:18:45.6071593Z,2021,25,6,14,14,0,PK,0,0,11,0,0,19,11,0,25,0,0,0
71639,5362,2020-11-18T16:21:15.0870906Z,2019,29,14,22,15,0,1ro,0,0,14,0,0,15,7,0,29,0,0,0
71639,5363,2020-11-18T16:21:15.0880915Z,2019,34,10,25,12,0,2do,0,0,22,0,0,24,9,0,34,0,0,0
71639,5364,2020-11-18T16:21:15.0880915Z,2019,27,14,18,13,0,3ro,0,0,14,0,0,13,9,0,27,0,0,0
71639,5365,2020-11-18T16:21:15.0880915Z,2019,43,14,32,22,0,4to,0,0,21,0,0,29,11,0,43,0,0,0
71639,5366,2020-11-18T16:21:15.0880915Z,2019,43,14,34,23,0,5to,0,0,20,0,0,29,9,0,43,0,0,0
71639,5367,2020-11-18T16:21:15.0890915Z,2019,35,10,24,18,0,6to,1,0,17,0,0,25,11,0,34,0,0,0
71639,5368,2020-11-18T16:21:15.0890915Z,2019,18,2,12,11,0,K,0,0,7,0,0,16,6,0,18,0,0,0
71639,5369,2020-11-18T16:21:15.0890915Z,2019,31,7,20,20,0,PK,1,0,11,0,0,24,11,0,30,0,0,0
20735,1067,2020-11-18T16:20:43.8182395Z,2019,15,9,12,9,0,1ro,0,1,6,0,0,6,3,0,15,0,0,0
20735,1068,2020-11-18T16:20:43.8182395Z,2019,16,6,15,8,0,2do,0,1,8,0,0,10,1,0,16,0,0,0
20735,1069,2020-11-18T16:20:43.8182395Z,2019,18,10,14,4,0,3ro,0,0,14,0,0,8,4,0,18,0,0,0
20735,1070,2020-11-18T16:20:43.8192421Z,2019,19,6,16,8,0,4to,0,0,11,0,0,13,3,0,19,0,0,0
20735,1071,2020-11-18T16:20:43.8192421Z,2019,14,5,10,6,0,5to,0,0,8,0,0,9,4,0,13,0,0,1
20735,1072,2020-11-18T16:20:43.8202421Z,2019,24,8,18,11,0,6to,0,0,13,0,0,16,6,0,23,0,1,1
20735,1073,2020-11-18T16:20:43.8202421Z,2019,18,8,17,12,0,7mo,0,0,6,0,0,10,1,0,18,0,0,0
20735,1074,2020-11-18T16:20:43.8202421Z,2019,20,8,17,11,0,8vo,0,0,9,0,0,12,3,0,19,0,1,1
20735,1075,2020-11-18T16:20:43.8202421Z,2019,12,4,10,8,0,K,0,1,4,0,0,8,2,0,12,0,0,0
20735,1076,2020-11-18T16:20:43.8202421Z,2019,5,5,4,0,0,Sin Grado,0,1,5,0,0,0,1,0,5,0,0,0
20735,31067,2021-06-24T13:18:12.0811125Z,2021,12,3,11,6,0,1ro,0,0,6,0,0,9,1,0,12,0,0,0
20735,31068,2021-06-24T13:18:12.0811125Z,2021,9,4,9,6,0,2do,0,0,3,0,0,5,0,0,9,0,0,0
20735,31069,2021-06-24T13:18:12.0811125Z,2021,15,6,12,8,0,3ro,0,0,7,0,0,9,3,0,15,0,1,0
20735,31070,2021-06-24T13:18:12.0811125Z,2021,15,4,15,8,0,4to,0,2,7,0,0,11,0,0,15,0,0,0
20735,31071,2021-06-24T13:18:12.0821139Z,2021,22,11,19,6,0,5to,0,0,16,0,0,11,3,0,22,0,0,0
20735,31072,2021-06-24T13:18:12.0821139Z,2021,22,9,17,7,0,6to,0,1,15,0,0,13,5,0,22,0,0,0
20735,31073,2021-06-24T13:18:12.0821139Z,2021,22,8,20,8,0,7mo,0,1,14,0,0,14,2,0,22,0,0,0
20735,31074,2021-06-24T13:18:12.0821139Z,2021,24,9,18,9,0,8vo,0,2,15,0,0,15,6,0,23,0,1,1
20735,31075,2021-06-24T13:18:12.083114Z,2021,18,4,15,11,0,K,0,2,7,0,0,14,3,0,18,0,0,0
20735,31076,2021-06-24T13:18:12.083114Z,2021,6,6,5,2,0,Sin Grado,0,0,4,0,0,0,1,0,6,0,0,0
20735,7071,2020-11-18T16:21:43.6441352Z,2020,11,6,11,7,0,1ro,0,1,4,0,0,5,0,0,11,0,0,0
20735,7072,2020-11-18T16:21:43.6441352Z,2020,19,7,16,11,0,2do,0,0,8,0,0,12,3,0,19,0,1,0
20735,7073,2020-11-18T16:21:43.6441352Z,2020,16,6,15,9,0,3ro,0,2,7,0,0,10,1,0,16,0,0,0
20735,7074,2020-11-18T16:21:43.645136Z,2020,25,11,19,9,0,4to,0,2,16,0,0,14,6,0,25,0,0,0
20735,7075,2020-11-18T16:21:43.645136Z,2020,16,5,13,5,0,5to,0,1,11,0,0,11,3,0,16,0,0,0
20735,7076,2020-11-18T16:21:43.645136Z,2020,21,9,19,8,0,6to,0,2,13,0,0,12,2,0,21,0,0,0
20735,7077,2020-11-18T16:21:43.6461365Z,2020,23,9,17,9,0,7mo,0,2,14,0,0,14,6,0,22,0,1,1
20735,7078,2020-11-18T16:21:43.6461365Z,2020,13,7,12,9,0,8vo,0,2,4,0,0,6,1,0,13,0,0,0
20735,7079,2020-11-18T16:21:43.6461365Z,2020,15,2,12,6,0,K,0,2,9,0,0,13,3,0,15,0,0,0
20735,7080,2020-11-18T16:21:43.6461365Z,2020,6,6,5,1,0,Sin Grado,0,1,5,0,0,0,1,0,6,0,0,0
26153,1563,2020-11-18T16:20:47.6558036Z,2019,19,12,17,6,0,1ro,0,0,13,0,0,7,2,0,19,0,0,0
26153,1564,2020-11-18T16:20:47.6558036Z,2019,16,5,14,7,0,2do,0,0,9,0,0,11,2,0,16,0,0,0
26153,1565,2020-11-18T16:20:47.6558036Z,2019,15,9,12,8,0,3ro,0,0,7,0,0,6,3,0,15,0,0,0
26153,1566,2020-11-18T16:20:47.6568054Z,2019,22,10,19,8,0,4to,0,0,14,0,0,12,3,0,22,0,0,0
26153,1567,2020-11-18T16:20:47.6568054Z,2019,13,8,8,7,0,5to,0,0,6,0,0,5,5,0,13,0,0,0
26153,1568,2020-11-18T16:20:47.6568054Z,2019,21,10,15,16,0,K,0,0,5,0,0,11,6,0,21,0,0,0
26153,1569,2020-11-18T16:20:47.6568054Z,2019,9,9,5,1,0,Sin Grado,0,0,8,0,0,0,4,0,9,0,0,0
26153,31566,2021-06-24T13:18:15.8388068Z,2021,17,7,14,9,0,1ro,0,0,8,0,0,10,3,1,15,0,0,1
26153,31567,2021-06-24T13:18:15.8398095Z,2021,31,13,26,16,0,2do,1,0,15,0,0,18,5,0,29,0,0,1
26153,31568,2021-06-24T13:18:15.8398095Z,2021,18,4,15,12,0,3ro,0,0,6,0,0,14,3,0,18,0,0,0
26153,31569,2021-06-24T13:18:15.8398095Z,2021,20,7,19,11,0,4to,0,0,9,0,0,13,1,0,19,0,0,1
26153,31570,2021-06-24T13:18:15.8408082Z,2021,14,9,12,8,0,5to,0,0,6,0,0,5,2,0,13,0,0,1
26153,31571,2021-06-24T13:18:15.8408082Z,2021,16,7,9,8,0,K,0,0,8,0,0,9,7,0,16,0,0,0
26153,31572,2021-06-24T13:18:15.8408082Z,2021,14,14,11,2,0,Sin Grado,0,0,12,0,0,0,3,0,13,0,0,1
26153,7569,2020-11-18T16:21:46.3819595Z,2020,36,16,28,18,0,1ro,0,0,18,0,0,20,8,0,35,0,0,1
26153,7570,2020-11-18T16:21:46.3819595Z,2020,20,10,18,11,0,2do,0,0,9,0,0,10,2,0,20,0,0,0
26153,7571,2020-11-18T16:21:46.3819595Z,2020,19,6,18,10,0,3ro,0,0,9,0,0,13,1,0,19,0,0,0
26153,7572,2020-11-18T16:21:46.3819595Z,2020,17,10,14,9,0,4to,0,0,8,0,0,7,3,0,16,0,0,1
26153,7573,2020-11-18T16:21:46.3819595Z,2020,16,7,15,7,0,5to,0,0,9,0,0,9,1,0,16,0,0,0
26153,7574,2020-11-18T16:21:46.3829604Z,2020,19,7,10,10,0,K,0,0,9,0,0,12,9,0,18,0,0,1
26153,7575,2020-11-18T16:21:46.3829604Z,2020,10,10,10,2,0,Sin Grado,0,0,8,0,0,0,0,0,10,0,0,0
11643,221,2020-11-18T16:20:38.7688736Z,2019,223,44,158,117,0,10mo,5,0,106,0,0,179,65,0,218,0,0,0
11643,222,2020-11-18T16:20:38.7688736Z,2019,241,38,185,123,0,11mo,4,2,118,0,0,203,56,0,237,0,0,0
11643,223,2020-11-18T16:20:38.7688736Z,2019,222,0,156,112,0,12mo,8,0,110,0,2,222,66,0,214,0,0,0
11643,224,2020-11-18T16:20:38.769874Z,2019,257,64,204,132,0,9no,4,3,125,0,0,193,53,0,253,0,0,0
11643,225,2020-11-18T16:20:38.769874Z,2019,7,5,6,1,0,Sin Grado,0,0,6,0,0,2,1,0,7,0,0,0
11643,30221,2021-06-24T13:18:07.0885328Z,2021,200,52,153,103,0,10mo,6,0,97,0,0,148,47,0,194,0,1,0
11643,30222,2021-06-24T13:18:07.0885328Z,2021,221,41,172,113,0,11mo,2,0,108,0,0,180,49,0,219,0,0,0
11643,30223,2021-06-24T13:18:07.0895333Z,2021,220,46,162,115,0,12mo,6,0,105,0,0,174,58,0,214,0,0,0
11643,30224,2021-06-24T13:18:07.0895333Z,2021,237,80,188,117,0,9no,8,0,120,0,0,157,49,0,229,8,3,0
11643,30225,2021-06-24T13:18:07.0895333Z,2021,8,8,5,3,0,Sin Grado,0,0,5,0,0,0,3,0,8,0,0,0
11643,6223,2020-11-18T16:21:38.6267893Z,2020,238,45,185,123,0,10mo,3,0,115,0,0,193,53,0,235,0,0,0
11643,6224,2020-11-18T16:21:38.6267893Z,2020,229,48,161,119,0,11mo,6,0,110,0,0,181,68,0,223,0,0,0
11643,6225,2020-11-18T16:21:38.6267893Z,2020,213,34,154,120,0,12mo,2,0,93,0,0,179,59,0,211,0,0,0
11643,6226,2020-11-18T16:21:38.6267893Z,2020,204,57,153,99,0,9no,6,0,105,0,0,147,51,0,198,0,1,0
11643,6227,2020-11-18T16:21:38.6267893Z,2020,8,8,6,2,0,Sin Grado,0,0,6,0,0,0,2,0,8,0,0,0
50252,3240,2020-11-18T16:21:01.4560042Z,2019,13,7,11,5,0,1ro,0,3,8,0,0,6,2,0,13,0,0,0
50252,3241,2020-11-18T16:21:01.4560042Z,2019,16,4,13,4,0,2do,0,3,12,0,0,12,3,0,16,0,0,0
50252,3242,2020-11-18T16:21:01.4560042Z,2019,23,8,20,12,0,3ro,0,8,11,0,0,15,3,0,23,1,0,0
50252,3243,2020-11-18T16:21:01.4560042Z,2019,15,3,13,7,0,4to,0,6,8,0,0,12,2,0,15,0,0,0
50252,3244,2020-11-18T16:21:01.4560042Z,2019,21,5,18,10,0,5to,0,5,11,0,0,16,3,0,21,0,0,0
50252,3245,2020-11-18T16:21:01.4570046Z,2019,1,0,1,0,0,6to,0,0,1,0,0,1,0,0,1,0,0,0
50252,3246,2020-11-18T16:21:01.4570046Z,2019,1,0,1,1,0,7mo,0,0,0,0,0,1,0,0,1,0,0,0
50252,3247,2020-11-18T16:21:01.4570046Z,2019,15,0,14,5,0,K,0,0,10,0,0,15,1,0,15,0,0,0
50252,33268,2021-06-24T13:18:30.8896053Z,2021,13,7,11,4,0,1ro,0,0,9,0,0,6,2,0,13,0,0,0
50252,33269,2021-06-24T13:18:30.8906067Z,2021,21,7,17,9,0,2do,1,0,12,0,0,14,4,0,20,0,0,0
50252,33270,2021-06-24T13:18:30.8906067Z,2021,18,6,16,7,0,3ro,0,0,11,0,0,12,2,0,18,0,0,0
50252,33271,2021-06-24T13:18:30.8906067Z,2021,20,5,18,5,0,4to,0,0,15,0,0,15,2,0,20,0,0,0
50252,33272,2021-06-24T13:18:30.8906067Z,2021,26,8,22,14,0,5to,0,0,12,0,0,18,4,0,26,1,0,0
50252,33273,2021-06-24T13:18:30.8916063Z,2021,14,2,9,7,0,K,0,0,7,0,0,12,5,0,14,0,0,0
50252,9262,2020-11-18T16:21:57.3282598Z,2020,20,6,18,8,0,1ro,1,0,12,0,0,14,2,0,19,0,0,0
50252,9263,2020-11-18T16:21:57.3282598Z,2020,15,7,14,7,0,2do,0,0,8,0,0,8,1,0,15,0,0,0
50252,9264,2020-11-18T16:21:57.3282598Z,2020,14,4,13,1,0,3ro,0,0,13,0,0,10,1,0,14,0,0,0
50252,9265,2020-11-18T16:21:57.3292603Z,2020,24,8,22,14,0,4to,0,0,10,0,0,16,2,0,24,1,0,0
50252,9266,2020-11-18T16:21:57.3292603Z,2020,16,3,13,6,0,5to,1,0,10,0,0,13,3,0,15,0,0,0
50252,9267,2020-11-18T16:21:57.3292603Z,2020,16,3,13,6,0,K,0,0,10,0,0,13,3,0,16,0,0,0
58081,10002,2020-11-18T16:22:01.9343341Z,2020,67,22,55,34,0,1ro,0,4,33,0,0,45,12,0,67,0,0,0
58081,10003,2020-11-18T16:22:01.9343341Z,2020,54,19,46,27,0,2do,1,3,27,0,0,35,8,0,53,0,0,0
58081,10004,2020-11-18T16:22:01.9353332Z,2020,68,27,61,32,0,3ro,2,0,36,0,0,41,7,0,66,0,0,0
58081,10005,2020-11-18T16:22:01.9353332Z,2020,61,19,50,27,0,4to,4,4,34,0,0,42,11,0,57,0,0,0
58081,10006,2020-11-18T16:22:01.9353332Z,2020,90,32,76,47,0,5to,3,3,43,0,0,58,14,0,86,0,0,1
58081,10007,2020-11-18T16:22:01.9353332Z,2020,73,19,47,38,0,K,0,0,35,0,0,54,26,0,73,1,0,0
58081,10008,2020-11-18T16:22:01.9353332Z,2020,14,14,9,4,0,Sin Grado,0,0,10,0,0,0,5,0,14,0,0,0
58081,34009,2021-06-24T13:18:36.9209308Z,2021,67,19,54,32,0,1ro,0,1,35,0,0,48,13,0,67,1,0,0
58081,34010,2021-06-24T13:18:36.9209308Z,2021,65,22,57,30,0,2do,0,1,35,0,0,43,8,0,65,0,0,0
58081,34011,2021-06-24T13:18:36.9209308Z,2021,49,20,41,23,0,3ro,1,1,26,0,0,29,8,0,48,0,0,0
58081,34012,2021-06-24T13:18:36.9219317Z,2021,63,26,52,32,0,4to,1,0,31,0,0,37,11,0,62,0,0,0
58081,34013,2021-06-24T13:18:36.9219317Z,2021,60,15,49,28,0,5to,3,0,32,0,0,45,11,0,57,0,0,0
58081,34014,2021-06-24T13:18:36.9219317Z,2021,45,12,28,25,0,K,0,0,20,0,0,33,17,0,45,0,0,0
58081,34015,2021-06-24T13:18:36.9229318Z,2021,9,9,7,1,0,Sin Grado,0,0,8,0,0,0,2,0,9,0,0,0
58081,3985,2020-11-18T16:21:06.8916276Z,2019,59,22,36,29,0,1ro,0,4,30,0,0,37,23,0,59,0,0,0
58081,3986,2020-11-18T16:21:06.8916276Z,2019,72,29,60,35,0,2do,2,3,37,0,0,43,12,0,70,0,0,0
58081,3987,2020-11-18T16:21:06.8916276Z,2019,63,21,53,27,0,3ro,3,8,36,0,0,42,10,0,60,0,1,0
58081,3988,2020-11-18T16:21:06.8926285Z,2019,85,31,69,45,0,4to,2,4,40,0,0,54,16,0,82,0,0,1
58081,3989,2020-11-18T16:21:06.8926285Z,2019,90,23,76,50,0,5to,2,8,40,0,0,67,14,0,88,0,0,0
58081,3990,2020-11-18T16:21:06.8926285Z,2019,60,15,10,33,0,K,0,4,27,0,0,45,50,0,60,0,0,0
58081,3991,2020-11-18T16:21:06.8926285Z,2019,17,17,13,5,0,Sin Grado,0,0,12,0,0,0,4,0,17,0,0,0
35907,2401,2020-11-18T16:20:56.2475322Z,2019,76,32,70,30,0,1ro,3,1,46,0,0,44,6,0,73,0,0,0
35907,2402,2020-11-18T16:20:56.2475322Z,2019,71,25,62,42,0,2do,0,0,29,0,0,46,9,0,71,0,0,0
35907,2403,2020-11-18T16:20:56.2475322Z,2019,70,32,64,29,0,3ro,0,0,41,0,0,38,6,0,70,0,0,0
35907,2404,2020-11-18T16:20:56.2485313Z,2019,66,17,53,38,0,4to,1,0,28,0,0,49,13,0,65,0,0,0
35907,2405,2020-11-18T16:20:56.2485313Z,2019,75,14,64,40,0,5to,0,0,35,0,0,61,11,0,75,0,0,0
35907,2406,2020-11-18T16:20:56.2485313Z,2019,61,12,53,27,0,K,1,0,34,0,0,49,8,0,57,0,0,3
35907,2407,2020-11-18T16:20:56.2495313Z,2019,1,1,1,0,0,PK,0,0,1,0,0,0,0,0,1,0,0,0
35907,2408,2020-11-18T16:20:56.2495313Z,2019,15,14,12,7,0,Sin Grado,0,0,8,0,0,1,3,0,15,0,1,0
35907,32409,2021-06-24T13:18:24.699164Z,2021,58,17,53,27,0,1ro,2,0,31,0,0,41,5,0,56,0,0,0
35907,32410,2021-06-24T13:18:24.699164Z,2021,58,22,55,26,0,2do,1,0,32,0,0,36,3,0,56,0,0,1
35907,32411,2021-06-24T13:18:24.699164Z,2021,72,26,66,26,0,3ro,1,2,46,0,0,46,6,0,70,0,0,1
35907,32412,2021-06-24T13:18:24.700165Z,2021,70,23,65,39,0,4to,2,0,31,0,0,47,5,0,67,0,0,1
35907,32413,2021-06-24T13:18:24.700165Z,2021,71,28,69,34,0,5to,0,0,37,0,0,43,2,0,70,0,0,1
35907,32414,2021-06-24T13:18:24.700165Z,2021,55,15,54,23,0,K,2,1,32,0,0,40,1,0,53,0,0,0
35907,32415,2021-06-24T13:18:24.7011655Z,2021,2,2,2,0,0,PK,0,0,2,0,0,0,0,0,2,0,0,0
35907,8414,2020-11-18T16:21:51.7875621Z,2020,52,15,48,24,0,1ro,0,0,28,0,0,37,4,0,51,0,0,1
35907,8415,2020-11-18T16:21:51.7875621Z,2020,62,18,56,22,0,2do,2,0,40,0,0,44,6,0,59,0,0,1
35907,8416,2020-11-18T16:21:51.7875621Z,2020,65,22,55,37,0,3ro,0,0,28,0,0,43,10,0,65,0,0,0
35907,8417,2020-11-18T16:21:51.7875621Z,2020,63,29,54,27,0,4to,0,0,36,0,0,34,9,0,62,0,0,1
35907,8418,2020-11-18T16:21:51.7885643Z,2020,68,18,58,36,0,5to,1,0,32,0,0,50,10,0,66,0,0,1
35907,8419,2020-11-18T16:21:51.7885643Z,2020,64,13,54,34,0,K,0,0,30,0,0,51,10,0,64,0,0,0
35907,8420,2020-11-18T16:21:51.7885643Z,2020,12,12,7,3,0,Sin Grado,0,0,9,0,0,0,5,0,12,0,0,0
70516,11037,2020-11-18T16:22:07.6211221Z,2020,95,31,79,43,0,10mo,5,0,52,0,0,64,16,0,90,0,0,0
70516,11038,2020-11-18T16:22:07.6221221Z,2020,86,21,64,50,0,11mo,2,0,36,0,0,65,22,0,84,0,0,0
70516,11039,2020-11-18T16:22:07.6221221Z,2020,114,27,82,68,0,12mo,8,0,46,0,0,87,32,0,106,0,0,0
70516,11040,2020-11-18T16:22:07.6221221Z,2020,141,42,121,70,0,9no,5,0,71,0,0,99,20,0,135,0,0,1
70516,35058,2021-06-24T13:18:43.7107988Z,2021,134,40,115,73,0,10mo,4,0,61,0,0,94,19,0,130,0,0,0
70516,35059,2021-06-24T13:18:43.7107988Z,2021,80,23,67,36,0,11mo,5,0,44,0,0,57,13,0,75,0,0,0
70516,35060,2021-06-24T13:18:43.7107988Z,2021,79,17,62,45,0,12mo,1,0,34,0,0,62,17,0,78,0,0,0
70516,35061,2021-06-24T13:18:43.7107988Z,2021,99,43,86,42,0,9no,3,0,57,0,0,56,13,0,96,0,0,0
70516,5029,2020-11-18T16:21:13.4259868Z,2019,89,22,65,47,0,10mo,0,1,42,0,0,67,24,0,89,0,0,0
70516,5030,2020-11-18T16:21:13.4269877Z,2019,128,28,96,75,0,11mo,9,0,53,0,0,100,32,0,119,0,0,0
70516,5031,2020-11-18T16:21:13.4269877Z,2019,132,0,98,81,0,12mo,5,0,51,0,0,132,34,0,127,0,0,0
70516,5032,2020-11-18T16:21:13.4269877Z,2019,97,33,84,45,0,9no,6,1,52,0,0,64,13,0,91,0,0,0
54866,33818,2021-06-24T13:18:35.7310765Z,2021,14,2,13,7,0,1ro,0,0,7,0,0,12,1,0,14,0,0,0
54866,33819,2021-06-24T13:18:35.7310765Z,2021,12,3,11,4,0,2do,0,0,8,0,0,9,1,0,12,0,0,0
54866,33820,2021-06-24T13:18:35.7320774Z,2021,8,1,7,4,0,3ro,0,0,4,0,0,7,1,0,8,0,0,0
54866,33821,2021-06-24T13:18:35.7320774Z,2021,16,8,14,7,0,4to,0,0,9,0,0,8,2,0,16,0,0,0
54866,33822,2021-06-24T13:18:35.7320774Z,2021,20,4,19,13,0,5to,0,0,7,0,0,16,1,0,20,0,0,0
54866,33823,2021-06-24T13:18:35.7320774Z,2021,30,10,27,19,0,6to,0,0,11,0,0,20,3,0,30,0,0,0
54866,33824,2021-06-24T13:18:35.7330788Z,2021,29,11,27,15,0,7mo,0,0,14,0,0,18,2,0,28,2,0,1
54866,33825,2021-06-24T13:18:35.7330788Z,2021,25,13,22,9,0,8vo,0,0,16,0,0,12,3,0,25,0,0,0
54866,33826,2021-06-24T13:18:35.7330788Z,2021,17,4,13,10,0,K,0,0,7,0,0,13,4,0,17,0,0,0
54866,3795,2020-11-18T16:21:05.1374565Z,2019,19,7,15,9,0,1ro,1,0,10,0,0,12,4,0,18,0,0,0
54866,3796,2020-11-18T16:21:05.1384569Z,2019,23,8,15,7,0,2do,0,0,16,0,0,15,8,0,23,0,0,0
54866,3797,2020-11-18T16:21:05.1384569Z,2019,25,9,21,19,0,3ro,0,0,6,0,0,16,4,0,24,0,0,1
54866,3798,2020-11-18T16:21:05.1384569Z,2019,25,9,23,13,0,4to,0,0,12,0,0,16,2,0,25,0,0,0
54866,3799,2020-11-18T16:21:05.1384569Z,2019,27,9,24,12,0,5to,0,0,15,0,0,18,3,0,26,0,0,1
54866,3800,2020-11-18T16:21:05.1384569Z,2019,40,15,36,14,0,6to,0,0,26,0,0,25,4,0,40,0,0,0
54866,3801,2020-11-18T16:21:05.5557372Z,2019,42,19,38,18,0,7mo,1,0,24,0,0,23,4,0,41,0,0,0
54866,3802,2020-11-18T16:21:05.5557372Z,2019,64,16,60,25,0,8vo,0,0,39,0,0,48,4,0,64,0,0,0
54866,3803,2020-11-18T16:21:05.5557372Z,2019,19,5,0,11,0,K,0,0,8,0,0,14,19,0,19,0,0,0
54866,9812,2020-11-18T16:22:00.5113838Z,2020,20,5,19,8,0,1ro,1,0,12,0,0,15,1,0,19,0,0,0
54866,9813,2020-11-18T16:22:00.5113838Z,2020,13,4,11,5,0,2do,0,0,8,0,0,9,2,0,13,0,0,0
54866,9814,2020-11-18T16:22:00.5113838Z,2020,20,11,19,7,0,3ro,0,1,13,0,0,9,1,0,20,0,0,0
54866,9815,2020-11-18T16:22:00.5123843Z,2020,22,8,20,13,0,4to,0,0,9,0,0,14,2,0,22,0,0,0
54866,9816,2020-11-18T16:22:00.5123843Z,2020,21,9,20,11,0,5to,0,1,10,0,0,12,1,0,21,0,0,0
54866,9817,2020-11-18T16:22:00.5123843Z,2020,34,14,31,16,0,6to,0,2,18,0,0,20,3,0,33,0,0,1
54866,9818,2020-11-18T16:22:00.5123843Z,2020,30,13,27,12,0,7mo,0,1,18,0,0,17,3,0,30,0,0,0
54866,9819,2020-11-18T16:22:00.5123843Z,2020,34,16,32,12,0,8vo,0,1,22,0,0,18,2,0,34,0,0,0
54866,9820,2020-11-18T16:22:00.5123843Z,2020,12,2,12,7,0,K,0,0,5,0,0,10,0,0,12,0,0,0
61333,10195,2020-11-18T16:22:02.7178514Z,2020,50,14,32,30,0,1ro,0,0,20,0,0,36,18,0,50,0,0,0
61333,10196,2020-11-18T16:22:02.7188523Z,2020,50,13,32,29,0,2do,0,0,21,0,0,37,18,1,49,0,0,0
61333,10197,2020-11-18T16:22:02.7188523Z,2020,39,11,26,19,0,3ro,0,0,20,0,0,28,13,0,39,0,0,0
61333,10198,2020-11-18T16:22:02.7188523Z,2020,49,8,29,31,0,4to,2,0,18,0,0,41,20,1,46,0,0,0
61333,10199,2020-11-18T16:22:02.7188523Z,2020,40,8,27,27,0,5to,1,0,13,0,0,32,13,0,39,0,0,0
61333,10200,2020-11-18T16:22:02.7188523Z,2020,49,5,29,26,0,K,1,0,23,0,0,44,20,0,48,0,0,0
61333,34211,2021-06-24T13:18:38.041734Z,2021,49,5,34,25,0,1ro,1,0,24,0,0,44,15,0,48,0,0,0
61333,34212,2021-06-24T13:18:38.0427345Z,2021,44,12,31,27,0,2do,0,0,17,0,0,32,13,0,44,0,0,0
61333,34213,2021-06-24T13:18:38.0427345Z,2021,47,14,27,27,0,3ro,0,0,20,0,0,33,20,1,46,0,0,0
61333,34214,2021-06-24T13:18:38.0427345Z,2021,37,9,22,19,0,4to,1,0,18,0,0,28,15,0,36,0,0,0
61333,34215,2021-06-24T13:18:38.0437355Z,2021,49,9,29,31,0,5to,1,0,18,0,0,40,20,1,47,0,0,0
61333,34216,2021-06-24T13:18:38.0437355Z,2021,47,10,33,24,0,K,0,0,23,0,0,37,14,0,47,0,0,0
61333,4178,2020-11-18T16:21:08.0193816Z,2019,54,14,37,31,0,1ro,0,0,23,0,0,40,17,0,54,0,0,0
61333,4179,2020-11-18T16:21:08.0193816Z,2019,41,10,25,21,0,2do,0,0,20,0,0,31,16,0,41,0,0,0
61333,4180,2020-11-18T16:21:08.0203843Z,2019,52,8,31,31,0,3ro,2,0,21,0,0,44,21,0,50,0,0,0
61333,4181,2020-11-18T16:21:08.0203843Z,2019,49,10,33,31,0,4to,1,0,18,0,0,39,16,0,48,0,0,0
61333,4182,2020-11-18T16:21:08.0203843Z,2019,39,11,22,17,0,5to,0,0,22,0,0,28,17,0,39,0,0,0
61333,4183,2020-11-18T16:21:08.0203843Z,2019,1,0,0,0,0,6to,0,0,1,0,0,1,1,0,1,0,0,0
61333,4184,2020-11-18T16:21:08.0203843Z,2019,1,0,1,1,0,7mo,0,0,0,0,0,1,0,0,1,0,0,0
61333,4185,2020-11-18T16:21:08.0213821Z,2019,50,12,28,32,0,K,0,0,18,0,0,38,22,0,50,0,0,0
40022,2494,2020-11-18T16:20:56.2815532Z,2019,289,56,174,164,0,10mo,0,0,125,0,1,233,115,0,289,9,0,0
40022,2495,2020-11-18T16:20:56.2815532Z,2019,263,36,154,145,0,11mo,11,4,118,0,0,227,109,0,251,5,0,1
40022,2496,2020-11-18T16:20:56.2825541Z,2019,349,0,216,186,0,12mo,8,2,163,0,0,349,133,0,340,7,0,1
40022,32500,2021-06-24T13:18:25.2025271Z,2021,229,42,172,116,0,10mo,4,1,113,0,0,187,57,0,224,3,1,1
40022,32501,2021-06-24T13:18:25.2035281Z,2021,274,66,178,151,0,11mo,1,0,123,0,0,208,96,0,273,2,1,0
40022,32502,2021-06-24T13:18:25.2035281Z,2021,299,58,196,177,0,12mo,0,0,122,0,0,241,103,0,298,11,0,1
40022,32503,2021-06-24T13:18:25.2035281Z,2021,62,4,41,42,0,9no,2,0,20,0,0,58,21,0,60,1,0,0
40022,8506,2020-11-18T16:21:52.6081106Z,2020,263,64,151,147,0,10mo,6,0,116,0,0,199,112,0,257,2,1,0
40022,8507,2020-11-18T16:21:52.6081106Z,2020,298,56,180,172,0,11mo,0,0,126,0,0,242,118,0,298,10,0,0
40022,8508,2020-11-18T16:21:52.6081106Z,2020,267,35,153,148,0,12mo,11,0,119,0,0,232,114,0,255,5,0,1
10439,30036,2021-06-24T13:18:05.8186229Z,2021,48,15,44,26,0,1ro,0,0,22,0,0,33,4,0,48,0,0,0
10439,30037,2021-06-24T13:18:05.8186229Z,2021,49,18,42,20,0,2do,0,0,29,0,0,31,7,0,49,0,0,0
10439,30038,2021-06-24T13:18:05.8196234Z,2021,56,28,44,30,0,3ro,0,0,26,0,0,28,12,0,56,1,0,0
10439,30039,2021-06-24T13:18:05.8196234Z,2021,68,24,53,33,0,4to,0,0,35,0,0,44,15,0,68,0,0,0
10439,30040,2021-06-24T13:18:05.8196234Z,2021,63,24,52,32,0,5to,0,1,31,0,0,39,11,0,63,1,0,0
10439,30041,2021-06-24T13:18:05.8196234Z,2021,64,29,50,28,0,6to,0,0,36,0,0,35,14,0,64,0,0,0
10439,30042,2021-06-24T13:18:05.8206239Z,2021,77,27,61,38,0,7mo,0,0,39,0,0,50,16,0,77,0,0,0
10439,30043,2021-06-24T13:18:05.8206239Z,2021,62,27,53,40,0,8vo,0,0,22,0,0,35,9,0,62,1,0,0
10439,30044,2021-06-24T13:18:05.8206239Z,2021,42,13,36,22,0,K,0,0,20,0,0,29,6,0,42,0,0,0
10439,30045,2021-06-24T13:18:05.8206239Z,2021,18,18,11,3,0,Sin Grado,0,0,15,0,0,0,7,0,18,0,0,0
10439,35,2020-11-18T16:20:36.6924921Z,2019,57,27,43,33,0,1ro,0,0,24,0,0,30,14,0,57,0,0,0
10439,36,2020-11-18T16:20:36.6924921Z,2019,66,24,49,34,0,2do,0,0,32,0,0,42,17,0,66,0,0,0
10439,37,2020-11-18T16:20:36.6924921Z,2019,58,20,43,31,0,3ro,0,0,27,0,0,38,15,0,58,0,0,0
10439,38,2020-11-18T16:20:36.6934921Z,2019,68,33,51,28,0,4to,0,0,40,0,0,35,17,0,68,0,0,0
10439,39,2020-11-18T16:20:36.6934921Z,2019,66,29,50,30,0,5to,0,0,36,0,0,37,16,0,66,0,0,0
10439,40,2020-11-18T16:20:36.6934921Z,2019,54,22,41,30,0,6to,1,0,24,0,0,32,13,0,53,0,0,0
10439,41,2020-11-18T16:20:36.6934921Z,2019,65,20,45,37,0,7mo,0,0,28,0,0,45,20,0,65,0,0,0
10439,42,2020-11-18T16:20:36.6934921Z,2019,90,37,67,38,0,8vo,2,0,52,0,0,53,23,0,88,0,0,0
10439,43,2020-11-18T16:20:36.6944934Z,2019,52,18,46,23,0,K,0,0,29,0,0,34,6,0,52,0,0,0
10439,44,2020-11-18T16:20:36.6944934Z,2019,23,23,18,4,0,Sin Grado,0,0,19,0,0,0,5,0,23,0,0,0
10439,6037,2020-11-18T16:21:37.6851614Z,2020,49,17,39,19,0,1ro,0,0,30,0,0,32,10,0,49,0,0,0
10439,6038,2020-11-18T16:21:37.686161Z,2020,56,23,40,32,0,2do,1,0,24,0,0,33,16,0,55,1,0,0
10439,6039,2020-11-18T16:21:37.686161Z,2020,67,21,50,34,0,3ro,0,0,33,0,0,46,17,0,67,0,0,0
10439,6040,2020-11-18T16:21:37.686161Z,2020,64,22,48,30,0,4to,0,0,34,0,0,42,16,0,64,1,0,0
10439,6041,2020-11-18T16:21:37.686161Z,2020,61,29,45,26,0,5to,0,0,35,0,0,32,16,0,61,0,0,0
10439,6042,2020-11-18T16:21:37.686161Z,2020,73,29,56,33,0,6to,0,0,40,0,0,44,17,0,73,0,0,0
10439,6043,2020-11-18T16:21:37.6871619Z,2020,63,27,50,40,0,7mo,0,0,23,0,0,36,13,0,63,1,0,0
10439,6044,2020-11-18T16:21:37.6871619Z,2020,73,25,49,37,0,8vo,0,0,36,0,0,48,24,0,73,0,0,0
10439,6045,2020-11-18T16:21:37.6871619Z,2020,49,15,37,26,0,K,0,0,23,0,0,34,12,0,49,0,0,0
10439,6046,2020-11-18T16:21:37.6871619Z,2020,19,19,14,4,0,Sin Grado,0,0,15,0,0,0,5,0,19,0,0,0
17707,30745,2021-06-24T13:18:11.188472Z,2021,24,4,23,11,0,1ro,0,0,13,0,0,20,1,0,24,0,0,0
17707,30746,2021-06-24T13:18:11.188472Z,2021,19,4,16,11,0,2do,0,0,8,0,0,15,3,0,19,0,0,0
17707,30747,2021-06-24T13:18:11.189473Z,2021,19,1,15,9,0,3ro,2,0,10,0,0,18,4,0,17,0,0,0
17707,30748,2021-06-24T13:18:11.189473Z,2021,21,7,18,10,0,4to,0,0,11,0,0,14,3,0,21,0,0,0
17707,30749,2021-06-24T13:18:11.1904735Z,2021,14,3,12,6,0,5to,1,0,8,0,0,11,2,0,13,0,0,0
17707,30750,2021-06-24T13:18:11.1904735Z,2021,16,0,14,9,0,K,0,0,7,0,0,16,2,0,16,0,0,0
17707,30751,2021-06-24T13:18:11.1924744Z,2021,5,1,4,1,0,PK,0,0,4,0,0,4,1,0,5,0,0,0
17707,30752,2021-06-24T13:18:11.1934758Z,2021,5,5,3,0,0,Sin Grado,0,0,5,0,0,0,2,0,5,0,1,0
17707,6748,2020-11-18T16:21:41.4426668Z,2020,18,3,15,10,0,1ro,0,0,8,0,0,15,3,0,18,0,0,0
17707,6749,2020-11-18T16:21:41.4426668Z,2020,18,3,14,9,0,2do,0,0,9,0,0,15,4,0,18,0,0,0
17707,6750,2020-11-18T16:21:41.4426668Z,2020,22,8,18,9,0,3ro,0,0,13,0,0,14,4,0,22,0,0,0
17707,6751,2020-11-18T16:21:41.4426668Z,2020,14,5,11,4,0,4to,0,0,10,0,0,9,3,0,14,0,0,0
17707,6752,2020-11-18T16:21:41.4426668Z,2020,23,5,18,12,0,5to,0,0,11,0,0,18,5,0,23,0,0,0
17707,6753,2020-11-18T16:21:41.4436677Z,2020,22,3,20,10,0,K,0,0,12,0,0,19,2,0,22,0,0,0
17707,6754,2020-11-18T16:21:41.4436677Z,2020,14,0,13,7,0,PK,0,0,7,0,0,14,1,0,14,0,0,0
17707,6755,2020-11-18T16:21:41.4436677Z,2020,6,6,4,0,0,Sin Grado,0,0,6,0,0,0,2,0,6,0,1,0
17707,747,2020-11-18T16:20:42.1131045Z,2019,18,2,13,10,0,1ro,0,0,8,0,0,16,5,0,18,0,0,0
17707,748,2020-11-18T16:20:42.1131045Z,2019,23,7,19,10,0,2do,0,0,13,0,0,16,4,0,23,0,0,0
17707,749,2020-11-18T16:20:42.1141054Z,2019,18,8,18,5,0,3ro,0,0,13,0,0,10,0,0,18,0,0,0
17707,750,2020-11-18T16:20:42.1141054Z,2019,23,5,19,11,0,4to,0,0,12,0,0,18,4,0,23,0,0,0
17707,751,2020-11-18T16:20:42.1141054Z,2019,28,11,24,13,0,5to,0,0,15,0,0,17,4,0,28,0,1,0
17707,752,2020-11-18T16:20:42.1141054Z,2019,20,5,17,11,0,K,0,0,9,0,0,15,3,0,20,0,0,0
17707,753,2020-11-18T16:20:42.1141054Z,2019,11,2,10,5,0,PK,0,0,6,0,0,9,1,0,11,0,0,0
17707,754,2020-11-18T16:20:42.1151058Z,2019,8,7,6,0,0,Sin Grado,0,0,8,0,0,1,2,0,8,0,1,0
71647,11378,2020-11-18T16:22:10.1828326Z,2020,42,14,33,21,0,1ro,0,0,21,0,0,28,9,0,42,0,0,0
71647,11379,2020-11-18T16:22:10.1838321Z,2020,46,13,39,25,0,2do,1,0,21,0,0,33,7,0,45,0,0,0
71647,11380,2020-11-18T16:22:10.1838321Z,2020,58,18,47,37,0,3ro,3,0,21,0,0,40,11,0,55,0,0,0
71647,11381,2020-11-18T16:22:10.1838321Z,2020,50,12,43,22,0,4to,2,0,28,0,0,38,7,0,48,0,0,0
71647,11382,2020-11-18T16:22:10.1848339Z,2020,54,13,42,21,0,5to,2,0,33,0,0,41,12,0,52,1,0,0
71647,11383,2020-11-18T16:22:10.1848339Z,2020,70,22,57,27,0,K,0,0,43,0,0,48,13,0,70,0,0,0
71647,11384,2020-11-18T16:22:10.1848339Z,2020,62,59,47,15,0,Sin Grado,1,0,47,0,0,3,15,0,60,0,0,1
71647,35400,2021-06-24T13:18:46.2005842Z,2021,65,26,57,29,0,1ro,0,0,36,0,0,39,8,0,65,0,0,0
71647,35401,2021-06-24T13:18:46.2005842Z,2021,43,11,35,24,0,2do,0,0,19,0,0,32,8,0,43,0,0,0
71647,35402,2021-06-24T13:18:46.2005842Z,2021,44,14,39,22,0,3ro,1,0,22,0,0,30,5,0,43,0,0,0
71647,35403,2021-06-24T13:18:46.201586Z,2021,57,21,53,39,0,4to,2,0,18,0,0,36,4,0,55,0,0,0
71647,35404,2021-06-24T13:18:46.201586Z,2021,50,15,40,20,0,5to,2,0,30,0,0,35,10,0,48,0,0,0
71647,35405,2021-06-24T13:18:46.201586Z,2021,49,15,41,21,0,K,1,0,28,0,0,34,8,0,48,0,0,0
71647,35406,2021-06-24T13:18:46.201586Z,2021,41,39,31,9,0,Sin Grado,0,0,32,0,0,2,10,0,41,0,0,0
71647,5370,2020-11-18T16:21:15.0880915Z,2019,55,19,42,31,0,1ro,1,0,24,0,0,36,13,0,54,0,0,0
71647,5371,2020-11-18T16:21:15.0880915Z,2019,67,28,53,39,0,2do,4,1,28,0,0,39,14,0,63,0,0,0
71647,5372,2020-11-18T16:21:15.0890915Z,2019,51,13,41,23,0,3ro,2,4,28,0,0,38,10,0,49,0,0,0
71647,5373,2020-11-18T16:21:15.0890915Z,2019,57,17,43,25,0,4to,1,1,32,0,0,40,14,0,56,1,0,0
71647,5374,2020-11-18T16:21:15.0890915Z,2019,69,27,50,33,0,5to,3,2,36,0,0,42,19,0,66,0,1,0
71647,5375,2020-11-18T16:21:15.0890915Z,2019,47,14,27,21,0,K,0,2,26,0,0,33,20,0,47,0,0,0
71647,5376,2020-11-18T16:21:15.0900937Z,2019,69,65,47,17,0,Sin Grado,2,0,52,0,0,4,22,0,65,0,0,2
46003,3038,2020-11-18T16:21:00.3322528Z,2019,124,37,105,53,0,6to,0,0,71,0,0,87,19,0,124,2,1,0
46003,3039,2020-11-18T16:21:00.3322528Z,2019,177,56,148,80,0,7mo,7,0,97,0,0,121,29,0,170,0,3,0
46003,3040,2020-11-18T16:21:00.3322528Z,2019,189,32,140,99,0,8vo,0,0,90,0,0,157,49,0,189,0,0,0
46003,3041,2020-11-18T16:21:00.3332542Z,2019,46,42,35,14,0,Sin Grado,0,1,32,0,0,4,11,0,46,0,2,0
46003,33048,2021-06-24T13:18:29.8188375Z,2021,102,29,85,49,0,6to,2,0,53,0,0,73,17,0,100,0,0,0
46003,33049,2021-06-24T13:18:29.8198385Z,2021,139,34,110,65,0,7mo,0,0,74,0,0,105,29,0,139,1,0,0
46003,33050,2021-06-24T13:18:29.8198385Z,2021,147,35,109,69,0,8vo,3,0,78,0,0,112,38,0,144,2,1,0
46003,33051,2021-06-24T13:18:29.8198385Z,2021,33,33,26,13,0,Sin Grado,0,0,20,0,0,0,7,0,33,0,1,0
46003,9052,2020-11-18T16:21:55.4279952Z,2020,126,36,110,55,0,6to,2,0,71,0,0,90,16,0,124,1,0,0
46003,9053,2020-11-18T16:21:55.4279952Z,2020,122,35,102,57,0,7mo,4,0,65,0,0,87,20,0,118,2,2,0
46003,9054,2020-11-18T16:21:55.4279952Z,2020,164,49,131,75,0,8vo,5,3,89,0,0,115,33,0,159,0,2,0
46003,9055,2020-11-18T16:21:55.4279952Z,2020,39,39,28,11,0,Sin Grado,0,0,28,0,0,0,11,0,39,0,2,0
61655,10328,2020-11-18T16:22:03.7065126Z,2020,53,15,49,26,0,10mo,17,0,27,0,0,38,4,0,35,0,0,1
61655,10329,2020-11-18T16:22:03.707513Z,2020,49,5,46,26,0,11mo,16,1,23,0,0,44,3,0,32,0,0,1
61655,10330,2020-11-18T16:22:03.707513Z,2020,67,14,60,35,0,12mo,21,0,32,0,0,53,7,0,46,0,0,0
61655,10331,2020-11-18T16:22:03.707513Z,2020,53,16,51,26,0,6to,3,0,27,0,0,37,2,0,49,0,0,1
61655,10332,2020-11-18T16:22:03.708513Z,2020,95,32,91,49,0,7mo,17,2,46,0,0,63,4,0,77,0,0,1
61655,10333,2020-11-18T16:22:03.708513Z,2020,77,25,72,45,0,8vo,19,1,32,0,0,52,5,1,57,0,0,0
61655,10334,2020-11-18T16:22:03.708513Z,2020,98,31,92,45,0,9no,21,0,53,0,0,67,6,0,77,0,0,0
61655,10335,2020-11-18T16:22:03.7095144Z,2020,16,15,15,5,0,Sin Grado,1,0,11,0,0,1,1,0,15,0,0,0
61655,34343,2021-06-24T13:18:38.6141445Z,2021,80,28,60,36,0,10mo,20,0,44,0,0,52,20,0,60,0,0,0
61655,34344,2021-06-24T13:18:38.615145Z,2021,51,12,41,26,0,11mo,19,0,25,0,0,39,10,0,31,0,0,1
61655,34345,2021-06-24T13:18:38.615145Z,2021,37,5,33,22,0,12mo,15,0,15,0,0,32,4,1,20,0,0,1
61655,34346,2021-06-24T13:18:38.615145Z,2021,59,22,54,30,0,6to,10,0,29,0,0,37,5,0,49,0,0,0
61655,34347,2021-06-24T13:18:38.6161455Z,2021,65,18,64,33,0,7mo,7,0,32,0,0,47,1,0,57,0,0,1
61655,34348,2021-06-24T13:18:38.6161455Z,2021,79,24,70,38,0,8vo,14,0,41,0,0,55,9,0,64,0,0,1
61655,34349,2021-06-24T13:18:38.6161455Z,2021,80,26,64,41,0,9no,17,0,39,0,0,54,16,0,63,0,0,0
61655,34350,2021-06-24T13:18:38.6161455Z,2021,20,17,14,7,0,Sin Grado,1,0,13,0,0,3,6,0,19,0,0,0
61655,4315,2020-11-18T16:21:09.6894905Z,2019,44,4,41,19,0,10mo,11,0,25,0,0,40,3,0,32,0,0,1
61655,4316,2020-11-18T16:21:09.6894905Z,2019,69,16,61,34,0,11mo,16,0,35,0,0,53,8,0,53,0,0,0
61655,4317,2020-11-18T16:21:09.6904914Z,2019,76,0,70,41,0,12mo,19,0,35,0,0,76,6,1,56,0,0,0
61655,4318,2020-11-18T16:21:09.6904914Z,2019,63,20,60,27,0,6to,13,0,36,0,0,43,3,0,49,0,0,1
61655,4319,2020-11-18T16:21:09.6904914Z,2019,78,25,71,41,0,7mo,22,1,37,0,0,53,7,1,55,0,0,0
61655,4320,2020-11-18T16:21:09.6914922Z,2019,92,21,87,53,0,8vo,18,1,39,0,0,71,5,0,73,0,0,1
61655,4321,2020-11-18T16:21:09.6914922Z,2019,61,24,54,25,0,9no,11,0,36,0,0,37,7,0,49,0,0,1
61655,4322,2020-11-18T16:21:09.6914922Z,2019,12,11,12,5,0,Sin Grado,1,0,7,0,0,1,0,0,11,0,0,0
61622,10321,2020-11-18T16:22:03.7065126Z,2020,27,9,21,14,0,1ro,2,1,13,0,0,18,6,0,25,0,0,0
61622,10322,2020-11-18T16:22:03.7065126Z,2020,37,11,34,20,0,2do,3,0,17,0,0,26,3,0,34,0,0,0
61622,10323,2020-11-18T16:22:03.7065126Z,2020,33,11,27,14,0,3ro,1,1,19,0,0,22,6,0,32,0,1,0
61622,10324,2020-11-18T16:22:03.707513Z,2020,43,13,37,21,0,4to,3,1,22,0,0,30,6,0,40,0,0,0
61622,10325,2020-11-18T16:22:03.707513Z,2020,38,18,36,20,0,5to,3,0,18,0,0,20,2,0,35,0,0,0
61622,10326,2020-11-18T16:22:03.708513Z,2020,43,17,39,22,0,6to,5,1,21,0,0,26,4,0,38,0,0,0
61622,10327,2020-11-18T16:22:03.708513Z,2020,25,5,21,13,0,K,0,0,12,0,0,20,4,0,24,0,0,1
61622,34336,2021-06-24T13:18:38.6101412Z,2021,28,9,27,15,0,1ro,1,0,13,0,0,19,1,0,27,0,0,0
61622,34337,2021-06-24T13:18:38.6101412Z,2021,31,12,26,17,0,2do,2,1,14,0,0,19,5,0,29,0,0,0
61622,34338,2021-06-24T13:18:38.6111425Z,2021,43,17,40,23,0,3ro,5,3,20,0,0,26,3,0,38,0,0,0
61622,34339,2021-06-24T13:18:38.6111425Z,2021,40,17,39,19,0,4to,0,1,21,0,0,23,1,0,40,0,1,0
61622,34340,2021-06-24T13:18:38.6111425Z,2021,45,12,39,23,0,5to,4,2,22,0,0,33,6,0,41,0,0,0
61622,34341,2021-06-24T13:18:38.612143Z,2021,45,22,42,23,0,6to,4,0,22,0,0,23,3,0,41,0,0,0
61622,34342,2021-06-24T13:18:38.612143Z,2021,25,7,24,14,0,K,0,1,11,0,0,18,1,0,25,0,0,0
61622,4308,2020-11-18T16:21:09.6864887Z,2019,43,13,38,22,0,1ro,2,4,21,0,0,30,5,0,41,0,0,0
61622,4309,2020-11-18T16:21:09.6864887Z,2019,33,15,29,14,0,2do,0,3,19,0,0,18,4,0,33,0,1,0
61622,4310,2020-11-18T16:21:09.6874896Z,2019,41,12,37,19,0,3ro,2,0,22,0,0,29,4,0,39,0,0,0
61622,4311,2020-11-18T16:21:09.6874896Z,2019,33,18,30,17,0,4to,3,0,16,0,0,15,3,0,30,0,0,0
61622,4312,2020-11-18T16:21:09.6874896Z,2019,36,13,29,16,0,5to,5,1,20,0,0,23,7,0,31,0,0,0
61622,4313,2020-11-18T16:21:09.6874896Z,2019,33,15,26,15,0,6to,4,1,18,0,0,18,7,0,29,0,0,0
61622,4314,2020-11-18T16:21:09.6874896Z,2019,22,7,18,12,0,K,2,3,10,0,0,15,4,0,20,0,0,0
15792,30648,2021-06-24T13:18:10.6500864Z,2021,157,54,110,78,0,10mo,5,0,79,0,0,103,47,0,152,0,0,0
15792,30649,2021-06-24T13:18:10.6500864Z,2021,185,57,132,83,0,11mo,6,0,102,0,0,128,53,0,179,0,2,0
15792,30650,2021-06-24T13:18:10.6500864Z,2021,156,50,119,88,0,12mo,3,0,68,0,0,106,37,0,153,2,0,0
15792,30651,2021-06-24T13:18:10.6500864Z,2021,224,81,168,111,0,9no,11,0,113,0,0,143,56,0,213,2,0,0
15792,30652,2021-06-24T13:18:10.6510869Z,2021,29,29,20,5,0,Sin Grado,1,0,24,0,0,0,9,0,28,0,0,0
15792,650,2020-11-18T16:20:41.1874886Z,2019,190,65,138,102,0,10mo,4,0,88,0,0,125,52,0,186,3,0,0
15792,651,2020-11-18T16:20:41.1874886Z,2019,190,57,136,87,0,11mo,6,1,103,0,0,133,54,0,184,3,1,0
15792,652,2020-11-18T16:20:41.1874886Z,2019,134,0,104,64,0,12mo,2,1,70,0,0,134,30,0,132,0,0,0
15792,653,2020-11-18T16:20:41.1874886Z,2019,225,73,174,98,0,9no,8,3,127,0,0,152,51,0,217,1,4,0
15792,654,2020-11-18T16:20:41.1884895Z,2019,27,13,25,2,0,Sin Grado,1,0,25,0,0,14,2,0,26,0,0,0
15792,6650,2020-11-18T16:21:40.7532108Z,2020,216,69,159,93,0,10mo,7,5,123,0,0,147,57,0,209,1,3,0
15792,6651,2020-11-18T16:21:40.7532108Z,2020,163,52,121,94,0,11mo,4,0,69,0,0,111,42,0,159,2,0,0
15792,6652,2020-11-18T16:21:40.7542108Z,2020,177,55,131,81,0,12mo,6,1,96,0,0,122,46,0,171,3,1,0
15792,6653,2020-11-18T16:21:40.7542108Z,2020,186,68,142,85,0,9no,8,4,101,0,0,118,44,0,178,0,0,0
15792,6654,2020-11-18T16:21:40.7542108Z,2020,21,21,19,6,0,Sin Grado,0,0,15,0,0,0,2,0,21,0,0,0
70136,10902,2020-11-18T16:22:07.1978413Z,2020,52,18,48,33,0,1ro,2,0,19,0,0,34,4,0,49,0,0,1
70136,10903,2020-11-18T16:22:07.1978413Z,2020,48,14,44,24,0,2do,2,0,24,0,0,34,4,0,46,0,0,0
70136,10904,2020-11-18T16:22:07.1978413Z,2020,47,15,37,28,0,3ro,0,0,19,0,0,32,10,0,46,0,0,1
70136,10905,2020-11-18T16:22:07.1978413Z,2020,33,10,28,16,0,4to,3,0,17,0,0,23,5,0,29,0,0,1
70136,10906,2020-11-18T16:22:07.1988418Z,2020,43,13,41,21,0,5to,3,0,22,0,0,30,2,0,40,0,1,0
70136,10907,2020-11-18T16:22:07.1988418Z,2020,65,17,56,24,0,K,2,0,41,0,0,48,9,0,63,0,0,0
70136,10908,2020-11-18T16:22:07.1988418Z,2020,24,2,21,16,0,PK,0,0,8,0,0,22,3,0,24,0,0,0
70136,10909,2020-11-18T16:22:07.1988418Z,2020,38,37,36,12,0,Sin Grado,0,0,26,0,0,1,2,0,38,0,0,0
70136,34924,2021-06-24T13:18:43.3265237Z,2021,60,15,54,22,0,1ro,2,0,38,0,0,45,6,0,58,0,0,0
70136,34925,2021-06-24T13:18:43.3265237Z,2021,54,17,48,34,0,2do,2,0,20,0,0,37,6,0,51,0,0,1
70136,34926,2021-06-24T13:18:43.3275247Z,2021,47,13,44,28,0,3ro,2,0,19,0,0,34,3,0,45,0,0,0
70136,34927,2021-06-24T13:18:43.3275247Z,2021,52,16,44,30,0,4to,1,0,22,0,0,36,8,0,50,0,0,1
70136,34928,2021-06-24T13:18:43.3275247Z,2021,31,9,26,13,0,5to,3,0,18,0,0,22,5,0,28,0,0,0
70136,34929,2021-06-24T13:18:43.3285247Z,2021,55,14,51,26,0,K,2,0,29,0,0,41,4,0,53,0,0,0
70136,34930,2021-06-24T13:18:43.3285247Z,2021,28,1,25,13,0,PK,0,0,15,0,0,27,3,0,28,0,0,0
70136,34931,2021-06-24T13:18:43.3285247Z,2021,29,29,28,8,0,Sin Grado,0,0,21,0,0,0,1,0,29,0,0,0
70136,4894,2020-11-18T16:21:12.4063059Z,2019,54,19,47,29,0,1ro,1,0,25,0,0,35,7,0,53,0,0,0
70136,4895,2020-11-18T16:21:12.4063059Z,2019,58,17,48,38,0,2do,0,0,20,0,0,41,10,0,57,0,0,1
70136,4896,2020-11-18T16:21:12.4063059Z,2019,33,15,25,11,0,3ro,2,0,22,0,0,18,8,0,30,0,0,1
70136,4897,2020-11-18T16:21:12.4063059Z,2019,45,17,42,21,0,4to,2,0,24,0,0,28,3,0,43,0,0,0
70136,4898,2020-11-18T16:21:12.4073063Z,2019,54,19,46,30,0,5to,1,0,24,0,0,35,8,0,53,0,0,0
70136,4899,2020-11-18T16:21:12.4073063Z,2019,41,14,37,25,0,K,0,0,16,0,0,27,4,0,40,0,0,1
70136,4900,2020-11-18T16:21:12.4083072Z,2019,24,6,19,13,0,PK,1,0,11,0,0,18,5,0,23,0,0,0
70136,4901,2020-11-18T16:21:12.9736842Z,2019,40,40,39,13,0,Sin Grado,0,0,27,0,0,0,1,0,40,0,0,0
70490,11030,2020-11-18T16:22:07.6201212Z,2020,123,55,114,60,0,6to,6,0,63,0,0,68,9,0,117,0,2,0
70490,11031,2020-11-18T16:22:07.6201212Z,2020,148,69,126,66,0,7mo,8,0,82,0,0,79,22,0,140,0,0,0
70490,11032,2020-11-18T16:22:07.6201212Z,2020,91,40,76,39,0,8vo,5,0,52,0,0,51,15,0,86,0,0,0
70490,11033,2020-11-18T16:22:07.6201212Z,2020,22,22,19,4,0,Sin Grado,0,0,18,0,0,0,3,0,22,0,0,0
70490,35051,2021-06-24T13:18:43.7087979Z,2021,114,49,103,55,0,6to,1,0,59,0,0,65,11,3,110,0,3,0
70490,35052,2021-06-24T13:18:43.7097988Z,2021,125,57,113,58,0,7mo,4,0,67,0,0,68,12,1,120,0,2,0
70490,35053,2021-06-24T13:18:43.7097988Z,2021,137,67,125,60,0,8vo,5,0,77,0,0,70,12,0,132,0,0,0
70490,35054,2021-06-24T13:18:43.7097988Z,2021,20,20,17,6,0,Sin Grado,0,0,14,0,0,0,3,0,20,0,0,0
70490,5022,2020-11-18T16:21:13.4169805Z,2019,159,74,138,73,0,6to,8,0,86,0,0,85,21,0,151,0,0,0
70490,5023,2020-11-18T16:21:13.4169805Z,2019,104,43,89,42,0,7mo,5,1,62,0,0,61,15,0,99,0,0,0
70490,5024,2020-11-18T16:21:13.4169805Z,2019,146,64,116,68,0,8vo,1,0,78,0,0,82,30,0,145,0,1,0
70490,5025,2020-11-18T16:21:13.4169805Z,2019,8,7,3,1,0,Sin Grado,0,0,7,0,0,1,5,0,8,0,0,0
52084,33527,2021-06-24T13:18:33.3733863Z,2021,25,3,24,13,0,1ro,0,0,12,0,0,22,1,0,25,0,0,0
52084,33528,2021-06-24T13:18:33.3733863Z,2021,24,7,24,13,0,2do,0,0,11,0,0,17,0,0,24,0,0,0
52084,33529,2021-06-24T13:18:33.3733863Z,2021,27,9,27,11,0,3ro,0,0,16,0,0,18,0,0,27,0,0,0
52084,33530,2021-06-24T13:18:33.3743868Z,2021,16,8,15,10,0,4to,0,0,6,0,0,8,1,0,15,0,0,1
52084,33531,2021-06-24T13:18:33.3743868Z,2021,22,9,21,9,0,5to,0,0,13,0,0,13,1,0,22,0,0,0
52084,33532,2021-06-24T13:18:33.3753882Z,2021,11,4,11,5,0,K,0,0,6,0,0,7,0,0,11,0,0,0
52084,3501,2020-11-18T16:21:03.2562056Z,2019,34,16,34,15,0,1ro,0,0,19,0,0,18,0,0,34,0,0,0
52084,3502,2020-11-18T16:21:03.2562056Z,2019,26,11,24,15,0,2do,0,0,11,0,0,15,2,0,26,0,0,0
52084,3503,2020-11-18T16:21:03.2562056Z,2019,25,10,24,12,0,3ro,0,0,13,0,0,15,1,0,25,0,0,0
52084,3504,2020-11-18T16:21:03.2562056Z,2019,26,11,26,14,0,4to,0,0,12,0,0,15,0,0,26,1,0,0
52084,3505,2020-11-18T16:21:03.257206Z,2019,21,7,20,17,0,5to,1,0,4,0,0,14,1,0,20,0,0,0
52084,3506,2020-11-18T16:21:03.257206Z,2019,24,6,23,20,0,K,0,0,4,0,0,18,1,0,24,0,0,0
52084,3507,2020-11-18T16:21:03.257206Z,2019,4,4,4,1,0,Sin Grado,0,0,3,0,0,0,0,0,4,0,0,0
52084,9522,2020-11-18T16:21:59.0794275Z,2020,29,9,28,17,0,1ro,0,0,12,0,0,20,1,0,29,0,0,0
52084,9523,2020-11-18T16:21:59.0794275Z,2020,33,13,33,14,0,2do,0,0,19,0,0,20,0,0,33,0,0,0
52084,9524,2020-11-18T16:21:59.0804275Z,2020,19,9,16,10,0,3ro,0,0,9,0,0,10,3,0,18,0,0,1
52084,9525,2020-11-18T16:21:59.0804275Z,2020,23,10,22,10,0,4to,0,2,13,0,0,13,1,0,23,0,0,0
52084,9526,2020-11-18T16:21:59.0804275Z,2020,24,10,23,13,0,5to,0,0,11,0,0,14,1,0,24,1,0,0
52084,9527,2020-11-18T16:21:59.0804275Z,2020,24,0,23,11,0,K,0,2,13,0,0,24,1,0,24,0,0,0
61663,10336,2020-11-18T16:22:03.708513Z,2020,55,21,37,22,0,10mo,0,1,33,0,0,34,18,0,55,0,0,0
61663,10337,2020-11-18T16:22:03.708513Z,2020,37,15,33,21,0,11mo,2,2,16,0,0,22,4,0,35,0,0,0
61663,10338,2020-11-18T16:22:03.7095144Z,2020,43,12,28,23,0,12mo,0,2,20,0,0,31,15,0,43,0,0,0
61663,10339,2020-11-18T16:22:03.7095144Z,2020,22,9,19,12,0,6to,0,0,10,0,0,13,3,0,22,0,0,0
61663,10340,2020-11-18T16:22:03.7095144Z,2020,45,16,39,22,0,7mo,1,1,23,0,0,29,6,0,43,0,0,1
61663,10341,2020-11-18T16:22:03.7095144Z,2020,37,11,26,19,0,8vo,0,1,18,0,0,26,11,0,37,0,0,0
61663,10342,2020-11-18T16:22:03.7105144Z,2020,40,12,33,24,0,9no,2,1,16,0,0,28,7,0,38,0,0,0
61663,34351,2021-06-24T13:18:38.6201497Z,2021,32,13,25,14,0,10mo,1,2,18,0,0,19,7,0,31,0,0,0
61663,34352,2021-06-24T13:18:38.6201497Z,2021,49,18,34,22,0,11mo,3,0,27,0,0,31,15,0,46,0,0,0
61663,34353,2021-06-24T13:18:38.6211497Z,2021,39,16,34,21,0,12mo,3,1,18,0,0,23,5,0,36,0,0,0
61663,34354,2021-06-24T13:18:38.6211497Z,2021,21,9,16,11,0,6to,0,0,10,0,0,12,5,0,21,0,0,0
61663,34355,2021-06-24T13:18:38.6211497Z,2021,34,13,31,17,0,7mo,0,0,17,0,0,21,3,0,34,0,0,0
61663,34356,2021-06-24T13:18:38.6211497Z,2021,44,16,41,22,0,8vo,1,2,22,0,0,28,3,0,43,0,0,0
61663,34357,2021-06-24T13:18:38.6221511Z,2021,36,10,28,19,0,9no,1,0,17,0,0,26,8,0,35,0,0,0
61663,4323,2020-11-18T16:21:09.694494Z,2019,36,14,31,21,0,10mo,3,4,15,0,0,22,5,0,33,0,0,0
61663,4324,2020-11-18T16:21:09.694494Z,2019,40,11,27,22,0,11mo,1,2,18,0,0,29,13,0,39,0,1,0
61663,4325,2020-11-18T16:21:09.694494Z,2019,45,0,33,24,0,12mo,1,3,21,0,0,45,12,0,44,0,0,0
61663,4326,2020-11-18T16:21:09.6954958Z,2019,19,5,17,6,0,6to,2,0,13,0,0,14,2,0,17,0,0,0
61663,4327,2020-11-18T16:21:09.6954958Z,2019,39,11,36,18,0,7mo,1,2,21,0,0,28,3,0,38,0,0,0
61663,4328,2020-11-18T16:21:09.6954958Z,2019,44,13,37,25,0,8vo,2,3,19,0,0,31,7,0,42,0,0,0
61663,4329,2020-11-18T16:21:09.6954958Z,2019,53,16,32,20,0,9no,0,4,33,0,0,37,21,0,53,0,0,0
65003,10699,2020-11-18T16:22:05.3566151Z,2020,90,23,71,41,0,10mo,7,0,49,0,0,67,19,0,81,0,1,2
65003,10700,2020-11-18T16:22:05.3576146Z,2020,148,37,118,74,0,11mo,13,1,74,0,0,111,30,0,135,0,0,0
65003,10701,2020-11-18T16:22:06.0060482Z,2020,107,20,82,58,0,12mo,4,0,49,0,0,87,25,0,103,0,0,0
65003,10702,2020-11-18T16:22:06.0060482Z,2020,125,28,101,58,0,9no,8,0,67,0,0,97,24,0,117,0,1,0
65003,10703,2020-11-18T16:22:06.0070487Z,2020,5,5,3,2,0,Sin Grado,2,0,3,0,0,0,2,0,3,0,0,0
65003,34716,2021-06-24T13:18:41.451179Z,2021,117,24,96,51,0,10mo,9,0,66,0,0,93,21,0,108,0,1,0
65003,34717,2021-06-24T13:18:41.451179Z,2021,83,20,70,37,0,11mo,6,0,46,0,0,63,13,0,75,0,1,2
65003,34718,2021-06-24T13:18:41.451179Z,2021,143,35,116,73,0,12mo,12,0,70,0,0,108,27,0,131,0,0,0
65003,34719,2021-06-24T13:18:41.45218Z,2021,112,23,104,60,0,9no,9,0,52,0,0,89,8,0,103,0,0,0
65003,34720,2021-06-24T13:18:41.45218Z,2021,3,3,3,2,0,Sin Grado,2,0,1,0,0,0,0,0,1,0,0,0
65003,4687,2020-11-18T16:21:11.2675447Z,2019,165,40,140,83,0,10mo,17,2,82,0,0,125,25,0,148,0,0,0
65003,4688,2020-11-18T16:21:11.2685452Z,2019,126,23,100,66,0,11mo,6,0,60,0,0,103,26,0,120,0,0,0
65003,4689,2020-11-18T16:21:11.2685452Z,2019,157,0,117,82,0,12mo,6,0,75,0,0,157,40,0,151,0,0,0
65003,4690,2020-11-18T16:21:11.2685452Z,2019,121,36,94,51,0,9no,3,0,70,0,0,85,27,0,117,0,1,1
65003,4691,2020-11-18T16:21:11.269546Z,2019,5,5,4,2,0,Sin Grado,1,0,3,0,0,0,1,0,4,0,0,0
20362,30946,2021-06-24T13:18:11.8069159Z,2021,133,48,103,73,0,10mo,0,0,60,0,0,85,30,0,133,0,0,0
20362,30947,2021-06-24T13:18:11.8069159Z,2021,103,31,76,54,0,11mo,0,0,49,0,0,72,27,0,103,0,0,0
20362,30948,2021-06-24T13:18:11.8079173Z,2021,116,31,72,64,0,12mo,0,0,52,0,0,85,44,0,116,0,0,0
20362,30949,2021-06-24T13:18:11.8079173Z,2021,108,33,77,52,0,9no,0,0,56,0,0,75,31,0,108,1,0,0
20362,30950,2021-06-24T13:18:11.8079173Z,2021,20,18,19,7,0,Sin Grado,0,0,13,0,0,2,1,0,20,0,0,0
20362,6950,2020-11-18T16:21:42.5834293Z,2020,111,34,81,55,0,10mo,0,0,56,0,0,77,30,0,111,0,0,0
20362,6951,2020-11-18T16:21:42.5834293Z,2020,124,35,79,67,0,11mo,0,0,57,0,0,89,45,0,124,0,0,0
20362,6952,2020-11-18T16:21:42.5834293Z,2020,128,29,76,73,0,12mo,0,0,55,0,0,99,52,0,127,0,0,1
20362,6953,2020-11-18T16:21:42.5834293Z,2020,108,42,82,55,0,9no,0,0,53,0,0,66,26,0,108,0,0,0
20362,6954,2020-11-18T16:21:42.5834293Z,2020,20,18,16,8,0,Sin Grado,0,0,12,0,0,2,4,0,20,0,0,0
20362,950,2020-11-18T16:20:43.3759445Z,2019,139,42,94,67,0,10mo,0,0,72,0,0,97,45,0,139,0,0,0
20362,951,2020-11-18T16:20:43.3759445Z,2019,160,32,97,85,0,11mo,1,1,75,0,0,128,63,0,158,1,1,1
20362,952,2020-11-18T16:20:43.3769458Z,2019,100,0,66,55,0,12mo,1,3,45,0,0,100,34,0,99,0,0,0
20362,953,2020-11-18T16:20:43.3769458Z,2019,119,43,90,53,0,9no,0,0,66,0,0,76,29,0,119,0,0,0
20362,954,2020-11-18T16:20:43.3769458Z,2019,11,8,9,6,0,Sin Grado,0,0,5,0,0,3,2,0,11,0,0,0
71043,11183,2020-11-18T16:22:08.3375999Z,2020,24,8,20,11,0,10mo,0,1,13,0,0,16,4,0,24,0,0,0
71043,11184,2020-11-18T16:22:08.3375999Z,2020,31,19,27,14,0,11mo,0,0,17,0,0,12,4,0,31,0,0,0
71043,11185,2020-11-18T16:22:08.3386022Z,2020,51,15,46,28,0,12mo,0,0,23,0,0,36,5,0,51,0,0,0
71043,11186,2020-11-18T16:22:08.3386022Z,2020,27,7,25,14,0,1ro,0,0,13,0,0,20,2,0,27,0,0,0
71043,11187,2020-11-18T16:22:08.3386022Z,2020,24,7,19,15,0,2do,0,0,9,0,0,17,5,0,24,0,0,0
71043,11188,2020-11-18T16:22:08.3396008Z,2020,39,13,35,19,0,3ro,1,0,20,0,0,26,4,0,38,0,0,0
71043,11189,2020-11-18T16:22:08.3396008Z,2020,36,13,32,16,0,4to,0,0,20,0,0,23,4,0,36,0,0,0
71043,11190,2020-11-18T16:22:08.3396008Z,2020,48,15,37,26,0,5to,0,0,22,0,0,33,11,0,47,0,0,1
71043,11191,2020-11-18T16:22:08.3396008Z,2020,42,10,30,22,0,6to,0,0,20,0,0,32,12,0,41,0,0,1
71043,11192,2020-11-18T16:22:08.3406013Z,2020,37,12,31,19,0,7mo,0,0,18,0,0,25,6,0,37,0,0,0
71043,11193,2020-11-18T16:22:08.3406013Z,2020,33,16,29,18,0,8vo,0,0,15,0,0,17,4,0,33,0,0,0
71043,11194,2020-11-18T16:22:08.3406013Z,2020,62,21,55,27,0,9no,1,2,35,0,0,41,7,0,61,0,0,0
71043,11195,2020-11-18T16:22:08.3416026Z,2020,27,9,23,12,0,K,0,0,15,0,0,18,4,0,27,0,0,0
71043,11196,2020-11-18T16:22:08.3416026Z,2020,18,17,17,6,0,Sin Grado,0,3,12,0,0,1,1,0,18,0,0,0
71043,35204,2021-06-24T13:18:44.7925752Z,2021,60,22,52,27,0,10mo,1,2,33,0,0,38,8,0,59,0,0,0
71043,35205,2021-06-24T13:18:44.7935753Z,2021,25,7,22,13,0,11mo,0,0,12,0,0,18,3,0,25,0,0,0
71043,35206,2021-06-24T13:18:44.7935753Z,2021,24,13,23,14,0,12mo,0,0,10,0,0,11,1,0,24,0,0,0
71043,35207,2021-06-24T13:18:44.7935753Z,2021,33,9,29,16,0,1ro,0,0,17,0,0,24,4,0,33,0,0,0
71043,35208,2021-06-24T13:18:44.7935753Z,2021,26,6,25,14,0,2do,0,0,12,0,0,20,1,0,26,0,0,0
71043,35209,2021-06-24T13:18:44.7945766Z,2021,23,7,20,13,0,3ro,0,0,10,0,0,16,3,0,23,0,0,0
71043,35210,2021-06-24T13:18:44.7945766Z,2021,39,13,36,19,0,4to,1,0,20,0,0,26,3,0,38,0,0,0
71043,35211,2021-06-24T13:18:44.7945766Z,2021,35,13,33,17,0,5to,0,0,18,0,0,22,2,0,35,0,0,0
71043,35212,2021-06-24T13:18:44.7945766Z,2021,49,13,41,27,0,6to,2,0,22,0,0,36,8,0,46,0,0,1
71043,35213,2021-06-24T13:18:44.7945766Z,2021,40,9,34,20,0,7mo,0,0,20,0,0,31,6,0,40,0,0,0
71043,35214,2021-06-24T13:18:44.7955776Z,2021,39,12,34,20,0,8vo,0,0,19,0,0,27,5,0,39,0,0,0
71043,35215,2021-06-24T13:18:44.7955776Z,2021,44,24,42,20,0,9no,0,0,24,0,0,20,2,0,44,0,0,0
71043,35216,2021-06-24T13:18:44.7955776Z,2021,27,4,20,15,0,K,0,0,12,0,0,23,7,0,27,0,0,0
71043,35217,2021-06-24T13:18:44.7955776Z,2021,32,28,24,5,0,Sin Grado,0,4,27,0,0,4,8,0,32,1,0,0
71043,5178,2020-11-18T16:21:14.0514022Z,2019,29,17,27,13,0,10mo,0,0,16,0,0,12,2,0,29,0,1,0
71043,5179,2020-11-18T16:21:14.0524031Z,2019,48,17,44,24,0,11mo,0,0,24,0,0,31,4,0,48,0,0,0
71043,5180,2020-11-18T16:21:14.0524031Z,2019,49,0,43,25,0,12mo,1,0,24,0,0,49,6,0,48,0,0,0
71043,5181,2020-11-18T16:21:14.0524031Z,2019,31,8,28,15,0,1ro,0,0,16,0,0,23,3,0,31,0,0,0
71043,5182,2020-11-18T16:21:14.0534031Z,2019,37,13,32,19,0,2do,1,1,18,0,0,24,5,0,36,0,0,0
71043,5183,2020-11-18T16:21:14.0534031Z,2019,31,12,30,15,0,3ro,0,0,16,0,0,19,1,0,31,0,0,0
71043,5184,2020-11-18T16:21:14.0534031Z,2019,43,13,33,21,0,4to,1,1,22,0,0,30,10,0,41,0,0,1
71043,5185,2020-11-18T16:21:14.0544035Z,2019,35,8,29,19,0,5to,0,0,16,0,0,27,6,0,34,0,0,1
71043,5186,2020-11-18T16:21:14.0544035Z,2019,34,10,28,15,0,6to,0,0,19,0,0,24,6,0,34,0,0,0
71043,5187,2020-11-18T16:21:14.0544035Z,2019,27,15,26,15,0,7mo,0,0,12,0,0,12,1,0,27,0,0,0
71043,5188,2020-11-18T16:21:14.0554044Z,2019,47,11,41,22,0,8vo,1,0,25,0,0,36,6,0,46,0,0,0
71043,5189,2020-11-18T16:21:14.0554044Z,2019,26,10,22,10,0,9no,0,1,16,0,0,16,4,0,26,0,0,0
71043,5190,2020-11-18T16:21:14.0554044Z,2019,28,7,27,15,0,K,0,0,13,0,0,21,1,0,28,0,0,0
71043,5191,2020-11-18T16:21:14.0554044Z,2019,14,10,13,4,0,Sin Grado,0,1,10,0,0,4,1,0,14,0,0,0
20818,1093,2020-11-18T16:20:43.822243Z,2019,80,32,75,39,0,10mo,1,0,41,0,0,48,5,0,79,0,0,0
20818,1094,2020-11-18T16:20:43.822243Z,2019,78,29,55,42,0,11mo,0,0,36,0,0,49,23,0,78,0,0,0
20818,1095,2020-11-18T16:20:43.8232439Z,2019,69,0,55,36,0,12mo,1,0,33,0,0,69,14,0,67,0,1,1
20818,1096,2020-11-18T16:20:43.8232439Z,2019,49,14,44,25,0,9no,0,0,24,0,0,35,5,0,49,0,0,0
20818,1097,2020-11-18T16:20:43.8232439Z,2019,60,49,40,24,0,Sin Grado,0,0,36,0,0,11,20,0,60,0,0,0
20818,31093,2021-06-24T13:18:12.1071307Z,2021,60,31,51,14,0,10mo,0,0,46,0,0,29,9,0,60,0,0,0
20818,31094,2021-06-24T13:18:12.1071307Z,2021,43,14,38,26,0,11mo,0,0,17,0,0,29,5,0,43,0,0,0
20818,31095,2021-06-24T13:18:12.1071307Z,2021,63,28,54,29,0,12mo,0,0,34,0,0,35,9,0,63,0,0,0
20818,31096,2021-06-24T13:18:12.1081317Z,2021,42,15,32,12,0,9no,2,0,30,0,0,27,10,0,40,0,0,0
20818,31097,2021-06-24T13:18:12.1081317Z,2021,53,50,36,18,0,Sin Grado,0,0,35,0,0,3,17,0,53,0,0,0
20818,7097,2020-11-18T16:21:43.6481378Z,2020,50,16,42,31,0,10mo,0,0,19,0,0,34,8,0,50,0,0,0
20818,7098,2020-11-18T16:21:43.6491383Z,2020,76,30,69,36,0,11mo,0,0,40,0,0,46,7,0,76,0,0,0
20818,7099,2020-11-18T16:21:43.6491383Z,2020,76,29,52,41,0,12mo,0,0,35,0,0,47,24,0,75,0,1,1
20818,7100,2020-11-18T16:21:43.6491383Z,2020,68,36,61,18,0,9no,0,1,50,0,0,32,7,0,68,0,0,0
20818,7101,2020-11-18T16:21:44.1804934Z,2020,57,56,43,22,0,Sin Grado,0,0,35,0,0,1,14,0,57,0,0,0
63073,10586,2020-11-18T16:22:04.9333317Z,2020,41,7,39,21,0,1ro,1,0,20,0,0,34,2,0,40,0,0,0
63073,10587,2020-11-18T16:22:04.9333317Z,2020,47,15,46,20,0,2do,0,1,27,0,0,32,1,0,45,0,1,2
63073,10588,2020-11-18T16:22:04.9343317Z,2020,30,6,28,17,0,3ro,0,0,13,0,0,24,2,0,29,0,0,1
63073,10589,2020-11-18T16:22:04.9343317Z,2020,39,13,37,18,0,4to,1,0,21,0,0,26,2,0,37,0,0,1
63073,10590,2020-11-18T16:22:04.9343317Z,2020,37,14,31,20,0,5to,3,0,17,0,0,23,6,0,34,0,0,0
63073,10591,2020-11-18T16:22:04.9343317Z,2020,49,6,49,21,0,K,0,0,28,0,0,43,0,0,49,0,0,0
63073,10592,2020-11-18T16:22:04.9343317Z,2020,24,24,24,4,0,Sin Grado,0,0,20,0,0,0,0,0,23,0,0,1
63073,34601,2021-06-24T13:18:41.0689036Z,2021,49,7,47,23,0,1ro,1,0,26,0,0,42,2,0,48,0,0,0
63073,34602,2021-06-24T13:18:41.0689036Z,2021,41,7,37,22,0,2do,1,0,19,0,0,34,4,0,40,0,0,0
63073,34603,2021-06-24T13:18:41.0699058Z,2021,49,15,45,22,0,3ro,0,0,27,0,0,34,4,0,49,0,1,0
63073,34604,2021-06-24T13:18:41.0699058Z,2021,29,5,28,14,0,4to,0,0,15,0,0,24,1,0,28,0,0,1
63073,34605,2021-06-24T13:18:41.0699058Z,2021,36,14,35,20,0,5to,1,0,16,0,0,22,1,0,34,0,0,1
63073,34606,2021-06-24T13:18:41.0699058Z,2021,24,4,14,12,0,K,0,0,12,0,0,20,10,0,24,0,0,0
63073,34607,2021-06-24T13:18:41.0709063Z,2021,17,17,17,3,0,Sin Grado,0,0,14,0,0,0,0,0,17,0,0,0
63073,4574,2020-11-18T16:21:10.8452635Z,2019,59,18,57,21,0,1ro,0,0,38,0,0,41,2,0,57,0,0,2
63073,4575,2020-11-18T16:21:10.8452635Z,2019,46,8,42,27,0,2do,2,0,19,0,0,38,4,0,43,0,1,1
63073,4576,2020-11-18T16:21:10.8462631Z,2019,50,14,46,28,0,3ro,2,1,22,0,0,36,4,0,48,0,0,0
63073,4577,2020-11-18T16:21:10.8462631Z,2019,46,18,41,26,0,4to,2,0,20,0,0,28,5,0,43,0,0,1
63073,4578,2020-11-18T16:21:10.8462631Z,2019,40,15,38,21,0,5to,4,0,19,0,0,25,2,0,36,0,0,0
63073,4579,2020-11-18T16:21:10.8472649Z,2019,48,5,47,25,0,K,2,1,23,0,0,43,1,0,46,0,0,0
63073,4580,2020-11-18T16:21:10.8472649Z,2019,12,12,12,1,0,Sin Grado,0,0,11,0,0,0,0,0,12,0,0,0
57877,33998,2021-06-24T13:18:36.6877634Z,2021,60,22,44,28,0,10mo,1,0,32,0,0,38,16,0,59,1,1,0
57877,33999,2021-06-24T13:18:36.6877634Z,2021,72,30,60,43,0,11mo,3,0,29,0,0,42,12,0,69,0,1,0
57877,34000,2021-06-24T13:18:36.9229318Z,2021,47,14,32,21,0,12mo,0,0,26,0,0,33,15,0,47,1,0,0
57877,34001,2021-06-24T13:18:36.9239327Z,2021,94,38,74,47,0,6to,3,0,47,0,0,56,20,0,91,3,0,0
57877,34002,2021-06-24T13:18:36.9239327Z,2021,68,28,55,30,0,7mo,1,0,38,0,0,40,13,0,67,0,1,0
57877,34003,2021-06-24T13:18:36.9239327Z,2021,61,21,48,31,0,8vo,4,0,30,0,0,40,13,0,57,2,0,0
57877,34004,2021-06-24T13:18:36.9249332Z,2021,73,22,54,35,0,9no,0,0,38,0,0,51,19,0,73,2,0,0
57877,3974,2020-11-18T16:21:06.8906272Z,2019,57,22,34,29,0,10mo,2,2,28,0,0,35,23,0,55,1,0,0
57877,3975,2020-11-18T16:21:06.8906272Z,2019,65,18,42,32,0,11mo,1,0,33,0,0,47,23,0,64,0,0,0
57877,3976,2020-11-18T16:21:06.8906272Z,2019,69,0,56,30,0,12mo,3,2,39,0,0,69,13,0,66,0,0,0
57877,3977,2020-11-18T16:21:06.8906272Z,2019,42,13,27,26,0,6to,4,1,16,0,0,29,15,0,38,2,1,0
57877,3978,2020-11-18T16:21:06.8906272Z,2019,75,19,51,38,0,7mo,1,1,37,0,0,56,24,0,74,2,0,0
57877,3979,2020-11-18T16:21:06.8916276Z,2019,75,23,52,35,0,8vo,1,0,40,0,0,52,23,0,74,1,1,0
57877,3980,2020-11-18T16:21:06.8916276Z,2019,83,36,57,46,0,9no,4,1,37,0,0,47,26,0,79,0,1,0
57877,9991,2020-11-18T16:22:01.5600843Z,2020,78,34,60,44,0,10mo,3,0,34,0,0,44,18,0,75,0,1,0
57877,9992,2020-11-18T16:22:01.5600843Z,2020,53,19,33,26,0,11mo,1,0,27,0,0,34,20,0,52,1,0,0
57877,9993,2020-11-18T16:22:01.5610852Z,2020,66,19,42,33,0,12mo,0,0,33,0,0,47,24,0,66,0,0,0
57877,9994,2020-11-18T16:22:01.5610852Z,2020,64,25,46,29,0,6to,0,0,35,0,0,39,18,0,64,0,0,0
57877,9995,2020-11-18T16:22:01.5610852Z,2020,64,24,50,33,0,7mo,4,0,31,0,0,40,14,0,60,2,0,0
57877,9996,2020-11-18T16:22:01.5620857Z,2020,73,20,54,35,0,8vo,0,0,38,0,0,53,19,0,73,2,0,0
57877,9997,2020-11-18T16:22:01.5620857Z,2020,55,20,37,25,0,9no,0,0,30,0,0,35,18,0,55,0,1,0
66001,10742,2020-11-18T16:22:06.0230589Z,2020,52,15,41,29,0,1ro,0,1,23,0,0,37,11,0,52,0,0,0
66001,10743,2020-11-18T16:22:06.0230589Z,2020,45,18,43,26,0,2do,2,0,19,0,0,27,2,0,43,0,0,0
66001,10744,2020-11-18T16:22:06.0240616Z,2020,57,19,49,36,0,3ro,1,1,21,0,0,38,8,0,56,0,0,0
66001,10745,2020-11-18T16:22:06.0240616Z,2020,65,22,38,40,0,4to,2,0,25,0,0,43,27,0,63,0,0,0
66001,10746,2020-11-18T16:22:06.0240616Z,2020,56,11,47,28,0,5to,0,1,28,0,0,45,9,0,56,0,0,0
66001,10747,2020-11-18T16:22:06.0250616Z,2020,40,8,37,19,0,K,0,0,21,0,0,32,3,0,40,0,0,0
66001,10748,2020-11-18T16:22:06.0250616Z,2020,34,34,31,6,0,Sin Grado,2,0,28,0,0,0,3,0,32,0,0,0
66001,34759,2021-06-24T13:18:41.4791987Z,2021,41,13,36,18,0,1ro,0,0,23,0,0,28,5,0,41,0,0,0
66001,34760,2021-06-24T13:18:41.4791987Z,2021,46,15,39,26,0,2do,1,0,20,0,0,31,7,0,45,0,0,0
66001,34761,2021-06-24T13:18:41.4791987Z,2021,45,17,41,20,0,3ro,1,0,25,0,0,28,4,0,44,0,0,0
66001,34762,2021-06-24T13:18:41.4801992Z,2021,51,16,45,34,0,4to,1,0,17,0,0,35,6,0,50,0,0,0
66001,34763,2021-06-24T13:18:41.4801992Z,2021,63,20,58,37,0,5to,0,0,26,0,0,43,5,0,63,0,0,0
66001,34764,2021-06-24T13:18:41.4801992Z,2021,41,4,35,17,0,K,1,0,24,0,0,37,6,0,40,0,0,0
66001,34765,2021-06-24T13:18:41.4801992Z,2021,30,30,28,8,0,Sin Grado,4,0,22,0,0,0,2,0,26,0,0,0
66001,4733,2020-11-18T16:21:11.9650113Z,2019,64,29,56,32,0,1ro,3,0,32,0,0,35,8,0,61,0,0,0
66001,4734,2020-11-18T16:21:11.9650113Z,2019,49,19,45,28,0,2do,0,0,21,0,0,30,4,0,49,0,0,0
66001,4735,2020-11-18T16:21:11.9650113Z,2019,61,23,52,35,0,3ro,3,1,26,0,0,38,9,0,58,0,0,0
66001,4736,2020-11-18T16:21:11.9660117Z,2019,57,11,50,30,0,4to,0,0,27,0,0,46,7,0,57,0,0,0
66001,4737,2020-11-18T16:21:11.9660117Z,2019,62,18,54,37,0,5to,0,0,25,0,0,44,8,0,62,0,0,0
66001,4738,2020-11-18T16:21:11.9660117Z,2019,37,8,31,22,0,K,0,0,15,0,0,29,6,0,37,0,0,0
66001,4739,2020-11-18T16:21:11.9660117Z,2019,37,36,35,4,0,Sin Grado,1,0,33,0,0,1,2,0,36,0,0,0
12872,30444,2021-06-24T13:18:09.492256Z,2021,51,27,39,28,0,6to,2,0,23,0,0,24,12,0,49,1,1,0
12872,30445,2021-06-24T13:18:09.4932578Z,2021,41,19,32,16,0,7mo,1,0,25,0,0,22,9,0,40,2,0,0
12872,30446,2021-06-24T13:18:09.4932578Z,2021,33,16,27,17,0,8vo,1,0,16,0,0,17,6,0,32,2,0,0
12872,30447,2021-06-24T13:18:09.4932578Z,2021,19,19,15,2,0,Sin Grado,0,0,17,0,0,0,4,0,19,0,0,0
12872,446,2020-11-18T16:20:40.0617363Z,2019,45,20,36,23,0,6to,0,0,22,0,0,25,9,0,45,2,0,0
12872,447,2020-11-18T16:20:40.0617363Z,2019,62,20,54,32,0,7mo,1,0,30,0,0,42,8,0,61,0,0,0
12872,448,2020-11-18T16:20:40.0617363Z,2019,66,19,55,34,0,8vo,0,2,32,0,0,47,11,0,65,0,0,1
12872,449,2020-11-18T16:20:40.0617363Z,2019,7,7,7,1,0,Sin Grado,0,0,6,0,0,0,0,0,7,0,0,0
12872,6447,2020-11-18T16:21:39.6634836Z,2020,42,20,32,17,0,6to,2,0,25,0,0,22,10,0,40,2,0,0
12872,6448,2020-11-18T16:21:39.6634836Z,2020,35,16,26,18,0,7mo,0,0,17,0,0,19,9,0,35,2,0,0
12872,6449,2020-11-18T16:21:39.6644832Z,2020,58,19,47,34,0,8vo,1,0,24,0,0,39,11,0,57,0,0,0
12872,6450,2020-11-18T16:21:39.6644832Z,2020,16,16,15,2,0,Sin Grado,0,0,14,0,0,0,1,0,16,0,0,0
27540,1629,2020-11-18T16:20:48.2511986Z,2019,87,28,73,40,0,6to,0,3,47,0,0,59,14,0,87,0,0,0
27540,1630,2020-11-18T16:20:48.2511986Z,2019,96,35,72,46,0,7mo,0,0,50,0,0,61,24,0,95,0,0,1
27540,1631,2020-11-18T16:20:48.2511986Z,2019,97,35,74,49,0,8vo,0,0,48,0,0,62,23,0,97,0,0,0
27540,1632,2020-11-18T16:20:48.2511986Z,2019,4,2,4,2,0,Sin Grado,0,0,2,0,0,2,0,0,4,0,0,0
27540,31632,2021-06-24T13:18:16.1080009Z,2021,66,26,55,27,0,6to,0,2,39,0,0,40,11,0,66,0,0,0
27540,31633,2021-06-24T13:18:16.1090019Z,2021,62,25,45,35,0,7mo,0,2,27,0,0,37,17,0,62,0,0,0
27540,31634,2021-06-24T13:18:16.1090019Z,2021,82,27,60,38,0,8vo,0,2,44,0,0,55,22,0,82,0,0,0
27540,31635,2021-06-24T13:18:16.1090019Z,2021,1,1,1,0,0,Sin Grado,0,0,1,0,0,0,0,0,1,0,0,0
27540,7635,2020-11-18T16:21:47.1844948Z,2020,62,26,49,34,0,6to,0,0,28,0,0,36,13,0,62,0,0,0
27540,7636,2020-11-18T16:21:47.1854948Z,2020,85,26,71,41,0,7mo,0,4,44,0,0,59,14,0,85,0,0,0
27540,7637,2020-11-18T16:21:47.1854948Z,2020,95,33,71,47,0,8vo,0,1,48,0,0,62,24,0,95,0,0,0
27540,7638,2020-11-18T16:21:47.1854948Z,2020,1,1,1,0,0,Sin Grado,0,1,1,0,0,0,0,0,1,0,0,0
31286,1938,2020-11-18T16:20:53.3996295Z,2019,57,19,49,27,0,1ro,3,16,30,0,0,38,8,0,54,0,0,0
31286,1939,2020-11-18T16:20:53.3996295Z,2019,68,9,61,43,0,2do,0,12,25,0,0,59,7,1,65,0,0,2
31286,1940,2020-11-18T16:20:53.3996295Z,2019,64,12,62,38,0,3ro,1,23,26,0,0,52,2,0,63,0,0,0
31286,1941,2020-11-18T16:20:53.3996295Z,2019,63,15,59,30,0,4to,0,19,33,0,0,48,4,0,63,0,1,0
31286,1942,2020-11-18T16:20:53.4006299Z,2019,59,10,51,33,0,5to,1,12,26,0,0,49,8,1,57,0,0,0
31286,1943,2020-11-18T16:20:53.4006299Z,2019,38,4,0,24,0,K,3,14,14,0,0,34,38,0,35,0,0,0
31286,1944,2020-11-18T16:20:53.4006299Z,2019,5,5,4,0,0,Sin Grado,0,1,5,0,0,0,1,0,5,0,0,0
31286,31947,2021-06-24T13:18:18.6838466Z,2021,41,2,39,17,0,1ro,2,0,24,0,0,39,2,0,39,0,0,0
31286,31948,2021-06-24T13:18:18.6848485Z,2021,51,11,48,34,0,2do,2,0,17,0,0,40,3,0,49,0,0,0
31286,31949,2021-06-24T13:18:18.6848485Z,2021,33,6,30,14,0,3ro,1,0,19,0,0,27,3,0,32,0,0,0
31286,31950,2021-06-24T13:18:18.6848485Z,2021,51,5,47,31,0,4to,1,0,20,0,0,46,4,1,49,0,0,0
31286,31951,2021-06-24T13:18:18.6858485Z,2021,47,8,43,28,0,5to,3,0,19,0,0,39,4,1,43,0,0,0
31286,31952,2021-06-24T13:18:18.6858485Z,2021,37,5,32,18,0,K,0,0,19,0,0,32,5,0,37,0,0,0
31286,31953,2021-06-24T13:18:18.6858485Z,2021,4,4,4,2,0,Sin Grado,0,0,2,0,0,0,0,0,4,0,0,0
31286,7950,2020-11-18T16:21:49.1357983Z,2020,59,14,58,38,0,1ro,2,11,21,0,0,45,1,0,57,0,0,0
31286,7951,2020-11-18T16:21:49.1368009Z,2020,39,8,39,15,0,2do,2,7,24,0,0,31,0,0,37,0,0,0
31286,7952,2020-11-18T16:21:49.1368009Z,2020,59,6,55,37,0,3ro,0,10,22,0,0,53,4,1,57,0,0,1
31286,7953,2020-11-18T16:21:49.1368009Z,2020,53,7,51,31,0,4to,2,13,22,0,0,46,2,1,50,0,0,0
31286,7954,2020-11-18T16:21:49.1377996Z,2020,56,9,52,28,0,5to,3,9,28,0,0,47,4,0,53,0,1,0
31286,7955,2020-11-18T16:21:49.1377996Z,2020,46,2,43,18,0,K,7,12,28,0,0,44,3,0,39,0,0,0
31286,7956,2020-11-18T16:21:49.1377996Z,2020,6,5,5,0,0,Sin Grado,0,2,6,0,0,1,1,0,6,0,0,0
55889,33864,2021-06-24T13:18:35.7610989Z,2021,31,8,25,16,0,1ro,0,0,15,0,0,23,6,0,31,0,0,0
55889,33865,2021-06-24T13:18:35.7610989Z,2021,50,23,40,29,0,2do,0,0,21,0,0,27,10,0,50,0,0,0
55889,33866,2021-06-24T13:18:35.7610989Z,2021,38,18,31,19,0,3ro,4,0,19,0,0,20,7,0,34,0,0,0
55889,33867,2021-06-24T13:18:35.7610989Z,2021,42,15,30,19,0,4to,2,0,23,0,0,27,12,0,40,0,0,0
55889,33868,2021-06-24T13:18:35.7620994Z,2021,41,18,34,20,0,5to,0,0,21,0,0,23,7,0,41,0,0,0
55889,33869,2021-06-24T13:18:35.7620994Z,2021,37,14,28,16,0,K,0,0,21,0,0,23,9,0,36,0,0,1
55889,33870,2021-06-24T13:18:35.7620994Z,2021,7,7,5,2,0,Sin Grado,0,0,5,0,0,0,2,0,7,0,0,0
55889,3841,2020-11-18T16:21:05.5737475Z,2019,62,30,50,29,0,1ro,11,2,33,0,0,32,12,0,51,0,0,0
55889,3842,2020-11-18T16:21:05.5737475Z,2019,50,23,40,19,0,2do,1,2,31,0,0,27,10,0,49,0,0,0
55889,3843,2020-11-18T16:21:05.5737475Z,2019,40,15,35,19,0,3ro,0,1,21,0,0,25,5,0,40,0,1,0
55889,3844,2020-11-18T16:21:05.5737475Z,2019,54,26,39,30,0,4to,1,3,24,0,0,28,15,0,53,0,0,0
55889,3845,2020-11-18T16:21:05.5737475Z,2019,39,17,30,15,0,5to,0,1,24,0,0,22,9,0,39,0,0,0
55889,3846,2020-11-18T16:21:05.5747488Z,2019,39,15,28,20,0,K,0,1,19,0,0,24,11,0,39,0,0,0
55889,3847,2020-11-18T16:21:05.5747488Z,2019,15,14,13,7,0,Sin Grado,0,0,8,0,0,1,2,0,15,0,0,0
55889,9858,2020-11-18T16:22:00.5253932Z,2020,48,22,37,27,0,1ro,1,0,21,0,0,26,11,0,47,0,0,0
55889,9859,2020-11-18T16:22:00.5253932Z,2020,41,19,37,18,0,2do,6,0,23,0,0,22,4,0,35,0,0,0
55889,9860,2020-11-18T16:22:00.5253932Z,2020,39,15,28,17,0,3ro,1,0,22,0,0,24,11,0,38,0,0,0
55889,9861,2020-11-18T16:22:00.5263936Z,2020,40,15,33,18,0,4to,0,0,22,0,0,25,7,0,40,0,1,0
55889,9862,2020-11-18T16:22:00.5263936Z,2020,49,23,37,27,0,5to,1,0,22,0,0,26,12,0,48,0,0,0
55889,9863,2020-11-18T16:22:00.5263936Z,2020,36,10,32,20,0,K,2,0,16,0,0,26,4,0,34,0,0,0
55889,9864,2020-11-18T16:22:00.5263936Z,2020,14,14,12,5,0,Sin Grado,1,0,9,0,0,0,2,1,12,0,0,0
57299,33958,2021-06-24T13:18:36.6567414Z,2021,19,3,6,7,0,10mo,0,3,12,0,0,16,13,1,18,0,1,0
57299,33959,2021-06-24T13:18:36.6567414Z,2021,14,0,9,4,0,11mo,0,0,10,0,0,14,5,0,14,0,0,0
57299,33960,2021-06-24T13:18:36.657741Z,2021,17,0,9,6,0,12mo,2,0,11,0,0,17,8,0,15,0,0,0
57299,33961,2021-06-24T13:18:36.657741Z,2021,23,1,8,10,0,9no,0,1,13,0,0,22,15,1,21,0,0,1
57299,3934,2020-11-18T16:21:06.794563Z,2019,25,0,12,6,0,10mo,2,0,19,0,0,25,13,0,23,0,0,0
57299,3935,2020-11-18T16:21:06.794563Z,2019,45,0,22,21,0,11mo,0,0,24,0,0,45,23,0,45,0,0,0
57299,3936,2020-11-18T16:21:06.794563Z,2019,29,0,14,19,0,12mo,0,0,10,0,0,29,15,0,29,0,0,0
57299,3937,2020-11-18T16:21:06.795563Z,2019,25,1,13,7,0,9no,0,0,18,0,0,24,12,0,25,0,0,0
57299,9951,2020-11-18T16:22:01.546075Z,2020,22,1,13,7,0,10mo,0,0,15,0,0,21,9,0,22,0,0,0
57299,9952,2020-11-18T16:22:01.547075Z,2020,20,0,9,6,0,11mo,2,0,14,0,0,20,11,0,18,0,0,0
57299,9953,2020-11-18T16:22:01.547075Z,2020,42,0,23,20,0,12mo,0,0,22,0,0,42,19,0,42,0,0,0
57299,9954,2020-11-18T16:22:01.547075Z,2020,18,2,9,7,0,9no,0,0,11,0,0,16,9,1,17,0,1,0
71670,11395,2020-11-18T16:22:10.1858334Z,2020,166,38,111,95,0,10mo,7,1,71,0,0,128,55,0,159,0,0,0
71670,11396,2020-11-18T16:22:10.1858334Z,2020,147,29,112,73,0,11mo,4,0,74,0,0,118,35,0,143,0,0,0
71670,11397,2020-11-18T16:22:10.1868348Z,2020,166,35,107,94,0,12mo,8,0,72,0,0,131,59,0,158,0,0,0
71670,11398,2020-11-18T16:22:10.1868348Z,2020,149,46,116,80,0,9no,2,0,69,0,0,103,33,0,147,0,0,0
71670,35417,2021-06-24T13:18:46.2065894Z,2021,147,44,122,75,0,10mo,2,0,72,0,0,103,25,0,145,0,0,0
71670,35418,2021-06-24T13:18:46.2065894Z,2021,159,35,109,90,0,11mo,3,0,69,0,0,124,50,0,156,0,0,0
71670,35419,2021-06-24T13:18:46.2075899Z,2021,134,31,100,65,0,12mo,5,0,69,0,0,103,34,0,128,0,0,1
71670,35420,2021-06-24T13:18:46.2075899Z,2021,159,32,124,71,0,9no,5,0,88,0,0,127,35,0,154,1,1,0
71670,5387,2020-11-18T16:21:15.0910924Z,2019,181,31,129,88,0,10mo,3,0,93,0,0,150,52,0,178,0,0,0
71670,5388,2020-11-18T16:21:15.0910924Z,2019,192,35,114,101,0,11mo,9,0,91,0,0,157,78,1,182,0,0,0
71670,5389,2020-11-18T16:21:15.0920933Z,2019,151,0,82,80,0,12mo,4,0,71,0,0,151,69,0,147,0,0,0
71670,5390,2020-11-18T16:21:15.0920933Z,2019,220,40,148,128,0,9no,5,0,92,0,0,180,72,0,215,0,1,0
42077,2722,2020-11-18T16:20:58.7441918Z,2019,218,79,192,111,0,10mo,5,0,107,0,0,139,26,3,210,0,1,0
42077,2723,2020-11-18T16:20:58.7441918Z,2019,187,61,162,97,0,11mo,4,0,90,0,1,126,25,1,182,0,1,0
42077,2724,2020-11-18T16:20:58.7441918Z,2019,224,0,191,109,0,12mo,4,0,115,0,0,224,33,0,220,0,0,0
42077,2725,2020-11-18T16:20:58.7441918Z,2019,256,85,225,109,0,9no,6,0,147,0,1,171,31,0,250,0,0,0
42077,2726,2020-11-18T16:20:58.7441918Z,2019,37,16,34,10,0,Sin Grado,1,0,27,0,0,21,3,0,36,0,0,0
42077,32729,2021-06-24T13:18:27.1359139Z,2021,236,86,204,104,0,10mo,6,0,132,0,0,150,32,0,230,0,0,0
42077,32730,2021-06-24T13:18:27.1359139Z,2021,226,79,186,97,0,11mo,7,0,129,0,0,147,40,0,219,0,0,0
42077,32731,2021-06-24T13:18:27.1369144Z,2021,179,63,149,96,0,12mo,2,0,83,0,0,116,30,2,175,0,1,0
42077,32732,2021-06-24T13:18:27.1369144Z,2021,292,116,258,143,0,9no,10,0,149,0,0,176,34,0,282,1,0,0
42077,32733,2021-06-24T13:18:27.1369144Z,2021,19,19,13,4,0,Sin Grado,0,0,15,0,0,0,6,0,19,0,0,0
42077,8733,2020-11-18T16:21:53.7979056Z,2020,248,87,208,110,0,10mo,9,0,138,0,0,161,40,0,239,0,0,0
42077,8734,2020-11-18T16:21:53.7979056Z,2020,192,69,166,102,0,11mo,4,0,90,0,0,123,26,2,186,0,1,0
42077,8735,2020-11-18T16:21:53.7979056Z,2020,158,52,138,84,0,12mo,4,0,74,0,0,106,20,1,153,0,0,0
42077,8736,2020-11-18T16:21:53.798907Z,2020,240,89,209,103,0,9no,5,0,137,0,0,151,31,0,234,0,0,1
42077,8737,2020-11-18T16:21:53.798907Z,2020,26,26,25,8,0,Sin Grado,0,0,18,0,0,0,1,0,26,0,0,0
52688,33607,2021-06-24T13:18:33.6565892Z,2021,111,35,89,54,0,10mo,0,0,57,0,0,76,22,0,111,0,0,0
52688,33608,2021-06-24T13:18:33.6575901Z,2021,76,32,61,30,0,11mo,0,0,46,0,0,44,15,0,76,0,0,0
52688,33609,2021-06-24T13:18:33.6575901Z,2021,71,26,60,30,0,12mo,1,0,41,0,0,45,11,0,69,0,0,1
52688,33610,2021-06-24T13:18:33.6575901Z,2021,72,27,58,40,0,9no,0,0,32,0,0,45,14,0,72,0,0,0
52688,3582,2020-11-18T16:21:03.2752181Z,2019,110,46,102,43,0,10mo,1,0,67,0,0,64,8,1,108,0,0,0
52688,3583,2020-11-18T16:21:03.2752181Z,2019,87,22,69,49,0,11mo,1,1,38,0,0,65,18,0,86,2,0,0
52688,3584,2020-11-18T16:21:03.2752181Z,2019,92,0,77,48,0,12mo,1,0,44,0,0,92,15,0,91,0,0,0
52688,3585,2020-11-18T16:21:03.2752181Z,2019,114,51,101,51,0,9no,0,0,63,0,0,63,13,0,114,0,0,0
52688,9601,2020-11-18T16:21:59.4796949Z,2020,99,47,90,40,0,10mo,0,2,59,0,0,52,9,0,99,0,0,0
52688,9602,2020-11-18T16:21:59.4796949Z,2020,96,35,88,39,0,11mo,1,1,57,0,0,61,8,1,93,0,0,1
52688,9603,2020-11-18T16:21:59.4796949Z,2020,77,19,67,43,0,12mo,1,0,34,0,0,58,10,0,76,1,0,0
52688,9604,2020-11-18T16:21:59.4806966Z,2020,132,45,121,64,0,9no,1,3,68,0,0,87,11,0,131,0,0,0
24810,1445,2020-11-18T16:20:46.3359213Z,2019,70,21,58,30,0,10mo,0,1,40,0,0,49,12,0,70,1,1,0
24810,1446,2020-11-18T16:20:46.3359213Z,2019,76,13,58,45,0,11mo,1,0,31,0,0,63,18,0,75,4,0,0
24810,1447,2020-11-18T16:20:46.3369222Z,2019,88,0,71,51,0,12mo,1,0,37,0,0,88,17,0,87,0,0,0
24810,1448,2020-11-18T16:20:46.3369222Z,2019,49,14,40,28,0,6to,1,0,21,0,0,35,9,1,47,0,0,0
24810,1449,2020-11-18T16:20:46.3369222Z,2019,64,20,60,41,0,7mo,0,0,23,0,0,44,4,1,63,0,0,0
24810,1450,2020-11-18T16:20:46.3369222Z,2019,73,14,65,40,0,8vo,0,0,33,0,0,59,8,0,73,1,0,0
24810,1451,2020-11-18T16:20:46.3369222Z,2019,71,21,64,37,0,9no,1,1,34,0,0,50,7,1,69,0,0,0
24810,1452,2020-11-18T16:20:46.3379226Z,2019,37,29,33,11,0,Sin Grado,0,0,26,0,0,8,4,0,37,0,0,0
24810,31445,2021-06-24T13:18:14.9171466Z,2021,73,16,52,40,0,10mo,0,1,33,0,0,57,21,0,73,0,0,0
24810,31446,2021-06-24T13:18:14.9171466Z,2021,66,21,52,34,0,11mo,1,0,32,0,0,45,14,2,63,0,0,0
24810,31447,2021-06-24T13:18:14.9181466Z,2021,66,14,55,32,0,12mo,2,4,34,0,0,52,11,0,64,1,0,0
24810,31448,2021-06-24T13:18:14.9181466Z,2021,57,21,47,28,0,6to,0,1,29,0,0,36,10,0,57,0,0,0
24810,31449,2021-06-24T13:18:14.9181466Z,2021,61,17,45,32,0,7mo,3,2,29,0,0,44,16,0,58,0,0,0
24810,31450,2021-06-24T13:18:14.9181466Z,2021,62,15,51,31,0,8vo,0,1,31,0,0,47,11,1,61,0,0,0
24810,31451,2021-06-24T13:18:14.9181466Z,2021,73,28,54,41,0,9no,2,2,32,0,0,45,19,1,70,0,0,0
24810,31452,2021-06-24T13:18:14.919148Z,2021,43,39,36,13,0,Sin Grado,0,4,30,0,0,4,7,0,43,0,0,0
24810,7448,2020-11-18T16:21:45.7675534Z,2020,81,26,77,40,0,10mo,1,2,41,0,0,55,4,2,78,0,0,0
24810,7449,2020-11-18T16:21:45.7675534Z,2020,70,18,58,34,0,11mo,0,5,36,0,0,52,12,0,70,1,0,0
24810,7450,2020-11-18T16:21:45.7675534Z,2020,72,11,54,42,0,12mo,0,2,30,0,0,61,18,0,72,5,0,0
24810,7451,2020-11-18T16:21:45.7675534Z,2020,61,16,52,29,0,6to,0,2,32,0,0,45,9,0,61,0,0,0
24810,7452,2020-11-18T16:21:45.7685543Z,2020,55,13,49,30,0,7mo,1,2,25,0,0,42,6,1,53,0,0,0
24810,7453,2020-11-18T16:21:45.7685543Z,2020,74,26,68,46,0,8vo,0,2,28,0,0,48,6,1,73,0,0,0
24810,7454,2020-11-18T16:21:45.7685543Z,2020,78,20,69,39,0,9no,1,3,39,0,0,58,9,0,77,1,0,0
24810,7455,2020-11-18T16:21:45.7685543Z,2020,37,36,33,12,0,Sin Grado,0,2,25,0,0,1,4,0,37,0,0,0
52522,33587,2021-06-24T13:18:33.4094117Z,2021,71,19,60,35,0,6to,1,0,36,0,0,52,11,0,70,1,0,0
52522,33588,2021-06-24T13:18:33.4104131Z,2021,66,19,54,33,0,7mo,1,0,33,0,0,47,12,0,65,0,0,0
52522,33589,2021-06-24T13:18:33.4104131Z,2021,75,23,64,35,0,8vo,1,0,40,0,0,52,11,0,73,0,0,1
52522,3562,2020-11-18T16:21:03.2702149Z,2019,84,28,73,39,0,6to,0,0,45,0,0,56,11,0,83,0,0,1
52522,3563,2020-11-18T16:21:03.2702149Z,2019,104,30,88,58,0,7mo,0,0,46,0,0,74,16,0,102,0,0,2
52522,3564,2020-11-18T16:21:03.2702149Z,2019,94,35,71,45,0,8vo,0,1,49,0,0,59,23,0,94,0,0,0
52522,9581,2020-11-18T16:21:59.0974391Z,2020,67,20,52,35,0,6to,1,1,32,0,0,47,15,0,66,0,0,0
52522,9582,2020-11-18T16:21:59.0974391Z,2020,80,30,72,38,0,7mo,1,0,42,0,0,50,8,0,78,0,0,1
52522,9583,2020-11-18T16:21:59.0974391Z,2020,91,27,77,50,0,8vo,0,1,41,0,0,64,14,0,90,0,0,1
25627,1533,2020-11-18T16:20:47.6407929Z,2019,137,48,98,78,0,6to,1,1,59,0,0,89,39,0,136,0,0,0
25627,1534,2020-11-18T16:20:47.6417947Z,2019,152,57,113,71,0,7mo,0,1,81,0,0,95,39,0,151,0,0,1
25627,1535,2020-11-18T16:20:47.6417947Z,2019,161,43,109,94,0,8vo,2,0,67,0,0,118,52,0,158,0,0,1
25627,1536,2020-11-18T16:20:47.6417947Z,2019,19,19,14,4,0,Sin Grado,1,0,15,0,0,0,5,0,18,0,0,0
25627,31535,2021-06-24T13:18:15.818792Z,2021,128,51,107,70,0,6to,3,1,58,0,0,77,21,0,125,1,0,0
25627,31536,2021-06-24T13:18:15.8197934Z,2021,118,44,95,66,0,7mo,2,1,52,0,0,74,23,0,116,2,0,0
25627,31537,2021-06-24T13:18:15.8197934Z,2021,125,51,96,68,0,8vo,0,0,57,0,0,74,29,0,125,0,0,0
25627,31538,2021-06-24T13:18:15.8197934Z,2021,14,14,10,3,0,Sin Grado,0,0,11,0,0,0,4,0,14,0,0,0
25627,7538,2020-11-18T16:21:46.369952Z,2020,115,44,86,62,0,6to,1,0,53,0,0,71,29,0,114,2,0,0
25627,7539,2020-11-18T16:21:46.369952Z,2020,128,50,95,68,0,7mo,1,1,60,0,0,78,33,0,127,0,0,0
25627,7540,2020-11-18T16:21:46.369952Z,2020,150,56,110,73,0,8vo,0,0,77,0,0,94,40,0,149,1,0,1
25627,7541,2020-11-18T16:21:46.369952Z,2020,13,13,10,3,0,Sin Grado,0,0,10,0,0,0,3,0,13,0,0,0
30247,1791,2020-11-18T16:20:48.8756116Z,2019,50,10,44,30,0,10mo,1,0,20,0,0,40,6,0,49,0,0,0
30247,1792,2020-11-18T16:20:48.8756116Z,2019,92,23,78,54,0,11mo,1,0,38,0,0,69,14,0,91,0,1,0
30247,1793,2020-11-18T16:20:48.8756116Z,2019,77,0,66,39,0,12mo,1,1,38,0,0,77,11,0,76,0,0,0
30247,1794,2020-11-18T16:20:48.8766129Z,2019,42,7,37,22,0,9no,1,1,20,0,0,35,5,0,40,1,0,1
30247,1795,2020-11-18T16:20:48.8766129Z,2019,19,8,18,10,0,Sin Grado,1,0,9,0,0,11,1,0,18,1,0,0
30247,31794,2021-06-24T13:18:17.2508191Z,2021,68,18,57,30,0,10mo,0,0,38,0,0,50,11,0,67,1,0,1
30247,31795,2021-06-24T13:18:17.2508191Z,2021,58,10,39,27,0,11mo,1,1,31,0,0,48,19,0,56,0,1,1
30247,31796,2021-06-24T13:18:17.2508191Z,2021,51,9,39,30,0,12mo,1,0,21,0,0,42,12,0,50,0,0,0
30247,31797,2021-06-24T13:18:17.25182Z,2021,91,21,81,47,0,9no,1,1,44,0,0,70,10,0,90,0,0,0
30247,31798,2021-06-24T13:18:17.25182Z,2021,18,17,16,8,0,Sin Grado,0,0,10,0,0,1,2,0,18,0,0,0
30247,7797,2020-11-18T16:21:47.9239876Z,2020,57,10,52,27,0,10mo,2,0,30,0,0,47,5,0,54,0,1,1
30247,7798,2020-11-18T16:21:47.9239876Z,2020,57,12,46,33,0,11mo,1,1,24,0,0,45,11,0,56,0,0,0
30247,7799,2020-11-18T16:21:47.9249881Z,2020,84,22,72,50,0,12mo,1,0,34,0,0,62,12,0,83,0,1,0
30247,7800,2020-11-18T16:21:47.9249881Z,2020,70,20,67,32,0,9no,0,0,38,0,0,50,3,0,69,1,0,1
30247,7801,2020-11-18T16:21:48.4503392Z,2020,17,16,14,8,0,Sin Grado,0,0,9,0,0,1,3,0,17,0,0,0
41699,2690,2020-11-18T16:20:58.0847553Z,2019,21,10,17,7,0,1ro,0,0,14,0,0,11,4,0,21,0,0,0
41699,2691,2020-11-18T16:20:58.0847553Z,2019,10,4,7,3,0,2do,0,0,7,0,0,6,3,0,10,0,0,0
41699,2692,2020-11-18T16:20:58.0857562Z,2019,13,8,10,7,0,3ro,1,0,6,0,0,5,3,0,12,0,0,0
41699,2693,2020-11-18T16:20:58.0857562Z,2019,23,13,19,13,0,4to,0,0,10,0,0,10,4,0,23,0,0,0
41699,2694,2020-11-18T16:20:58.0857562Z,2019,15,3,13,7,0,5to,1,0,8,0,0,12,2,0,14,0,0,0
41699,2695,2020-11-18T16:20:58.0867567Z,2019,14,2,14,7,0,K,0,0,7,0,0,12,0,0,14,0,0,0
41699,32697,2021-06-24T13:18:26.2933097Z,2021,12,1,10,8,0,1ro,0,0,4,0,0,11,2,0,12,0,0,0
41699,32698,2021-06-24T13:18:26.2933097Z,2021,12,3,12,4,0,2do,0,0,8,0,0,9,0,0,12,0,0,0
41699,32699,2021-06-24T13:18:26.2933097Z,2021,13,5,11,4,0,3ro,0,0,9,0,0,8,2,0,13,0,0,0
41699,32700,2021-06-24T13:18:27.1199029Z,2021,9,5,9,4,0,4to,1,0,5,0,0,4,0,0,8,0,0,0
41699,32701,2021-06-24T13:18:27.1199029Z,2021,11,6,9,6,0,5to,1,0,5,0,0,5,2,0,10,0,0,0
41699,32702,2021-06-24T13:18:27.1209034Z,2021,17,4,14,5,0,K,0,0,12,0,0,13,3,0,17,0,0,0
41699,8701,2020-11-18T16:21:53.794903Z,2020,13,3,12,4,0,1ro,0,0,9,0,0,10,1,0,13,0,0,0
41699,8702,2020-11-18T16:21:53.7959043Z,2020,16,6,13,5,0,2do,0,0,11,0,0,10,3,0,16,0,0,0
41699,8703,2020-11-18T16:21:53.7959043Z,2020,8,5,5,3,0,3ro,0,0,5,0,0,3,3,0,8,0,0,0
41699,8704,2020-11-18T16:21:53.7959043Z,2020,14,10,10,8,0,4to,1,0,6,0,0,4,4,0,13,0,0,0
41699,8705,2020-11-18T16:21:53.796907Z,2020,22,12,19,12,0,5to,0,0,10,0,0,10,3,0,22,0,0,0
41699,8706,2020-11-18T16:21:53.796907Z,2020,11,0,10,8,0,K,0,0,3,0,0,11,1,0,11,0,0,0
28076,1668,2020-11-18T16:20:48.2682096Z,2019,43,19,30,21,0,1ro,0,2,22,0,0,24,13,1,42,0,0,0
28076,1669,2020-11-18T16:20:48.2692096Z,2019,37,15,30,15,0,2do,0,1,22,0,0,22,7,0,37,0,0,0
28076,1670,2020-11-18T16:20:48.2692096Z,2019,32,11,24,15,0,3ro,0,1,17,0,0,21,8,0,32,2,0,0
28076,1671,2020-11-18T16:20:48.2692096Z,2019,50,18,39,26,0,4to,1,2,24,0,0,32,11,0,49,0,0,0
28076,1672,2020-11-18T16:20:48.2692096Z,2019,68,23,61,35,0,5to,1,3,33,0,0,45,7,0,67,2,0,0
28076,1673,2020-11-18T16:20:48.2692096Z,2019,36,15,27,13,0,6to,1,2,23,0,0,21,9,0,35,0,0,0
28076,1674,2020-11-18T16:20:48.2702105Z,2019,43,14,28,19,0,7mo,0,3,24,0,0,29,15,0,43,0,0,0
28076,1675,2020-11-18T16:20:48.2702105Z,2019,41,18,28,15,0,8vo,0,1,26,0,0,23,13,0,41,0,0,0
28076,1676,2020-11-18T16:20:48.2702105Z,2019,33,11,19,21,0,K,0,1,12,0,0,22,14,0,33,0,0,0
28076,1677,2020-11-18T16:20:48.2702105Z,2019,17,15,11,3,0,Sin Grado,0,1,14,0,0,2,6,0,17,0,1,0
28076,31670,2021-06-24T13:18:16.124012Z,2021,28,13,25,14,0,1ro,1,2,14,0,0,15,3,0,26,0,0,1
28076,31671,2021-06-24T13:18:16.124012Z,2021,33,7,27,16,0,2do,0,0,17,0,0,26,6,0,32,0,1,1
28076,31672,2021-06-24T13:18:16.124012Z,2021,40,18,37,17,0,3ro,0,1,23,0,0,22,3,0,40,0,0,0
28076,31673,2021-06-24T13:18:16.1250111Z,2021,34,9,27,15,0,4to,0,1,19,0,0,25,7,0,34,0,0,0
28076,31674,2021-06-24T13:18:16.1250111Z,2021,31,14,24,16,0,5to,0,0,15,0,0,17,7,0,31,2,0,0
28076,31675,2021-06-24T13:18:16.1250111Z,2021,44,16,37,24,0,6to,1,1,20,0,0,28,7,0,43,0,0,0
28076,31676,2021-06-24T13:18:16.1250111Z,2021,66,26,57,33,0,7mo,1,0,33,0,0,40,9,0,65,1,0,0
28076,31677,2021-06-24T13:18:16.1260121Z,2021,31,12,24,13,0,8vo,2,0,18,0,0,19,7,0,28,0,0,1
28076,31678,2021-06-24T13:18:16.1260121Z,2021,22,2,17,13,0,K,0,1,9,0,0,20,5,0,22,0,0,0
28076,31679,2021-06-24T13:18:16.1260121Z,2021,21,21,18,6,0,Sin Grado,1,3,15,0,0,0,3,0,20,0,1,0
28076,7673,2020-11-18T16:21:47.2025068Z,2020,31,9,24,13,0,1ro,0,1,18,0,0,22,7,0,31,0,0,0
28076,7674,2020-11-18T16:21:47.2025068Z,2020,41,18,34,21,0,2do,0,1,20,0,0,23,7,0,41,0,0,0
28076,7675,2020-11-18T16:21:47.2035068Z,2020,35,9,28,16,0,3ro,0,1,19,0,0,26,7,0,35,0,0,0
28076,7676,2020-11-18T16:21:47.2035068Z,2020,33,13,26,18,0,4to,0,1,15,0,0,20,7,0,33,2,0,0
28076,7677,2020-11-18T16:21:47.2035068Z,2020,46,16,35,25,0,5to,1,3,21,0,0,30,11,0,45,0,0,0
28076,7678,2020-11-18T16:21:47.2035068Z,2020,68,26,60,33,0,6to,1,2,35,0,0,42,8,0,67,2,0,0
28076,7679,2020-11-18T16:21:47.2045086Z,2020,31,11,22,14,0,7mo,1,0,17,0,0,20,9,0,30,0,0,0
28076,7680,2020-11-18T16:21:47.2045086Z,2020,41,15,28,19,0,8vo,0,0,22,0,0,26,13,0,41,0,0,0
28076,7681,2020-11-18T16:21:47.2045086Z,2020,33,11,32,14,0,K,1,1,19,0,0,22,1,0,32,0,0,0
28076,7682,2020-11-18T16:21:47.2055086Z,2020,21,21,19,4,0,Sin Grado,1,0,17,0,0,0,2,0,20,0,1,0
26773,1600,2020-11-18T16:20:47.663809Z,2019,141,36,109,69,0,10mo,1,1,72,0,0,105,32,0,140,0,0,0
26773,1601,2020-11-18T16:20:48.2431924Z,2019,140,34,100,71,0,11mo,0,0,69,0,0,106,40,0,140,0,0,0
26773,1602,2020-11-18T16:20:48.2431924Z,2019,102,0,80,53,0,12mo,1,0,49,0,0,102,22,0,101,0,0,0
26773,1603,2020-11-18T16:20:48.2431924Z,2019,117,51,89,55,0,9no,0,0,62,0,0,66,28,1,116,0,0,0
26773,1604,2020-11-18T16:20:48.2441933Z,2019,23,19,21,6,0,Sin Grado,0,0,17,0,0,4,2,0,23,0,0,0
26773,31603,2021-06-24T13:18:16.0999948Z,2021,120,46,98,55,0,10mo,0,1,65,0,0,74,22,0,120,0,0,0
26773,31604,2021-06-24T13:18:16.0999948Z,2021,125,50,102,61,0,11mo,0,2,64,0,0,75,23,1,124,0,0,0
26773,31605,2021-06-24T13:18:16.1009952Z,2021,110,35,89,55,0,12mo,2,0,55,0,0,75,21,0,108,0,0,0
26773,31606,2021-06-24T13:18:16.1009952Z,2021,118,34,94,58,0,9no,0,0,60,0,0,84,24,0,118,0,0,0
26773,31607,2021-06-24T13:18:16.1009952Z,2021,38,34,32,9,0,Sin Grado,0,0,29,0,0,4,6,0,38,1,0,0
26773,7606,2020-11-18T16:21:47.1794912Z,2020,119,49,92,57,0,10mo,0,1,62,0,0,70,27,1,117,0,0,1
26773,7607,2020-11-18T16:21:47.1794912Z,2020,122,41,96,62,0,11mo,1,0,60,0,0,81,26,0,121,0,0,0
26773,7608,2020-11-18T16:21:47.1794912Z,2020,129,35,93,67,0,12mo,0,1,62,0,0,94,36,0,129,0,0,0
26773,7609,2020-11-18T16:21:47.1804917Z,2020,122,47,101,59,0,9no,0,0,63,0,0,75,21,0,122,0,0,0
26773,7610,2020-11-18T16:21:47.1804917Z,2020,33,32,29,8,0,Sin Grado,0,0,25,0,0,1,4,0,33,0,0,0
28563,1741,2020-11-18T16:20:48.8596013Z,2019,302,48,230,158,0,10mo,8,0,144,0,0,254,72,1,293,0,0,0
28563,1742,2020-11-18T16:20:48.8596013Z,2019,204,39,152,114,0,11mo,5,1,90,0,0,165,52,2,197,0,0,0
28563,1743,2020-11-18T16:20:48.8596013Z,2019,176,0,134,98,0,12mo,1,0,78,0,0,176,42,0,175,0,0,0
28563,1744,2020-11-18T16:20:48.8596013Z,2019,328,63,237,176,0,9no,3,0,152,0,1,265,91,0,325,0,2,0
28563,1745,2020-11-18T16:20:48.8596013Z,2019,84,52,73,24,0,Sin Grado,0,4,60,0,0,32,11,0,84,1,0,0
28563,31744,2021-06-24T13:18:17.231807Z,2021,283,55,213,151,0,10mo,3,2,132,0,0,228,70,0,280,0,1,0
28563,31745,2021-06-24T13:18:17.2328066Z,2021,270,44,206,155,0,11mo,2,1,115,0,0,226,64,0,268,0,2,0
28563,31746,2021-06-24T13:18:17.2328066Z,2021,258,39,185,135,0,12mo,7,0,123,0,0,219,73,1,250,0,0,0
28563,31747,2021-06-24T13:18:17.2328066Z,2021,284,66,204,144,0,9no,3,2,140,0,0,218,80,3,278,1,1,0
28563,31748,2021-06-24T13:18:17.2328066Z,2021,40,40,27,10,0,Sin Grado,0,1,30,0,0,0,13,0,40,0,0,0
28563,7747,2020-11-18T16:21:47.9119801Z,2020,287,49,198,166,0,10mo,2,0,121,0,0,238,89,0,285,0,2,0
28563,7748,2020-11-18T16:21:47.9119801Z,2020,282,47,211,148,0,11mo,8,1,134,0,0,235,71,1,273,0,0,0
28563,7749,2020-11-18T16:21:47.912981Z,2020,196,39,145,112,0,12mo,5,0,84,0,0,157,51,2,189,0,0,0
28563,7750,2020-11-18T16:21:47.912981Z,2020,311,59,226,158,0,9no,3,1,153,0,0,252,85,0,308,0,1,0
28563,7751,2020-11-18T16:21:47.912981Z,2020,53,41,44,13,0,Sin Grado,0,3,40,0,0,12,9,0,53,1,0,0
27607,1650,2020-11-18T16:20:48.2612039Z,2019,39,10,33,23,0,1ro,0,0,16,0,0,29,6,0,39,0,0,0
27607,1651,2020-11-18T16:20:48.2612039Z,2019,51,10,40,27,0,2do,1,0,24,0,0,41,11,0,50,0,0,0
27607,1652,2020-11-18T16:20:48.2622047Z,2019,58,14,45,28,0,3ro,0,1,30,0,0,44,13,0,58,0,0,0
27607,1653,2020-11-18T16:20:48.2622047Z,2019,52,9,40,30,0,4to,0,0,22,0,0,43,12,0,52,0,0,0
27607,1654,2020-11-18T16:20:48.2622047Z,2019,71,16,51,27,0,5to,2,0,44,0,0,55,20,0,69,0,0,0
27607,1655,2020-11-18T16:20:48.2622047Z,2019,82,17,54,31,0,6to,0,0,51,0,0,65,28,0,81,0,0,1
27607,1656,2020-11-18T16:20:48.2622047Z,2019,81,20,65,46,0,7mo,0,0,35,0,0,61,16,0,81,0,0,0
27607,1657,2020-11-18T16:20:48.2622047Z,2019,94,16,66,54,0,8vo,0,0,40,0,0,78,28,0,94,0,0,0
27607,1658,2020-11-18T16:20:48.2632052Z,2019,39,9,29,17,0,K,0,0,22,0,0,30,10,0,39,0,0,0
27607,1659,2020-11-18T16:20:48.2632052Z,2019,11,9,8,5,0,Sin Grado,0,0,6,0,0,2,3,0,11,0,0,0
27607,31652,2021-06-24T13:18:16.1150053Z,2021,40,5,35,20,0,1ro,0,0,20,0,0,35,5,0,40,0,0,0
27607,31653,2021-06-24T13:18:16.1160058Z,2021,40,6,29,20,0,2do,0,0,20,0,0,34,11,0,40,0,0,0
27607,31654,2021-06-24T13:18:16.1160058Z,2021,40,10,33,24,0,3ro,0,0,16,0,0,30,7,0,40,0,0,0
27607,31655,2021-06-24T13:18:16.1160058Z,2021,55,10,48,28,0,4to,1,0,27,0,0,45,7,0,54,0,0,0
27607,31656,2021-06-24T13:18:16.1160058Z,2021,56,12,44,27,0,5to,0,0,29,0,0,44,12,0,56,0,0,0
27607,31657,2021-06-24T13:18:16.1170072Z,2021,75,9,61,36,0,6to,0,1,39,0,0,66,14,0,75,0,0,0
27607,31658,2021-06-24T13:18:16.1170072Z,2021,79,21,60,33,0,7mo,1,0,46,0,0,58,19,0,78,0,0,0
27607,31659,2021-06-24T13:18:16.1170072Z,2021,85,15,66,32,0,8vo,0,0,53,0,0,70,19,0,84,0,0,1
27607,31660,2021-06-24T13:18:16.1170072Z,2021,45,8,33,25,0,K,0,0,20,0,0,37,12,0,45,0,0,0
27607,31661,2021-06-24T13:18:16.1180072Z,2021,12,12,10,6,0,Sin Grado,0,0,6,0,0,0,2,0,12,0,0,0
27607,7655,2020-11-18T16:21:47.1985028Z,2020,40,6,25,18,0,1ro,0,0,22,0,0,34,15,0,40,0,0,0
27607,7656,2020-11-18T16:21:47.1985028Z,2020,43,9,33,26,0,2do,0,0,17,0,0,34,10,0,43,0,0,0
27607,7657,2020-11-18T16:21:47.1995041Z,2020,54,10,45,29,0,3ro,1,0,25,0,0,44,9,0,53,0,0,0
27607,7658,2020-11-18T16:21:47.1995041Z,2020,61,10,47,33,0,4to,0,0,28,0,0,51,14,0,61,0,0,0
27607,7659,2020-11-18T16:21:47.1995041Z,2020,59,8,46,32,0,5to,0,0,27,0,0,51,13,0,59,0,0,0
27607,7660,2020-11-18T16:21:47.1995041Z,2020,77,21,53,32,0,6to,1,0,45,0,0,56,24,0,76,0,0,0
27607,7661,2020-11-18T16:21:47.1995041Z,2020,87,16,58,32,0,7mo,0,0,55,0,0,71,29,0,86,0,0,1
27607,7662,2020-11-18T16:21:47.200505Z,2020,78,18,60,48,0,8vo,0,0,30,0,0,60,18,0,78,0,0,0
27607,7663,2020-11-18T16:21:47.200505Z,2020,41,4,35,25,0,K,1,0,16,0,0,37,6,0,40,0,0,0
27607,7664,2020-11-18T16:21:47.200505Z,2020,12,11,7,6,0,Sin Grado,0,0,6,0,0,1,5,0,12,0,0,0
37507,2480,2020-11-18T16:20:56.2855559Z,2019,10,3,8,4,0,10mo,1,1,6,0,0,7,2,0,9,0,0,0
37507,2481,2020-11-18T16:20:56.2855559Z,2019,11,2,6,6,0,11mo,0,0,5,0,0,9,5,0,11,0,0,0
37507,2482,2020-11-18T16:20:56.2865563Z,2019,9,0,6,6,0,12mo,0,0,3,0,0,9,3,0,9,0,0,0
37507,2483,2020-11-18T16:20:56.2865563Z,2019,23,6,20,11,0,1ro,1,3,12,0,0,17,3,0,22,0,0,0
37507,2484,2020-11-18T16:20:56.2865563Z,2019,8,1,6,5,0,2do,0,0,3,0,0,7,2,0,8,0,0,0
37507,2485,2020-11-18T16:20:56.2875572Z,2019,6,2,4,2,0,3ro,0,0,4,0,0,4,2,0,6,0,0,0
37507,2486,2020-11-18T16:20:56.2875572Z,2019,15,2,12,9,0,4to,1,1,6,0,0,13,3,0,14,0,0,0
37507,2487,2020-11-18T16:20:56.2875572Z,2019,5,1,5,2,0,5to,0,0,3,0,0,4,0,0,5,0,0,0
37507,2488,2020-11-18T16:20:56.2885581Z,2019,12,6,8,3,0,6to,1,0,9,0,0,6,4,0,11,0,0,0
37507,2489,2020-11-18T16:20:56.2885581Z,2019,8,1,5,7,0,7mo,1,0,1,0,0,7,3,0,7,0,0,0
37507,2490,2020-11-18T16:20:56.289559Z,2019,11,2,7,5,0,8vo,1,0,6,0,0,9,4,0,10,0,0,0
37507,2491,2020-11-18T16:20:56.289559Z,2019,8,4,8,2,0,9no,1,0,6,0,0,4,0,0,7,0,0,0
37507,2492,2020-11-18T16:20:56.289559Z,2019,18,3,13,9,0,K,1,1,9,0,0,15,5,0,17,0,0,0
37507,2493,2020-11-18T16:20:56.289559Z,2019,2,2,2,1,0,Sin Grado,0,0,1,0,0,0,0,0,2,0,0,0
37507,32487,2021-06-24T13:18:24.7421954Z,2021,8,2,4,4,0,10mo,0,0,4,0,0,6,4,0,8,0,0,0
37507,32488,2021-06-24T13:18:24.7421954Z,2021,9,4,9,3,0,11mo,1,0,6,0,0,5,0,0,8,0,0,0
37507,32489,2021-06-24T13:18:24.7431959Z,2021,10,2,9,4,0,12mo,1,0,6,0,0,8,1,0,9,0,0,0
37507,32490,2021-06-24T13:18:24.7431959Z,2021,13,2,13,5,0,1ro,1,0,8,0,0,11,0,0,12,0,0,0
37507,32491,2021-06-24T13:18:24.7431959Z,2021,11,3,10,4,0,2do,1,0,7,0,0,8,1,0,10,0,0,0
37507,32492,2021-06-24T13:18:24.7441964Z,2021,17,3,15,8,0,3ro,0,1,9,0,0,14,2,0,17,0,0,0
37507,32493,2021-06-24T13:18:24.7441964Z,2021,6,2,6,3,0,4to,0,0,3,0,0,4,0,0,6,0,0,0
37507,32494,2021-06-24T13:18:24.7441964Z,2021,5,1,5,2,0,5to,0,0,3,0,0,4,0,0,5,0,0,0
37507,32495,2021-06-24T13:18:24.7451982Z,2021,13,1,11,8,0,6to,0,1,5,0,0,12,2,0,13,0,0,0
37507,32496,2021-06-24T13:18:24.7451982Z,2021,7,1,7,3,0,7mo,0,0,4,0,0,6,0,0,7,0,0,0
37507,32497,2021-06-24T13:18:24.7451982Z,2021,11,6,9,3,0,8vo,0,0,8,0,0,5,2,0,11,0,0,0
37507,32498,2021-06-24T13:18:24.7451982Z,2021,11,1,8,9,0,9no,2,1,2,0,0,10,3,0,9,0,0,0
37507,32499,2021-06-24T13:18:24.7461978Z,2021,14,4,12,4,0,K,0,0,10,0,0,10,2,0,14,0,0,0
37507,8492,2020-11-18T16:21:51.8145803Z,2020,9,4,9,2,0,10mo,1,0,7,0,0,5,0,0,8,0,0,0
37507,8493,2020-11-18T16:21:51.8145803Z,2020,9,2,9,4,0,11mo,1,0,5,0,0,7,0,0,8,0,0,0
37507,8494,2020-11-18T16:21:51.8145803Z,2020,12,4,7,6,0,12mo,0,0,6,0,0,8,5,0,12,0,0,0
37507,8495,2020-11-18T16:21:51.8145803Z,2020,10,3,9,4,0,1ro,0,0,6,0,0,7,1,0,10,0,0,0
37507,8496,2020-11-18T16:21:51.8155812Z,2020,18,4,13,9,0,2do,0,0,9,0,0,14,5,0,18,0,0,0
37507,8497,2020-11-18T16:21:51.8155812Z,2020,6,2,4,4,0,3ro,0,0,2,0,0,4,2,0,6,0,0,0
37507,8498,2020-11-18T16:21:51.8155812Z,2020,6,1,4,2,0,4to,0,0,4,0,0,5,2,0,6,0,0,0
37507,8499,2020-11-18T16:21:51.8155812Z,2020,13,1,11,9,0,5to,0,0,4,0,0,12,2,0,13,0,0,0
37507,8500,2020-11-18T16:21:51.8155812Z,2020,6,1,5,2,0,6to,0,0,4,0,0,5,1,0,6,0,0,0
37507,8501,2020-11-18T16:21:52.5941008Z,2020,8,4,7,2,0,7mo,0,0,6,0,0,4,1,0,8,0,0,0
37507,8502,2020-11-18T16:21:52.5941008Z,2020,7,1,6,5,0,8vo,1,0,2,0,0,6,1,0,6,0,0,0
37507,8503,2020-11-18T16:21:52.5941008Z,2020,10,2,3,6,0,9no,1,0,4,0,0,8,7,0,9,0,0,0
37507,8504,2020-11-18T16:21:52.5941008Z,2020,13,5,2,3,0,K,0,0,10,0,0,8,11,0,13,0,0,0
37507,8505,2020-11-18T16:21:52.5951017Z,2020,1,1,1,0,0,Sin Grado,0,0,1,0,0,0,0,0,1,0,0,0
34314,2231,2020-11-18T16:20:55.0026985Z,2019,87,9,69,44,0,1ro,0,1,43,0,0,78,18,0,87,0,0,0
34314,2232,2020-11-18T16:20:55.0037007Z,2019,74,18,63,37,0,2do,1,1,37,0,0,56,11,0,73,0,0,0
34314,2233,2020-11-18T16:20:55.0037007Z,2019,67,16,56,39,0,3ro,0,0,28,0,0,51,11,1,65,0,0,1
34314,2234,2020-11-18T16:20:55.0037007Z,2019,65,15,58,30,0,4to,2,0,35,0,0,50,7,0,63,0,0,0
34314,2235,2020-11-18T16:20:55.0037007Z,2019,78,14,70,41,0,5to,2,0,37,0,0,64,8,0,76,1,0,0
34314,2236,2020-11-18T16:20:55.0037007Z,2019,54,9,3,29,0,K,1,1,25,0,0,45,51,0,53,0,0,0
34314,32238,2021-06-24T13:18:21.7520471Z,2021,29,4,28,18,0,1ro,0,0,11,0,0,25,1,0,29,0,0,0
34314,32239,2021-06-24T13:18:21.7530481Z,2021,46,7,38,19,0,2do,0,0,27,0,0,39,8,0,46,0,0,0
34314,32240,2021-06-24T13:18:21.7530481Z,2021,59,12,51,32,0,3ro,1,0,27,0,0,47,8,0,58,0,0,0
34314,32241,2021-06-24T13:18:21.7530481Z,2021,42,6,38,22,0,4to,1,0,20,0,0,36,4,0,41,0,0,0
34314,32242,2021-06-24T13:18:21.7530481Z,2021,49,9,42,24,0,5to,0,0,25,0,0,40,7,1,48,0,0,0
34314,32243,2021-06-24T13:18:21.7530481Z,2021,26,4,19,9,0,K,0,0,17,0,0,22,7,0,26,0,0,0
34314,8243,2020-11-18T16:21:50.6838308Z,2020,47,7,44,19,0,1ro,0,0,28,0,0,40,3,0,47,0,0,0
34314,8244,2020-11-18T16:21:50.6838308Z,2020,64,8,56,36,0,2do,1,0,28,0,0,56,8,0,63,0,0,0
34314,8245,2020-11-18T16:21:50.6848317Z,2020,47,10,40,26,0,3ro,1,0,21,0,0,37,7,0,46,0,0,0
34314,8246,2020-11-18T16:21:50.6848317Z,2020,51,9,44,26,0,4to,0,0,25,0,0,42,7,1,49,0,0,1
34314,8247,2020-11-18T16:21:50.6848317Z,2020,54,14,46,27,0,5to,2,0,27,0,0,40,8,0,52,0,0,0
34314,8248,2020-11-18T16:21:50.6848317Z,2020,29,5,27,20,0,K,0,0,9,0,0,24,2,0,29,0,0,0
34926,2284,2020-11-18T16:20:55.01971Z,2019,56,6,45,28,0,10mo,0,0,28,0,0,50,11,0,56,0,0,0
34926,2285,2020-11-18T16:20:55.01971Z,2019,53,12,49,29,0,11mo,0,0,24,0,0,41,4,0,53,0,0,0
34926,2286,2020-11-18T16:20:55.0207105Z,2019,44,0,37,23,0,12mo,1,0,21,0,0,44,7,0,43,0,0,0
34926,2287,2020-11-18T16:20:55.0207105Z,2019,93,24,79,39,0,9no,0,1,54,0,0,69,14,0,93,0,0,0
34926,2288,2020-11-18T16:20:55.0207105Z,2019,10,5,10,2,0,Sin Grado,0,0,8,0,0,5,0,0,10,0,0,0
34926,32291,2021-06-24T13:18:21.7750634Z,2021,66,14,51,30,0,10mo,0,0,36,0,0,52,15,0,66,0,0,0
34926,32292,2021-06-24T13:18:21.7750634Z,2021,73,11,62,34,0,11mo,0,0,39,0,0,62,11,0,73,0,0,0
34926,32293,2021-06-24T13:18:21.7760639Z,2021,42,3,29,23,0,12mo,0,0,19,0,0,39,13,0,42,0,0,0
34926,32294,2021-06-24T13:18:21.7760639Z,2021,45,17,34,16,0,9no,0,0,29,0,0,28,11,0,45,0,0,0
34926,32295,2021-06-24T13:18:21.7760639Z,2021,5,5,4,3,0,Sin Grado,0,0,2,0,0,0,1,0,5,0,0,0
34926,8296,2020-11-18T16:21:50.7088482Z,2020,86,17,78,37,0,10mo,0,0,49,0,0,69,8,0,86,0,0,0
34926,8297,2020-11-18T16:21:50.7088482Z,2020,48,4,41,26,0,11mo,0,0,22,0,0,44,7,0,48,0,0,0
34926,8298,2020-11-18T16:21:50.7088482Z,2020,46,12,44,25,0,12mo,1,0,21,0,0,34,2,0,45,0,0,0
34926,8299,2020-11-18T16:21:50.7088482Z,2020,69,16,58,29,0,9no,0,0,40,0,0,53,11,0,69,0,0,0
34926,8300,2020-11-18T16:21:50.7098482Z,2020,7,7,7,1,0,Sin Grado,0,0,6,0,0,0,0,0,7,0,0,0
60301,10137,2020-11-18T16:22:02.6988386Z,2020,37,10,28,21,0,10mo,4,0,16,0,0,27,9,0,33,0,0,0
60301,10138,2020-11-18T16:22:02.6988386Z,2020,23,8,12,11,0,11mo,2,0,12,0,0,15,11,0,21,0,0,0
60301,10139,2020-11-18T16:22:02.6988386Z,2020,20,3,17,9,0,12mo,1,0,11,0,0,17,3,0,19,0,0,0
60301,10140,2020-11-18T16:22:02.6988386Z,2020,22,12,13,12,0,7mo,1,0,10,0,0,10,9,0,21,0,0,0
60301,10141,2020-11-18T16:22:02.6998391Z,2020,26,4,19,14,0,8vo,2,0,12,0,0,22,7,0,24,0,0,0
60301,10142,2020-11-18T16:22:02.6998391Z,2020,37,7,25,22,0,9no,2,0,15,0,0,30,12,0,35,0,0,0
60301,34154,2021-06-24T13:18:37.4623192Z,2021,35,7,25,21,0,10mo,2,0,14,0,0,28,10,0,33,0,0,0
60301,34155,2021-06-24T13:18:37.4623192Z,2021,30,7,23,15,0,11mo,3,0,15,0,0,23,7,0,27,0,0,0
60301,34156,2021-06-24T13:18:37.4633215Z,2021,21,7,16,9,0,12mo,2,0,12,0,0,14,5,0,19,0,0,0
60301,34157,2021-06-24T13:18:37.4633215Z,2021,22,5,17,14,0,7mo,2,0,8,0,0,17,5,0,20,0,1,0
60301,34158,2021-06-24T13:18:37.4633215Z,2021,21,11,14,11,0,8vo,1,0,10,0,0,10,7,0,20,0,0,0
60301,34159,2021-06-24T13:18:37.4633215Z,2021,21,4,16,12,0,9no,1,0,9,0,0,17,5,0,20,0,0,0
60301,4117,2020-11-18T16:21:07.9903629Z,2019,23,8,17,11,0,10mo,2,0,12,0,0,15,6,0,21,0,0,0
60301,4118,2020-11-18T16:21:07.9903629Z,2019,25,3,23,10,0,11mo,3,0,15,0,0,22,2,0,22,0,0,0
60301,4119,2020-11-18T16:21:07.9913625Z,2019,10,0,9,7,0,12mo,2,0,3,0,0,10,1,0,8,0,0,0
60301,4120,2020-11-18T16:21:07.9913625Z,2019,28,4,22,14,0,7mo,2,0,14,0,0,24,6,0,26,0,0,0
60301,4121,2020-11-18T16:21:07.9913625Z,2019,44,9,32,25,0,8vo,2,1,19,0,0,35,12,0,42,0,0,0
60301,4122,2020-11-18T16:21:07.9913625Z,2019,39,14,32,20,0,9no,4,1,19,0,0,25,7,0,35,0,0,0
52118,33533,2021-06-24T13:18:33.3883973Z,2021,18,2,15,11,0,1ro,0,0,7,0,0,16,3,0,18,0,0,0
52118,33534,2021-06-24T13:18:33.3883973Z,2021,17,6,17,14,0,2do,1,0,3,0,0,11,0,0,16,0,0,0
52118,33535,2021-06-24T13:18:33.3893987Z,2021,14,2,14,5,0,3ro,0,0,9,0,0,12,0,0,14,0,0,0
52118,33536,2021-06-24T13:18:33.3893987Z,2021,13,6,12,7,0,4to,0,0,6,0,0,7,1,0,13,0,0,0
52118,33537,2021-06-24T13:18:33.3893987Z,2021,22,7,22,13,0,5to,1,0,9,0,0,15,0,0,21,0,0,0
52118,33538,2021-06-24T13:18:33.3903988Z,2021,46,16,45,19,0,6to,1,0,27,0,0,30,1,0,45,0,0,0
52118,33539,2021-06-24T13:18:33.3903988Z,2021,55,21,53,29,0,7mo,2,0,26,0,0,34,2,0,53,0,1,0
52118,33540,2021-06-24T13:18:33.3913997Z,2021,49,15,44,24,0,8vo,0,0,25,0,0,34,5,0,49,0,0,0
52118,33541,2021-06-24T13:18:33.3913997Z,2021,10,2,10,5,0,K,0,0,5,0,0,8,0,0,10,0,0,0
52118,3508,2020-11-18T16:21:03.2582065Z,2019,17,7,17,4,0,1ro,0,0,13,0,0,10,0,0,17,0,0,0
52118,3509,2020-11-18T16:21:03.2582065Z,2019,17,6,16,8,0,2do,0,1,9,0,0,11,1,0,17,0,0,0
52118,3510,2020-11-18T16:21:03.2592074Z,2019,28,11,26,18,0,3ro,0,3,10,0,0,17,2,0,28,0,0,0
52118,3511,2020-11-18T16:21:03.2592074Z,2019,37,8,35,19,1,4to,1,2,18,0,0,29,2,0,36,0,0,0
52118,3512,2020-11-18T16:21:03.2592074Z,2019,44,17,41,25,0,5to,1,0,19,0,0,27,3,0,43,0,0,0
52118,3513,2020-11-18T16:21:03.2592074Z,2019,64,22,59,32,0,6to,0,1,32,0,0,42,5,0,64,0,2,0
52118,3514,2020-11-18T16:21:03.2602087Z,2019,89,32,84,51,0,7mo,0,1,38,0,0,57,5,0,89,0,1,0
52118,3515,2020-11-18T16:21:03.2602087Z,2019,86,28,73,40,2,8vo,1,4,46,0,0,58,13,0,85,0,0,0
52118,3516,2020-11-18T16:21:03.2602087Z,2019,22,4,22,17,0,K,2,0,5,0,0,18,0,0,20,0,0,0
52118,9528,2020-11-18T16:21:59.0904342Z,2020,19,5,19,16,0,1ro,0,1,3,0,0,14,0,0,19,0,0,0
52118,9529,2020-11-18T16:21:59.0904342Z,2020,15,2,15,5,0,2do,0,2,10,0,0,13,0,0,15,0,0,0
52118,9530,2020-11-18T16:21:59.0904342Z,2020,15,7,13,7,0,3ro,0,1,8,0,0,8,2,0,15,0,0,0
52118,9531,2020-11-18T16:21:59.0904342Z,2020,23,9,22,14,0,4to,0,2,9,0,0,14,1,0,23,0,0,0
52118,9532,2020-11-18T16:21:59.0904342Z,2020,33,9,31,19,0,5to,0,1,14,0,0,24,2,0,33,0,0,0
52118,9533,2020-11-18T16:21:59.0914364Z,2020,62,25,58,29,0,6to,1,5,33,0,0,37,4,0,61,0,1,0
52118,9534,2020-11-18T16:21:59.0914364Z,2020,58,17,52,33,0,7mo,0,1,25,0,0,41,6,0,58,0,0,0
52118,9535,2020-11-18T16:21:59.0924359Z,2020,74,27,70,44,0,8vo,0,3,30,0,0,47,4,0,74,0,1,0
52118,9536,2020-11-18T16:21:59.0924359Z,2020,21,2,19,13,0,K,1,1,8,0,0,19,2,0,20,0,0,0
21576,1225,2020-11-18T16:20:45.0880884Z,2019,13,1,4,9,0,10mo,0,0,4,0,0,12,9,0,13,0,0,0
21576,1226,2020-11-18T16:20:45.0880884Z,2019,20,1,11,12,0,11mo,0,0,8,0,0,19,9,0,20,0,0,0
21576,1227,2020-11-18T16:20:45.0890888Z,2019,18,0,8,5,0,12mo,0,0,13,0,0,18,10,0,18,0,0,0
21576,1228,2020-11-18T16:20:45.0890888Z,2019,40,5,15,17,0,1ro,0,0,23,0,0,35,25,0,40,0,0,0
21576,1229,2020-11-18T16:20:45.0890888Z,2019,42,5,18,21,0,2do,0,0,21,0,0,37,24,0,42,0,0,0
21576,1230,2020-11-18T16:20:45.0890888Z,2019,37,5,11,22,0,3ro,0,0,15,0,0,32,26,0,36,0,0,1
21576,1231,2020-11-18T16:20:45.0890888Z,2019,42,4,19,26,0,4to,0,0,16,0,0,38,23,0,41,0,0,1
21576,1232,2020-11-18T16:20:45.0900897Z,2019,23,0,7,14,0,5to,0,0,9,0,0,23,16,0,23,0,0,0
21576,1233,2020-11-18T16:20:45.0900897Z,2019,24,0,9,14,0,6to,0,0,10,0,0,24,15,0,24,0,0,0
21576,1234,2020-11-18T16:20:45.0900897Z,2019,24,2,7,15,0,7mo,0,0,9,0,0,22,17,0,24,0,0,0
21576,1235,2020-11-18T16:20:45.0900897Z,2019,43,2,13,17,0,8vo,0,0,26,0,0,41,30,0,43,0,0,0
21576,1236,2020-11-18T16:20:45.0910902Z,2019,22,1,5,15,0,9no,0,0,7,0,0,21,17,0,22,0,0,0
21576,1237,2020-11-18T16:20:45.0910902Z,2019,45,6,11,19,0,K,0,0,26,0,0,39,34,0,44,0,0,1
21576,31226,2021-06-24T13:18:14.0205036Z,2021,43,2,24,18,0,10mo,0,0,25,0,0,41,19,0,43,0,0,0
21576,31227,2021-06-24T13:18:14.0215041Z,2021,21,1,8,14,0,11mo,0,0,7,0,0,20,13,0,21,0,0,0
21576,31228,2021-06-24T13:18:14.0215041Z,2021,18,2,7,13,0,12mo,0,0,5,0,0,16,11,0,18,0,0,0
21576,31229,2021-06-24T13:18:14.0215041Z,2021,39,7,30,23,0,1ro,2,1,16,0,0,32,9,0,37,0,0,0
21576,31230,2021-06-24T13:18:14.0225042Z,2021,49,4,28,24,0,2do,0,1,25,0,0,45,21,0,48,0,0,1
21576,31231,2021-06-24T13:18:14.0225042Z,2021,40,5,26,18,0,3ro,0,0,22,0,0,35,14,0,40,0,0,0
21576,31232,2021-06-24T13:18:14.0225042Z,2021,45,7,28,22,0,4to,0,3,23,0,0,38,17,0,45,0,0,0
21576,31233,2021-06-24T13:18:14.023506Z,2021,46,4,21,26,0,5to,0,0,20,0,0,42,25,0,45,0,0,1
21576,31234,2021-06-24T13:18:14.023506Z,2021,46,4,29,27,0,6to,0,0,19,0,0,42,17,0,45,0,0,1
21576,31235,2021-06-24T13:18:14.023506Z,2021,22,0,10,14,0,7mo,0,0,8,0,0,22,12,0,22,0,0,0
21576,31236,2021-06-24T13:18:14.023506Z,2021,26,0,17,16,0,8vo,0,0,10,0,0,26,9,0,26,0,0,0
21576,31237,2021-06-24T13:18:14.0245056Z,2021,22,1,10,15,0,9no,0,0,7,0,0,21,12,0,22,0,0,0
21576,31238,2021-06-24T13:18:14.0245056Z,2021,49,7,31,27,0,K,0,0,22,0,0,42,18,0,48,0,0,1
21576,7230,2020-11-18T16:21:44.5967711Z,2020,22,1,12,15,0,10mo,0,0,7,0,0,21,10,0,22,0,0,0
21576,7231,2020-11-18T16:21:44.5977715Z,2020,15,1,6,11,0,11mo,0,0,4,0,0,14,9,0,15,0,0,0
21576,7232,2020-11-18T16:21:44.5977715Z,2020,19,1,12,11,0,12mo,0,0,8,0,0,18,7,0,19,0,0,0
21576,7233,2020-11-18T16:21:44.5987724Z,2020,51,6,18,25,0,1ro,0,1,26,0,0,45,33,0,50,0,0,1
21576,7234,2020-11-18T16:21:44.5987724Z,2020,45,5,19,21,0,2do,0,0,24,0,0,40,26,0,45,0,0,0
21576,7235,2020-11-18T16:21:44.5987724Z,2020,47,7,19,23,0,3ro,0,3,24,0,0,40,28,0,47,0,0,0
21576,7236,2020-11-18T16:21:44.5987724Z,2020,48,5,19,28,0,4to,0,0,20,0,0,43,29,0,47,0,0,1
21576,7237,2020-11-18T16:21:44.5997733Z,2020,47,4,21,28,0,5to,0,0,19,0,0,43,26,0,46,0,0,1
21576,7238,2020-11-18T16:21:44.5997733Z,2020,24,0,11,15,0,6to,0,0,9,0,0,24,13,0,24,0,0,0
21576,7239,2020-11-18T16:21:44.6007746Z,2020,26,0,10,16,0,7mo,0,0,10,0,0,26,16,0,26,0,0,0
21576,7240,2020-11-18T16:21:44.6007746Z,2020,26,2,15,16,0,8vo,0,0,10,0,0,24,11,0,26,0,0,0
21576,7241,2020-11-18T16:21:44.6007746Z,2020,44,2,23,17,0,9no,0,0,27,0,0,42,21,0,44,0,0,0
21576,7242,2020-11-18T16:21:44.6017746Z,2020,42,6,17,23,0,K,2,2,19,0,0,36,25,0,40,0,0,0
60095,10121,2020-11-18T16:22:02.6968373Z,2020,40,11,30,27,0,1ro,0,0,13,0,0,29,10,1,39,0,0,0
60095,10122,2020-11-18T16:22:02.6968373Z,2020,41,11,29,12,0,2do,1,0,29,0,0,30,12,0,40,0,0,0
60095,10123,2020-11-18T16:22:02.6978382Z,2020,47,16,39,27,0,3ro,2,0,20,0,0,31,8,0,45,0,0,0
60095,10124,2020-11-18T16:22:02.6978382Z,2020,36,7,25,17,0,4to,1,0,19,0,0,29,11,0,35,0,0,0
60095,10125,2020-11-18T16:22:02.6978382Z,2020,40,14,28,24,0,5to,0,0,16,0,0,26,12,0,40,0,0,0
60095,10126,2020-11-18T16:22:02.6978382Z,2020,37,4,26,17,0,6to,2,0,20,0,0,33,11,0,35,0,0,0
60095,10127,2020-11-18T16:22:02.6988386Z,2020,44,9,35,15,0,K,0,0,29,0,0,35,9,0,44,0,0,0
60095,10128,2020-11-18T16:22:02.6988386Z,2020,32,32,28,10,0,Sin Grado,3,0,22,0,0,0,4,0,29,0,0,0
60095,34138,2021-06-24T13:18:37.441303Z,2021,32,8,27,13,0,1ro,1,0,19,0,0,24,5,0,31,0,0,0
60095,34139,2021-06-24T13:18:37.4423044Z,2021,30,6,27,21,0,2do,0,0,9,0,0,24,3,1,29,0,0,0
60095,34140,2021-06-24T13:18:37.4423044Z,2021,36,11,32,11,0,3ro,1,0,25,0,0,25,4,0,35,0,0,0
60095,34141,2021-06-24T13:18:37.4423044Z,2021,39,13,34,21,0,4to,2,0,18,0,0,26,5,0,37,0,0,0
60095,34142,2021-06-24T13:18:37.4423044Z,2021,34,11,27,14,0,5to,1,0,20,0,0,23,7,0,33,0,0,0
60095,34143,2021-06-24T13:18:37.4433045Z,2021,51,19,41,30,0,6to,0,0,21,0,0,32,10,0,51,0,0,0
60095,34144,2021-06-24T13:18:37.4433045Z,2021,44,19,39,22,0,K,0,0,22,0,0,25,5,0,44,0,0,0
60095,34145,2021-06-24T13:18:37.4433045Z,2021,35,35,32,16,0,Sin Grado,2,0,19,0,0,0,3,0,33,0,0,0
60095,4103,2020-11-18T16:21:07.9883611Z,2019,45,15,33,18,0,1ro,1,0,27,0,0,30,12,0,44,0,0,0
60095,4104,2020-11-18T16:21:07.9883611Z,2019,50,16,41,31,0,2do,1,0,19,0,0,34,9,0,49,0,0,0
60095,4105,2020-11-18T16:21:07.9883611Z,2019,44,18,31,17,0,3ro,0,0,27,0,0,26,13,0,44,0,0,0
60095,4106,2020-11-18T16:21:07.989362Z,2019,49,17,34,26,0,4to,3,0,23,0,0,32,15,0,46,0,0,0
60095,4107,2020-11-18T16:21:07.989362Z,2019,29,6,25,13,0,5to,1,0,16,0,0,23,4,0,28,0,0,0
60095,4108,2020-11-18T16:21:07.9903629Z,2019,38,7,27,22,0,K,0,0,16,0,0,31,11,1,37,0,0,0
60095,4109,2020-11-18T16:21:07.9903629Z,2019,39,38,35,16,0,Sin Grado,2,0,23,0,0,1,4,0,37,0,0,0
20412,30972,2021-06-24T13:18:11.8199259Z,2021,30,5,27,18,0,1ro,1,0,12,0,0,25,3,0,28,0,0,1
20412,30973,2021-06-24T13:18:11.8199259Z,2021,18,6,17,8,0,2do,0,0,10,0,0,12,1,0,18,0,0,0
20412,30974,2021-06-24T13:18:11.8199259Z,2021,24,6,23,13,0,3ro,0,0,11,0,0,18,1,0,24,0,0,0
20412,30975,2021-06-24T13:18:11.8199259Z,2021,26,8,22,13,0,4to,0,0,13,0,0,18,4,0,26,0,0,0
20412,30976,2021-06-24T13:18:11.8209264Z,2021,20,8,17,8,0,5to,1,0,12,0,0,12,3,0,19,0,0,0
20412,30977,2021-06-24T13:18:11.8209264Z,2021,22,5,19,12,0,K,1,0,10,0,0,17,3,0,21,0,0,0
20412,6975,2020-11-18T16:21:42.5944337Z,2020,18,5,17,7,0,1ro,0,0,11,0,0,13,1,0,17,0,0,1
20412,6976,2020-11-18T16:21:42.5944337Z,2020,32,11,28,14,0,2do,0,0,18,0,0,21,4,0,32,0,0,0
20412,6977,2020-11-18T16:21:42.5944337Z,2020,29,11,23,14,0,3ro,0,0,15,0,0,18,6,0,29,0,0,0
20412,6978,2020-11-18T16:21:42.5944337Z,2020,19,6,14,9,0,4to,1,0,10,0,0,13,5,0,18,0,0,0
20412,6979,2020-11-18T16:21:42.5944337Z,2020,10,3,9,5,0,5to,0,0,5,0,0,7,1,0,10,0,0,0
20412,6980,2020-11-18T16:21:42.5954346Z,2020,42,7,32,27,0,K,1,0,15,0,0,35,10,0,41,0,0,0
20412,974,2020-11-18T16:20:43.3859511Z,2019,36,15,30,15,0,1ro,0,1,21,0,0,21,6,0,36,0,0,0
20412,975,2020-11-18T16:20:43.386952Z,2019,34,12,27,17,0,2do,0,0,17,0,0,22,7,0,34,0,0,0
20412,976,2020-11-18T16:20:43.386952Z,2019,30,10,25,14,0,3ro,1,2,16,0,0,20,5,0,29,0,0,0
20412,977,2020-11-18T16:20:43.386952Z,2019,21,7,19,9,0,4to,0,0,12,0,0,14,2,0,21,0,0,0
20412,978,2020-11-18T16:20:43.386952Z,2019,23,5,15,12,0,5to,0,0,11,0,0,18,8,0,23,0,0,0
20412,979,2020-11-18T16:20:43.3879538Z,2019,17,5,15,5,0,K,0,1,12,0,0,12,2,0,17,0,0,0
66076,10753,2020-11-18T16:22:06.0260621Z,2020,43,19,33,30,0,1ro,0,0,13,0,0,24,10,0,43,0,0,0
66076,10754,2020-11-18T16:22:06.0260621Z,2020,60,24,50,25,0,2do,1,1,35,0,0,36,10,0,59,0,0,0
66076,10755,2020-11-18T16:22:06.027063Z,2020,37,13,31,18,0,3ro,0,0,19,0,0,24,6,0,37,0,0,0
66076,10756,2020-11-18T16:22:06.027063Z,2020,44,20,37,12,0,4to,0,0,32,0,0,24,7,0,44,0,1,0
66076,10757,2020-11-18T16:22:06.027063Z,2020,46,17,35,14,0,5to,0,0,32,0,0,29,11,0,46,0,0,0
66076,10758,2020-11-18T16:22:06.0280634Z,2020,68,23,57,35,0,K,0,0,33,0,0,45,11,1,67,0,0,0
66076,10759,2020-11-18T16:22:06.0280634Z,2020,19,18,15,3,0,Sin Grado,0,0,16,0,0,1,4,0,19,0,0,0
66076,34770,2021-06-24T13:18:41.4902081Z,2021,66,21,58,32,0,1ro,0,2,34,0,0,45,8,1,65,0,0,0
66076,34771,2021-06-24T13:18:41.4902081Z,2021,41,19,36,26,0,2do,0,0,15,0,0,22,5,0,41,0,0,0
66076,34772,2021-06-24T13:18:41.4902081Z,2021,54,26,45,19,0,3ro,1,0,35,0,0,28,9,0,53,0,0,0
66076,34773,2021-06-24T13:18:41.4902081Z,2021,34,13,28,16,0,4to,0,0,18,0,0,21,6,0,34,0,0,0
66076,34774,2021-06-24T13:18:41.4912068Z,2021,38,16,35,11,0,5to,0,0,27,0,0,22,3,0,38,0,0,0
66076,34775,2021-06-24T13:18:41.4912068Z,2021,47,15,41,19,0,K,0,0,28,0,0,32,6,0,46,0,0,1
66076,34776,2021-06-24T13:18:41.4912068Z,2021,21,21,18,2,0,Sin Grado,1,0,19,0,0,0,3,0,20,0,0,0
66076,4744,2020-11-18T16:21:11.9109747Z,2019,64,21,56,33,2,1ro,1,3,31,0,0,43,8,0,62,0,0,1
66076,4745,2020-11-18T16:21:11.9109747Z,2019,44,19,35,21,0,2do,0,1,23,0,0,25,9,0,44,0,0,0
66076,4746,2020-11-18T16:21:11.9109747Z,2019,47,21,37,15,0,3ro,1,0,32,0,0,26,10,0,46,0,1,0
66076,4747,2020-11-18T16:21:11.9109747Z,2019,54,20,46,20,0,4to,0,0,34,0,0,34,8,0,54,0,0,0
66076,4748,2020-11-18T16:21:11.9109747Z,2019,45,13,41,24,1,5to,1,2,21,0,0,32,4,0,43,0,0,1
66076,4749,2020-11-18T16:21:11.9119752Z,2019,47,20,37,29,0,K,0,1,18,0,0,27,10,0,47,0,0,0
66076,4750,2020-11-18T16:21:11.9119752Z,2019,23,20,18,3,0,Sin Grado,1,0,20,0,0,3,5,0,22,0,0,0
46086,3052,2020-11-18T16:21:00.3342537Z,2019,94,27,72,46,0,10mo,1,0,48,0,0,67,22,0,93,3,0,0
46086,3053,2020-11-18T16:21:00.3352546Z,2019,83,17,60,43,0,11mo,1,0,40,0,0,66,23,0,82,3,0,0
46086,3054,2020-11-18T16:21:00.3352546Z,2019,58,0,47,32,0,12mo,0,0,26,0,0,58,11,0,58,0,0,0
46086,3055,2020-11-18T16:21:00.3352546Z,2019,96,24,72,51,0,9no,5,0,45,0,0,72,24,0,91,1,2,0
46086,3056,2020-11-18T16:21:00.3362551Z,2019,6,4,6,0,0,Sin Grado,1,0,6,0,0,2,0,0,5,0,0,0
46086,33062,2021-06-24T13:18:29.8248418Z,2021,162,44,130,91,0,10mo,7,0,71,0,0,118,32,0,154,3,0,1
46086,33063,2021-06-24T13:18:29.8248418Z,2021,83,20,62,46,0,11mo,4,0,37,0,0,63,21,0,79,1,2,0
46086,33064,2021-06-24T13:18:29.8248418Z,2021,77,20,63,40,0,12mo,1,0,37,0,0,57,14,0,76,3,1,0
46086,33065,2021-06-24T13:18:29.8258423Z,2021,100,19,75,46,0,9no,1,0,54,0,0,81,25,0,99,2,0,0
46086,33066,2021-06-24T13:18:29.8258423Z,2021,7,7,6,2,0,Sin Grado,1,1,5,0,0,0,1,0,6,0,0,0
46086,9066,2020-11-18T16:21:55.4339997Z,2020,94,24,67,52,0,10mo,5,0,42,0,0,70,27,0,89,1,1,0
46086,9067,2020-11-18T16:21:55.4349997Z,2020,85,24,63,43,0,11mo,1,0,42,0,0,61,22,0,84,3,0,0
46086,9068,2020-11-18T16:21:55.4349997Z,2020,81,17,57,41,0,12mo,1,0,40,0,0,64,24,0,80,3,0,0
46086,9069,2020-11-18T16:21:55.4360001Z,2020,145,40,106,76,0,9no,9,0,69,0,0,105,39,0,136,3,1,0
46086,9070,2020-11-18T16:21:55.4360001Z,2020,6,6,5,1,0,Sin Grado,1,0,5,0,0,0,1,0,5,0,0,0
15024,30586,2021-06-24T13:18:10.4009075Z,2021,48,8,40,24,0,1ro,0,1,24,0,0,40,8,0,48,0,0,0
15024,30587,2021-06-24T13:18:10.4009075Z,2021,59,15,52,34,0,2do,2,1,25,0,0,44,7,0,57,0,0,0
15024,30588,2021-06-24T13:18:10.4009075Z,2021,64,26,50,28,0,3ro,0,0,36,0,0,38,14,0,64,1,0,0
15024,30589,2021-06-24T13:18:10.4009075Z,2021,51,19,41,29,0,4to,1,0,22,0,0,32,10,0,50,1,0,0
15024,30590,2021-06-24T13:18:10.401908Z,2021,48,17,36,24,0,5to,0,0,24,0,0,31,12,0,48,2,0,0
15024,30591,2021-06-24T13:18:10.401908Z,2021,57,15,44,29,0,K,0,3,28,0,0,42,13,0,56,0,0,1
15024,30592,2021-06-24T13:18:10.401908Z,2021,2,2,2,0,0,Sin Grado,0,0,2,0,0,0,0,0,2,0,0,0
15024,588,2020-11-18T16:20:40.7842194Z,2019,75,34,56,32,0,1ro,0,0,43,0,0,41,19,0,75,1,0,0
15024,589,2020-11-18T16:20:40.7852194Z,2019,61,19,45,28,0,2do,0,0,33,0,0,42,16,0,61,1,0,0
15024,590,2020-11-18T16:20:40.7852194Z,2019,63,22,39,34,0,3ro,0,0,29,0,0,41,24,0,63,2,0,0
15024,591,2020-11-18T16:20:40.7852194Z,2019,73,24,52,31,0,4to,1,0,42,0,0,49,21,0,72,0,0,0
15024,592,2020-11-18T16:20:40.7852194Z,2019,56,16,39,29,0,5to,0,1,27,0,0,40,17,0,56,0,0,0
15024,593,2020-11-18T16:20:40.7852194Z,2019,68,15,54,37,0,K,0,0,31,0,0,53,14,0,68,0,0,0
15024,594,2020-11-18T16:20:40.7862216Z,2019,3,2,3,0,0,Sin Grado,0,0,3,0,0,1,0,0,3,0,0,0
15024,6588,2020-11-18T16:21:40.3669516Z,2020,59,15,49,31,0,1ro,0,1,28,0,0,44,10,0,59,0,0,0
15024,6589,2020-11-18T16:21:40.3669516Z,2020,75,28,56,33,0,2do,0,1,42,0,0,47,19,0,75,2,0,0
15024,6590,2020-11-18T16:21:40.3679525Z,2020,55,19,41,28,0,3ro,0,0,27,0,0,36,14,0,55,1,0,0
15024,6591,2020-11-18T16:21:40.3679525Z,2020,55,17,35,29,0,4to,0,0,26,0,0,38,20,0,55,2,0,0
15024,6592,2020-11-18T16:21:40.3679525Z,2020,65,22,48,27,0,5to,1,0,38,0,0,43,17,0,64,0,0,0
15024,6593,2020-11-18T16:21:40.3679525Z,2020,59,14,47,31,0,K,0,1,28,0,0,45,12,0,59,0,0,0
15024,6594,2020-11-18T16:21:40.3679525Z,2020,2,2,2,0,0,Sin Grado,0,0,2,0,0,0,0,0,2,0,0,0
61358,10201,2020-11-18T16:22:03.1111137Z,2020,49,11,44,28,0,1ro,1,3,21,0,0,38,5,0,48,0,0,0
61358,10202,2020-11-18T16:22:03.1121146Z,2020,41,14,29,23,0,2do,2,1,18,0,0,27,12,0,39,0,0,0
61358,10203,2020-11-18T16:22:03.1121146Z,2020,46,18,36,19,0,3ro,1,2,27,0,0,28,10,1,44,1,1,0
61358,10204,2020-11-18T16:22:03.1121146Z,2020,38,15,32,19,0,4to,0,2,19,0,0,23,6,0,38,0,0,0
61358,10205,2020-11-18T16:22:03.1121146Z,2020,52,16,45,28,0,5to,3,3,24,0,0,36,7,0,49,0,0,0
61358,10206,2020-11-18T16:22:03.1131155Z,2020,43,18,36,18,0,K,1,1,25,0,0,25,7,0,42,0,0,0
61358,34217,2021-06-24T13:18:38.0437355Z,2021,39,16,34,16,0,1ro,2,1,23,0,0,23,5,0,37,0,0,0
61358,34218,2021-06-24T13:18:38.044736Z,2021,43,12,39,24,0,2do,1,3,19,0,0,31,4,0,42,0,0,0
61358,34219,2021-06-24T13:18:38.044736Z,2021,37,13,28,20,0,3ro,2,1,17,0,0,24,9,0,35,0,0,0
61358,34220,2021-06-24T13:18:38.044736Z,2021,47,18,39,18,0,4to,1,2,29,0,0,29,8,1,45,1,1,0
61358,34221,2021-06-24T13:18:38.0457369Z,2021,43,16,32,19,0,5to,1,2,24,0,0,27,11,0,42,0,0,0
61358,34222,2021-06-24T13:18:38.0457369Z,2021,42,16,34,22,0,K,1,0,20,0,0,26,8,0,41,0,0,0
61358,4186,2020-11-18T16:21:08.0183807Z,2019,52,19,36,25,0,1ro,2,2,27,0,0,33,16,0,50,0,0,0
61358,4187,2020-11-18T16:21:08.0183807Z,2019,47,17,34,20,0,2do,1,0,27,0,0,30,13,1,45,1,1,0
61358,4188,2020-11-18T16:21:08.0183807Z,2019,44,18,36,21,0,3ro,1,3,23,0,0,26,8,0,43,0,0,0
61358,4189,2020-11-18T16:21:08.0183807Z,2019,54,17,45,28,0,4to,2,0,26,0,0,37,9,0,51,0,0,1
61358,4190,2020-11-18T16:21:08.0193816Z,2019,35,11,26,13,0,5to,1,2,22,0,0,24,9,1,33,0,0,0
61358,4191,2020-11-18T16:21:08.0193816Z,2019,46,13,41,28,0,K,1,2,18,0,0,33,5,0,45,0,0,0
35923,2409,2020-11-18T16:20:56.2515336Z,2019,18,2,14,11,0,1ro,0,0,7,0,0,16,4,0,18,0,0,0
35923,2410,2020-11-18T16:20:56.2515336Z,2019,19,5,17,7,0,2do,0,0,12,0,0,14,2,0,19,0,0,0
35923,2411,2020-11-18T16:20:56.2515336Z,2019,22,6,15,9,0,3ro,1,0,13,0,0,16,7,0,21,0,1,0
35923,2412,2020-11-18T16:20:56.2525354Z,2019,17,2,14,10,0,4to,0,0,7,0,0,15,3,0,17,1,0,0
35923,2413,2020-11-18T16:20:56.2525354Z,2019,15,3,10,5,0,5to,1,0,10,0,0,12,5,0,14,0,0,0
35923,2414,2020-11-18T16:20:56.2525354Z,2019,22,4,12,13,0,6to,0,0,9,0,0,18,10,0,22,0,0,0
35923,2415,2020-11-18T16:20:56.2525354Z,2019,17,6,12,8,0,7mo,0,0,9,0,0,11,5,0,17,0,0,0
35923,2416,2020-11-18T16:20:56.2525354Z,2019,18,3,9,14,0,8vo,0,0,4,0,0,15,9,0,18,0,0,0
35923,2417,2020-11-18T16:20:56.2535345Z,2019,12,0,5,4,0,K,0,0,8,0,0,12,7,0,12,0,0,0
35923,32416,2021-06-24T13:18:24.7091708Z,2021,20,2,16,6,0,1ro,0,0,14,0,0,18,4,0,20,0,0,0
35923,32417,2021-06-24T13:18:24.7101718Z,2021,20,0,14,4,0,2do,0,0,16,0,0,20,6,0,20,0,0,0
35923,32418,2021-06-24T13:18:24.7101718Z,2021,24,3,20,13,0,3ro,0,0,11,0,0,21,4,0,24,0,0,0
35923,32419,2021-06-24T13:18:24.7111736Z,2021,22,6,19,5,0,4to,0,0,17,0,0,16,3,0,21,0,0,1
35923,32420,2021-06-24T13:18:24.7111736Z,2021,26,4,23,13,0,5to,2,0,13,0,0,22,3,0,24,0,0,0
35923,32421,2021-06-24T13:18:24.7111736Z,2021,22,2,16,13,0,6to,0,0,9,0,0,20,6,0,22,1,0,0
35923,32422,2021-06-24T13:18:24.7111736Z,2021,19,2,11,8,0,7mo,1,0,11,0,0,17,8,0,18,0,0,0
35923,32423,2021-06-24T13:18:24.7121741Z,2021,19,3,14,11,0,8vo,0,0,8,0,0,16,5,0,19,0,0,0
35923,32424,2021-06-24T13:18:24.7121741Z,2021,17,0,13,12,0,K,0,0,5,0,0,17,4,0,17,0,0,0
35923,8421,2020-11-18T16:21:51.7955679Z,2020,18,0,14,5,0,1ro,0,0,13,0,0,18,4,0,18,0,0,0
35923,8422,2020-11-18T16:21:51.7955679Z,2020,22,4,15,14,0,2do,0,0,8,0,0,18,7,0,22,0,0,0
35923,8423,2020-11-18T16:21:51.7965687Z,2020,19,4,16,8,0,3ro,0,0,11,0,0,15,3,0,18,0,0,1
35923,8424,2020-11-18T16:21:51.7965687Z,2020,28,4,21,13,0,4to,2,0,15,0,0,24,7,0,26,0,0,0
35923,8425,2020-11-18T16:21:51.7965687Z,2020,17,2,15,9,0,5to,0,0,8,0,0,15,2,0,17,1,0,0
35923,8426,2020-11-18T16:21:51.7975696Z,2020,19,4,16,7,0,6to,1,0,12,0,0,15,3,0,18,0,0,0
35923,8427,2020-11-18T16:21:51.7975696Z,2020,22,4,15,14,0,7mo,0,0,8,0,0,18,7,0,22,0,0,0
35923,8428,2020-11-18T16:21:51.7975696Z,2020,17,6,14,8,0,8vo,0,0,9,0,0,11,3,0,17,0,0,0
35923,8429,2020-11-18T16:21:51.7985705Z,2020,23,1,19,4,0,K,0,0,19,0,0,22,4,0,23,0,0,0
18259,30838,2021-06-24T13:18:11.4586667Z,2021,57,20,49,29,0,1ro,0,0,28,0,0,37,8,0,57,0,0,0
18259,30839,2021-06-24T13:18:11.4586667Z,2021,56,13,48,40,0,2do,0,0,16,0,0,43,8,0,56,0,0,0
18259,30840,2021-06-24T13:18:11.4596671Z,2021,41,6,37,21,0,3ro,0,1,20,0,0,35,4,0,41,0,0,0
18259,30841,2021-06-24T13:18:11.4596671Z,2021,50,18,42,19,0,4to,1,1,31,0,0,32,8,0,49,0,0,0
18259,30842,2021-06-24T13:18:11.4596671Z,2021,49,18,39,24,0,5to,0,0,25,0,0,31,10,0,49,0,0,0
18259,30843,2021-06-24T13:18:11.4596671Z,2021,70,21,57,35,0,6to,1,0,35,0,0,49,13,0,69,1,0,0
18259,30844,2021-06-24T13:18:11.4606672Z,2021,77,22,65,33,0,7mo,0,3,44,0,0,55,12,0,77,0,1,0
18259,30845,2021-06-24T13:18:11.4606672Z,2021,71,23,57,43,0,8vo,0,2,28,0,0,48,14,0,71,0,0,0
18259,30846,2021-06-24T13:18:11.4606672Z,2021,50,10,42,23,0,K,1,1,27,0,0,40,8,0,49,0,0,0
18259,30847,2021-06-24T13:18:11.4616681Z,2021,21,20,18,9,0,Sin Grado,0,2,12,0,0,1,3,0,21,0,0,0
18259,6842,2020-11-18T16:21:42.0450674Z,2020,60,13,49,43,0,1ro,1,0,17,0,0,47,11,0,59,0,0,0
18259,6843,2020-11-18T16:21:42.0450674Z,2020,37,7,32,18,0,2do,0,1,19,0,0,30,5,0,37,0,0,0
18259,6844,2020-11-18T16:21:42.0450674Z,2020,52,19,39,22,0,3ro,2,0,30,0,0,33,13,0,50,0,0,0
18259,6845,2020-11-18T16:21:42.0460674Z,2020,51,17,34,24,0,4to,0,1,27,0,0,34,17,0,51,0,0,0
18259,6846,2020-11-18T16:21:42.0460674Z,2020,48,11,38,29,0,5to,1,0,19,0,0,37,10,0,47,0,0,0
18259,6847,2020-11-18T16:21:42.0460674Z,2020,77,23,60,35,0,6to,1,0,42,0,0,54,17,0,76,0,1,0
18259,6848,2020-11-18T16:21:42.0460674Z,2020,72,26,54,43,0,7mo,0,4,29,0,0,46,18,0,72,0,0,0
18259,6849,2020-11-18T16:21:42.0460674Z,2020,63,22,49,32,0,8vo,1,0,31,0,0,41,14,0,62,0,1,0
18259,6850,2020-11-18T16:21:42.0470683Z,2020,49,13,43,19,0,K,0,0,30,0,0,36,6,0,49,0,0,0
18259,6851,2020-11-18T16:21:42.0470683Z,2020,24,24,21,10,0,Sin Grado,0,2,14,0,0,0,3,0,24,0,0,0
18259,841,2020-11-18T16:20:42.6454568Z,2019,47,15,40,26,0,1ro,0,0,21,0,0,32,7,0,47,0,0,0
18259,842,2020-11-18T16:20:42.6464572Z,2019,49,18,33,19,0,2do,1,0,30,0,0,31,16,0,48,0,0,0
18259,843,2020-11-18T16:20:42.6464572Z,2019,50,17,36,23,0,3ro,0,0,27,0,0,33,14,0,50,0,0,0
18259,844,2020-11-18T16:20:42.6464572Z,2019,54,15,42,30,0,4to,1,0,24,0,0,39,12,0,53,0,0,0
18259,845,2020-11-18T16:20:42.6464572Z,2019,58,16,41,23,0,5to,0,1,35,0,0,42,17,0,58,0,1,0
18259,846,2020-11-18T16:20:42.6464572Z,2019,66,26,51,39,0,6to,0,0,27,0,0,40,15,0,66,0,0,0
18259,847,2020-11-18T16:20:42.6464572Z,2019,66,20,53,34,0,7mo,1,0,32,0,0,46,13,0,65,0,1,0
18259,848,2020-11-18T16:20:42.6474577Z,2019,85,33,72,42,0,8vo,0,2,43,0,0,52,13,0,85,0,0,0
18259,849,2020-11-18T16:20:42.6474577Z,2019,48,5,30,40,0,K,0,0,8,0,0,43,18,0,48,0,0,0
18259,850,2020-11-18T16:20:42.6474577Z,2019,24,21,21,11,0,Sin Grado,0,2,13,0,0,3,3,0,24,0,0,0
77289,11678,2020-11-18T16:22:11.7408731Z,2020,23,6,23,12,0,1ro,0,1,11,0,0,17,0,0,23,0,0,0
77289,11679,2020-11-18T16:22:11.7408731Z,2020,17,6,17,7,0,2do,4,0,10,0,0,11,0,0,13,0,0,0
77289,11680,2020-11-18T16:22:11.7408731Z,2020,22,8,21,14,0,3ro,1,0,8,0,0,14,1,0,21,0,0,0
77289,11681,2020-11-18T16:22:11.7408731Z,2020,28,7,28,14,0,4to,2,0,14,0,0,21,0,0,26,0,0,0
77289,11682,2020-11-18T16:22:11.7418736Z,2020,28,9,27,12,0,5to,2,0,16,0,0,19,1,0,26,0,0,0
77289,11683,2020-11-18T16:22:11.7418736Z,2020,25,7,23,13,0,6to,2,0,12,0,0,18,2,0,23,0,0,0
77289,11684,2020-11-18T16:22:11.7418736Z,2020,10,5,7,6,0,7mo,2,0,4,0,0,5,3,0,8,0,0,0
77289,11685,2020-11-18T16:22:11.7428744Z,2020,29,7,25,13,0,8vo,5,0,16,0,0,22,4,0,24,0,0,0
77289,11686,2020-11-18T16:22:11.7428744Z,2020,22,6,21,11,0,K,1,0,11,0,0,16,1,0,21,0,0,0
77289,11687,2020-11-18T16:22:11.7428744Z,2020,21,20,17,4,0,Sin Grado,1,0,17,0,0,1,4,0,20,0,0,0
77289,35701,2021-06-24T13:18:47.7216771Z,2021,21,6,20,11,0,1ro,3,0,10,0,0,15,1,0,18,0,0,0
77289,35702,2021-06-24T13:18:47.7216771Z,2021,20,4,20,10,0,2do,1,0,10,0,0,16,0,0,19,0,0,0
77289,35703,2021-06-24T13:18:47.7226758Z,2021,16,5,16,7,0,3ro,5,0,9,0,0,11,0,0,11,0,0,0
77289,35704,2021-06-24T13:18:47.7226758Z,2021,26,9,25,15,0,4to,2,0,11,0,0,17,1,0,24,0,0,0
77289,35705,2021-06-24T13:18:47.7226758Z,2021,27,9,27,13,0,5to,2,0,14,0,0,18,0,0,25,0,0,0
77289,35706,2021-06-24T13:18:47.7236772Z,2021,35,10,34,14,0,6to,4,0,21,0,0,25,1,0,31,0,0,0
77289,35707,2021-06-24T13:18:47.7236772Z,2021,28,9,26,12,0,7mo,3,0,16,0,0,19,2,0,25,0,0,0
77289,35708,2021-06-24T13:18:47.7236772Z,2021,12,5,9,6,0,8vo,2,0,6,0,0,7,3,0,10,0,0,0
77289,35709,2021-06-24T13:18:47.7246768Z,2021,20,5,15,10,0,K,1,0,10,0,0,15,5,0,19,0,0,0
77289,35710,2021-06-24T13:18:47.7246768Z,2021,15,15,12,3,0,Sin Grado,0,0,12,0,0,0,3,0,14,0,0,1
77289,5671,2020-11-18T16:21:16.62812Z,2019,17,3,17,7,0,1ro,2,0,10,0,0,14,0,0,15,0,0,0
77289,5672,2020-11-18T16:21:16.6291227Z,2019,27,10,24,13,0,2do,2,0,14,0,0,17,3,0,25,0,0,0
77289,5673,2020-11-18T16:21:16.6291227Z,2019,26,6,25,14,0,3ro,4,0,12,0,0,20,1,0,22,0,0,0
77289,5674,2020-11-18T16:21:16.6291227Z,2019,30,9,29,12,0,4to,2,0,18,0,0,21,1,0,28,0,0,0
77289,5675,2020-11-18T16:21:16.6291227Z,2019,22,5,20,11,0,5to,2,0,11,0,0,17,2,0,20,0,0,0
77289,5676,2020-11-18T16:21:16.6301222Z,2019,16,4,13,11,0,6to,4,0,5,0,0,12,3,0,12,0,0,0
77289,5677,2020-11-18T16:21:16.6301222Z,2019,26,7,25,11,0,7mo,4,1,15,0,0,19,1,0,22,0,0,0
77289,5678,2020-11-18T16:21:16.6301222Z,2019,30,10,26,16,0,8vo,2,0,14,0,0,20,4,0,28,0,0,0
77289,5679,2020-11-18T16:21:16.6301222Z,2019,27,7,27,15,0,K,0,0,12,0,0,20,0,0,27,0,0,0
77289,5680,2020-11-18T16:21:16.6311218Z,2019,18,18,13,3,0,Sin Grado,2,0,15,0,0,0,5,0,16,0,0,0
12369,30342,2021-06-24T13:18:08.8357857Z,2021,34,17,31,17,0,1ro,3,6,17,0,0,17,3,0,31,0,0,0
12369,30343,2021-06-24T13:18:08.8367862Z,2021,41,15,38,17,0,2do,0,5,24,0,0,26,3,0,41,0,0,0
12369,30344,2021-06-24T13:18:08.8367862Z,2021,40,16,35,15,0,3ro,1,10,25,0,0,24,5,0,39,0,0,0
12369,30345,2021-06-24T13:18:08.8367862Z,2021,44,17,39,23,0,4to,0,9,21,0,0,27,5,0,44,0,0,0
12369,30346,2021-06-24T13:18:08.8367862Z,2021,50,10,45,25,0,5to,1,3,25,0,0,40,5,0,49,1,1,0
12369,30347,2021-06-24T13:18:08.8367862Z,2021,42,10,38,23,0,K,1,1,19,0,0,32,4,0,41,0,0,0
12369,30348,2021-06-24T13:18:08.8377876Z,2021,36,35,35,8,0,Sin Grado,0,0,28,0,0,1,1,0,36,0,0,0
12369,344,2020-11-18T16:20:39.6384547Z,2019,51,21,47,21,0,1ro,2,0,30,0,0,30,4,0,49,0,0,0
12369,345,2020-11-18T16:20:39.6384547Z,2019,46,15,42,23,0,2do,0,0,23,0,0,31,4,0,46,0,0,0
12369,346,2020-11-18T16:20:39.6384547Z,2019,56,18,47,28,0,3ro,0,0,28,0,0,38,9,0,56,1,1,0
12369,347,2020-11-18T16:20:39.6394547Z,2019,39,13,37,19,0,4to,0,0,20,0,0,26,2,0,39,0,0,0
12369,348,2020-11-18T16:20:39.6394547Z,2019,55,20,51,27,0,5to,2,0,28,0,0,35,4,0,53,0,0,0
12369,349,2020-11-18T16:20:39.6394547Z,2019,38,13,36,16,0,K,0,0,22,0,0,25,2,0,38,0,0,0
12369,350,2020-11-18T16:20:39.6394547Z,2019,50,46,46,8,0,Sin Grado,0,0,42,0,0,4,4,0,50,0,0,0
12369,6345,2020-11-18T16:21:39.244202Z,2020,44,16,42,20,0,1ro,1,5,24,0,0,28,2,0,43,0,0,0
12369,6346,2020-11-18T16:21:39.244202Z,2020,45,17,41,18,0,2do,1,6,27,0,0,28,4,0,44,0,0,0
12369,6347,2020-11-18T16:21:39.2452029Z,2020,48,18,44,24,0,3ro,0,8,24,0,0,30,4,0,48,0,0,0
12369,6348,2020-11-18T16:21:39.2452029Z,2020,52,14,41,25,0,4to,0,4,27,0,0,38,11,0,52,1,1,0
12369,6349,2020-11-18T16:21:39.2452029Z,2020,41,13,39,19,0,5to,0,4,22,0,0,28,2,0,41,0,0,0
12369,6350,2020-11-18T16:21:39.2452029Z,2020,36,14,31,18,0,K,3,9,18,0,0,22,5,0,33,0,0,0
12369,6351,2020-11-18T16:21:39.2462033Z,2020,47,47,43,10,0,Sin Grado,0,3,37,0,0,0,4,0,47,0,0,0
71720,11409,2020-11-18T16:22:10.5640861Z,2020,28,12,27,17,0,1ro,0,0,11,0,0,16,1,0,28,0,0,0
71720,11410,2020-11-18T16:22:10.5640861Z,2020,23,7,22,8,0,2do,0,0,15,0,0,16,1,0,23,0,0,0
71720,11411,2020-11-18T16:22:10.5640861Z,2020,20,6,18,12,0,3ro,0,0,8,0,0,14,2,0,20,0,0,0
71720,11412,2020-11-18T16:22:10.5650875Z,2020,24,12,23,13,0,4to,0,0,11,0,0,12,1,0,24,0,0,0
71720,11413,2020-11-18T16:22:10.5650875Z,2020,26,8,22,16,0,5to,1,0,10,0,0,18,4,1,24,1,0,0
71720,11414,2020-11-18T16:22:10.5650875Z,2020,23,8,20,12,0,K,1,0,11,0,0,15,3,1,21,0,0,0
71720,11415,2020-11-18T16:22:10.5650875Z,2020,53,53,48,11,0,Sin Grado,2,1,42,0,0,0,5,0,51,0,0,0
71720,35431,2021-06-24T13:18:46.2175961Z,2021,21,7,21,9,0,1ro,0,0,12,0,0,14,0,0,21,0,0,0
71720,35432,2021-06-24T13:18:46.2175961Z,2021,26,11,25,16,0,2do,0,0,10,0,0,15,1,0,26,0,0,0
71720,35433,2021-06-24T13:18:46.2175961Z,2021,20,9,18,8,0,3ro,2,0,12,0,0,11,2,0,18,0,0,0
71720,35434,2021-06-24T13:18:46.2175961Z,2021,17,6,17,9,0,4to,0,0,8,0,0,11,0,0,17,0,0,0
71720,35435,2021-06-24T13:18:46.2175961Z,2021,24,15,23,11,0,5to,0,0,13,0,0,9,1,0,24,0,0,0
71720,35436,2021-06-24T13:18:46.2185975Z,2021,22,7,19,11,0,K,0,1,11,0,0,15,3,0,22,0,0,0
71720,35437,2021-06-24T13:18:46.2185975Z,2021,43,42,38,11,0,Sin Grado,1,0,32,0,0,1,5,0,42,0,1,0
71720,5401,2020-11-18T16:21:15.4683455Z,2019,26,9,24,10,0,1ro,0,0,16,0,0,17,2,0,26,0,0,0
71720,5402,2020-11-18T16:21:15.4683455Z,2019,22,7,21,10,0,2do,0,0,12,0,0,15,1,0,22,0,0,0
71720,5403,2020-11-18T16:21:15.4693451Z,2019,31,15,30,15,0,3ro,0,0,16,0,0,16,1,0,31,0,0,0
71720,5404,2020-11-18T16:21:15.4693451Z,2019,16,5,14,10,0,4to,0,0,6,0,0,11,2,1,15,1,0,0
71720,5405,2020-11-18T16:21:15.4693451Z,2019,28,11,26,15,0,5to,3,0,13,0,0,17,2,0,25,0,0,0
71720,5406,2020-11-18T16:21:15.4693451Z,2019,24,10,22,18,0,K,0,0,6,0,0,14,2,0,24,0,0,0
71720,5407,2020-11-18T16:21:15.470346Z,2019,54,51,47,15,0,Sin Grado,2,0,39,0,0,3,7,0,52,0,0,0
50120,3222,2020-11-18T16:21:01.4459966Z,2019,81,31,63,37,0,1ro,1,0,44,0,0,50,18,0,80,0,0,0
50120,3223,2020-11-18T16:21:01.446997Z,2019,68,24,51,41,0,2do,6,1,27,0,0,44,17,0,62,1,0,0
50120,3224,2020-11-18T16:21:01.446997Z,2019,69,17,51,31,0,3ro,2,0,38,0,1,52,18,0,67,0,0,0
50120,3225,2020-11-18T16:21:01.446997Z,2019,86,36,68,45,0,4to,0,3,41,0,0,50,18,0,86,1,0,0
50120,3226,2020-11-18T16:21:01.446997Z,2019,97,40,80,46,0,5to,2,1,51,0,0,57,17,0,95,0,0,0
50120,3227,2020-11-18T16:21:01.446997Z,2019,4,1,2,3,0,6to,0,0,1,0,0,3,2,0,4,0,0,0
50120,3228,2020-11-18T16:21:01.4479975Z,2019,50,11,42,28,0,K,1,0,22,0,0,39,8,0,49,0,0,0
50120,3229,2020-11-18T16:21:01.4479975Z,2019,49,10,39,25,0,PK,0,0,24,0,0,39,10,0,49,0,0,0
50120,3230,2020-11-18T16:21:01.4479975Z,2019,29,29,24,6,0,Sin Grado,1,1,23,0,0,0,5,0,28,0,0,0
50120,33247,2021-06-24T13:18:30.8846015Z,2021,56,10,45,30,0,1ro,0,7,26,0,0,46,11,0,56,0,0,0
50120,33248,2021-06-24T13:18:30.8846015Z,2021,54,23,47,22,0,2do,0,3,32,0,0,31,7,0,54,0,0,0
50120,33249,2021-06-24T13:18:30.8856033Z,2021,69,26,52,37,0,3ro,1,2,32,0,0,43,17,0,68,0,0,0
50120,33250,2021-06-24T13:18:30.8856033Z,2021,56,20,45,25,0,4to,4,3,31,0,0,36,11,0,52,1,0,0
50120,33251,2021-06-24T13:18:30.8856033Z,2021,56,14,39,32,0,5to,2,2,24,0,0,42,17,0,54,0,0,0
50120,33252,2021-06-24T13:18:30.8866034Z,2021,20,6,14,9,0,6to,1,0,11,0,0,14,6,0,19,0,0,0
50120,33253,2021-06-24T13:18:30.8866034Z,2021,15,4,9,8,0,7mo,1,0,7,0,0,11,6,0,14,0,0,0
50120,33254,2021-06-24T13:18:30.8876066Z,2021,5,2,4,4,0,8vo,0,0,1,0,0,3,1,0,5,0,0,0
50120,33255,2021-06-24T13:18:30.8876066Z,2021,10,1,8,8,0,9no,0,0,2,0,0,9,2,0,10,0,0,0
50120,33256,2021-06-24T13:18:30.8876066Z,2021,54,9,43,23,0,K,0,1,31,0,0,45,11,0,54,0,0,0
50120,33257,2021-06-24T13:18:30.8886057Z,2021,34,6,26,17,0,PK,0,1,17,0,0,28,8,0,34,0,0,0
50120,33258,2021-06-24T13:18:30.8886057Z,2021,27,27,26,7,0,Sin Grado,0,2,20,0,0,0,1,0,27,0,0,0
50120,9242,2020-11-18T16:21:57.3262585Z,2020,68,25,55,32,0,1ro,1,8,36,0,0,43,13,0,67,0,0,0
50120,9243,2020-11-18T16:21:57.3262585Z,2020,76,25,53,42,0,2do,1,2,34,0,0,51,23,0,75,0,0,0
50120,9244,2020-11-18T16:21:57.3272594Z,2020,58,19,43,32,0,3ro,4,4,26,0,0,39,15,0,54,1,0,0
50120,9245,2020-11-18T16:21:57.3272594Z,2020,63,16,45,30,0,4to,2,5,33,0,0,47,18,0,61,0,0,0
50120,9246,2020-11-18T16:21:57.3272594Z,2020,87,36,66,46,0,5to,1,4,41,0,0,51,21,0,86,1,0,0
50120,9247,2020-11-18T16:21:57.3272594Z,2020,12,3,8,6,0,6to,1,0,6,0,0,9,4,0,11,0,0,0
50120,9248,2020-11-18T16:21:57.3282598Z,2020,8,3,4,6,0,7mo,0,0,2,0,0,5,4,0,8,0,0,0
50120,9249,2020-11-18T16:21:57.3282598Z,2020,11,2,8,8,0,8vo,0,0,3,0,0,9,3,0,11,0,0,0
50120,9250,2020-11-18T16:21:57.3282598Z,2020,55,11,47,28,0,K,0,7,27,0,0,44,8,0,55,0,0,0
50120,9251,2020-11-18T16:21:57.3282598Z,2020,33,4,27,16,0,PK,0,2,17,0,0,29,6,0,33,0,0,0
50120,9252,2020-11-18T16:21:57.3292603Z,2020,29,29,22,6,0,Sin Grado,0,2,23,0,0,0,7,0,29,0,0,0
18176,30802,2021-06-24T13:18:11.4396528Z,2021,44,13,38,25,0,1ro,0,0,19,0,0,31,6,0,44,0,0,0
18176,30803,2021-06-24T13:18:11.4406528Z,2021,45,14,34,29,0,2do,1,2,16,0,0,31,11,0,44,0,0,0
18176,30804,2021-06-24T13:18:11.4406528Z,2021,39,12,28,16,0,3ro,0,1,23,0,0,27,11,0,39,0,0,0
18176,30805,2021-06-24T13:18:11.4406528Z,2021,46,21,38,22,0,4to,0,0,24,0,0,25,8,0,45,0,0,1
18176,30806,2021-06-24T13:18:11.4406528Z,2021,61,29,47,30,0,5to,1,0,31,0,0,32,14,0,60,0,0,0
18176,30807,2021-06-24T13:18:11.4416538Z,2021,42,9,22,17,0,K,6,0,25,0,0,33,20,0,35,0,0,1
18176,30808,2021-06-24T13:18:11.4416538Z,2021,14,5,10,7,0,PK,0,0,7,0,0,9,4,0,14,0,0,0
18176,30809,2021-06-24T13:18:11.4416538Z,2021,18,18,13,3,0,Sin Grado,1,0,15,0,0,0,5,0,17,0,0,0
18176,6805,2020-11-18T16:21:42.0330585Z,2020,55,15,49,33,0,1ro,1,0,22,0,0,40,6,0,54,0,0,0
18176,6806,2020-11-18T16:21:42.0330585Z,2020,46,12,39,21,0,2do,0,0,25,0,0,34,7,0,46,0,0,0
18176,6807,2020-11-18T16:21:42.0330585Z,2020,47,19,39,21,0,3ro,0,0,26,0,0,28,8,0,46,0,0,1
18176,6808,2020-11-18T16:21:42.0340603Z,2020,61,27,53,30,0,4to,1,0,31,0,0,34,8,0,60,0,0,0
18176,6809,2020-11-18T16:21:42.0340603Z,2020,49,17,39,28,0,5to,0,0,21,0,0,32,10,0,49,0,0,0
18176,6810,2020-11-18T16:21:42.0340603Z,2020,45,12,40,26,0,K,1,0,19,0,0,33,5,0,44,0,0,0
18176,6811,2020-11-18T16:21:42.0340603Z,2020,16,3,15,7,0,PK,1,0,9,0,0,13,1,0,15,0,0,0
18176,6812,2020-11-18T16:21:42.0340603Z,2020,21,21,17,6,0,Sin Grado,0,0,15,0,0,0,4,0,21,0,0,0
18176,804,2020-11-18T16:20:42.6374515Z,2019,49,19,40,20,0,1ro,0,1,29,0,0,30,9,0,49,0,0,0
18176,805,2020-11-18T16:20:42.6374515Z,2019,54,22,41,23,0,2do,0,0,31,0,0,32,13,0,53,0,0,1
18176,806,2020-11-18T16:20:42.6384519Z,2019,55,23,44,26,0,3ro,0,0,29,0,0,32,11,0,55,0,0,0
18176,807,2020-11-18T16:20:42.6384519Z,2019,57,23,48,30,0,4to,0,0,27,0,0,34,9,0,57,0,0,0
18176,808,2020-11-18T16:20:42.6384519Z,2019,49,16,43,34,0,5to,1,0,15,0,0,33,6,0,48,0,0,0
18176,809,2020-11-18T16:20:42.6384519Z,2019,47,9,36,36,0,K,0,0,11,0,0,38,11,0,47,0,0,0
18176,810,2020-11-18T16:20:42.6384519Z,2019,15,2,10,11,0,PK,0,0,4,0,0,13,5,0,15,0,0,0
18176,811,2020-11-18T16:20:42.639455Z,2019,26,25,24,4,0,Sin Grado,0,0,22,0,0,1,2,0,26,0,0,0
71795,11443,2020-11-18T16:22:10.5710919Z,2020,30,7,25,20,0,1ro,0,0,10,0,0,23,5,0,30,0,0,0
71795,11444,2020-11-18T16:22:10.5710919Z,2020,33,14,27,14,0,2do,0,0,19,0,0,19,6,0,33,0,0,0
71795,11445,2020-11-18T16:22:10.5710919Z,2020,25,13,18,10,0,3ro,2,0,15,0,0,12,7,0,23,0,0,0
71795,11446,2020-11-18T16:22:10.5710919Z,2020,29,15,23,11,0,4to,1,0,18,0,0,14,6,0,28,0,0,0
71795,11447,2020-11-18T16:22:10.5720919Z,2020,29,14,24,19,0,5to,0,0,10,0,0,15,5,0,29,0,0,0
71795,11448,2020-11-18T16:22:10.5720919Z,2020,22,7,20,8,0,K,0,0,14,0,0,15,2,0,22,0,0,0
71795,35464,2021-06-24T13:18:46.2436161Z,2021,26,11,23,8,0,1ro,1,0,18,0,0,15,3,0,25,0,0,0
71795,35465,2021-06-24T13:18:46.2436161Z,2021,29,10,25,18,0,2do,0,0,11,0,0,19,4,0,29,0,0,0
71795,35466,2021-06-24T13:18:46.2446171Z,2021,34,14,28,14,0,3ro,0,0,20,0,0,20,6,0,34,0,0,0
71795,35467,2021-06-24T13:18:46.2446171Z,2021,30,16,25,14,0,4to,2,0,16,0,0,14,5,0,28,0,0,0
71795,35468,2021-06-24T13:18:46.2446171Z,2021,28,14,21,11,0,5to,2,0,17,0,0,14,7,0,26,0,0,0
71795,35469,2021-06-24T13:18:46.2456171Z,2021,17,5,15,10,0,K,0,0,7,0,0,12,2,0,17,0,0,0
71795,5434,2020-11-18T16:21:15.4813531Z,2019,35,14,28,17,0,1ro,0,0,18,0,0,21,7,0,35,0,0,0
71795,5435,2020-11-18T16:21:15.4813531Z,2019,31,14,24,14,0,2do,3,0,17,0,0,17,7,0,28,0,0,0
71795,5436,2020-11-18T16:21:15.4813531Z,2019,32,17,26,13,0,3ro,1,0,19,0,0,15,6,0,31,0,0,0
71795,5437,2020-11-18T16:21:15.482354Z,2019,30,13,23,20,0,4to,0,0,10,0,0,17,7,0,30,0,0,0
71795,5438,2020-11-18T16:21:15.482354Z,2019,26,6,18,13,0,5to,0,0,13,0,0,20,8,0,26,0,0,0
71795,5439,2020-11-18T16:21:15.482354Z,2019,36,8,31,23,0,K,0,0,13,0,0,28,5,0,36,0,0,0
25601,1524,2020-11-18T16:20:47.6367921Z,2019,89,27,57,42,0,10mo,0,0,47,0,0,62,32,2,87,0,0,0
25601,1525,2020-11-18T16:20:47.6377921Z,2019,101,31,64,50,0,11mo,0,0,51,0,0,70,37,0,101,0,0,0
25601,1526,2020-11-18T16:20:47.6377921Z,2019,112,1,81,55,0,12mo,2,0,57,0,0,111,31,0,110,0,0,0
25601,1527,2020-11-18T16:20:47.6377921Z,2019,78,31,56,42,0,9no,1,0,36,0,0,47,22,0,77,0,0,0
25601,1528,2020-11-18T16:20:47.6387925Z,2019,5,4,4,1,0,Sin Grado,0,0,4,0,0,1,1,0,5,0,0,0
25601,31526,2021-06-24T13:18:15.8097858Z,2021,88,24,57,35,0,10mo,0,0,53,0,0,64,31,0,87,0,0,1
25601,31527,2021-06-24T13:18:15.8107867Z,2021,87,30,59,48,0,11mo,2,0,39,0,0,57,28,0,85,0,0,0
25601,31528,2021-06-24T13:18:15.8107867Z,2021,86,23,52,50,0,12mo,3,0,36,0,0,63,34,1,82,0,0,0
25601,31529,2021-06-24T13:18:15.8107867Z,2021,76,25,55,35,0,9no,0,0,41,0,0,51,21,0,76,0,0,0
25601,31530,2021-06-24T13:18:15.8107867Z,2021,5,5,3,2,0,Sin Grado,0,0,3,0,0,0,2,0,5,0,0,0
25601,7529,2020-11-18T16:21:46.3679503Z,2020,88,28,66,44,0,10mo,2,1,44,0,0,60,22,0,86,0,0,0
25601,7530,2020-11-18T16:21:46.3689507Z,2020,103,28,65,51,0,11mo,1,0,52,0,0,75,38,1,101,0,0,0
25601,7531,2020-11-18T16:21:46.3689507Z,2020,110,32,70,51,0,12mo,0,0,59,0,0,78,40,0,110,0,0,0
25601,7532,2020-11-18T16:21:46.3689507Z,2020,75,18,56,30,0,9no,0,1,45,0,0,57,19,0,74,0,0,1
25601,7533,2020-11-18T16:21:46.3689507Z,2020,5,5,5,2,0,Sin Grado,0,0,3,0,0,0,0,0,5,0,0,0
45955,3028,2020-11-18T16:21:00.3312524Z,2019,45,16,38,23,0,1ro,0,0,22,0,0,29,7,0,45,0,0,0
45955,3029,2020-11-18T16:21:00.3312524Z,2019,48,21,45,25,0,2do,0,1,23,0,0,27,3,0,48,0,1,0
45955,3030,2020-11-18T16:21:00.3322528Z,2019,45,22,36,15,0,3ro,2,0,30,0,0,23,9,0,43,0,1,0
45955,3031,2020-11-18T16:21:00.3322528Z,2019,55,23,52,31,0,4to,1,0,24,0,0,32,3,0,54,0,1,0
45955,3032,2020-11-18T16:21:00.3322528Z,2019,65,21,58,36,0,5to,0,0,29,0,0,44,7,0,65,0,0,0
45955,3033,2020-11-18T16:21:00.3332542Z,2019,118,35,106,54,0,6to,4,0,64,0,0,83,12,0,114,0,1,0
45955,3034,2020-11-18T16:21:00.3332542Z,2019,141,57,111,72,0,7mo,1,0,69,0,0,84,30,0,140,0,0,0
45955,3035,2020-11-18T16:21:00.3332542Z,2019,121,39,110,63,0,8vo,2,0,58,0,0,82,11,0,119,0,0,0
45955,3036,2020-11-18T16:21:00.3342537Z,2019,30,9,27,19,0,K,0,0,11,0,0,21,3,0,30,0,0,0
45955,3037,2020-11-18T16:21:00.3342537Z,2019,6,6,5,0,0,Sin Grado,0,0,6,0,0,0,1,0,6,0,0,0
45955,33038,2021-06-24T13:18:29.8238413Z,2021,35,10,33,17,0,1ro,1,0,18,0,0,25,2,0,34,0,0,0
45955,33039,2021-06-24T13:18:29.8238413Z,2021,32,7,28,13,0,2do,0,0,19,0,0,25,4,0,32,0,0,0
45955,33040,2021-06-24T13:18:29.8238413Z,2021,48,23,44,24,0,3ro,0,0,24,0,0,25,4,0,48,0,0,0
45955,33041,2021-06-24T13:18:29.8248418Z,2021,48,14,43,26,0,4to,0,0,22,0,0,34,5,0,48,0,0,0
45955,33042,2021-06-24T13:18:29.8248418Z,2021,56,28,49,21,0,5to,2,0,35,0,0,28,7,0,54,0,2,0
45955,33043,2021-06-24T13:18:29.8248418Z,2021,114,38,98,48,0,6to,1,0,66,0,0,76,16,0,113,0,0,0
45955,33044,2021-06-24T13:18:29.8258423Z,2021,121,37,105,66,0,7mo,3,0,55,0,0,84,16,0,118,0,0,0
45955,33045,2021-06-24T13:18:29.8258423Z,2021,114,36,100,46,0,8vo,3,0,68,0,0,78,14,0,111,0,1,0
45955,33046,2021-06-24T13:18:29.8258423Z,2021,25,7,17,13,0,K,0,0,12,0,0,18,8,0,25,0,0,0
45955,33047,2021-06-24T13:18:29.8268433Z,2021,11,11,8,5,0,Sin Grado,0,0,6,0,0,0,3,0,11,0,0,0
45955,9042,2020-11-18T16:21:55.4329974Z,2020,34,7,32,16,0,1ro,0,0,18,0,0,27,2,0,34,0,0,0
45955,9043,2020-11-18T16:21:55.4339997Z,2020,47,20,43,20,0,2do,0,0,27,0,0,27,4,0,47,0,0,0
45955,9044,2020-11-18T16:21:55.4339997Z,2020,45,15,39,25,0,3ro,0,1,20,0,0,30,6,0,45,0,0,0
45955,9045,2020-11-18T16:21:55.4339997Z,2020,50,24,41,19,0,4to,2,1,31,0,0,26,9,0,48,0,2,0
45955,9046,2020-11-18T16:21:55.4349997Z,2020,62,24,57,33,0,5to,1,0,29,0,0,38,5,0,61,0,0,0
45955,9047,2020-11-18T16:21:55.4349997Z,2020,121,41,105,67,0,6to,3,0,54,0,0,80,16,0,118,0,0,0
45955,9048,2020-11-18T16:21:55.4349997Z,2020,116,40,99,46,0,7mo,3,0,70,0,0,76,17,0,113,0,1,0
45955,9049,2020-11-18T16:21:55.4360001Z,2020,135,51,115,67,0,8vo,2,0,68,0,0,84,20,0,133,0,0,0
45955,9050,2020-11-18T16:21:55.4360001Z,2020,35,9,30,17,0,K,0,0,18,0,0,26,5,0,35,0,0,0
45955,9051,2020-11-18T16:21:55.4360001Z,2020,8,8,6,4,0,Sin Grado,0,0,4,0,0,0,2,0,8,0,0,0
50690,3296,2020-11-18T16:21:01.46701Z,2019,27,5,17,13,0,1ro,1,0,14,0,0,22,10,0,26,0,0,0
50690,3297,2020-11-18T16:21:01.46701Z,2019,27,11,21,11,0,2do,0,2,16,0,0,16,6,0,27,0,1,0
50690,3298,2020-11-18T16:21:01.46701Z,2019,35,11,29,15,0,3ro,1,3,20,0,0,24,6,0,34,1,1,0
50690,3299,2020-11-18T16:21:01.46701Z,2019,18,5,13,11,0,4to,0,3,7,0,0,13,5,0,18,0,0,0
50690,3300,2020-11-18T16:21:01.46701Z,2019,23,6,19,7,0,5to,0,2,16,0,0,17,4,0,23,0,0,0
50690,3301,2020-11-18T16:21:02.1244494Z,2019,19,3,15,11,0,K,0,1,8,0,0,16,4,0,19,1,0,0
50690,3302,2020-11-18T16:21:02.1244494Z,2019,16,3,14,9,0,PK,0,1,7,0,0,13,2,0,16,0,0,0
50690,33322,2021-06-24T13:18:31.5550823Z,2021,19,4,17,9,0,1ro,0,2,10,0,0,15,2,0,19,0,0,0
50690,33323,2021-06-24T13:18:31.5550823Z,2021,18,5,16,8,0,2do,0,0,10,0,0,13,2,0,18,1,0,0
50690,33324,2021-06-24T13:18:31.5560832Z,2021,19,3,14,11,0,3ro,0,2,8,0,0,16,5,0,19,0,0,0
50690,33325,2021-06-24T13:18:31.5560832Z,2021,21,10,18,8,0,4to,0,3,13,0,0,11,3,0,21,0,1,0
50690,33326,2021-06-24T13:18:31.5560832Z,2021,25,9,21,11,0,5to,0,1,14,0,0,16,4,0,25,1,1,0
50690,33327,2021-06-24T13:18:31.5560832Z,2021,18,2,12,10,0,K,0,1,8,0,0,16,6,0,18,0,0,0
50690,33328,2021-06-24T13:18:31.5570837Z,2021,8,1,7,7,0,PK,0,0,1,0,0,7,1,0,8,0,0,0
50690,9316,2020-11-18T16:21:57.9917007Z,2020,21,5,19,9,0,1ro,0,5,12,0,0,16,2,0,21,1,0,0
50690,9317,2020-11-18T16:21:57.9917007Z,2020,25,5,16,14,0,2do,0,2,11,0,0,20,9,0,25,0,0,0
50690,9318,2020-11-18T16:21:57.9917007Z,2020,24,10,20,9,0,3ro,0,5,15,0,0,14,4,0,24,0,1,0
50690,9319,2020-11-18T16:21:57.992702Z,2020,29,10,23,11,0,4to,0,4,18,0,0,19,6,0,29,1,1,0
50690,9320,2020-11-18T16:21:57.992702Z,2020,16,4,11,9,0,5to,0,2,7,0,0,12,5,0,16,0,0,0
50690,9321,2020-11-18T16:21:57.992702Z,2020,23,4,20,10,0,K,0,1,13,0,0,19,3,0,23,0,0,0
50690,9322,2020-11-18T16:21:57.9937024Z,2020,15,1,8,8,0,PK,0,0,7,0,0,14,7,0,14,0,0,1
57703,33983,2021-06-24T13:18:36.6867624Z,2021,93,29,74,49,0,10mo,0,0,44,0,0,64,19,1,92,0,1,0
57703,33984,2021-06-24T13:18:36.6867624Z,2021,73,22,53,34,0,11mo,0,0,39,0,0,51,20,0,73,0,1,0
57703,33985,2021-06-24T13:18:36.6867624Z,2021,87,20,68,53,0,12mo,0,0,34,0,0,67,19,1,86,0,0,0
57703,33986,2021-06-24T13:18:36.6877634Z,2021,70,24,58,34,0,9no,1,0,36,0,0,46,12,0,69,0,0,0
57703,33987,2021-06-24T13:18:36.6877634Z,2021,11,11,9,1,0,Sin Grado,0,0,10,0,0,0,2,0,11,0,0,0
57703,3959,2020-11-18T16:21:06.8846231Z,2019,101,24,83,56,0,10mo,0,2,45,0,0,77,18,0,101,0,0,0
57703,3960,2020-11-18T16:21:06.8856236Z,2019,92,18,77,47,0,11mo,0,2,45,0,0,74,15,0,92,0,2,0
57703,3961,2020-11-18T16:21:06.8856236Z,2019,106,0,82,50,0,12mo,0,6,56,0,0,106,24,0,106,0,0,0
57703,3962,2020-11-18T16:21:06.8856236Z,2019,91,27,73,47,0,9no,0,1,44,0,0,64,18,0,91,0,1,0
57703,3963,2020-11-18T16:21:06.886624Z,2019,8,7,7,0,0,Sin Grado,0,1,8,0,0,1,1,0,8,0,0,0
57703,9976,2020-11-18T16:22:01.5560817Z,2020,80,24,61,34,0,10mo,0,0,46,0,0,56,19,0,80,0,1,0
57703,9977,2020-11-18T16:22:01.5560817Z,2020,89,23,65,53,0,11mo,0,0,36,0,0,66,24,0,89,0,0,0
57703,9978,2020-11-18T16:22:01.5560817Z,2020,82,17,65,45,0,12mo,1,0,37,0,0,65,17,0,81,0,1,0
57703,9979,2020-11-18T16:22:01.5570826Z,2020,97,35,79,51,0,9no,0,0,46,0,0,62,18,0,97,0,1,0
57703,9980,2020-11-18T16:22:01.5570826Z,2020,8,8,7,0,0,Sin Grado,0,0,8,0,0,0,1,0,8,0,0,0
53603,33724,2021-06-24T13:18:35.23272Z,2021,74,29,59,36,0,6to,1,1,38,0,0,45,15,0,73,0,0,0
53603,33725,2021-06-24T13:18:35.2337201Z,2021,69,22,57,34,0,7mo,0,0,35,0,0,47,12,0,69,0,0,0
53603,33726,2021-06-24T13:18:35.2337201Z,2021,79,25,67,39,0,8vo,0,0,40,0,0,54,12,0,79,1,0,0
53603,3700,2020-11-18T16:21:04.3369245Z,2019,87,27,70,41,0,6to,0,0,46,0,1,60,17,0,87,1,0,0
53603,3701,2020-11-18T16:21:05.0984297Z,2019,99,32,80,46,0,7mo,0,0,53,0,0,67,19,0,99,4,0,0
53603,3702,2020-11-18T16:21:05.0984297Z,2019,106,28,77,39,0,8vo,0,1,67,0,1,78,29,0,106,2,3,0
53603,9718,2020-11-18T16:22:00.1071146Z,2020,77,24,63,40,0,6to,0,0,37,0,0,53,14,0,77,0,0,0
53603,9719,2020-11-18T16:22:00.1081155Z,2020,97,30,78,47,0,7mo,0,0,50,0,0,67,19,0,97,1,0,0
53603,9720,2020-11-18T16:22:00.1081155Z,2020,93,28,71,45,0,8vo,0,0,48,0,0,65,22,0,93,3,0,0
21188,1170,2020-11-18T16:20:44.6437907Z,2019,81,33,64,35,0,1ro,0,1,46,0,1,48,17,0,81,0,0,0
21188,1171,2020-11-18T16:20:44.6437907Z,2019,67,27,56,37,0,2do,0,2,30,0,0,40,11,0,67,0,0,0
21188,1172,2020-11-18T16:20:44.6437907Z,2019,63,22,53,27,0,3ro,0,0,36,0,0,41,10,0,63,0,0,0
21188,1173,2020-11-18T16:20:44.6437907Z,2019,66,37,55,32,0,4to,0,0,34,0,0,29,11,0,66,0,0,0
21188,1174,2020-11-18T16:20:44.6437907Z,2019,62,24,54,35,0,5to,1,1,27,0,1,38,8,0,61,0,0,0
21188,1175,2020-11-18T16:20:44.644792Z,2019,9,8,7,5,0,6to,0,0,4,0,0,1,2,0,9,0,0,0
21188,1176,2020-11-18T16:20:44.644792Z,2019,50,8,34,27,0,K,0,1,23,0,0,42,16,0,50,0,0,0
21188,1177,2020-11-18T16:20:44.644792Z,2019,45,9,29,26,0,PK,0,0,19,0,0,36,16,0,45,0,0,0
21188,1178,2020-11-18T16:20:44.644792Z,2019,10,10,10,2,0,Sin Grado,0,0,8,0,0,0,0,0,10,0,0,0
21188,31171,2021-06-24T13:18:13.1128521Z,2021,48,16,41,25,0,1ro,0,0,23,0,0,32,7,0,48,0,0,0
21188,31172,2021-06-24T13:18:13.1128521Z,2021,55,19,45,28,0,2do,0,1,27,0,0,36,10,0,55,0,0,0
21188,31173,2021-06-24T13:18:13.1128521Z,2021,64,25,55,31,0,3ro,0,0,33,0,0,39,9,0,64,0,0,0
21188,31174,2021-06-24T13:18:13.1128521Z,2021,46,20,41,28,0,4to,0,2,18,0,0,26,5,0,46,0,0,0
21188,31175,2021-06-24T13:18:13.113854Z,2021,53,20,47,22,0,5to,0,0,31,0,0,33,6,0,53,0,0,0
21188,31176,2021-06-24T13:18:13.113854Z,2021,15,8,13,7,0,6to,0,0,8,0,0,7,2,0,15,0,0,0
21188,31177,2021-06-24T13:18:13.113854Z,2021,58,13,49,29,0,K,0,1,29,0,0,45,9,0,58,0,0,0
21188,31178,2021-06-24T13:18:13.114854Z,2021,19,1,11,14,0,PK,1,0,5,0,0,18,8,0,18,0,0,0
21188,31179,2021-06-24T13:18:13.114854Z,2021,11,11,9,3,0,Sin Grado,0,0,8,0,0,0,2,0,11,0,0,0
21188,7175,2020-11-18T16:21:44.2105135Z,2020,55,17,42,27,0,1ro,0,0,28,0,0,38,13,0,55,0,0,0
21188,7176,2020-11-18T16:21:44.2105135Z,2020,69,31,57,31,0,2do,0,0,38,0,0,38,12,0,69,0,0,0
21188,7177,2020-11-18T16:21:44.2105135Z,2020,59,21,50,34,0,3ro,0,2,25,0,0,38,9,0,59,0,0,0
21188,7178,2020-11-18T16:21:44.2105135Z,2020,62,20,52,27,0,4to,0,1,35,0,0,42,10,0,62,0,0,0
21188,7179,2020-11-18T16:21:44.2105135Z,2020,66,33,54,30,0,5to,0,0,36,0,0,33,12,0,66,0,0,0
21188,7180,2020-11-18T16:21:44.2115135Z,2020,6,3,6,4,0,6to,0,0,2,0,0,3,0,0,6,0,0,0
21188,7181,2020-11-18T16:21:44.2115135Z,2020,51,16,41,26,0,K,0,1,25,0,0,35,10,0,51,0,0,0
21188,7182,2020-11-18T16:21:44.2115135Z,2020,39,3,27,19,0,PK,0,2,20,0,0,36,12,0,39,0,0,0
21188,7183,2020-11-18T16:21:44.2115135Z,2020,14,14,11,3,0,Sin Grado,0,0,11,0,0,0,3,0,14,0,0,0
62513,10415,2020-11-18T16:22:04.130796Z,2020,21,4,19,16,0,1ro,0,2,5,0,0,17,2,0,21,0,0,0
62513,10416,2020-11-18T16:22:04.130796Z,2020,24,8,19,13,0,2do,2,2,11,0,0,16,5,0,22,0,0,0
62513,10417,2020-11-18T16:22:04.130796Z,2020,26,15,22,13,0,3ro,0,1,13,0,0,11,4,0,26,0,0,0
62513,10418,2020-11-18T16:22:04.131796Z,2020,17,10,14,7,0,4to,2,1,10,0,0,7,3,0,15,0,0,0
62513,10419,2020-11-18T16:22:04.131796Z,2020,26,12,25,12,0,5to,0,1,14,0,0,14,1,0,26,0,0,0
62513,10420,2020-11-18T16:22:04.131796Z,2020,23,7,20,8,0,K,0,0,15,0,0,16,3,0,23,0,0,0
62513,10421,2020-11-18T16:22:04.1327965Z,2020,12,11,10,4,0,Sin Grado,2,0,8,0,0,1,2,0,10,0,2,0
62513,34429,2021-06-24T13:18:39.4417372Z,2021,18,9,18,7,0,1ro,0,0,11,0,0,9,0,0,18,0,0,0
62513,34430,2021-06-24T13:18:39.4417372Z,2021,20,4,20,15,0,2do,0,1,5,0,0,16,0,0,20,0,0,0
62513,34431,2021-06-24T13:18:39.4417372Z,2021,22,6,20,13,0,3ro,0,0,9,0,0,16,2,0,22,0,0,0
62513,34432,2021-06-24T13:18:39.4427382Z,2021,24,13,22,13,0,4to,0,1,11,0,0,11,2,0,24,0,0,0
62513,34433,2021-06-24T13:18:39.4427382Z,2021,19,10,15,8,0,5to,2,0,11,0,0,9,4,0,17,0,0,0
62513,34434,2021-06-24T13:18:39.4427382Z,2021,15,6,15,8,0,K,1,1,7,0,0,9,0,0,14,0,0,0
62513,34435,2021-06-24T13:18:39.4427382Z,2021,7,7,5,4,0,Sin Grado,2,0,3,0,0,0,2,0,5,0,2,0
62513,4403,2020-11-18T16:21:10.1237813Z,2019,23,9,20,13,0,1ro,0,0,10,0,0,14,3,0,23,0,0,0
62513,4404,2020-11-18T16:21:10.1247822Z,2019,26,16,22,12,0,2do,0,0,14,0,0,10,4,0,26,0,0,0
62513,4405,2020-11-18T16:21:10.1247822Z,2019,18,10,14,6,0,3ro,0,0,12,0,0,8,4,0,18,0,0,0
62513,4406,2020-11-18T16:21:10.1247822Z,2019,30,17,28,13,0,4to,1,0,17,0,0,13,2,0,29,0,0,0
62513,4407,2020-11-18T16:21:10.1257822Z,2019,29,13,22,11,0,5to,2,0,18,0,0,16,7,0,27,0,0,0
62513,4408,2020-11-18T16:21:10.1257822Z,2019,26,6,24,18,0,K,0,0,8,0,0,20,2,0,26,0,0,0
62513,4409,2020-11-18T16:21:10.1257822Z,2019,15,14,11,5,0,Sin Grado,2,0,10,0,0,1,4,0,13,0,2,0
70888,11155,2020-11-18T16:22:08.324591Z,2020,198,38,145,100,0,10mo,0,0,98,0,0,160,53,0,198,0,0,0
70888,11156,2020-11-18T16:22:08.324591Z,2020,186,32,135,93,0,11mo,2,0,93,0,0,154,51,0,184,1,0,0
70888,11157,2020-11-18T16:22:08.325591Z,2020,183,35,128,94,0,12mo,0,0,89,0,0,148,55,0,183,0,0,0
70888,11158,2020-11-18T16:22:08.325591Z,2020,174,51,150,96,0,9no,0,0,78,0,0,123,24,0,174,0,0,0
70888,11159,2020-11-18T16:22:08.325591Z,2020,7,7,6,2,0,Sin Grado,0,0,5,0,0,0,1,0,7,0,0,0
70888,35176,2021-06-24T13:18:44.5453977Z,2021,172,48,153,95,0,10mo,0,0,77,0,0,124,19,0,172,0,0,0
70888,35177,2021-06-24T13:18:44.5453977Z,2021,178,29,140,92,0,11mo,0,0,86,0,0,149,38,0,178,1,0,0
70888,35178,2021-06-24T13:18:44.5453977Z,2021,157,29,126,80,0,12mo,2,0,77,0,0,128,31,0,155,0,0,0
70888,35179,2021-06-24T13:18:44.5463987Z,2021,172,40,152,95,0,9no,0,0,77,0,0,132,20,0,172,0,0,0
70888,35180,2021-06-24T13:18:44.5463987Z,2021,6,6,5,1,0,Sin Grado,0,0,5,0,0,0,1,0,6,0,0,0
70888,5149,2020-11-18T16:21:14.0323899Z,2019,203,40,149,99,0,10mo,1,0,104,0,0,163,54,0,202,1,0,0
70888,5150,2020-11-18T16:21:14.0323899Z,2019,189,36,131,94,0,11mo,0,0,95,0,0,153,58,0,189,0,0,0
70888,5151,2020-11-18T16:21:14.0333899Z,2019,168,0,129,98,0,12mo,3,0,70,0,0,168,39,0,165,2,0,0
70888,5152,2020-11-18T16:21:14.0333899Z,2019,195,42,152,100,0,9no,1,0,95,0,0,153,43,0,193,0,0,1
70888,5153,2020-11-18T16:21:14.0333899Z,2019,8,4,7,1,0,Sin Grado,0,0,7,0,0,4,1,0,8,0,0,0
46201,3057,2020-11-18T16:21:00.3402582Z,2019,30,8,21,9,0,1ro,0,0,21,0,0,22,9,0,30,0,0,0
46201,3058,2020-11-18T16:21:00.3412586Z,2019,41,13,36,20,0,2do,0,0,21,0,0,28,5,0,41,0,0,0
46201,3059,2020-11-18T16:21:00.3412586Z,2019,53,10,41,27,0,3ro,0,0,26,0,0,43,12,0,53,0,0,0
46201,3060,2020-11-18T16:21:00.3412586Z,2019,47,21,42,21,0,4to,0,0,26,0,0,26,5,0,47,1,2,0
46201,3061,2020-11-18T16:21:00.3422595Z,2019,46,12,36,20,0,5to,0,1,26,0,0,34,10,0,46,0,1,0
46201,3062,2020-11-18T16:21:00.3422595Z,2019,42,20,36,22,0,6to,0,1,20,0,0,22,6,0,42,0,1,0
46201,3063,2020-11-18T16:21:00.3422595Z,2019,24,8,20,12,0,7mo,0,3,12,0,0,16,4,0,24,0,1,0
46201,3064,2020-11-18T16:21:00.3432608Z,2019,23,10,18,9,0,8vo,0,0,14,0,0,13,5,0,23,0,1,0
46201,3065,2020-11-18T16:21:00.3432608Z,2019,37,13,31,25,0,K,0,0,12,0,0,24,6,0,37,0,0,0
46201,3066,2020-11-18T16:21:00.3432608Z,2019,34,28,30,12,0,Sin Grado,1,0,22,0,0,6,4,0,33,0,1,0
46201,33067,2021-06-24T13:18:29.8298452Z,2021,29,9,21,16,0,1ro,0,0,13,0,0,20,8,0,29,0,0,0
46201,33068,2021-06-24T13:18:29.8298452Z,2021,33,9,26,19,0,2do,0,0,14,0,0,24,7,0,33,0,0,0
46201,33069,2021-06-24T13:18:29.8298452Z,2021,24,8,18,9,0,3ro,0,0,15,0,0,16,6,0,24,0,0,0
46201,33070,2021-06-24T13:18:29.8308461Z,2021,31,8,27,14,0,4to,0,0,17,0,0,23,4,0,31,0,0,0
46201,33071,2021-06-24T13:18:29.8308461Z,2021,34,8,26,20,0,5to,0,0,14,0,0,26,8,0,34,0,0,0
46201,33072,2021-06-24T13:18:29.8318466Z,2021,22,12,21,8,0,6to,0,0,14,0,0,10,1,0,22,0,0,0
46201,33073,2021-06-24T13:18:29.8318466Z,2021,30,11,27,15,0,7mo,0,0,15,0,0,19,3,0,30,0,1,0
46201,33074,2021-06-24T13:18:29.8318466Z,2021,29,13,20,14,0,8vo,0,0,15,0,0,16,9,0,29,0,0,0
46201,33075,2021-06-24T13:18:29.8328476Z,2021,27,4,22,14,0,K,0,0,13,0,0,23,5,0,26,0,0,1
46201,33076,2021-06-24T13:18:29.8328476Z,2021,25,23,24,9,0,Sin Grado,0,0,16,0,0,2,1,0,25,0,0,0
46201,9071,2020-11-18T16:21:55.4440046Z,2020,35,13,29,19,0,1ro,0,0,16,0,0,22,6,0,35,0,0,0
46201,9072,2020-11-18T16:21:55.4440046Z,2020,32,9,25,11,0,2do,0,0,21,0,0,23,7,2,30,0,0,0
46201,9073,2020-11-18T16:21:55.4440046Z,2020,42,13,38,22,0,3ro,0,0,20,0,0,29,4,1,41,0,0,0
46201,9074,2020-11-18T16:21:55.4450064Z,2020,43,12,32,25,0,4to,0,0,18,0,0,31,11,0,43,0,0,0
46201,9075,2020-11-18T16:21:55.4450064Z,2020,47,22,42,20,0,5to,0,0,27,0,0,25,5,0,47,0,1,0
46201,9076,2020-11-18T16:21:55.4450064Z,2020,38,12,30,18,0,6to,0,0,20,0,0,26,8,0,38,0,1,0
46201,9077,2020-11-18T16:21:55.4450064Z,2020,36,16,30,19,0,7mo,0,0,17,0,0,20,6,0,36,0,0,0
46201,9078,2020-11-18T16:21:55.4460073Z,2020,25,3,20,17,0,8vo,0,0,8,0,0,22,5,0,25,0,1,0
46201,9079,2020-11-18T16:21:55.4460073Z,2020,33,9,27,16,0,K,0,0,17,0,0,24,6,2,31,0,0,0
46201,9080,2020-11-18T16:21:55.4460073Z,2020,24,23,20,9,0,Sin Grado,0,0,15,0,0,1,4,0,24,0,0,0
15404,30604,2021-06-24T13:18:10.6580922Z,2021,30,8,26,15,0,1ro,1,0,15,0,0,22,4,0,29,0,0,0
15404,30605,2021-06-24T13:18:10.6590931Z,2021,40,15,39,20,0,2do,0,0,20,0,0,25,1,0,40,0,0,0
15404,30606,2021-06-24T13:18:10.6590931Z,2021,41,18,36,21,0,3ro,1,0,20,0,0,23,5,0,40,0,0,0
15404,30607,2021-06-24T13:18:10.6600931Z,2021,37,10,30,21,0,4to,0,0,16,0,0,27,7,0,37,0,0,0
15404,30608,2021-06-24T13:18:10.6600931Z,2021,33,15,29,14,0,5to,1,0,19,0,0,18,4,0,32,0,0,0
15404,30609,2021-06-24T13:18:10.6600931Z,2021,24,12,17,12,0,K,0,0,12,0,0,12,7,0,24,0,0,0
15404,30610,2021-06-24T13:18:10.6600931Z,2021,16,3,13,6,0,PK,0,0,10,0,0,13,3,0,16,0,0,0
15404,30611,2021-06-24T13:18:10.6610941Z,2021,15,13,11,7,0,Sin Grado,1,0,8,0,0,2,4,0,14,0,0,0
15404,606,2020-11-18T16:20:41.1744828Z,2019,33,14,28,16,0,1ro,0,0,17,0,0,19,5,0,33,0,0,0
15404,607,2020-11-18T16:20:41.175481Z,2019,24,6,19,15,0,2do,0,0,9,0,0,18,5,0,24,0,0,0
15404,608,2020-11-18T16:20:41.175481Z,2019,27,13,25,10,0,3ro,2,0,17,0,0,14,2,0,25,0,0,0
15404,609,2020-11-18T16:20:41.175481Z,2019,38,18,25,17,0,4to,2,0,21,0,0,20,13,0,36,0,0,0
15404,610,2020-11-18T16:20:41.175481Z,2019,31,11,22,17,0,5to,1,0,14,0,0,20,9,0,30,0,1,0
15404,611,2020-11-18T16:20:41.1764819Z,2019,27,9,22,16,0,K,0,0,11,0,0,18,5,0,27,0,0,0
15404,612,2020-11-18T16:20:41.1764819Z,2019,18,4,16,9,0,PK,0,0,9,0,0,14,2,0,18,0,0,0
15404,613,2020-11-18T16:20:41.1764819Z,2019,19,17,13,7,0,Sin Grado,0,0,12,0,0,2,6,0,19,0,0,0
15404,6606,2020-11-18T16:21:40.7452064Z,2020,29,11,26,16,0,1ro,0,0,13,0,0,18,3,0,29,0,0,0
15404,6607,2020-11-18T16:21:40.7452064Z,2020,38,16,30,19,0,2do,1,0,19,0,0,22,8,0,37,0,0,0
15404,6608,2020-11-18T16:21:40.7452064Z,2020,28,7,21,15,0,3ro,0,0,13,0,0,21,7,0,28,0,0,0
15404,6609,2020-11-18T16:21:40.7452064Z,2020,31,15,25,14,0,4to,1,0,17,0,0,16,6,0,30,0,0,0
15404,6610,2020-11-18T16:21:40.7452064Z,2020,36,17,25,17,0,5to,1,0,19,0,0,19,11,0,35,0,0,0
15404,6611,2020-11-18T16:21:40.7462055Z,2020,24,6,20,12,0,K,1,0,12,0,0,18,4,0,23,0,0,0
15404,6612,2020-11-18T16:21:40.7462055Z,2020,19,3,14,10,0,PK,0,0,9,0,0,16,5,0,19,0,0,0
15404,6613,2020-11-18T16:21:40.7462055Z,2020,17,17,11,8,0,Sin Grado,0,0,9,0,0,0,6,0,17,0,0,0
70144,10910,2020-11-18T16:22:07.1978413Z,2020,42,10,38,27,0,1ro,0,2,15,0,0,32,4,0,42,0,0,0
70144,10911,2020-11-18T16:22:07.1988418Z,2020,56,15,54,27,0,2do,0,1,29,0,0,41,2,1,55,0,0,0
70144,10912,2020-11-18T16:22:07.1988418Z,2020,63,25,60,33,0,3ro,1,0,30,0,0,38,3,0,62,0,0,0
70144,10913,2020-11-18T16:22:07.1988418Z,2020,66,20,59,33,0,4to,2,0,33,0,0,46,7,0,64,0,0,0
70144,10914,2020-11-18T16:22:07.1988418Z,2020,60,24,55,29,0,5to,2,0,31,0,0,36,5,0,58,0,0,0
70144,10915,2020-11-18T16:22:07.1998422Z,2020,25,7,24,14,0,K,0,0,11,0,0,18,1,0,25,0,0,0
70144,10916,2020-11-18T16:22:07.1998422Z,2020,2,2,2,0,0,Sin Grado,0,0,2,0,0,0,0,0,2,0,0,0
70144,34932,2021-06-24T13:18:43.3255233Z,2021,25,8,24,14,0,1ro,0,0,11,0,0,17,1,1,24,0,0,0
70144,34933,2021-06-24T13:18:43.3265237Z,2021,41,11,35,25,0,2do,0,0,16,0,0,30,6,0,41,0,0,0
70144,34934,2021-06-24T13:18:43.3265237Z,2021,46,18,40,22,0,3ro,1,0,24,0,0,28,6,1,44,0,0,0
70144,34935,2021-06-24T13:18:43.3265237Z,2021,57,25,52,33,0,4to,1,0,24,0,0,32,5,0,56,0,1,0
70144,34936,2021-06-24T13:18:43.3275247Z,2021,60,20,47,30,0,5to,2,0,30,0,0,40,13,0,58,0,0,0
70144,34937,2021-06-24T13:18:43.3275247Z,2021,24,5,22,13,0,K,0,0,11,0,0,19,2,1,23,0,0,0
70144,4902,2020-11-18T16:21:12.9856927Z,2019,63,23,58,30,0,1ro,0,0,33,0,0,40,5,0,63,0,0,0
70144,4903,2020-11-18T16:21:12.9856927Z,2019,75,29,64,40,0,2do,0,0,35,0,0,46,11,1,74,0,0,0
70144,4904,2020-11-18T16:21:12.9866931Z,2019,69,19,60,30,0,3ro,1,0,39,0,0,50,9,0,68,0,0,0
70144,4905,2020-11-18T16:21:12.9866931Z,2019,67,26,62,33,0,4to,2,0,34,0,0,41,5,0,65,0,0,0
70144,4906,2020-11-18T16:21:12.9866931Z,2019,61,21,56,32,0,5to,1,0,29,0,0,40,5,0,60,0,0,0
70144,4907,2020-11-18T16:21:12.9876953Z,2019,40,8,33,29,0,K,0,1,11,0,0,32,7,0,40,0,0,0
70144,4908,2020-11-18T16:21:12.9876953Z,2019,4,4,3,0,0,Sin Grado,0,0,4,0,0,0,1,0,4,0,0,0
71571,11361,2020-11-18T16:22:10.1798294Z,2020,33,14,33,15,0,1ro,3,0,18,0,0,19,0,0,30,0,0,0
71571,11362,2020-11-18T16:22:10.1808308Z,2020,23,7,20,9,0,2do,1,0,14,0,0,16,3,0,22,0,0,0
71571,11363,2020-11-18T16:22:10.1808308Z,2020,20,14,20,10,0,3ro,1,0,10,0,0,6,0,0,19,0,0,0
71571,11364,2020-11-18T16:22:10.1808308Z,2020,24,9,20,7,0,4to,2,0,17,0,0,15,4,0,22,0,0,0
71571,11365,2020-11-18T16:22:10.1808308Z,2020,30,16,29,17,0,5to,2,0,13,0,0,14,1,0,28,0,0,0
71571,11366,2020-11-18T16:22:10.1818317Z,2020,20,5,18,11,0,6to,0,0,9,0,0,15,2,0,20,0,0,0
71571,11367,2020-11-18T16:22:10.1818317Z,2020,22,5,16,12,0,K,16,0,10,0,0,17,6,0,6,0,0,0
71571,11368,2020-11-18T16:22:10.1818317Z,2020,24,0,21,14,0,PK,24,0,10,0,0,24,3,0,0,0,0,0
71571,11369,2020-11-18T16:22:10.1828326Z,2020,22,21,21,5,0,Sin Grado,0,0,17,0,0,1,1,0,22,0,0,0
71571,35382,2021-06-24T13:18:45.5971521Z,2021,28,6,27,15,0,1ro,13,0,13,0,0,22,1,0,15,0,0,0
71571,35383,2021-06-24T13:18:45.5981526Z,2021,42,22,40,18,0,2do,2,0,24,0,0,20,2,0,40,0,0,0
71571,35384,2021-06-24T13:18:45.5981526Z,2021,28,10,25,12,0,3ro,0,0,16,0,0,18,3,0,28,0,0,0
71571,35385,2021-06-24T13:18:45.5981526Z,2021,19,13,17,9,0,4to,1,0,10,0,0,6,2,0,18,0,0,0
71571,35386,2021-06-24T13:18:45.5981526Z,2021,20,9,17,5,0,5to,2,0,15,0,0,11,3,0,18,0,0,0
71571,35387,2021-06-24T13:18:45.5991531Z,2021,24,12,19,14,0,6to,2,0,10,0,0,12,5,0,22,0,0,0
71571,35388,2021-06-24T13:18:45.5991531Z,2021,31,3,29,12,0,K,13,0,19,0,0,28,2,0,18,0,0,0
71571,35389,2021-06-24T13:18:45.5991531Z,2021,18,2,17,9,0,PK,4,0,9,0,0,16,1,0,14,0,0,0
71571,35390,2021-06-24T13:18:45.5991531Z,2021,20,20,19,6,0,Sin Grado,1,0,14,0,0,0,1,0,19,0,0,0
71571,5354,2020-11-18T16:21:15.0840879Z,2019,30,11,27,15,0,1ro,0,0,15,0,0,19,3,0,30,0,0,0
71571,5355,2020-11-18T16:21:15.0840879Z,2019,15,9,15,6,0,2do,0,0,9,0,0,6,0,0,15,0,0,0
71571,5356,2020-11-18T16:21:15.0850888Z,2019,22,8,20,8,0,3ro,1,0,14,0,0,14,2,0,21,0,0,0
71571,5357,2020-11-18T16:21:15.0850888Z,2019,25,12,24,14,0,4to,0,0,11,0,0,13,1,0,25,0,0,0
71571,5358,2020-11-18T16:21:15.0850888Z,2019,23,9,22,10,0,5to,0,0,13,0,0,14,1,0,23,0,0,0
71571,5359,2020-11-18T16:21:15.0850888Z,2019,9,2,9,5,0,6to,0,0,4,0,0,7,0,0,9,0,0,0
71571,5360,2020-11-18T16:21:15.0860902Z,2019,24,7,24,13,0,K,0,0,11,0,0,17,0,0,24,0,0,0
71571,5361,2020-11-18T16:21:15.0860902Z,2019,17,16,17,3,0,Sin Grado,0,0,14,0,0,1,0,0,17,0,0,0
46805,3092,2020-11-18T16:21:00.3432608Z,2019,152,53,124,73,1,6to,0,5,79,0,0,99,28,0,152,0,0,0
46805,3093,2020-11-18T16:21:00.3432608Z,2019,180,44,141,86,1,7mo,2,4,94,0,0,136,39,1,177,0,2,0
46805,3094,2020-11-18T16:21:00.3442604Z,2019,205,40,145,104,0,8vo,1,3,101,0,0,165,60,1,203,3,0,0
46805,33103,2021-06-24T13:18:30.3021843Z,2021,129,18,114,65,0,6to,1,0,64,0,0,111,15,0,128,1,1,0
46805,33104,2021-06-24T13:18:30.3021843Z,2021,184,43,156,88,0,7mo,1,0,96,0,0,141,28,0,183,0,1,0
46805,33105,2021-06-24T13:18:30.3021843Z,2021,143,35,112,74,0,8vo,0,0,69,0,0,108,31,1,142,0,0,0
46805,33106,2021-06-24T13:18:30.3021843Z,2021,47,4,36,20,0,9no,1,0,27,0,0,43,11,0,46,0,0,0
46805,9106,2020-11-18T16:21:56.1214569Z,2020,182,51,154,87,0,6to,0,0,95,0,0,131,28,0,182,0,1,0
46805,9107,2020-11-18T16:21:56.1224582Z,2020,152,42,124,73,0,7mo,0,0,79,0,0,110,28,0,152,0,0,0
46805,9108,2020-11-18T16:21:56.1224582Z,2020,167,37,130,83,0,8vo,2,0,84,0,0,130,37,1,164,0,2,0
53470,33702,2021-06-24T13:18:35.2337201Z,2021,43,5,22,28,0,10mo,0,0,15,0,0,38,21,0,43,2,0,0
53470,33703,2021-06-24T13:18:35.2337201Z,2021,65,5,35,44,0,11mo,0,0,21,0,0,60,30,0,65,6,0,0
53470,33704,2021-06-24T13:18:35.2337201Z,2021,51,2,18,33,0,12mo,0,0,18,0,0,49,33,0,51,5,0,0
53470,33705,2021-06-24T13:18:35.234721Z,2021,45,9,21,31,0,6to,0,0,14,0,0,36,24,0,45,2,0,0
53470,33706,2021-06-24T13:18:35.234721Z,2021,51,5,24,34,0,7mo,0,0,17,0,0,46,27,0,51,0,0,0
53470,33707,2021-06-24T13:18:35.2357215Z,2021,56,3,27,34,0,8vo,0,0,22,0,0,53,29,0,56,8,0,0
53470,33708,2021-06-24T13:18:35.2357215Z,2021,51,1,29,37,0,9no,0,0,14,0,0,50,22,0,51,3,0,0
53470,33709,2021-06-24T13:18:35.2367225Z,2021,9,9,8,1,0,Sin Grado,0,0,8,0,0,0,1,0,9,0,0,0
53470,3678,2020-11-18T16:21:04.3379249Z,2019,53,2,22,35,0,10mo,0,0,18,0,0,51,31,0,53,4,0,0
53470,3679,2020-11-18T16:21:04.3389254Z,2019,57,3,24,33,0,11mo,1,0,24,0,0,54,33,0,56,4,0,0
53470,3680,2020-11-18T16:21:04.3389254Z,2019,46,0,18,28,0,12mo,1,0,18,0,0,46,28,0,45,0,0,0
53470,3681,2020-11-18T16:21:04.3389254Z,2019,66,5,27,40,0,6to,0,0,26,0,0,61,39,0,66,8,0,0
53470,3682,2020-11-18T16:21:04.3399258Z,2019,63,3,22,47,0,7mo,0,0,16,0,0,60,41,0,63,3,0,0
53470,3683,2020-11-18T16:21:04.3399258Z,2019,50,8,23,35,0,8vo,1,0,15,0,0,42,27,0,49,3,0,0
53470,3684,2020-11-18T16:21:04.3399258Z,2019,89,7,37,59,0,9no,0,0,30,0,0,82,52,0,89,7,0,0
53470,3685,2020-11-18T16:21:04.3399258Z,2019,13,13,10,4,0,Sin Grado,0,0,9,0,0,0,3,0,13,0,0,0
53470,9696,2020-11-18T16:21:59.5137171Z,2020,68,6,33,46,0,10mo,0,0,22,0,0,62,35,0,68,3,0,0
53470,9697,2020-11-18T16:21:59.5137171Z,2020,54,2,22,36,0,11mo,0,0,18,0,0,52,32,0,54,4,0,0
53470,9698,2020-11-18T16:21:59.514718Z,2020,57,3,26,33,0,12mo,1,0,24,0,0,54,31,0,56,4,0,0
53470,9699,2020-11-18T16:21:59.514718Z,2020,52,5,21,32,0,6to,0,1,20,0,0,47,31,0,52,0,0,0
53470,9700,2020-11-18T16:21:59.514718Z,2020,63,5,28,39,0,7mo,0,0,24,0,0,58,35,0,63,8,0,0
53470,9701,2020-11-18T16:22:00.1011102Z,2020,63,3,24,48,0,8vo,0,0,15,0,0,60,39,0,63,3,0,0
53470,9702,2020-11-18T16:22:00.1021111Z,2020,51,7,23,35,0,9no,0,0,16,0,0,44,28,0,51,2,0,0
53470,9703,2020-11-18T16:22:00.1021111Z,2020,18,18,15,5,0,Sin Grado,0,1,13,0,0,0,3,0,18,0,0,0
54288,33764,2021-06-24T13:18:35.2737488Z,2021,19,5,19,3,0,1ro,0,0,16,0,0,14,0,0,19,0,0,0
54288,33765,2021-06-24T13:18:35.2747493Z,2021,20,2,19,8,0,2do,0,2,12,0,0,18,1,0,20,0,0,0
54288,33766,2021-06-24T13:18:35.2747493Z,2021,28,10,26,12,0,3ro,2,1,16,0,0,18,2,0,26,0,0,0
54288,33767,2021-06-24T13:18:35.2747493Z,2021,16,6,14,7,0,4to,0,1,9,0,0,10,2,0,16,0,0,0
54288,33768,2021-06-24T13:18:35.2757498Z,2021,23,9,20,9,0,5to,1,1,14,0,0,14,3,0,21,0,0,1
54288,33769,2021-06-24T13:18:35.2757498Z,2021,32,12,29,17,0,6to,0,1,15,0,0,20,3,0,31,0,0,1
54288,33770,2021-06-24T13:18:35.2757498Z,2021,24,3,23,13,0,7mo,0,2,11,0,0,21,1,0,23,0,0,1
54288,33771,2021-06-24T13:18:35.2767516Z,2021,27,11,25,15,0,8vo,2,2,12,0,0,16,2,0,25,0,0,0
54288,33772,2021-06-24T13:18:35.2767516Z,2021,22,2,13,16,0,K,0,0,6,0,0,20,9,0,22,0,0,0
54288,33773,2021-06-24T13:18:35.2767516Z,2021,65,64,59,22,0,Sin Grado,0,2,43,0,0,1,6,0,65,0,0,0
54288,3741,2020-11-18T16:21:05.1154409Z,2019,31,5,28,17,0,1ro,3,1,14,0,0,26,3,0,28,0,0,0
54288,3742,2020-11-18T16:21:05.1164427Z,2019,28,10,28,9,0,2do,2,2,19,0,0,18,0,0,25,0,0,1
54288,3743,2020-11-18T16:21:05.1164427Z,2019,30,9,27,13,0,3ro,0,0,17,0,0,21,3,0,28,0,0,2
54288,3744,2020-11-18T16:21:05.1164427Z,2019,29,11,29,16,0,4to,0,1,13,0,0,18,0,0,28,0,0,1
54288,3745,2020-11-18T16:21:05.1164427Z,2019,35,10,35,19,0,5to,0,0,16,0,0,25,0,0,34,0,0,1
54288,3746,2020-11-18T16:21:05.1164427Z,2019,30,12,28,19,0,6to,1,1,11,0,0,18,2,0,29,0,0,0
54288,3747,2020-11-18T16:21:05.1174422Z,2019,27,10,25,8,0,7mo,0,0,19,0,0,17,2,0,27,0,0,0
54288,3748,2020-11-18T16:21:05.1174422Z,2019,29,5,27,15,0,8vo,0,1,14,0,0,24,2,0,29,0,0,0
54288,3749,2020-11-18T16:21:05.1174422Z,2019,25,2,20,5,0,K,0,0,20,0,0,23,5,0,24,0,0,1
54288,3750,2020-11-18T16:21:05.1174422Z,2019,74,65,71,18,0,Sin Grado,0,2,56,0,0,9,3,0,74,0,0,0
54288,9758,2020-11-18T16:22:00.1241262Z,2020,23,2,23,10,0,1ro,0,0,13,0,0,21,0,0,23,0,0,0
54288,9759,2020-11-18T16:22:00.1251262Z,2020,30,10,28,14,0,2do,2,2,16,0,0,20,2,0,28,0,0,0
54288,9760,2020-11-18T16:22:00.1251262Z,2020,19,5,19,7,0,3ro,0,2,12,0,0,14,0,0,19,0,0,0
54288,9761,2020-11-18T16:22:00.1251262Z,2020,21,9,19,8,0,4to,0,3,13,0,0,12,2,0,20,0,0,1
54288,9762,2020-11-18T16:22:00.1261276Z,2020,32,11,32,19,0,5to,0,1,13,0,0,21,0,0,31,0,0,1
54288,9763,2020-11-18T16:22:00.1261276Z,2020,29,4,29,16,0,6to,1,2,13,0,0,25,0,0,27,0,0,1
54288,9764,2020-11-18T16:22:00.1271271Z,2020,27,11,26,14,0,7mo,2,1,13,0,0,16,1,0,25,0,0,0
54288,9765,2020-11-18T16:22:00.1271271Z,2020,27,8,27,12,0,8vo,0,0,15,0,0,19,0,0,27,0,0,0
54288,9766,2020-11-18T16:22:00.1271271Z,2020,30,5,29,10,0,K,0,2,20,0,0,25,1,0,30,0,0,0
54288,9767,2020-11-18T16:22:00.1271271Z,2020,71,70,66,17,0,Sin Grado,0,3,54,0,0,1,5,0,71,0,0,0
63131,10621,2020-11-18T16:22:05.3315968Z,2020,66,21,62,31,0,6to,8,0,35,0,0,45,4,0,58,0,0,0
63131,10622,2020-11-18T16:22:05.3315968Z,2020,87,25,77,40,0,7mo,13,0,47,0,0,62,10,0,74,0,0,0
63131,10623,2020-11-18T16:22:05.3325977Z,2020,74,20,69,39,0,8vo,8,2,35,0,0,54,5,0,66,0,0,0
63131,10624,2020-11-18T16:22:05.3325977Z,2020,13,12,11,5,0,Sin Grado,0,0,8,0,0,1,2,0,13,0,0,0
63131,34636,2021-06-24T13:18:41.0849159Z,2021,67,22,63,40,0,6to,7,0,27,0,0,45,4,0,60,0,0,0
63131,34637,2021-06-24T13:18:41.0849159Z,2021,76,20,74,39,0,7mo,9,0,37,0,0,56,2,0,67,0,0,0
63131,34638,2021-06-24T13:18:41.0849159Z,2021,81,29,74,38,0,8vo,12,0,43,0,0,52,7,0,69,0,0,0
63131,34639,2021-06-24T13:18:41.0849159Z,2021,17,16,17,3,0,Sin Grado,1,0,14,0,0,1,0,0,16,0,0,0
63131,4610,2020-11-18T16:21:11.24453Z,2019,105,33,100,45,0,6to,8,0,60,0,0,72,5,0,97,0,0,0
63131,4611,2020-11-18T16:21:11.24453Z,2019,95,30,87,48,0,7mo,13,2,47,0,0,65,8,0,82,0,0,0
63131,4612,2020-11-18T16:21:11.24453Z,2019,116,26,110,62,0,8vo,12,1,54,0,0,90,6,0,104,0,0,0
63131,4613,2020-11-18T16:21:11.2455304Z,2019,11,9,10,3,0,Sin Grado,0,0,8,0,0,2,1,0,11,0,0,0
64402,10650,2020-11-18T16:22:05.3496093Z,2020,60,6,26,33,0,10mo,1,0,27,0,0,54,34,0,59,0,0,0
64402,10651,2020-11-18T16:22:05.3496093Z,2020,92,3,30,50,0,11mo,1,0,42,0,0,89,62,1,90,0,0,0
64402,10652,2020-11-18T16:22:05.3506106Z,2020,74,6,22,36,0,12mo,3,0,38,0,0,68,52,0,71,0,0,0
64402,10653,2020-11-18T16:22:05.3506106Z,2020,48,3,17,26,0,6to,2,0,22,0,0,45,31,0,46,0,0,0
64402,10654,2020-11-18T16:22:05.3506106Z,2020,46,4,17,32,0,7mo,0,0,14,0,0,42,29,0,46,0,0,0
64402,10655,2020-11-18T16:22:05.3506106Z,2020,76,9,27,38,0,8vo,0,0,38,0,0,67,49,0,76,0,0,0
64402,10656,2020-11-18T16:22:05.3506106Z,2020,76,6,30,37,0,9no,3,0,39,0,0,70,46,0,73,0,0,0
64402,34667,2021-06-24T13:18:41.1049298Z,2021,74,6,36,35,0,10mo,3,0,39,0,0,68,38,0,71,0,0,0
64402,34668,2021-06-24T13:18:41.1049298Z,2021,59,6,30,32,0,11mo,0,0,27,0,0,53,29,0,59,0,0,0
64402,34669,2021-06-24T13:18:41.1049298Z,2021,87,3,37,48,0,12mo,1,0,39,0,0,84,50,1,85,0,0,0
64402,34670,2021-06-24T13:18:41.1059308Z,2021,60,12,41,30,0,6to,1,0,30,0,0,48,19,0,59,1,0,0
64402,34671,2021-06-24T13:18:41.1059308Z,2021,49,3,26,29,0,7mo,3,0,20,0,0,46,23,0,46,0,0,0
64402,34672,2021-06-24T13:18:41.1059308Z,2021,48,4,26,32,0,8vo,1,0,16,0,0,44,22,0,47,0,0,0
64402,34673,2021-06-24T13:18:41.1059308Z,2021,71,8,34,35,0,9no,0,0,36,0,0,63,37,0,71,0,0,0
64402,4638,2020-11-18T16:21:11.255538Z,2019,97,3,36,53,0,10mo,1,0,44,0,0,94,61,1,95,0,0,0
64402,4639,2020-11-18T16:21:11.256538Z,2019,76,6,20,38,0,11mo,3,0,38,0,0,70,56,0,73,0,0,0
64402,4640,2020-11-18T16:21:11.256538Z,2019,72,0,23,40,0,12mo,1,0,32,0,0,72,49,1,70,0,0,0
64402,4641,2020-11-18T16:21:11.256538Z,2019,24,3,13,18,0,6to,0,0,6,0,0,21,11,0,24,0,0,0
64402,4642,2020-11-18T16:21:11.256538Z,2019,73,8,22,36,0,7mo,0,0,37,0,0,65,51,0,73,0,0,0
64402,4643,2020-11-18T16:21:11.2575376Z,2019,77,7,29,36,0,8vo,4,1,41,0,0,70,48,0,73,0,0,0
64402,4644,2020-11-18T16:21:11.2575376Z,2019,64,6,23,34,0,9no,1,1,30,0,0,58,41,0,63,0,0,0
28555,1735,2020-11-18T16:20:48.8586009Z,2019,32,10,25,16,0,1ro,0,0,16,0,0,22,7,0,32,0,0,0
28555,1736,2020-11-18T16:20:48.8586009Z,2019,21,10,17,8,0,2do,0,1,13,0,0,11,4,0,21,0,0,0
28555,1737,2020-11-18T16:20:48.8586009Z,2019,31,9,21,13,0,3ro,0,2,18,0,0,22,10,0,31,0,0,0
28555,1738,2020-11-18T16:20:48.8596013Z,2019,33,13,29,12,0,4to,0,0,21,0,0,20,4,0,33,0,0,0
28555,1739,2020-11-18T16:20:48.8596013Z,2019,33,7,23,18,0,5to,0,1,15,0,0,26,10,0,33,0,0,0
28555,1740,2020-11-18T16:20:48.8596013Z,2019,27,8,19,17,0,K,0,1,10,0,0,19,8,0,27,0,0,0
28555,31737,2021-06-24T13:18:17.2308061Z,2021,31,10,30,15,0,1ro,2,0,16,0,0,21,1,0,29,0,0,0
28555,31738,2021-06-24T13:18:17.231807Z,2021,32,14,32,17,0,2do,0,1,15,0,0,18,0,0,32,0,0,0
28555,31739,2021-06-24T13:18:17.231807Z,2021,24,6,20,12,0,3ro,0,1,12,0,0,18,4,0,24,0,0,0
28555,31740,2021-06-24T13:18:17.231807Z,2021,25,11,22,9,0,4to,0,2,16,0,0,14,3,0,25,0,0,0
28555,31741,2021-06-24T13:18:17.2328066Z,2021,31,12,28,11,0,5to,0,0,20,0,0,19,3,0,31,0,0,0
28555,31742,2021-06-24T13:18:17.2328066Z,2021,17,8,15,6,0,6to,0,1,11,0,0,9,2,0,17,0,0,0
28555,31743,2021-06-24T13:18:17.2328066Z,2021,24,8,21,14,0,K,0,0,10,0,0,16,3,0,24,0,0,0
28555,7740,2020-11-18T16:21:47.913981Z,2020,36,15,33,21,0,1ro,0,1,15,0,0,21,3,0,36,0,0,0
28555,7741,2020-11-18T16:21:47.913981Z,2020,27,6,20,14,0,2do,0,2,13,0,0,21,7,0,27,0,0,0
28555,7742,2020-11-18T16:21:47.9149823Z,2020,23,10,20,9,0,3ro,0,1,14,0,0,13,3,0,23,0,0,0
28555,7743,2020-11-18T16:21:47.9149823Z,2020,32,11,22,12,0,4to,0,0,20,0,0,21,10,0,32,0,0,0
28555,7744,2020-11-18T16:21:47.9149823Z,2020,31,12,27,11,0,5to,0,0,20,0,0,19,4,0,31,0,0,0
28555,7745,2020-11-18T16:21:47.9149823Z,2020,25,6,23,13,0,6to,0,1,12,0,0,19,2,0,25,0,0,0
28555,7746,2020-11-18T16:21:47.9149823Z,2020,34,6,28,15,0,K,2,1,19,0,0,28,6,0,32,0,0,0
36012,2436,2020-11-18T16:20:56.2565363Z,2019,91,2,29,67,0,10mo,1,0,24,0,0,89,62,1,89,0,0,0
36012,2437,2020-11-18T16:20:56.2575367Z,2019,69,3,17,50,0,11mo,2,0,19,0,0,66,52,0,67,0,0,0
36012,2438,2020-11-18T16:20:56.2575367Z,2019,71,0,26,49,0,12mo,1,0,22,0,0,71,45,1,69,0,0,0
36012,2439,2020-11-18T16:20:56.2575367Z,2019,55,6,17,37,0,6to,0,0,18,0,0,49,38,0,55,0,0,0
36012,2440,2020-11-18T16:20:56.2585389Z,2019,65,0,11,47,0,7mo,1,1,18,0,0,65,54,0,64,0,0,0
36012,2441,2020-11-18T16:20:56.2595389Z,2019,59,1,13,42,0,8vo,1,0,17,0,0,58,46,0,58,0,0,0
36012,2442,2020-11-18T16:20:56.2595389Z,2019,92,3,22,65,0,9no,2,0,27,0,0,89,70,0,90,0,0,0
36012,32443,2021-06-24T13:18:24.7231823Z,2021,74,2,24,52,0,10mo,2,0,22,0,0,72,50,0,72,0,0,0
36012,32444,2021-06-24T13:18:24.7241828Z,2021,85,4,22,60,0,11mo,2,0,25,0,0,81,63,0,83,0,1,0
36012,32445,2021-06-24T13:18:24.7241828Z,2021,86,2,33,61,0,12mo,1,0,25,0,0,84,53,1,84,0,1,0
36012,32446,2021-06-24T13:18:24.7241828Z,2021,48,3,22,32,0,6to,0,0,16,0,0,45,26,0,48,0,0,0
36012,32447,2021-06-24T13:18:24.7251842Z,2021,75,3,28,52,0,7mo,1,0,23,0,0,72,47,0,72,0,0,2
36012,32448,2021-06-24T13:18:24.7251842Z,2021,58,4,20,43,0,8vo,1,0,15,0,0,54,38,0,56,0,0,1
36012,32449,2021-06-24T13:18:24.7261838Z,2021,94,4,30,71,0,9no,2,0,23,0,0,90,64,0,92,0,0,0
36012,32450,2021-06-24T13:18:24.7261838Z,2021,1,1,1,0,0,Sin Grado,0,0,1,0,0,0,0,0,1,0,0,0
36012,8448,2020-11-18T16:21:51.7985705Z,2020,87,3,17,61,0,10mo,2,0,26,0,0,84,70,0,85,0,0,0
36012,8449,2020-11-18T16:21:51.7985705Z,2020,87,2,26,62,0,11mo,1,0,25,0,0,85,61,1,85,0,0,0
36012,8450,2020-11-18T16:21:51.799571Z,2020,65,3,16,46,0,12mo,2,0,19,0,0,62,49,0,63,0,0,0
36012,8451,2020-11-18T16:21:51.799571Z,2020,52,2,18,34,0,6to,1,0,18,0,0,50,34,0,50,0,0,1
36012,8452,2020-11-18T16:21:51.8005714Z,2020,55,4,10,41,0,7mo,1,0,14,0,0,51,45,0,54,0,0,0
36012,8453,2020-11-18T16:21:51.8005714Z,2020,75,1,13,59,0,8vo,2,0,16,0,0,74,62,0,73,0,0,0
36012,8454,2020-11-18T16:21:51.8005714Z,2020,74,2,20,54,0,9no,2,0,20,0,0,72,54,0,72,0,0,0
36012,8455,2020-11-18T16:21:51.8015714Z,2020,2,1,2,1,0,Sin Grado,0,0,1,0,0,1,0,0,2,0,0,0
48017,3188,2020-11-18T16:21:01.0397247Z,2019,53,16,45,24,0,1ro,1,0,29,0,0,37,8,0,52,0,0,0
48017,3189,2020-11-18T16:21:01.0397247Z,2019,49,12,37,28,0,2do,0,1,21,0,0,37,12,0,49,0,0,0
48017,3190,2020-11-18T16:21:01.0407261Z,2019,70,26,55,32,0,3ro,5,0,38,0,0,44,15,0,65,0,0,0
48017,3191,2020-11-18T16:21:01.0407261Z,2019,54,21,39,24,0,4to,1,0,30,0,0,33,15,0,53,0,0,0
48017,3192,2020-11-18T16:21:01.0407261Z,2019,56,17,46,26,0,5to,1,0,30,0,0,39,10,0,55,0,0,0
48017,3193,2020-11-18T16:21:01.0407261Z,2019,41,11,32,25,0,K,1,0,16,0,0,30,9,0,40,0,0,0
48017,3194,2020-11-18T16:21:01.0417265Z,2019,16,2,12,10,0,PK,0,1,6,0,0,14,4,0,16,0,0,0
48017,3195,2020-11-18T16:21:01.0417265Z,2019,8,8,6,2,0,Sin Grado,0,0,6,0,0,0,2,0,8,0,0,0
48017,33213,2021-06-24T13:18:30.8685905Z,2021,46,10,45,16,0,1ro,0,1,30,0,0,36,1,0,46,0,0,0
48017,33214,2021-06-24T13:18:30.8685905Z,2021,42,12,41,26,0,2do,1,0,16,0,0,30,1,0,41,0,0,0
48017,33215,2021-06-24T13:18:30.869591Z,2021,46,15,37,21,0,3ro,0,0,25,0,0,31,9,0,46,0,0,0
48017,33216,2021-06-24T13:18:30.869591Z,2021,50,15,42,23,0,4to,0,0,27,0,0,35,8,0,50,0,0,0
48017,33217,2021-06-24T13:18:30.869591Z,2021,86,29,74,39,0,5to,3,0,47,0,0,57,12,0,83,0,0,0
48017,33218,2021-06-24T13:18:30.869591Z,2021,41,14,36,12,0,K,0,0,29,0,0,27,5,0,41,0,0,0
48017,33219,2021-06-24T13:18:30.869591Z,2021,14,3,13,5,0,PK,0,0,9,0,0,11,1,0,14,0,0,0
48017,33220,2021-06-24T13:18:30.8705915Z,2021,9,9,8,3,0,Sin Grado,0,0,6,0,0,0,1,0,9,0,0,0
48017,9209,2020-11-18T16:21:57.313251Z,2020,42,11,34,26,0,1ro,1,0,16,0,0,31,8,0,41,0,0,0
48017,9210,2020-11-18T16:21:57.313251Z,2020,52,19,43,26,0,2do,0,0,26,0,0,33,9,0,52,0,0,0
48017,9211,2020-11-18T16:21:57.313251Z,2020,48,13,39,25,0,3ro,0,0,23,0,0,35,9,0,48,0,0,0
48017,9212,2020-11-18T16:21:57.313251Z,2020,72,27,55,35,0,4to,5,0,37,0,0,45,17,0,67,0,0,0
48017,9213,2020-11-18T16:21:57.313251Z,2020,55,19,42,27,0,5to,1,0,28,0,0,36,13,0,54,0,0,0
48017,9214,2020-11-18T16:21:57.314251Z,2020,49,12,46,15,0,K,0,0,34,0,0,37,3,0,49,0,0,0
48017,9215,2020-11-18T16:21:57.314251Z,2020,17,4,16,8,0,PK,0,0,9,0,0,13,1,0,17,0,0,0
48017,9216,2020-11-18T16:21:57.314251Z,2020,10,10,8,3,0,Sin Grado,0,0,7,0,0,0,2,0,10,0,0,0
40519,2594,2020-11-18T16:20:57.6514681Z,2019,32,3,15,18,0,10mo,0,0,14,0,0,29,17,0,32,1,0,0
40519,2595,2020-11-18T16:20:57.652469Z,2019,44,0,17,24,0,11mo,2,0,20,0,0,44,27,0,42,0,0,0
40519,2596,2020-11-18T16:20:57.652469Z,2019,25,0,9,13,0,12mo,2,0,12,0,0,25,16,1,22,0,0,0
40519,2597,2020-11-18T16:20:57.652469Z,2019,50,4,27,33,0,6to,2,0,17,0,0,46,23,0,48,1,0,0
40519,2598,2020-11-18T16:20:57.652469Z,2019,74,8,42,33,0,7mo,4,1,41,0,0,66,32,0,70,1,1,0
40519,2599,2020-11-18T16:20:57.6534703Z,2019,70,3,39,29,0,8vo,2,0,41,0,0,67,31,0,68,1,0,0
40519,2600,2020-11-18T16:20:57.6534703Z,2019,42,1,18,17,0,9no,0,0,25,0,0,41,24,1,41,1,0,0
40519,32601,2021-06-24T13:18:26.2292634Z,2021,52,1,27,26,0,10mo,3,0,26,0,0,51,25,0,49,1,0,0
40519,32602,2021-06-24T13:18:26.2292634Z,2021,44,1,21,16,0,11mo,0,0,28,0,0,43,23,1,43,1,0,0
40519,32603,2021-06-24T13:18:26.2292634Z,2021,33,2,17,16,0,12mo,0,0,17,0,0,31,16,0,33,1,0,0
40519,32604,2021-06-24T13:18:26.2302639Z,2021,52,4,28,32,0,6to,4,0,20,0,0,48,24,0,48,0,0,0
40519,32605,2021-06-24T13:18:26.2302639Z,2021,43,4,23,27,0,7mo,2,0,16,0,0,39,20,0,41,0,0,0
40519,32606,2021-06-24T13:18:26.2302639Z,2021,56,3,27,36,0,8vo,2,0,20,0,0,53,29,0,54,1,0,0
40519,32607,2021-06-24T13:18:26.2302639Z,2021,65,6,33,32,0,9no,2,1,33,0,0,59,32,0,63,2,0,0
40519,8605,2020-11-18T16:21:53.0363963Z,2020,43,1,20,16,0,10mo,0,0,27,0,0,42,23,1,42,1,0,0
40519,8606,2020-11-18T16:21:53.0373972Z,2020,37,4,12,19,0,11mo,0,0,18,0,0,33,25,0,37,1,0,0
40519,8607,2020-11-18T16:21:53.0373972Z,2020,49,0,16,24,0,12mo,2,0,25,0,0,49,33,0,47,0,0,0
40519,8608,2020-11-18T16:21:53.0373972Z,2020,47,4,25,28,0,6to,2,0,19,0,0,43,22,0,45,0,0,0
40519,8609,2020-11-18T16:21:53.0373972Z,2020,55,3,29,34,0,7mo,2,1,21,0,0,52,26,0,53,1,0,0
40519,8610,2020-11-18T16:21:53.0383985Z,2020,70,7,36,33,0,8vo,2,1,37,0,0,63,34,0,68,1,1,0
40519,8611,2020-11-18T16:21:53.0383985Z,2020,47,1,15,22,0,9no,2,1,25,0,0,46,32,0,45,1,0,0
22772,1337,2020-11-18T16:20:45.8906254Z,2019,38,6,17,29,0,10mo,2,0,9,0,0,32,21,0,36,0,0,0
22772,1338,2020-11-18T16:20:45.8906254Z,2019,45,4,18,25,0,11mo,0,0,20,0,0,41,27,0,45,0,0,0
22772,1339,2020-11-18T16:20:45.8916254Z,2019,43,0,20,28,0,12mo,0,0,15,0,0,43,23,0,43,0,0,0
22772,1340,2020-11-18T16:20:45.8916254Z,2019,25,1,6,21,0,7mo,1,0,4,0,0,24,19,0,24,0,1,0
22772,1341,2020-11-18T16:20:45.8916254Z,2019,23,5,12,18,0,8vo,0,0,5,0,0,18,11,0,23,0,0,0
22772,1342,2020-11-18T16:20:45.8916254Z,2019,53,11,25,33,0,9no,0,0,20,0,0,42,28,0,53,2,0,0
22772,1343,2020-11-18T16:20:45.8926258Z,2019,16,9,10,6,0,Sin Grado,0,0,10,0,0,7,6,0,16,0,0,0
22772,31338,2021-06-24T13:18:14.5949151Z,2021,45,8,30,30,0,10mo,1,0,15,0,0,37,15,0,44,0,0,0
22772,31339,2021-06-24T13:18:14.5959156Z,2021,50,10,27,30,0,11mo,0,0,20,0,0,40,23,0,50,2,0,0
22772,31340,2021-06-24T13:18:14.5959156Z,2021,37,6,21,27,0,12mo,2,0,10,0,0,31,16,0,35,0,0,0
22772,31341,2021-06-24T13:18:14.5959156Z,2021,21,3,14,13,0,6to,0,0,8,0,0,18,7,0,20,0,0,1
22772,31342,2021-06-24T13:18:14.5969161Z,2021,20,1,12,15,0,7mo,0,0,5,0,0,19,8,0,20,0,0,0
22772,31343,2021-06-24T13:18:14.5969161Z,2021,32,2,11,25,0,8vo,0,0,7,0,0,30,21,0,32,0,0,0
22772,31344,2021-06-24T13:18:14.5969161Z,2021,41,3,18,31,0,9no,1,0,10,0,0,38,23,0,40,0,0,0
22772,31345,2021-06-24T13:18:14.597917Z,2021,12,12,9,5,0,Sin Grado,2,0,7,0,0,0,3,0,10,0,0,0
22772,7342,2020-11-18T16:21:45.3402702Z,2020,49,10,3,29,0,10mo,0,0,20,0,0,39,46,0,49,2,0,0
22772,7343,2020-11-18T16:21:45.3402702Z,2020,38,6,1,28,0,11mo,2,0,10,0,0,32,37,0,36,0,0,0
22772,7344,2020-11-18T16:21:45.3412693Z,2020,38,3,11,22,0,12mo,0,0,16,0,0,35,27,0,38,0,0,0
22772,7345,2020-11-18T16:21:45.3412693Z,2020,23,1,5,18,0,7mo,0,0,5,0,0,22,18,0,23,0,0,0
22772,7346,2020-11-18T16:21:45.3412693Z,2020,30,1,10,25,0,8vo,1,0,5,0,0,29,20,0,29,0,1,0
22772,7347,2020-11-18T16:21:45.3422697Z,2020,44,10,1,29,0,9no,0,0,15,0,0,34,43,0,44,0,0,0
22772,7348,2020-11-18T16:21:45.3422697Z,2020,13,12,1,6,0,Sin Grado,1,0,7,0,0,1,12,0,12,0,0,0
12260,30320,2021-06-24T13:18:08.827779Z,2021,23,12,20,13,0,1ro,0,0,10,0,0,11,3,0,23,0,0,0
12260,30321,2021-06-24T13:18:08.827779Z,2021,26,11,23,16,0,2do,0,2,10,0,0,15,3,0,26,0,0,0
12260,30322,2021-06-24T13:18:08.8287795Z,2021,43,15,37,19,0,3ro,0,2,24,0,0,28,6,0,43,0,0,0
12260,30323,2021-06-24T13:18:08.8287795Z,2021,48,15,37,25,0,4to,0,3,23,0,0,33,11,0,48,0,0,0
12260,30324,2021-06-24T13:18:08.8287795Z,2021,34,7,30,19,0,5to,0,2,15,0,0,27,4,0,34,0,0,0
12260,30325,2021-06-24T13:18:08.8287795Z,2021,23,9,23,15,0,K,1,0,8,0,0,14,0,0,22,0,0,0
12260,30326,2021-06-24T13:18:08.8297832Z,2021,4,4,4,2,0,PK,0,0,2,0,0,0,0,0,4,0,0,0
12260,322,2020-11-18T16:20:39.629448Z,2019,52,20,40,23,0,1ro,0,3,29,0,0,32,12,0,52,0,0,0
12260,323,2020-11-18T16:20:39.6304485Z,2019,43,15,34,23,0,2do,0,3,20,0,0,28,9,0,43,0,0,0
12260,324,2020-11-18T16:20:39.6304485Z,2019,40,9,29,21,0,3ro,0,3,19,0,0,31,11,0,40,0,0,0
12260,325,2020-11-18T16:20:39.6304485Z,2019,41,15,28,11,0,4to,0,1,30,0,0,26,13,0,41,0,0,0
12260,326,2020-11-18T16:20:39.6314489Z,2019,49,16,43,23,0,5to,0,2,26,0,0,33,6,0,49,0,0,0
12260,327,2020-11-18T16:20:39.6314489Z,2019,27,9,19,17,0,K,0,1,10,0,0,18,8,0,27,0,0,0
12260,328,2020-11-18T16:20:39.6314489Z,2019,9,8,8,6,0,Sin Grado,0,0,3,0,0,1,1,0,9,0,0,0
12260,6323,2020-11-18T16:21:39.2371975Z,2020,27,11,22,15,0,1ro,0,2,12,0,0,16,5,0,27,0,0,0
12260,6324,2020-11-18T16:21:39.238198Z,2020,43,14,32,20,0,2do,0,2,23,0,0,29,11,0,43,0,0,0
12260,6325,2020-11-18T16:21:39.238198Z,2020,44,13,29,24,0,3ro,0,3,20,0,0,31,15,0,44,0,0,0
12260,6326,2020-11-18T16:21:39.238198Z,2020,33,6,26,18,0,4to,0,3,15,0,0,27,7,0,33,0,0,0
12260,6327,2020-11-18T16:21:39.238198Z,2020,39,15,29,12,0,5to,0,0,27,0,0,24,10,0,39,0,0,0
12260,6328,2020-11-18T16:21:39.2391984Z,2020,27,12,20,17,0,K,0,0,10,0,0,15,7,0,27,0,0,0
12260,6329,2020-11-18T16:21:39.2391984Z,2020,10,10,10,9,0,PK,0,0,1,0,0,0,0,0,10,0,0,0
40626,2607,2020-11-18T16:20:58.0527337Z,2019,30,14,26,11,0,1ro,0,0,19,0,0,16,4,0,30,0,0,0
40626,2608,2020-11-18T16:20:58.0527337Z,2019,44,18,37,24,0,2do,0,0,20,0,0,26,7,0,44,0,0,0
40626,2609,2020-11-18T16:20:58.0537346Z,2019,36,12,29,16,0,3ro,0,0,20,0,0,24,7,0,36,0,0,0
40626,2610,2020-11-18T16:20:58.0537346Z,2019,41,14,35,25,0,4to,0,0,16,0,0,27,6,0,41,0,0,0
40626,2611,2020-11-18T16:20:58.0537346Z,2019,44,15,37,20,0,5to,0,0,24,0,0,29,7,0,44,0,0,0
40626,2612,2020-11-18T16:20:58.0547359Z,2019,35,9,31,16,0,K,0,0,19,0,0,26,4,0,35,0,0,0
40626,2613,2020-11-18T16:20:58.0547359Z,2019,16,5,9,6,0,PK,0,0,10,0,0,11,7,0,16,0,0,0
40626,32614,2021-06-24T13:18:26.2452748Z,2021,46,20,40,21,0,1ro,0,0,25,0,0,26,6,0,46,0,0,0
40626,32615,2021-06-24T13:18:26.2452748Z,2021,39,11,36,16,0,2do,1,0,23,0,0,28,3,0,38,0,0,0
40626,32616,2021-06-24T13:18:26.2462758Z,2021,31,12,27,12,0,3ro,0,0,19,0,0,19,4,0,31,0,0,0
40626,32617,2021-06-24T13:18:26.2462758Z,2021,41,16,40,24,0,4to,0,0,17,0,0,25,1,0,41,0,0,0
40626,32618,2021-06-24T13:18:26.2462758Z,2021,40,12,36,18,0,5to,0,0,22,0,0,28,4,0,40,0,0,0
40626,32619,2021-06-24T13:18:26.2462758Z,2021,23,4,23,15,0,K,0,0,8,0,0,19,0,0,23,0,0,0
40626,32620,2021-06-24T13:18:26.2462758Z,2021,16,1,15,7,0,PK,0,0,9,0,0,15,1,0,16,0,0,0
40626,8618,2020-11-18T16:21:53.0484052Z,2020,37,10,35,18,0,1ro,0,0,19,0,0,27,2,0,37,0,0,0
40626,8619,2020-11-18T16:21:53.049407Z,2020,29,13,24,12,0,2do,0,0,17,0,0,16,5,0,29,0,0,0
40626,8620,2020-11-18T16:21:53.049407Z,2020,42,16,34,23,0,3ro,0,0,19,0,0,26,8,0,42,0,0,0
40626,8621,2020-11-18T16:21:53.049407Z,2020,39,12,33,18,0,4to,0,0,21,0,0,27,6,0,39,0,0,0
40626,8622,2020-11-18T16:21:53.049407Z,2020,44,15,38,28,0,5to,0,0,16,0,0,29,6,0,44,0,0,0
40626,8623,2020-11-18T16:21:53.0504061Z,2020,39,22,34,16,0,K,0,0,23,0,0,17,5,0,39,0,0,0
40626,8624,2020-11-18T16:21:53.0504061Z,2020,16,6,15,10,0,PK,0,0,6,0,0,10,1,0,16,0,0,0
47084,3114,2020-11-18T16:21:01.0197114Z,2019,21,8,21,12,0,1ro,0,0,9,0,0,13,0,0,21,0,0,0
47084,3115,2020-11-18T16:21:01.0197114Z,2019,36,9,33,17,0,2do,0,0,19,0,0,27,3,0,36,0,0,0
47084,3116,2020-11-18T16:21:01.0197114Z,2019,43,19,39,23,0,3ro,3,1,20,0,0,24,4,0,40,0,1,0
47084,3117,2020-11-18T16:21:01.0197114Z,2019,41,21,38,17,0,4to,0,0,24,0,0,20,3,0,41,0,0,0
47084,3118,2020-11-18T16:21:01.0207123Z,2019,52,18,44,20,0,5to,4,0,32,0,0,34,8,0,48,0,0,0
47084,3119,2020-11-18T16:21:01.0207123Z,2019,53,15,44,31,0,6to,2,0,22,0,0,38,9,0,51,0,0,0
47084,3120,2020-11-18T16:21:01.0207123Z,2019,66,25,60,33,0,7mo,0,0,33,0,0,41,6,0,66,1,0,0
47084,3121,2020-11-18T16:21:01.0207123Z,2019,63,25,57,24,0,8vo,0,0,39,0,0,38,6,0,63,0,0,0
47084,3122,2020-11-18T16:21:01.0217127Z,2019,20,5,16,11,0,K,1,0,9,0,0,15,4,0,19,0,0,0
47084,33129,2021-06-24T13:18:30.3191959Z,2021,19,8,16,10,0,1ro,0,0,9,0,0,11,3,0,19,0,0,0
47084,33130,2021-06-24T13:18:30.3191959Z,2021,14,2,9,11,0,2do,0,0,3,0,0,12,5,0,14,0,0,0
47084,33131,2021-06-24T13:18:30.3191959Z,2021,18,6,17,9,0,3ro,0,0,9,0,0,12,1,0,18,0,0,0
47084,33132,2021-06-24T13:18:30.3191959Z,2021,40,13,34,19,0,4to,0,0,21,0,0,27,6,0,40,0,0,0
47084,33133,2021-06-24T13:18:30.3191959Z,2021,35,18,29,17,0,5to,2,0,18,0,0,17,6,0,33,0,0,0
47084,33134,2021-06-24T13:18:30.3201968Z,2021,57,26,48,32,0,6to,0,0,25,0,0,31,9,1,56,0,0,0
47084,33135,2021-06-24T13:18:30.3201968Z,2021,63,22,54,24,0,7mo,3,0,39,0,0,41,9,0,60,1,0,0
47084,33136,2021-06-24T13:18:30.3201968Z,2021,51,13,41,27,0,8vo,1,0,24,0,0,38,10,0,50,0,0,0
47084,33137,2021-06-24T13:18:30.3201968Z,2021,17,7,13,11,0,K,0,0,6,0,0,10,4,0,17,0,0,0
47084,9128,2020-11-18T16:21:56.1344663Z,2020,15,2,13,9,0,1ro,0,0,6,0,0,13,2,0,15,0,0,0
47084,9129,2020-11-18T16:21:56.1344663Z,2020,21,6,20,11,0,2do,1,0,10,0,0,15,1,0,20,0,0,0
47084,9130,2020-11-18T16:21:56.1354667Z,2020,42,12,39,21,0,3ro,0,0,21,0,0,30,3,0,42,0,0,0
47084,9131,2020-11-18T16:21:56.1354667Z,2020,38,19,33,17,0,4to,2,1,21,0,0,19,5,0,36,0,0,0
47084,9132,2020-11-18T16:21:56.1354667Z,2020,40,19,36,21,0,5to,0,0,19,0,0,21,4,0,40,0,0,0
47084,9133,2020-11-18T16:21:56.1354667Z,2020,67,24,58,25,0,6to,4,0,42,0,0,43,9,0,63,1,0,0
47084,9134,2020-11-18T16:21:56.1364671Z,2020,56,16,53,30,0,7mo,2,0,26,0,0,40,3,0,54,0,0,0
47084,9135,2020-11-18T16:21:56.1364671Z,2020,62,23,52,33,0,8vo,0,0,29,0,0,39,10,0,62,1,0,0
47084,9136,2020-11-18T16:21:56.1364671Z,2020,24,10,21,13,0,K,0,2,11,0,0,14,3,0,24,0,0,0
46664,3078,2020-11-18T16:21:00.3402582Z,2019,113,37,99,51,0,6to,2,11,62,0,0,76,14,0,111,2,1,0
46664,3079,2020-11-18T16:21:00.3412586Z,2019,125,29,110,58,0,7mo,2,10,67,0,0,96,15,0,123,0,4,0
46664,3080,2020-11-18T16:21:00.3412586Z,2019,141,43,117,57,0,8vo,3,2,84,0,0,98,24,0,138,0,1,0
46664,3081,2020-11-18T16:21:00.3412586Z,2019,16,14,14,2,0,Sin Grado,0,2,14,0,0,2,2,0,16,0,0,0
46664,33089,2021-06-24T13:18:29.83685Z,2021,124,40,102,63,0,6to,1,2,61,0,0,84,22,0,123,0,0,0
46664,33090,2021-06-24T13:18:29.83685Z,2021,120,36,92,58,0,7mo,5,0,62,0,0,84,28,0,115,1,0,0
46664,33091,2021-06-24T13:18:29.8378509Z,2021,133,42,98,58,0,8vo,2,1,75,0,0,91,35,0,131,2,1,0
46664,33092,2021-06-24T13:18:29.8378509Z,2021,15,15,13,3,0,Sin Grado,1,0,12,0,0,0,2,0,14,0,0,0
46664,9092,2020-11-18T16:21:55.4440046Z,2020,119,39,97,54,0,6to,3,2,65,0,0,80,22,0,116,1,0,0
46664,9093,2020-11-18T16:21:55.4440046Z,2020,127,42,102,55,0,7mo,4,2,72,0,0,85,25,0,123,2,1,0
46664,9094,2020-11-18T16:21:55.4440046Z,2020,128,29,108,69,0,8vo,1,2,59,0,0,99,20,0,127,0,2,0
46664,9095,2020-11-18T16:21:55.4450064Z,2020,18,18,15,4,0,Sin Grado,1,0,14,0,0,0,3,0,17,0,0,0
31617,1993,2020-11-18T16:20:53.415641Z,2019,41,7,40,17,0,1ro,1,0,24,0,0,34,1,0,40,0,0,0
31617,1994,2020-11-18T16:20:53.416641Z,2019,38,9,31,12,0,2do,1,0,26,0,0,29,7,0,37,0,0,0
31617,1995,2020-11-18T16:20:53.416641Z,2019,35,8,32,19,0,3ro,1,0,16,0,0,27,3,0,34,0,0,0
31617,1996,2020-11-18T16:20:53.416641Z,2019,44,11,39,24,0,4to,1,0,20,0,0,33,5,0,43,0,0,0
31617,1997,2020-11-18T16:20:53.4176432Z,2019,39,8,32,17,0,5to,3,0,22,0,0,31,7,0,36,0,0,0
31617,1998,2020-11-18T16:20:53.4176432Z,2019,1,0,1,0,0,6to,0,0,1,0,0,1,0,0,1,0,0,0
31617,1999,2020-11-18T16:20:53.4176432Z,2019,34,5,31,20,0,K,0,0,14,0,0,29,3,0,34,0,0,0
31617,2000,2020-11-18T16:20:53.4176432Z,2019,19,17,13,6,0,Sin Grado,0,0,13,0,0,2,6,0,19,0,0,0
31617,32001,2021-06-24T13:18:20.0698416Z,2021,25,2,22,16,0,1ro,1,0,9,0,0,23,3,0,24,0,0,0
31617,32002,2021-06-24T13:18:20.0698416Z,2021,36,8,35,16,0,2do,1,0,20,0,0,28,1,0,35,0,0,0
31617,32003,2021-06-24T13:18:20.0708421Z,2021,41,10,38,19,0,3ro,1,0,22,0,0,31,3,0,40,0,0,0
31617,32004,2021-06-24T13:18:20.0708421Z,2021,38,7,31,18,0,4to,1,0,20,0,0,31,7,0,37,0,1,0
31617,32005,2021-06-24T13:18:20.0718435Z,2021,35,9,31,16,0,5to,1,0,19,0,0,26,4,0,34,0,0,0
31617,32006,2021-06-24T13:18:20.0718435Z,2021,30,2,25,18,0,K,0,0,12,0,0,28,5,0,30,0,0,0
31617,32007,2021-06-24T13:18:20.0718435Z,2021,27,25,22,9,0,Sin Grado,0,0,18,0,0,2,5,0,27,0,0,0
31617,8005,2020-11-18T16:21:49.5480737Z,2020,37,7,33,18,0,1ro,1,0,19,0,0,30,4,0,36,0,0,0
31617,8006,2020-11-18T16:21:49.5480737Z,2020,39,10,39,17,0,2do,1,0,22,0,0,29,0,0,37,0,0,1
31617,8007,2020-11-18T16:21:49.5490741Z,2020,36,5,26,17,0,3ro,2,0,19,0,0,31,10,0,33,0,0,1
31617,8008,2020-11-18T16:21:49.5490741Z,2020,46,11,40,22,0,4to,2,0,24,0,0,35,6,0,44,0,0,0
31617,8009,2020-11-18T16:21:49.5490741Z,2020,40,8,34,25,0,5to,1,0,15,0,0,32,6,0,39,0,0,0
31617,8010,2020-11-18T16:21:49.5500754Z,2020,39,4,24,23,0,K,1,0,16,0,0,35,15,0,38,0,0,0
31617,8011,2020-11-18T16:21:49.5500754Z,2020,23,23,20,10,0,Sin Grado,0,0,13,0,0,0,3,0,23,0,0,0
57281,33951,2021-06-24T13:18:36.6547395Z,2021,66,13,40,39,0,10mo,1,2,27,0,0,53,26,0,65,0,0,0
57281,33952,2021-06-24T13:18:36.6547395Z,2021,68,7,49,34,0,11mo,1,2,34,0,0,61,19,0,67,0,0,0
57281,33953,2021-06-24T13:18:36.6547395Z,2021,41,6,20,25,0,12mo,1,0,16,0,0,35,21,0,40,0,0,0
57281,33954,2021-06-24T13:18:36.65574Z,2021,10,2,7,7,0,6to,0,0,3,0,0,8,3,0,10,0,0,0
57281,33955,2021-06-24T13:18:36.65574Z,2021,16,4,9,10,0,7mo,0,1,6,0,0,12,7,0,16,0,0,0
57281,33956,2021-06-24T13:18:36.65574Z,2021,36,5,17,16,0,8vo,1,1,20,0,0,31,19,0,35,2,0,0
57281,33957,2021-06-24T13:18:36.6567414Z,2021,61,10,35,26,0,9no,1,4,35,0,0,51,26,0,60,1,0,0
57281,3928,2020-11-18T16:21:06.794563Z,2019,52,6,21,29,0,10mo,0,5,23,0,0,46,31,0,52,1,0,0
57281,3929,2020-11-18T16:21:06.795563Z,2019,68,5,26,36,0,11mo,1,12,32,0,1,63,42,0,67,3,0,0
57281,3930,2020-11-18T16:21:06.795563Z,2019,62,0,30,32,0,12mo,0,10,30,0,0,62,32,0,61,0,0,1
57281,3931,2020-11-18T16:21:06.795563Z,2019,40,5,17,18,0,7mo,1,2,22,0,0,35,23,0,39,1,0,0
57281,3932,2020-11-18T16:21:06.795563Z,2019,37,5,11,20,0,8vo,0,1,17,0,1,32,26,0,37,0,0,0
57281,3933,2020-11-18T16:21:06.7965643Z,2019,56,6,30,26,0,9no,1,3,30,0,0,50,26,0,55,0,0,0
57281,9945,2020-11-18T16:22:01.546075Z,2020,61,6,34,31,0,10mo,1,1,30,0,0,55,27,0,60,0,0,0
57281,9946,2020-11-18T16:22:01.546075Z,2020,49,7,24,26,0,11mo,1,0,23,0,0,42,25,0,48,0,0,0
57281,9947,2020-11-18T16:22:01.546075Z,2020,62,3,26,32,0,12mo,1,6,30,0,0,59,36,0,61,2,0,0
57281,9948,2020-11-18T16:22:01.546075Z,2020,28,5,20,15,0,7mo,1,2,13,0,0,23,8,0,27,1,0,0
57281,9949,2020-11-18T16:22:01.547075Z,2020,54,8,26,20,0,8vo,1,2,34,0,0,46,28,0,53,1,0,0
57281,9950,2020-11-18T16:22:01.547075Z,2020,53,11,27,30,0,9no,0,1,23,0,0,42,26,0,53,0,0,0
56440,33912,2021-06-24T13:18:36.6177127Z,2021,117,34,99,47,0,6to,6,0,70,0,0,83,18,0,111,0,1,0
56440,33913,2021-06-24T13:18:36.6177127Z,2021,126,28,103,57,0,7mo,4,0,69,0,0,98,23,0,122,0,0,0
56440,33914,2021-06-24T13:18:36.6177127Z,2021,113,32,91,55,0,8vo,1,1,58,0,0,81,22,0,112,0,1,0
56440,33915,2021-06-24T13:18:36.6177127Z,2021,33,32,31,10,0,Sin Grado,0,0,23,0,0,1,2,0,33,0,0,0
56440,3889,2020-11-18T16:21:06.096096Z,2019,126,37,107,60,0,6to,1,1,66,0,0,89,19,0,125,0,1,0
56440,3890,2020-11-18T16:21:06.096096Z,2019,115,38,93,51,0,7mo,1,0,64,0,0,77,22,0,114,0,0,0
56440,3891,2020-11-18T16:21:06.096096Z,2019,123,40,102,53,0,8vo,0,0,70,0,0,83,21,0,123,0,0,0
56440,3892,2020-11-18T16:21:06.0970977Z,2019,23,17,19,10,0,Sin Grado,0,0,13,0,0,6,4,0,23,0,0,0
56440,9906,2020-11-18T16:22:01.5310647Z,2020,130,31,116,62,0,6to,5,3,68,0,0,99,14,0,125,1,0,0
56440,9907,2020-11-18T16:22:01.5310647Z,2020,129,33,111,62,0,7mo,1,4,67,0,0,96,18,0,128,0,1,0
56440,9908,2020-11-18T16:22:01.5320652Z,2020,107,33,91,52,0,8vo,1,0,55,0,0,74,16,1,105,0,0,0
56440,9909,2020-11-18T16:22:01.5320652Z,2020,27,27,26,8,0,Sin Grado,1,2,19,0,0,0,1,0,26,0,0,0
10272,10,2020-11-18T16:20:36.6824855Z,2019,21,2,20,14,0,K,0,0,7,0,0,19,1,0,21,0,0,0
10272,2,2020-11-18T16:20:36.6804846Z,2019,17,4,16,7,0,1ro,0,0,10,0,0,13,1,0,17,0,0,0
10272,3,2020-11-18T16:20:36.6814846Z,2019,15,5,15,5,0,2do,1,0,10,0,0,10,0,0,14,0,0,0
10272,30001,2021-06-24T13:18:05.9116889Z,2021,15,3,11,8,0,1ro,1,2,7,0,0,12,4,0,14,0,0,0
10272,30002,2021-06-24T13:18:05.9116889Z,2021,22,6,20,12,0,2do,0,0,10,0,0,16,2,0,22,0,0,0
10272,30003,2021-06-24T13:18:05.9126894Z,2021,23,6,21,11,0,3ro,0,0,12,0,0,17,2,0,23,0,0,0
10272,30004,2021-06-24T13:18:05.9126894Z,2021,18,5,16,6,0,4to,1,1,12,0,0,13,2,0,17,0,0,0
10272,30005,2021-06-24T13:18:05.9126894Z,2021,16,5,14,9,0,5to,0,1,7,0,0,11,2,0,16,0,0,0
10272,30006,2021-06-24T13:18:05.9126894Z,2021,43,16,39,20,0,6to,1,5,23,0,0,27,4,0,42,0,0,0
10272,30007,2021-06-24T13:18:05.9136899Z,2021,38,21,34,18,0,7mo,0,4,20,0,0,17,4,0,38,0,0,0
10272,30008,2021-06-24T13:18:05.9136899Z,2021,42,24,39,22,0,8vo,0,2,20,0,0,18,3,0,42,0,0,0
10272,30009,2021-06-24T13:18:05.9136899Z,2021,12,2,9,3,0,K,0,0,9,0,0,10,3,0,12,0,0,0
10272,30010,2021-06-24T13:18:05.9136899Z,2021,9,0,9,5,0,PK,0,0,4,0,0,9,0,0,9,0,0,0
10272,4,2020-11-18T16:20:36.6814846Z,2019,17,7,16,9,0,3ro,0,2,8,0,0,10,1,0,17,0,0,0
10272,5,2020-11-18T16:20:36.6814846Z,2019,29,10,24,14,0,4to,0,1,15,0,0,19,5,0,29,0,0,0
10272,6,2020-11-18T16:20:36.6814846Z,2019,42,22,37,20,0,5to,0,11,22,0,0,20,5,0,42,0,0,0
10272,6002,2020-11-18T16:21:37.6781557Z,2020,21,3,21,12,0,1ro,0,0,9,0,0,18,0,0,21,0,0,0
10272,6003,2020-11-18T16:21:37.6781557Z,2020,20,4,19,8,0,2do,0,0,12,0,0,16,1,0,20,0,0,0
10272,6004,2020-11-18T16:21:37.6781557Z,2020,19,5,19,6,0,3ro,1,0,13,0,0,14,0,0,18,0,0,0
10272,6005,2020-11-18T16:21:37.6781557Z,2020,18,6,16,10,0,4to,0,0,8,0,0,12,2,0,18,0,0,0
10272,6006,2020-11-18T16:21:37.6781557Z,2020,34,13,29,14,0,5to,0,0,20,0,0,21,5,0,34,0,0,0
10272,6007,2020-11-18T16:21:37.6781557Z,2020,40,22,34,18,0,6to,1,0,22,0,0,18,6,0,39,0,0,0
10272,6008,2020-11-18T16:21:37.6791574Z,2020,40,19,35,20,0,7mo,0,0,20,0,0,21,5,0,40,0,0,0
10272,6009,2020-11-18T16:21:37.6791574Z,2020,33,9,23,18,0,8vo,1,0,15,0,0,24,10,0,32,0,0,0
10272,6010,2020-11-18T16:21:37.6791574Z,2020,11,1,9,4,0,K,0,0,7,0,0,10,2,0,11,0,0,0
10272,6011,2020-11-18T16:21:37.6791574Z,2020,10,0,9,4,0,PK,0,0,6,0,0,10,1,0,10,0,0,0
10272,7,2020-11-18T16:20:36.6824855Z,2019,37,19,31,19,0,6to,0,1,18,0,0,18,6,0,37,0,0,0
10272,8,2020-11-18T16:20:36.6824855Z,2019,30,9,21,16,0,7mo,1,1,14,0,0,21,9,0,29,0,0,0
10272,9,2020-11-18T16:20:36.6824855Z,2019,32,9,27,14,0,8vo,0,1,18,0,0,23,5,0,32,0,0,0
11403,180,2020-11-18T16:20:37.5790802Z,2019,48,14,45,25,0,1ro,1,0,23,0,0,34,3,0,47,1,0,0
11403,181,2020-11-18T16:20:37.5790802Z,2019,40,22,37,17,0,2do,0,0,23,0,0,18,3,0,39,0,0,1
11403,182,2020-11-18T16:20:37.5800797Z,2019,44,26,39,17,0,3ro,0,0,27,0,0,18,5,0,44,0,0,0
11403,183,2020-11-18T16:20:37.5800797Z,2019,44,20,38,22,0,4to,0,0,22,0,0,24,6,0,44,0,0,0
11403,184,2020-11-18T16:20:37.5800797Z,2019,41,13,32,21,0,5to,0,0,20,0,0,28,9,0,41,0,0,0
11403,185,2020-11-18T16:20:37.5810802Z,2019,47,13,45,24,0,K,0,0,23,0,0,34,2,0,47,0,0,0
11403,186,2020-11-18T16:20:37.5810802Z,2019,18,18,17,4,0,Sin Grado,0,0,14,0,0,0,1,0,18,0,0,0
11403,30179,2021-06-24T13:18:06.327987Z,2021,44,13,40,21,0,1ro,1,0,23,0,0,31,4,1,42,0,0,0
11403,30180,2021-06-24T13:18:06.327987Z,2021,46,11,44,24,0,2do,1,0,22,0,0,35,2,0,45,0,0,0
11403,30181,2021-06-24T13:18:06.3289884Z,2021,48,19,46,23,0,3ro,0,0,25,0,0,29,2,0,46,1,0,2
11403,30182,2021-06-24T13:18:06.3289884Z,2021,33,14,30,14,0,4to,0,0,19,0,0,19,3,0,33,0,0,0
11403,30183,2021-06-24T13:18:06.3289884Z,2021,41,22,35,20,0,5to,0,0,21,0,0,19,6,0,41,0,0,0
11403,30184,2021-06-24T13:18:06.3289884Z,2021,34,10,32,22,0,K,1,0,12,0,0,24,2,0,33,0,0,0
11403,30185,2021-06-24T13:18:06.3299902Z,2021,13,13,12,1,0,Sin Grado,0,0,12,0,0,0,1,0,13,0,0,0
11403,6181,2020-11-18T16:21:38.256542Z,2020,48,13,44,28,0,1ro,1,0,20,0,0,35,4,0,47,0,0,0
11403,6182,2020-11-18T16:21:38.2575425Z,2020,47,21,43,20,0,2do,0,0,27,0,0,26,4,0,46,1,0,1
11403,6183,2020-11-18T16:21:38.2575425Z,2020,29,13,26,11,0,3ro,0,0,18,0,0,16,3,0,29,0,0,0
11403,6184,2020-11-18T16:21:38.2575425Z,2020,39,23,34,18,0,4to,0,0,21,0,0,16,5,0,39,0,0,0
11403,6185,2020-11-18T16:21:38.2575425Z,2020,42,19,39,18,0,5to,0,0,24,0,0,23,3,0,42,0,0,0
11403,6186,2020-11-18T16:21:38.2575425Z,2020,42,15,40,17,0,K,1,0,25,0,0,27,2,0,41,0,0,0
11403,6187,2020-11-18T16:21:38.2575425Z,2020,21,20,20,6,0,Sin Grado,1,0,15,0,0,1,1,0,20,0,0,0
47977,3178,2020-11-18T16:21:01.0377248Z,2019,38,13,31,20,0,1ro,0,0,18,0,0,25,7,0,38,0,0,0
47977,3179,2020-11-18T16:21:01.0377248Z,2019,55,17,45,26,0,2do,1,0,29,0,0,38,10,0,54,0,0,0
47977,3180,2020-11-18T16:21:01.0377248Z,2019,46,16,41,17,0,3ro,0,0,29,0,0,30,5,0,46,0,0,0
47977,3181,2020-11-18T16:21:01.0377248Z,2019,49,17,37,25,0,4to,1,0,24,0,0,32,12,0,48,0,0,0
47977,3182,2020-11-18T16:21:01.0377248Z,2019,53,17,44,24,1,5to,1,1,29,0,0,36,9,0,52,0,0,0
47977,3183,2020-11-18T16:21:01.0387248Z,2019,54,15,42,23,0,6to,2,0,31,0,0,39,12,0,52,0,0,0
47977,3184,2020-11-18T16:21:01.0387248Z,2019,97,30,81,51,0,7mo,0,0,46,0,0,67,16,0,96,0,0,1
47977,3185,2020-11-18T16:21:01.0387248Z,2019,70,17,57,37,0,8vo,0,0,33,0,0,53,13,0,70,0,0,0
47977,3186,2020-11-18T16:21:01.0387248Z,2019,41,9,29,22,0,K,0,0,19,0,0,32,12,0,41,0,0,0
47977,3187,2020-11-18T16:21:01.0397247Z,2019,29,20,29,6,0,Sin Grado,0,0,23,0,0,9,0,0,29,0,0,0
47977,33203,2021-06-24T13:18:30.8675895Z,2021,33,9,30,15,0,1ro,0,0,18,0,0,24,3,0,33,0,0,0
47977,33204,2021-06-24T13:18:30.8675895Z,2021,46,14,40,28,0,2do,0,0,18,0,0,32,6,0,46,0,0,0
47977,33205,2021-06-24T13:18:30.8675895Z,2021,44,11,38,23,0,3ro,0,0,21,0,0,33,6,0,44,0,0,0
47977,33206,2021-06-24T13:18:30.8675895Z,2021,56,17,47,27,0,4to,1,0,29,0,0,39,9,0,55,0,0,0
47977,33207,2021-06-24T13:18:30.8685905Z,2021,53,22,41,23,0,5to,1,0,30,0,0,31,12,0,52,0,0,0
47977,33208,2021-06-24T13:18:30.8685905Z,2021,65,24,57,30,0,6to,2,0,35,0,0,41,8,0,63,0,0,0
47977,33209,2021-06-24T13:18:30.8685905Z,2021,64,18,52,30,0,7mo,1,0,34,0,0,46,12,0,63,0,0,0
47977,33210,2021-06-24T13:18:30.8685905Z,2021,60,20,50,27,0,8vo,2,0,33,0,0,40,10,0,58,0,0,0
47977,33211,2021-06-24T13:18:30.8685905Z,2021,32,9,27,13,0,K,0,0,19,0,0,23,5,0,32,0,0,0
47977,33212,2021-06-24T13:18:30.869591Z,2021,20,20,16,6,0,Sin Grado,0,0,14,0,0,0,4,0,20,0,0,0
47977,9199,2020-11-18T16:21:56.1524787Z,2020,46,11,36,28,0,1ro,0,0,18,0,0,35,10,0,46,0,0,0
47977,9200,2020-11-18T16:21:56.1524787Z,2020,42,10,35,23,0,2do,0,0,19,0,0,32,7,0,42,0,0,0
47977,9201,2020-11-18T16:21:57.3112484Z,2020,57,18,47,27,0,3ro,1,0,30,0,0,39,10,0,56,0,0,0
47977,9202,2020-11-18T16:21:57.3112484Z,2020,44,15,39,16,0,4to,0,0,28,0,0,29,5,0,44,0,0,0
47977,9203,2020-11-18T16:21:57.3122501Z,2020,56,16,45,25,0,5to,1,0,31,0,0,40,11,0,55,0,0,0
47977,9204,2020-11-18T16:21:57.3122501Z,2020,58,17,48,28,0,6to,1,0,30,0,0,41,10,0,57,0,0,0
47977,9205,2020-11-18T16:21:57.3122501Z,2020,57,18,50,21,0,7mo,2,0,36,0,0,39,7,0,55,0,0,0
47977,9206,2020-11-18T16:21:57.313251Z,2020,94,34,80,50,0,8vo,0,0,44,0,0,60,14,0,93,0,0,1
47977,9207,2020-11-18T16:21:57.313251Z,2020,32,7,28,15,0,K,0,0,17,0,0,25,4,0,32,0,0,0
47977,9208,2020-11-18T16:21:57.313251Z,2020,26,26,26,8,0,Sin Grado,0,0,18,0,0,0,0,0,26,0,1,0
48298,3208,2020-11-18T16:21:01.4349903Z,2019,193,43,156,108,0,10mo,4,0,85,0,0,150,37,0,189,0,0,0
48298,3209,2020-11-18T16:21:01.4349903Z,2019,207,25,171,108,0,11mo,6,1,99,0,0,182,36,0,201,0,0,0
48298,3210,2020-11-18T16:21:01.4349903Z,2019,217,0,182,128,0,12mo,10,1,89,0,0,217,35,0,207,0,0,0
48298,3211,2020-11-18T16:21:01.4349903Z,2019,206,50,182,119,0,9no,9,0,87,0,0,156,24,0,197,0,0,0
48298,33233,2021-06-24T13:18:30.8745948Z,2021,209,55,188,118,0,10mo,3,0,91,0,0,154,21,0,206,0,0,0
48298,33234,2021-06-24T13:18:30.8745948Z,2021,158,39,146,92,0,11mo,2,0,66,0,0,119,12,0,155,0,0,1
48298,33235,2021-06-24T13:18:30.8755948Z,2021,158,34,137,91,0,12mo,3,0,67,0,0,124,21,0,155,0,0,0
48298,33236,2021-06-24T13:18:30.8755948Z,2021,162,45,138,80,0,9no,3,0,82,0,0,117,24,0,159,0,0,0
48298,9228,2020-11-18T16:21:57.3172532Z,2020,167,40,146,99,0,10mo,5,1,68,0,0,127,21,0,162,0,0,0
48298,9229,2020-11-18T16:21:57.3172532Z,2020,173,37,147,95,0,11mo,3,0,78,0,0,136,26,0,170,0,0,0
48298,9230,2020-11-18T16:21:57.3182554Z,2020,201,29,166,108,0,12mo,6,1,93,0,0,172,35,0,195,0,0,0
48298,9231,2020-11-18T16:21:57.3182554Z,2020,229,59,204,126,0,9no,3,0,103,0,0,170,25,0,226,0,0,0
46219,3067,2020-11-18T16:21:00.3372555Z,2019,102,28,88,51,0,10mo,1,0,51,0,0,74,14,0,101,0,0,0
46219,3068,2020-11-18T16:21:00.3372555Z,2019,60,12,46,35,0,11mo,1,0,25,0,0,48,14,0,59,0,0,0
46219,3069,2020-11-18T16:21:00.3382568Z,2019,65,0,54,36,0,12mo,1,2,29,0,1,65,11,0,64,0,0,0
46219,3070,2020-11-18T16:21:00.3382568Z,2019,79,21,64,42,0,9no,0,2,37,0,1,58,15,0,79,0,0,0
46219,33077,2021-06-24T13:18:29.8318466Z,2021,78,16,64,48,0,10mo,0,0,30,0,0,62,14,0,78,0,0,0
46219,33078,2021-06-24T13:18:29.8318466Z,2021,72,19,60,35,0,11mo,0,0,37,0,0,53,12,0,72,0,0,0
46219,33079,2021-06-24T13:18:29.8318466Z,2021,84,23,73,46,0,12mo,1,0,38,0,0,61,11,0,83,0,0,0
46219,33080,2021-06-24T13:18:29.8318466Z,2021,97,29,81,56,0,9no,0,0,41,0,0,68,16,0,96,0,0,1
46219,33081,2021-06-24T13:18:29.8328476Z,2021,7,7,6,4,0,Sin Grado,0,0,3,0,0,0,1,0,7,0,1,0
46219,9081,2020-11-18T16:21:55.4430041Z,2020,85,21,72,43,0,10mo,0,1,42,0,0,64,13,0,85,0,0,0
46219,9082,2020-11-18T16:21:55.4430041Z,2020,95,28,79,49,0,11mo,1,1,46,0,0,67,16,0,94,0,0,0
46219,9083,2020-11-18T16:21:55.4430041Z,2020,59,12,45,35,0,12mo,1,0,24,0,0,47,14,0,58,0,0,0
46219,9084,2020-11-18T16:21:55.4440046Z,2020,82,18,63,49,0,9no,0,0,33,0,0,64,19,0,82,0,0,0
12138,297,2020-11-18T16:20:39.1911552Z,2019,22,12,20,7,0,1ro,0,0,15,0,0,10,2,0,22,0,0,0
12138,298,2020-11-18T16:20:39.1911552Z,2019,12,4,11,6,0,2do,0,0,6,0,0,8,1,0,12,0,0,0
12138,299,2020-11-18T16:20:39.1911552Z,2019,23,7,21,15,0,3ro,0,0,8,0,0,16,2,0,23,0,0,0
12138,300,2020-11-18T16:20:39.1911552Z,2019,18,11,15,6,0,4to,0,0,12,0,0,7,3,0,18,0,0,0
12138,301,2020-11-18T16:20:39.6174427Z,2019,22,6,17,8,0,5to,0,0,14,0,0,16,5,0,22,0,0,0
12138,302,2020-11-18T16:20:39.6184409Z,2019,24,8,22,18,0,K,0,0,6,0,0,16,2,0,24,0,0,0
12138,30295,2021-06-24T13:18:07.41877Z,2021,19,4,16,10,0,1ro,0,0,9,0,0,15,3,0,19,0,0,0
12138,30296,2021-06-24T13:18:07.41877Z,2021,23,12,21,6,0,2do,0,0,17,0,0,11,2,0,23,0,0,0
12138,30297,2021-06-24T13:18:07.4197701Z,2021,18,9,15,6,0,3ro,0,0,12,0,0,9,3,0,18,0,0,0
12138,30298,2021-06-24T13:18:07.4197701Z,2021,10,5,9,5,0,4to,0,0,5,0,0,5,1,0,10,0,0,0
12138,30299,2021-06-24T13:18:07.4197701Z,2021,18,6,16,11,0,5to,0,0,7,0,0,12,2,0,18,0,0,0
12138,30300,2021-06-24T13:18:08.7777436Z,2021,17,2,14,9,0,K,0,0,8,0,0,15,3,0,17,0,0,0
12138,6298,2020-11-18T16:21:38.6448023Z,2020,27,11,24,7,0,1ro,0,0,20,0,0,16,3,0,27,0,0,0
12138,6299,2020-11-18T16:21:38.6448023Z,2020,17,11,16,6,0,2do,0,0,11,0,0,6,1,0,17,0,0,0
12138,6300,2020-11-18T16:21:38.6448023Z,2020,12,4,11,7,0,3ro,0,0,5,0,0,8,1,0,12,0,0,0
12138,6301,2020-11-18T16:21:39.2261895Z,2020,20,7,17,13,0,4to,0,0,7,0,0,13,3,0,20,0,0,0
12138,6302,2020-11-18T16:21:39.2271904Z,2020,15,8,12,6,0,5to,0,0,9,0,0,7,3,0,15,0,0,0
12138,6303,2020-11-18T16:21:39.2271904Z,2020,20,4,18,12,0,K,0,0,8,0,0,16,2,0,20,0,0,0
61556,10286,2020-11-18T16:22:03.1371311Z,2020,25,4,23,20,0,1ro,0,0,5,0,0,21,2,0,25,0,0,0
61556,10287,2020-11-18T16:22:03.138132Z,2020,15,4,15,8,0,2do,0,0,7,0,0,11,0,0,15,0,0,0
61556,10288,2020-11-18T16:22:03.138132Z,2020,40,4,37,20,0,3ro,1,0,20,0,0,36,3,0,39,0,0,0
61556,10289,2020-11-18T16:22:03.138132Z,2020,44,11,44,20,0,4to,1,0,24,0,0,33,0,0,43,0,0,0
61556,10290,2020-11-18T16:22:03.138132Z,2020,28,14,28,19,0,5to,1,0,9,0,0,14,0,0,27,0,0,0
61556,10291,2020-11-18T16:22:03.138132Z,2020,41,12,40,23,0,6to,1,1,18,0,0,29,1,0,40,0,0,0
61556,10292,2020-11-18T16:22:03.1391338Z,2020,31,10,27,11,0,7mo,1,0,20,0,0,21,4,0,30,0,0,0
61556,10293,2020-11-18T16:22:03.1391338Z,2020,34,20,33,14,0,8vo,2,0,20,0,0,14,1,0,32,0,0,0
61556,10294,2020-11-18T16:22:03.1391338Z,2020,18,3,13,8,0,K,0,0,10,0,0,15,5,0,18,0,0,0
61556,10295,2020-11-18T16:22:03.1391338Z,2020,16,13,16,3,0,Sin Grado,0,0,13,0,0,3,0,0,16,0,0,0
61556,34301,2021-06-24T13:18:38.6011349Z,2021,24,3,23,10,0,1ro,0,0,14,0,0,21,1,0,24,0,0,0
61556,34302,2021-06-24T13:18:38.6011349Z,2021,19,2,18,10,0,2do,0,0,9,0,0,17,1,0,19,0,0,0
61556,34303,2021-06-24T13:18:38.6011349Z,2021,13,2,11,8,0,3ro,0,0,5,0,0,11,2,0,13,0,0,0
61556,34304,2021-06-24T13:18:38.6021359Z,2021,30,5,27,14,0,4to,1,0,16,0,0,25,3,0,29,0,0,0
61556,34305,2021-06-24T13:18:38.6021359Z,2021,32,11,28,13,0,5to,0,0,19,0,0,21,4,0,32,0,0,0
61556,34306,2021-06-24T13:18:38.6021359Z,2021,26,15,20,15,0,6to,1,0,11,0,0,11,6,0,25,0,0,0
61556,34307,2021-06-24T13:18:38.6021359Z,2021,27,10,25,19,0,7mo,1,0,8,0,0,17,2,0,26,0,0,0
61556,34308,2021-06-24T13:18:38.6031364Z,2021,26,9,24,7,0,8vo,1,0,19,0,0,17,2,0,25,0,0,0
61556,34309,2021-06-24T13:18:38.6031364Z,2021,22,7,16,8,0,K,0,0,14,0,0,15,6,0,22,0,0,0
61556,34310,2021-06-24T13:18:38.6031364Z,2021,11,11,11,4,0,Sin Grado,0,0,7,0,0,0,0,0,11,0,0,0
61556,4272,2020-11-18T16:21:09.0400609Z,2019,20,6,16,11,0,1ro,0,0,9,0,0,14,4,0,20,0,0,0
61556,4273,2020-11-18T16:21:09.0400609Z,2019,39,5,36,18,0,2do,0,0,21,0,0,34,3,0,39,0,0,0
61556,4274,2020-11-18T16:21:09.0410614Z,2019,40,9,40,18,0,3ro,0,0,22,0,0,31,0,0,40,0,0,0
61556,4275,2020-11-18T16:21:09.0410614Z,2019,32,15,32,21,0,4to,0,0,11,0,0,17,0,0,32,0,0,0
61556,4276,2020-11-18T16:21:09.0410614Z,2019,33,8,32,20,0,5to,0,0,13,0,0,25,1,0,33,0,0,0
61556,4277,2020-11-18T16:21:09.0410614Z,2019,26,11,22,8,0,6to,1,0,18,0,0,15,4,0,25,0,0,0
61556,4278,2020-11-18T16:21:09.0410614Z,2019,41,20,39,19,0,7mo,1,0,22,0,0,21,2,0,40,0,0,0
61556,4279,2020-11-18T16:21:09.0410614Z,2019,20,11,20,7,0,8vo,0,0,13,0,0,9,0,0,20,0,0,0
61556,4280,2020-11-18T16:21:09.0420618Z,2019,28,4,2,25,0,K,0,0,3,0,0,24,26,0,28,0,0,0
61556,4281,2020-11-18T16:21:09.0420618Z,2019,13,10,13,2,0,Sin Grado,0,0,11,0,0,3,0,0,13,0,0,0
17780,30770,2021-06-24T13:18:11.1994797Z,2021,66,20,43,32,0,1ro,0,0,34,0,0,46,23,0,66,0,0,0
17780,30771,2021-06-24T13:18:11.2004806Z,2021,73,27,57,40,0,2do,0,0,33,0,0,46,16,0,73,0,0,0
17780,30772,2021-06-24T13:18:11.2004806Z,2021,51,17,38,19,0,3ro,0,0,32,0,0,34,13,0,51,0,0,0
17780,30773,2021-06-24T13:18:11.2004806Z,2021,57,20,44,30,0,4to,0,0,27,0,0,37,13,0,57,0,0,0
17780,30774,2021-06-24T13:18:11.2014829Z,2021,44,16,30,25,0,5to,0,0,19,0,0,28,14,0,44,0,0,0
17780,30775,2021-06-24T13:18:11.2014829Z,2021,65,13,47,26,0,K,0,0,39,0,0,52,18,0,64,0,0,1
17780,30776,2021-06-24T13:18:11.202483Z,2021,14,14,11,3,0,Sin Grado,0,0,11,0,0,0,3,0,14,0,0,0
17780,6773,2020-11-18T16:21:41.4496712Z,2020,76,28,55,41,0,1ro,0,0,35,0,0,48,21,0,76,0,0,0
17780,6774,2020-11-18T16:21:41.4506717Z,2020,55,19,37,25,0,2do,0,0,30,0,0,36,18,0,55,0,0,0
17780,6775,2020-11-18T16:21:41.4506717Z,2020,65,21,42,32,0,3ro,0,0,33,0,0,44,23,0,65,0,0,0
17780,6776,2020-11-18T16:21:41.4506717Z,2020,47,18,36,25,0,4to,0,0,22,0,0,29,11,0,47,0,0,0
17780,6777,2020-11-18T16:21:41.4506717Z,2020,54,18,33,25,0,5to,0,0,29,0,0,36,21,0,54,0,0,0
17780,6778,2020-11-18T16:21:41.4516721Z,2020,67,21,44,32,0,K,0,0,35,0,0,46,23,0,67,0,0,0
17780,6779,2020-11-18T16:21:41.4516721Z,2020,11,11,9,2,0,Sin Grado,0,0,9,0,0,0,2,0,11,0,0,0
17780,772,2020-11-18T16:20:42.1201089Z,2019,64,19,43,25,0,1ro,1,0,39,0,0,45,21,0,63,0,0,0
17780,773,2020-11-18T16:20:42.1201089Z,2019,73,21,47,37,0,2do,0,0,36,0,0,52,26,0,73,0,0,0
17780,774,2020-11-18T16:20:42.1211093Z,2019,51,19,32,26,0,3ro,0,0,25,0,0,32,19,0,50,0,0,1
17780,775,2020-11-18T16:20:42.1211093Z,2019,63,19,40,30,0,4to,0,0,33,0,0,44,23,0,63,0,0,0
17780,776,2020-11-18T16:20:42.1211093Z,2019,51,11,33,27,0,5to,0,0,24,0,0,40,18,0,51,0,0,0
17780,777,2020-11-18T16:20:42.1211093Z,2019,76,21,53,44,0,K,0,0,32,0,0,55,23,0,76,0,0,0
17780,778,2020-11-18T16:20:42.1211093Z,2019,15,12,11,4,0,Sin Grado,0,0,11,0,0,3,4,0,15,0,0,0
69021,10826,2020-11-18T16:22:06.5333999Z,2020,38,14,30,15,0,1ro,1,0,23,0,0,24,8,0,37,0,0,0
69021,10827,2020-11-18T16:22:06.5333999Z,2020,39,15,35,16,0,2do,1,0,23,0,0,24,4,0,38,0,0,0
69021,10828,2020-11-18T16:22:06.5344007Z,2020,37,18,33,17,0,3ro,3,0,20,0,0,19,4,0,34,0,0,0
69021,10829,2020-11-18T16:22:06.5344007Z,2020,33,11,30,19,0,4to,1,0,14,0,0,22,3,0,32,0,0,0
69021,10830,2020-11-18T16:22:06.5344007Z,2020,44,18,38,24,0,5to,2,0,20,0,0,26,6,0,42,0,0,0
69021,10831,2020-11-18T16:22:06.5344007Z,2020,27,13,23,9,0,6to,0,0,18,0,0,14,4,0,27,0,0,0
69021,10832,2020-11-18T16:22:06.5354016Z,2020,50,8,43,19,0,K,0,0,31,0,0,42,7,0,50,0,0,0
69021,10833,2020-11-18T16:22:06.5354016Z,2020,23,3,18,9,0,PK,0,0,14,0,0,20,5,0,23,0,0,0
69021,10834,2020-11-18T16:22:06.5354016Z,2020,16,16,15,7,0,Sin Grado,0,0,9,0,0,0,1,0,16,0,0,0
69021,34847,2021-06-24T13:18:42.9912836Z,2021,42,10,36,15,0,1ro,0,0,27,0,0,32,6,0,42,0,0,0
69021,34848,2021-06-24T13:18:42.9922845Z,2021,37,15,33,17,0,2do,2,0,20,0,0,22,4,0,35,0,0,0
69021,34849,2021-06-24T13:18:42.9922845Z,2021,38,13,34,14,0,3ro,1,0,24,0,0,25,4,0,37,0,0,0
69021,34850,2021-06-24T13:18:42.9922845Z,2021,33,16,31,16,0,4to,2,0,17,0,0,17,2,0,31,0,0,0
69021,34851,2021-06-24T13:18:42.9922845Z,2021,29,11,27,16,0,5to,1,0,13,0,0,18,2,0,28,0,0,0
69021,34852,2021-06-24T13:18:42.9932859Z,2021,49,22,44,26,0,6to,2,0,23,0,0,27,5,0,47,0,0,0
69021,34853,2021-06-24T13:18:42.9932859Z,2021,43,16,40,18,0,K,0,0,25,0,0,27,3,0,43,0,0,0
69021,34854,2021-06-24T13:18:42.9932859Z,2021,20,1,15,8,0,PK,0,0,12,0,0,19,5,0,20,0,0,0
69021,34855,2021-06-24T13:18:42.994286Z,2021,15,15,12,5,0,Sin Grado,0,0,10,0,0,0,3,0,15,0,0,0
69021,4819,2020-11-18T16:21:12.3832911Z,2019,38,13,31,15,0,1ro,2,0,23,0,0,25,7,0,36,0,0,0
69021,4820,2020-11-18T16:21:12.3832911Z,2019,43,18,38,21,0,2do,3,0,22,0,0,25,5,0,40,0,0,0
69021,4821,2020-11-18T16:21:12.3842916Z,2019,45,18,39,21,0,3ro,1,0,24,0,0,27,6,0,44,0,0,0
69021,4822,2020-11-18T16:21:12.3842916Z,2019,43,17,37,22,0,4to,2,0,21,0,0,26,6,0,41,0,0,0
69021,4823,2020-11-18T16:21:12.385292Z,2019,32,15,29,11,0,5to,1,0,21,0,0,17,3,0,31,0,0,0
69021,4824,2020-11-18T16:21:12.385292Z,2019,25,13,23,10,0,6to,0,0,15,0,0,12,2,0,25,0,0,0
69021,4825,2020-11-18T16:21:12.385292Z,2019,27,8,24,14,0,K,1,0,13,0,0,19,3,0,26,0,0,0
69021,4826,2020-11-18T16:21:12.3862929Z,2019,26,2,23,9,0,PK,0,0,17,0,0,24,3,0,26,0,0,0
69021,4827,2020-11-18T16:21:12.3862929Z,2019,11,11,8,6,0,Sin Grado,0,0,5,0,0,0,3,0,11,0,0,0
70599,11074,2020-11-18T16:22:07.6381327Z,2020,24,8,22,12,0,1ro,0,0,12,0,0,16,2,0,24,0,0,0
70599,11075,2020-11-18T16:22:07.6391336Z,2020,39,18,39,23,0,2do,2,0,16,0,0,21,0,0,36,0,0,1
70599,11076,2020-11-18T16:22:07.6391336Z,2020,25,9,25,13,0,3ro,1,0,12,0,0,16,0,0,24,0,0,0
70599,11077,2020-11-18T16:22:07.6391336Z,2020,24,4,23,14,0,4to,1,0,10,0,0,20,1,0,23,0,0,0
70599,11078,2020-11-18T16:22:07.6391336Z,2020,24,7,22,14,0,5to,2,0,10,0,0,17,2,0,22,0,0,0
70599,11079,2020-11-18T16:22:07.6401345Z,2020,21,8,19,12,0,6to,0,0,9,0,0,13,2,0,21,0,0,0
70599,11080,2020-11-18T16:22:07.6401345Z,2020,34,7,29,17,0,K,0,0,17,0,0,27,5,0,34,0,0,0
70599,11081,2020-11-18T16:22:07.6401345Z,2020,18,18,17,3,0,Sin Grado,0,0,15,0,0,0,1,0,18,0,0,0
70599,35095,2021-06-24T13:18:43.7238084Z,2021,22,3,21,16,0,1ro,0,0,6,0,0,19,1,0,22,0,0,0
70599,35096,2021-06-24T13:18:43.7238084Z,2021,21,6,19,10,0,2do,0,0,11,0,0,15,2,0,21,0,0,0
70599,35097,2021-06-24T13:18:43.7238084Z,2021,33,14,30,18,0,3ro,2,0,15,0,0,19,3,0,31,0,0,0
70599,35098,2021-06-24T13:18:43.7248093Z,2021,23,8,20,13,0,4to,1,0,10,0,0,15,3,0,22,0,0,0
70599,35099,2021-06-24T13:18:43.7248093Z,2021,23,5,23,12,0,5to,0,0,11,0,0,18,0,0,23,0,1,0
70599,35100,2021-06-24T13:18:44.4693432Z,2021,32,10,26,21,0,6to,3,0,11,0,0,22,6,0,29,0,0,0
70599,35101,2021-06-24T13:18:44.4703442Z,2021,29,5,14,13,0,K,0,0,16,0,0,24,15,0,29,0,0,0
70599,35102,2021-06-24T13:18:44.4703442Z,2021,22,21,19,4,0,Sin Grado,0,0,18,0,0,1,3,0,22,0,0,0
70599,5068,2020-11-18T16:21:13.4369948Z,2019,36,13,29,18,0,1ro,2,0,18,0,0,23,7,0,33,0,0,1
70599,5069,2020-11-18T16:21:13.4369948Z,2019,35,16,32,15,0,2do,2,0,20,0,0,19,3,0,33,0,0,0
70599,5070,2020-11-18T16:21:13.4369948Z,2019,26,7,25,16,0,3ro,1,0,10,0,0,19,1,0,25,0,0,0
70599,5071,2020-11-18T16:21:13.4369948Z,2019,29,13,26,15,0,4to,2,0,14,0,0,16,3,0,27,0,1,0
70599,5072,2020-11-18T16:21:13.4369948Z,2019,20,8,18,9,0,5to,2,0,11,0,0,12,2,0,18,0,0,0
70599,5073,2020-11-18T16:21:13.4379948Z,2019,29,6,29,20,0,6to,1,0,9,0,0,23,0,0,28,0,0,0
70599,5074,2020-11-18T16:21:13.4379948Z,2019,23,9,14,14,0,K,0,0,9,0,0,14,9,0,23,0,0,0
70599,5075,2020-11-18T16:21:13.4379948Z,2019,17,17,14,3,0,Sin Grado,0,0,14,0,0,0,3,0,17,0,0,0
63032,10581,2020-11-18T16:22:04.9303303Z,2020,47,9,38,23,0,10mo,3,0,24,0,0,38,9,0,44,0,0,0
63032,10582,2020-11-18T16:22:04.9303303Z,2020,111,27,89,57,0,6to,8,0,54,0,0,84,22,0,103,0,0,0
63032,10583,2020-11-18T16:22:04.9303303Z,2020,73,18,50,32,0,7mo,10,0,41,0,0,55,23,0,63,0,0,0
63032,10584,2020-11-18T16:22:04.9303303Z,2020,59,7,52,41,0,8vo,5,0,18,0,0,52,7,0,53,0,1,1
63032,10585,2020-11-18T16:22:04.9303303Z,2020,55,12,42,33,0,9no,2,0,22,0,0,43,13,0,53,0,0,0
63032,34596,2021-06-24T13:18:40.2593237Z,2021,51,10,40,30,0,10mo,2,0,21,0,0,41,11,0,49,0,0,0
63032,34597,2021-06-24T13:18:40.2593237Z,2021,49,9,46,23,0,11mo,3,0,26,0,0,40,3,0,46,0,0,0
63032,34598,2021-06-24T13:18:40.2603256Z,2021,101,26,78,52,0,7mo,8,1,49,0,0,75,23,0,93,0,0,0
63032,34599,2021-06-24T13:18:40.2603256Z,2021,70,16,54,32,0,8vo,9,1,38,0,0,54,16,0,61,0,0,0
63032,34600,2021-06-24T13:18:41.0578968Z,2021,48,3,44,35,0,9no,3,0,13,0,0,45,4,0,44,0,0,1
63032,4570,2020-11-18T16:21:10.8382582Z,2019,119,36,92,54,0,6to,12,0,65,0,0,83,27,0,107,0,0,0
63032,4571,2020-11-18T16:21:10.8382582Z,2019,102,24,92,64,0,7mo,7,0,38,0,0,78,10,0,94,1,1,1
63032,4572,2020-11-18T16:21:10.8382582Z,2019,109,37,84,58,0,8vo,3,0,51,0,0,72,25,0,106,0,0,0
63032,4573,2020-11-18T16:21:10.8382582Z,2019,51,10,41,23,0,9no,4,0,28,0,0,41,10,0,47,0,0,0
20552,1007,2020-11-18T16:20:43.7982274Z,2019,39,12,36,22,0,1ro,0,0,17,0,0,27,3,0,39,0,0,0
20552,1008,2020-11-18T16:20:43.7982274Z,2019,36,9,31,19,1,2do,0,0,17,0,0,27,5,0,36,0,0,0
20552,1009,2020-11-18T16:20:43.7992274Z,2019,49,15,41,26,0,3ro,0,0,23,0,0,34,8,0,49,3,0,0
20552,1010,2020-11-18T16:20:43.7992274Z,2019,64,19,52,32,1,4to,0,0,32,0,0,45,12,0,64,3,0,0
20552,1011,2020-11-18T16:20:43.7992274Z,2019,65,23,51,35,0,5to,0,0,30,0,0,42,14,0,65,3,0,0
20552,1012,2020-11-18T16:20:43.7992274Z,2019,57,17,51,23,0,6to,0,0,34,0,0,40,6,0,57,2,0,0
20552,1013,2020-11-18T16:20:43.8002279Z,2019,71,20,55,34,0,7mo,0,0,37,0,0,51,16,0,71,5,0,0
20552,1014,2020-11-18T16:20:43.8002279Z,2019,65,26,51,32,0,8vo,0,0,33,0,0,39,14,0,65,0,0,0
20552,1015,2020-11-18T16:20:43.8002279Z,2019,38,10,34,20,0,K,0,0,18,0,0,28,4,0,38,0,0,0
20552,31006,2021-06-24T13:18:12.0540925Z,2021,36,6,35,19,0,1ro,0,0,17,0,0,30,1,0,36,0,0,0
20552,31007,2021-06-24T13:18:12.0540925Z,2021,34,10,34,18,0,2do,0,0,16,0,0,24,0,0,34,0,0,0
20552,31008,2021-06-24T13:18:12.0550939Z,2021,47,14,45,25,0,3ro,0,0,22,0,0,33,2,0,47,0,0,0
20552,31009,2021-06-24T13:18:12.0550939Z,2021,35,9,32,19,0,4to,0,0,16,0,0,26,3,0,35,0,0,0
20552,31010,2021-06-24T13:18:12.0550939Z,2021,56,19,49,30,0,5to,0,0,26,0,0,37,7,0,56,1,0,0
20552,31011,2021-06-24T13:18:12.0560944Z,2021,59,17,49,33,0,6to,0,0,26,0,0,42,10,0,59,3,0,0
20552,31012,2021-06-24T13:18:12.0560944Z,2021,81,33,69,43,0,7mo,0,0,38,0,0,48,12,0,81,2,0,0
20552,31013,2021-06-24T13:18:12.0560944Z,2021,51,16,49,20,0,8vo,0,0,31,0,0,35,2,0,51,2,0,0
20552,31014,2021-06-24T13:18:12.0570949Z,2021,44,8,39,23,0,K,1,0,21,0,0,36,5,0,43,0,0,0
20552,7009,2020-11-18T16:21:43.6281271Z,2020,37,12,35,20,0,1ro,0,0,17,0,0,25,2,0,37,0,0,0
20552,7010,2020-11-18T16:21:43.6281271Z,2020,42,13,37,22,0,2do,0,0,20,0,0,29,5,0,42,0,0,0
20552,7011,2020-11-18T16:21:43.6281271Z,2020,32,8,26,17,0,3ro,0,0,15,0,0,24,6,0,32,0,0,0
20552,7012,2020-11-18T16:21:43.6291258Z,2020,53,21,45,29,0,4to,0,0,24,0,0,32,8,0,53,1,0,0
20552,7013,2020-11-18T16:21:43.6291258Z,2020,59,20,52,31,0,5to,0,0,28,0,0,39,7,0,59,3,0,0
20552,7014,2020-11-18T16:21:43.6291258Z,2020,70,28,58,36,0,6to,0,0,34,0,0,42,12,0,70,3,0,0
20552,7015,2020-11-18T16:21:43.6301276Z,2020,52,16,47,21,0,7mo,0,0,31,0,0,36,5,0,52,3,0,0
20552,7016,2020-11-18T16:21:43.6301276Z,2020,69,18,53,33,0,8vo,0,0,36,0,0,51,16,0,69,5,0,0
20552,7017,2020-11-18T16:21:43.6311267Z,2020,43,5,37,20,0,K,0,1,23,0,0,38,6,0,43,0,0,0
20552,7018,2020-11-18T16:21:43.6311267Z,2020,1,1,1,1,0,Sin Grado,0,0,0,0,0,0,0,0,1,0,0,0
27599,1642,2020-11-18T16:20:48.2602034Z,2019,46,18,33,18,0,1ro,1,0,28,0,0,28,13,0,45,0,0,0
27599,1643,2020-11-18T16:20:48.2602034Z,2019,32,13,26,15,0,2do,0,3,17,0,0,19,6,0,32,0,0,0
27599,1644,2020-11-18T16:20:48.2602034Z,2019,38,11,33,21,0,3ro,0,0,17,0,0,27,5,1,37,0,0,0
27599,1645,2020-11-18T16:20:48.2602034Z,2019,38,14,25,21,0,4to,0,0,17,0,0,24,13,0,38,1,0,0
27599,1646,2020-11-18T16:20:48.2602034Z,2019,38,17,28,17,0,5to,1,0,21,0,0,21,10,0,37,0,0,0
27599,1647,2020-11-18T16:20:48.2612039Z,2019,38,14,29,23,0,6to,0,0,15,0,0,24,9,0,38,0,0,0
27599,1648,2020-11-18T16:20:48.2612039Z,2019,42,13,16,23,0,K,1,0,19,0,0,29,26,0,41,0,0,0
27599,1649,2020-11-18T16:20:48.2612039Z,2019,42,38,34,16,0,Sin Grado,0,0,26,0,0,4,8,0,42,0,0,0
27599,31645,2021-06-24T13:18:16.1140044Z,2021,30,11,28,18,0,1ro,0,0,12,0,0,19,2,0,30,0,0,0
27599,31646,2021-06-24T13:18:16.1140044Z,2021,40,14,34,17,0,2do,0,0,23,0,0,26,6,0,40,0,0,0
27599,31647,2021-06-24T13:18:16.1140044Z,2021,46,17,41,16,0,3ro,1,0,30,0,0,29,5,0,45,0,0,0
27599,31648,2021-06-24T13:18:16.1150053Z,2021,37,15,30,19,0,4to,0,0,18,0,0,22,7,0,37,0,0,0
27599,31649,2021-06-24T13:18:16.1150053Z,2021,34,8,31,20,0,5to,0,0,14,0,0,26,3,1,33,0,0,0
27599,31650,2021-06-24T13:18:16.1150053Z,2021,38,9,32,17,0,K,2,0,21,0,0,29,6,0,35,0,0,1
27599,31651,2021-06-24T13:18:16.1150053Z,2021,49,47,41,18,0,Sin Grado,0,0,31,0,0,2,8,0,49,0,0,0
27599,7648,2020-11-18T16:21:47.1925001Z,2020,40,12,34,18,0,1ro,0,0,22,0,0,28,6,0,40,0,0,0
27599,7649,2020-11-18T16:21:47.1925001Z,2020,42,15,33,14,0,2do,1,0,28,0,0,27,9,0,41,0,0,0
27599,7650,2020-11-18T16:21:47.1925001Z,2020,35,10,27,22,0,3ro,0,1,13,0,0,25,8,0,35,0,0,0
27599,7651,2020-11-18T16:21:47.1925001Z,2020,35,8,30,21,0,4to,0,0,14,0,0,27,5,1,34,0,0,0
27599,7652,2020-11-18T16:21:47.193501Z,2020,38,15,29,23,0,5to,0,1,15,0,0,23,9,0,38,1,0,0
27599,7653,2020-11-18T16:21:47.193501Z,2020,38,10,32,20,0,K,1,0,18,0,0,28,6,0,36,0,0,1
27599,7654,2020-11-18T16:21:47.193501Z,2020,48,48,36,18,0,Sin Grado,0,0,30,0,0,0,12,0,48,0,0,0
51631,33446,2021-06-24T13:18:32.4697386Z,2021,89,29,66,50,0,6to,0,0,39,0,0,60,23,0,89,0,1,0
51631,33447,2021-06-24T13:18:32.4707395Z,2021,86,31,68,49,0,7mo,4,0,37,0,0,55,18,0,82,0,1,0
51631,33448,2021-06-24T13:18:32.4707395Z,2021,118,35,96,60,0,8vo,5,0,58,0,0,83,22,0,113,0,0,0
51631,33449,2021-06-24T13:18:32.4707395Z,2021,51,48,46,14,0,Sin Grado,0,0,37,0,0,3,5,0,51,0,0,0
51631,3422,2020-11-18T16:21:02.550735Z,2019,126,32,96,65,0,6to,6,0,61,0,0,94,30,0,120,0,1,0
51631,3423,2020-11-18T16:21:02.5517354Z,2019,139,46,110,66,0,7mo,8,0,73,0,0,93,29,0,130,0,2,1
51631,3424,2020-11-18T16:21:02.5517354Z,2019,177,55,120,78,0,8vo,0,0,99,0,0,122,57,0,176,0,1,1
51631,3425,2020-11-18T16:21:02.5517354Z,2019,68,58,58,20,0,Sin Grado,1,1,48,0,0,10,10,0,67,0,1,0
51631,9442,2020-11-18T16:21:58.4149836Z,2020,94,34,70,52,0,6to,4,0,42,0,0,60,24,0,90,0,1,0
51631,9443,2020-11-18T16:21:58.4149836Z,2020,124,33,96,65,0,7mo,10,0,59,0,0,91,28,0,114,0,2,0
51631,9444,2020-11-18T16:21:58.4149836Z,2020,123,39,96,60,0,8vo,4,0,63,0,0,84,27,0,119,0,1,0
51631,9445,2020-11-18T16:21:58.4149836Z,2020,55,52,48,16,0,Sin Grado,1,0,39,0,0,3,7,0,54,0,1,0
62521,10422,2020-11-18T16:22:04.1327965Z,2020,52,13,51,26,0,1ro,1,0,26,0,0,39,1,0,51,0,0,0
62521,10423,2020-11-18T16:22:04.1327965Z,2020,47,17,46,15,0,2do,0,0,32,0,0,30,1,0,47,0,0,0
62521,10424,2020-11-18T16:22:04.1337978Z,2020,41,12,40,19,0,3ro,0,0,22,0,0,29,1,0,41,0,0,0
62521,10425,2020-11-18T16:22:04.1337978Z,2020,49,11,47,31,0,4to,2,0,18,0,0,38,2,0,47,0,0,0
62521,10426,2020-11-18T16:22:04.1337978Z,2020,35,15,33,13,0,5to,1,0,22,0,0,20,2,0,34,0,0,0
62521,10427,2020-11-18T16:22:04.1347987Z,2020,37,9,37,20,0,K,0,0,17,0,0,28,0,0,37,0,0,0
62521,10428,2020-11-18T16:22:04.1347987Z,2020,18,17,15,4,0,Sin Grado,1,0,14,0,0,1,3,0,17,0,0,0
62521,34436,2021-06-24T13:18:39.4427382Z,2021,39,11,38,20,0,1ro,1,0,19,0,0,28,1,0,38,0,0,0
62521,34437,2021-06-24T13:18:39.4427382Z,2021,47,12,45,25,0,2do,1,0,22,0,0,35,2,0,46,0,0,0
62521,34438,2021-06-24T13:18:39.4427382Z,2021,38,18,38,15,0,3ro,0,0,23,0,0,20,0,0,38,0,0,0
62521,34439,2021-06-24T13:18:39.4427382Z,2021,35,9,33,14,0,4to,0,0,21,0,0,26,2,0,35,0,0,0
62521,34440,2021-06-24T13:18:39.4427382Z,2021,45,11,44,31,0,5to,2,0,14,0,0,34,1,0,43,0,0,0
62521,34441,2021-06-24T13:18:39.4437405Z,2021,25,8,22,10,0,K,1,0,15,0,0,17,3,0,24,0,0,0
62521,34442,2021-06-24T13:18:39.4437405Z,2021,22,22,20,5,0,Sin Grado,1,0,17,0,0,0,2,0,21,0,0,0
62521,4410,2020-11-18T16:21:10.1277849Z,2019,56,20,54,20,0,1ro,0,3,36,0,0,36,2,0,56,0,0,0
62521,4411,2020-11-18T16:21:10.1277849Z,2019,44,12,44,19,0,2do,1,0,25,0,0,32,0,0,43,0,0,0
62521,4412,2020-11-18T16:21:10.128784Z,2019,58,15,57,37,0,3ro,2,0,21,0,0,43,1,0,56,0,0,0
62521,4413,2020-11-18T16:21:10.128784Z,2019,43,12,41,21,0,4to,0,2,22,0,0,31,2,0,43,0,0,0
62521,4414,2020-11-18T16:21:10.128784Z,2019,35,11,31,14,0,5to,2,0,21,0,0,24,4,0,33,0,0,0
62521,4415,2020-11-18T16:21:10.128784Z,2019,51,11,49,24,0,K,5,0,27,0,0,40,2,0,46,0,0,0
62521,4416,2020-11-18T16:21:10.128784Z,2019,18,17,17,6,0,Sin Grado,1,0,12,0,0,1,1,0,17,0,0,0
25619,1529,2020-11-18T16:20:47.6387925Z,2019,97,30,64,42,0,6to,1,6,55,0,0,67,33,0,96,0,1,0
25619,1530,2020-11-18T16:20:47.6397925Z,2019,121,35,97,61,0,7mo,0,6,60,0,0,86,24,0,121,0,0,0
25619,1531,2020-11-18T16:20:47.6397925Z,2019,127,37,95,68,0,8vo,1,3,59,0,0,90,32,0,126,0,0,0
25619,1532,2020-11-18T16:20:47.6397925Z,2019,2,1,1,1,0,Sin Grado,0,0,1,0,0,1,1,0,2,0,0,0
25619,31531,2021-06-24T13:18:15.8147891Z,2021,141,62,118,79,0,6to,0,1,62,0,0,79,23,0,141,0,0,0
25619,31532,2021-06-24T13:18:15.8147891Z,2021,138,54,106,66,0,7mo,1,1,72,0,0,84,32,0,137,0,0,0
25619,31533,2021-06-24T13:18:15.8147891Z,2021,115,46,78,53,0,8vo,2,1,62,0,0,69,37,0,113,0,0,0
25619,31534,2021-06-24T13:18:15.8147891Z,2021,1,1,0,0,0,Sin Grado,0,0,1,0,0,0,1,0,1,0,0,0
25619,7534,2020-11-18T16:21:46.3709525Z,2020,138,56,105,66,0,6to,2,7,72,0,0,82,33,0,136,0,0,0
25619,7535,2020-11-18T16:21:46.3709525Z,2020,128,49,91,54,0,7mo,2,9,74,0,0,79,37,0,126,0,0,0
25619,7536,2020-11-18T16:21:46.3709525Z,2020,120,33,91,65,0,8vo,0,5,55,0,0,87,29,0,120,0,0,0
25619,7537,2020-11-18T16:21:46.3709525Z,2020,1,1,1,0,0,Sin Grado,0,0,1,0,0,0,0,0,1,0,0,0
12070,281,2020-11-18T16:20:38.7988928Z,2019,57,24,47,27,0,1ro,1,0,30,0,0,33,10,0,56,0,0,0
12070,282,2020-11-18T16:20:38.7988928Z,2019,66,28,56,28,0,2do,2,0,38,0,0,38,10,0,64,0,0,0
12070,283,2020-11-18T16:20:38.7998932Z,2019,57,12,46,23,0,3ro,0,0,34,0,0,45,11,0,57,0,0,0
12070,284,2020-11-18T16:20:38.7998932Z,2019,51,13,47,28,0,4to,0,0,23,0,0,38,4,0,51,0,0,0
12070,285,2020-11-18T16:20:38.7998932Z,2019,51,13,40,20,0,5to,2,0,31,0,0,38,11,0,49,0,0,0
12070,286,2020-11-18T16:20:38.7998932Z,2019,50,11,41,38,0,K,0,0,12,0,0,39,9,0,50,0,0,0
12070,287,2020-11-18T16:20:38.7998932Z,2019,10,9,7,2,0,Sin Grado,0,0,8,0,0,1,3,0,10,0,0,0
12070,30279,2021-06-24T13:18:07.1565811Z,2021,46,13,44,23,0,1ro,0,0,23,0,0,33,2,0,46,0,0,0
12070,30280,2021-06-24T13:18:07.1565811Z,2021,55,16,51,31,0,2do,0,0,24,0,0,39,4,0,55,0,0,0
12070,30281,2021-06-24T13:18:07.1575821Z,2021,54,16,46,29,0,3ro,1,0,25,0,0,38,8,2,51,0,0,0
12070,30282,2021-06-24T13:18:07.1585835Z,2021,60,24,53,28,0,4to,2,0,32,0,0,36,7,0,58,0,0,0
12070,30283,2021-06-24T13:18:07.1595835Z,2021,47,10,38,22,0,5to,0,0,25,0,0,37,9,0,47,0,0,0
12070,30284,2021-06-24T13:18:07.1595835Z,2021,43,12,33,21,0,K,0,0,22,0,0,31,10,0,39,0,0,4
12070,30285,2021-06-24T13:18:07.160584Z,2021,7,7,7,2,0,Sin Grado,0,0,5,0,0,0,0,0,7,0,0,0
12070,6282,2020-11-18T16:21:38.6428005Z,2020,54,16,47,38,0,1ro,0,0,16,0,0,38,7,0,54,0,0,0
12070,6283,2020-11-18T16:21:38.6438023Z,2020,53,18,41,26,0,2do,1,0,27,0,0,35,12,2,50,0,0,0
12070,6284,2020-11-18T16:21:38.6438023Z,2020,66,27,61,30,0,3ro,2,0,36,0,0,39,5,0,64,0,0,0
12070,6285,2020-11-18T16:21:38.6438023Z,2020,52,11,43,26,0,4to,0,0,26,0,0,41,9,0,52,0,0,0
12070,6286,2020-11-18T16:21:38.6438023Z,2020,45,14,39,25,0,5to,0,0,20,0,0,31,6,0,45,0,0,0
12070,6287,2020-11-18T16:21:38.6448023Z,2020,44,10,37,22,0,K,0,0,22,0,0,34,7,0,44,0,0,0
12070,6288,2020-11-18T16:21:38.6448023Z,2020,11,11,10,3,0,Sin Grado,0,0,8,0,0,0,1,0,11,0,0,0
52795,33628,2021-06-24T13:18:33.6715997Z,2021,33,9,27,15,0,1ro,0,0,18,0,0,24,6,0,33,0,0,0
52795,33629,2021-06-24T13:18:33.6715997Z,2021,31,13,27,15,0,2do,0,3,16,0,0,18,4,0,31,0,0,0
52795,33630,2021-06-24T13:18:33.6715997Z,2021,24,9,23,12,0,3ro,2,1,12,0,0,15,1,0,22,0,0,0
52795,33631,2021-06-24T13:18:33.672602Z,2021,32,8,29,14,0,4to,2,2,18,0,0,24,3,0,30,1,0,0
52795,33632,2021-06-24T13:18:33.672602Z,2021,29,10,27,16,0,5to,0,3,13,0,0,19,2,0,29,1,0,0
52795,33633,2021-06-24T13:18:33.672602Z,2021,27,6,24,16,0,K,2,0,11,0,0,21,3,0,25,0,0,0
52795,33634,2021-06-24T13:18:33.6736021Z,2021,8,8,8,3,0,Sin Grado,0,0,5,0,0,0,0,0,8,0,0,0
52795,3603,2020-11-18T16:21:04.3139086Z,2019,32,15,30,14,0,1ro,3,0,18,0,0,17,2,0,29,0,0,0
52795,3604,2020-11-18T16:21:04.3139086Z,2019,33,8,32,18,0,2do,3,0,15,0,0,25,1,0,30,1,0,0
52795,3605,2020-11-18T16:21:04.3139086Z,2019,35,12,32,20,0,3ro,1,0,15,0,0,23,3,0,34,1,0,0
52795,3606,2020-11-18T16:21:04.3149099Z,2019,26,8,23,11,0,4to,0,0,15,0,0,18,3,0,26,0,0,0
52795,3607,2020-11-18T16:21:04.3149099Z,2019,24,6,20,15,0,5to,2,0,9,0,0,18,4,0,22,0,1,0
52795,3608,2020-11-18T16:21:04.3149099Z,2019,24,7,22,11,0,K,2,0,13,0,0,17,2,0,22,0,0,0
52795,3609,2020-11-18T16:21:04.3149099Z,2019,5,4,3,2,0,Sin Grado,1,0,3,0,0,1,2,0,4,0,0,0
52795,9622,2020-11-18T16:21:59.4967056Z,2020,30,12,27,15,0,1ro,1,1,15,0,0,18,3,0,29,0,0,0
52795,9623,2020-11-18T16:21:59.4967056Z,2020,26,11,24,13,0,2do,2,1,13,0,0,15,2,0,24,0,0,0
52795,9624,2020-11-18T16:21:59.4967056Z,2020,31,9,28,16,0,3ro,2,4,15,0,0,22,3,0,29,1,0,0
52795,9625,2020-11-18T16:21:59.497706Z,2020,33,12,30,18,0,4to,1,5,15,0,0,21,3,0,32,1,0,0
52795,9626,2020-11-18T16:21:59.497706Z,2020,25,8,21,12,0,5to,0,2,13,0,0,17,4,0,25,0,0,0
52795,9627,2020-11-18T16:21:59.497706Z,2020,34,9,27,16,0,K,0,1,18,0,0,25,7,0,34,0,0,0
52795,9628,2020-11-18T16:21:59.497706Z,2020,6,6,4,2,0,Sin Grado,0,0,4,0,0,0,2,0,6,0,0,0
35535,2340,2020-11-18T16:20:55.7301851Z,2019,48,15,46,18,0,1ro,0,1,30,0,0,33,2,0,48,0,0,0
35535,2341,2020-11-18T16:20:55.7301851Z,2019,46,13,40,19,0,2do,0,0,27,0,0,33,6,0,46,0,0,0
35535,2342,2020-11-18T16:20:55.7301851Z,2019,48,13,36,24,0,3ro,1,0,24,0,0,35,12,0,47,0,0,0
35535,2343,2020-11-18T16:20:55.7311851Z,2019,44,16,35,21,0,4to,1,0,23,0,0,28,9,0,43,0,1,0
35535,2344,2020-11-18T16:20:55.7311851Z,2019,56,14,43,25,0,5to,1,0,31,0,0,42,13,0,55,0,0,0
35535,2345,2020-11-18T16:20:55.7311851Z,2019,42,10,38,23,0,K,1,0,19,0,0,32,4,0,41,0,0,0
35535,2346,2020-11-18T16:20:55.7321869Z,2019,26,25,22,8,0,Sin Grado,0,0,18,0,0,1,4,0,26,0,0,0
35535,32347,2021-06-24T13:18:23.3391848Z,2021,39,8,33,24,0,1ro,0,0,15,0,0,31,6,0,39,0,0,0
35535,32348,2021-06-24T13:18:23.3401862Z,2021,45,14,45,23,0,2do,1,1,22,0,0,31,0,0,44,0,0,0
35535,32349,2021-06-24T13:18:23.3401862Z,2021,46,11,43,21,0,3ro,0,0,25,0,0,35,3,0,46,0,0,0
35535,32350,2021-06-24T13:18:23.3401862Z,2021,42,14,33,16,0,4to,0,0,26,0,0,28,9,0,42,0,0,0
35535,32351,2021-06-24T13:18:23.3401862Z,2021,45,12,33,22,0,5to,0,0,23,0,0,33,12,0,45,0,0,0
35535,32352,2021-06-24T13:18:23.3411871Z,2021,38,11,36,16,0,K,1,0,22,0,0,27,2,0,36,0,0,1
35535,32353,2021-06-24T13:18:23.3411871Z,2021,15,15,14,2,0,Sin Grado,0,0,13,0,0,0,1,0,15,0,0,0
35535,8352,2020-11-18T16:21:51.4043092Z,2020,43,12,38,22,0,1ro,1,0,21,0,0,31,5,0,42,0,0,0
35535,8353,2020-11-18T16:21:51.4043092Z,2020,47,12,44,22,0,2do,1,0,25,0,0,35,3,0,46,0,0,0
35535,8354,2020-11-18T16:21:51.4043092Z,2020,38,12,30,17,0,3ro,0,0,21,0,0,26,8,0,38,0,0,0
35535,8355,2020-11-18T16:21:51.4053092Z,2020,46,11,32,22,0,4to,0,0,24,0,0,35,14,0,46,0,0,0
35535,8356,2020-11-18T16:21:51.4053092Z,2020,41,16,31,19,0,5to,0,0,22,0,0,25,10,0,41,0,0,0
35535,8357,2020-11-18T16:21:51.4053092Z,2020,42,9,35,24,0,K,0,0,18,0,0,33,7,0,42,0,0,0
35535,8358,2020-11-18T16:21:51.4063097Z,2020,25,25,21,4,0,Sin Grado,1,0,21,0,0,0,4,0,24,0,0,0
36350,2464,2020-11-18T16:20:56.2725469Z,2019,27,7,14,13,0,1ro,0,0,14,0,0,20,13,0,27,0,0,0
36350,2465,2020-11-18T16:20:56.2725469Z,2019,33,8,28,17,0,2do,0,0,16,0,0,25,5,0,33,0,0,0
36350,2466,2020-11-18T16:20:56.2725469Z,2019,26,5,24,14,0,3ro,1,0,12,0,0,21,2,0,25,0,0,0
36350,2467,2020-11-18T16:20:56.2735478Z,2019,28,9,25,15,0,4to,0,0,13,0,0,19,3,0,28,0,0,0
36350,2468,2020-11-18T16:20:56.2735478Z,2019,33,9,23,16,0,5to,0,0,17,0,0,24,10,0,33,0,0,0
36350,2469,2020-11-18T16:20:56.2745478Z,2019,36,10,31,15,0,6to,0,0,21,0,0,26,5,0,36,0,0,0
36350,2470,2020-11-18T16:20:56.2745478Z,2019,42,10,32,20,0,7mo,0,0,22,0,0,32,10,0,42,0,0,0
36350,2471,2020-11-18T16:20:56.2755487Z,2019,39,13,30,19,0,8vo,0,0,20,0,0,26,9,0,39,0,0,0
36350,2472,2020-11-18T16:20:56.2755487Z,2019,18,4,14,15,0,9no,0,0,3,0,0,14,4,0,18,0,0,0
36350,2473,2020-11-18T16:20:56.2765505Z,2019,24,5,6,16,0,K,0,0,8,0,0,19,18,0,24,0,0,0
36350,2474,2020-11-18T16:20:56.2765505Z,2019,14,1,0,6,0,PK,0,0,8,0,0,13,14,0,14,0,0,0
36350,32471,2021-06-24T13:18:24.7321886Z,2021,19,2,19,8,0,1ro,0,0,11,0,0,17,0,0,19,0,0,0
36350,32472,2021-06-24T13:18:24.7331891Z,2021,28,6,26,18,0,2do,0,0,10,0,0,22,2,0,28,0,0,0
36350,32473,2021-06-24T13:18:24.7331891Z,2021,23,6,20,14,0,3ro,0,0,9,0,0,17,3,0,23,0,0,0
36350,32474,2021-06-24T13:18:24.7331891Z,2021,34,8,30,16,0,4to,0,0,18,0,0,26,4,0,34,0,0,0
36350,32475,2021-06-24T13:18:24.7331891Z,2021,22,5,20,11,0,5to,0,0,11,0,0,17,2,0,22,0,0,0
36350,32476,2021-06-24T13:18:24.73419Z,2021,43,16,39,19,0,6to,0,0,24,0,0,27,4,0,43,0,0,0
36350,32477,2021-06-24T13:18:24.73419Z,2021,47,13,36,23,0,7mo,0,0,24,0,0,34,11,0,47,0,0,0
36350,32478,2021-06-24T13:18:24.73419Z,2021,37,10,31,18,0,8vo,0,0,19,0,0,27,6,0,37,0,0,0
36350,32479,2021-06-24T13:18:24.73419Z,2021,12,4,11,4,0,9no,0,0,8,0,0,8,1,0,11,0,0,1
36350,32480,2021-06-24T13:18:24.7351901Z,2021,10,1,8,4,0,K,0,0,6,0,0,9,2,0,10,0,0,0
36350,32481,2021-06-24T13:18:24.7351901Z,2021,16,1,12,5,0,PK,0,0,11,0,0,15,4,0,16,0,0,0
36350,8476,2020-11-18T16:21:51.8085763Z,2020,26,6,18,15,0,1ro,0,0,11,0,0,20,8,0,26,0,0,0
36350,8477,2020-11-18T16:21:51.8095777Z,2020,24,6,19,13,0,2do,0,0,11,0,0,18,5,0,24,0,0,0
36350,8478,2020-11-18T16:21:51.8095777Z,2020,33,7,29,17,0,3ro,0,0,16,0,0,26,4,0,33,0,0,0
36350,8479,2020-11-18T16:21:51.8095777Z,2020,23,5,20,11,0,4to,1,0,12,0,0,18,3,0,22,0,0,0
36350,8480,2020-11-18T16:21:51.8095777Z,2020,32,12,28,15,0,5to,0,0,17,0,0,20,4,0,32,0,0,0
36350,8481,2020-11-18T16:21:51.8105777Z,2020,42,12,26,20,0,6to,0,0,22,0,0,30,16,0,42,0,0,0
36350,8482,2020-11-18T16:21:51.8105777Z,2020,37,9,32,18,0,7mo,0,0,19,0,0,28,5,0,37,0,0,0
36350,8483,2020-11-18T16:21:51.8105777Z,2020,45,10,34,22,0,8vo,0,0,23,0,0,35,11,0,45,0,0,0
36350,8484,2020-11-18T16:21:51.8105777Z,2020,12,7,10,5,0,9no,0,0,7,0,0,5,2,0,12,0,0,0
36350,8485,2020-11-18T16:21:51.8115794Z,2020,18,3,13,8,0,K,0,0,10,0,0,15,5,0,18,0,0,0
36350,8486,2020-11-18T16:21:51.8115794Z,2020,9,1,0,5,0,PK,0,0,4,0,0,8,9,0,9,0,0,0
12088,288,2020-11-18T16:20:38.7998932Z,2019,162,46,152,87,0,10mo,0,2,75,0,0,116,10,0,162,0,0,0
12088,289,2020-11-18T16:20:38.8008945Z,2019,114,27,110,52,0,11mo,0,0,62,0,0,87,4,0,114,0,1,0
12088,290,2020-11-18T16:20:38.8008945Z,2019,106,0,92,52,0,12mo,0,0,54,0,0,106,14,0,106,0,0,0
12088,291,2020-11-18T16:20:38.8008945Z,2019,136,30,127,71,0,9no,0,0,65,0,0,106,9,0,136,0,0,0
12088,292,2020-11-18T16:20:38.8008945Z,2019,8,6,6,2,0,Sin Grado,0,0,6,0,0,2,2,1,7,0,1,0
12088,30286,2021-06-24T13:18:07.1585835Z,2021,89,27,74,43,0,10mo,1,0,46,0,0,62,15,0,88,0,0,0
12088,30287,2021-06-24T13:18:07.1585835Z,2021,85,23,63,43,0,11mo,1,0,42,0,0,62,22,0,84,0,0,0
12088,30288,2021-06-24T13:18:07.1595835Z,2021,108,33,95,59,0,12mo,0,0,49,0,0,75,13,0,108,0,0,0
12088,30289,2021-06-24T13:18:07.160584Z,2021,86,27,69,45,0,9no,1,0,41,0,0,59,17,0,84,0,0,1
12088,30290,2021-06-24T13:18:07.160584Z,2021,15,15,15,2,0,Sin Grado,0,0,13,0,0,0,0,1,14,0,1,0
12088,6289,2020-11-18T16:21:38.6428005Z,2020,102,25,95,50,0,10mo,0,0,52,0,0,77,7,0,102,0,0,0
12088,6290,2020-11-18T16:21:38.6428005Z,2020,125,47,116,65,0,11mo,0,0,60,0,0,78,9,0,125,0,0,0
12088,6291,2020-11-18T16:21:38.6438023Z,2020,93,24,88,43,0,12mo,0,0,50,0,0,69,5,0,93,0,0,0
12088,6292,2020-11-18T16:21:38.6438023Z,2020,101,29,97,46,0,9no,2,0,55,0,0,72,4,0,99,0,0,0
12088,6293,2020-11-18T16:21:38.6438023Z,2020,8,8,6,1,0,Sin Grado,0,0,7,0,0,0,2,1,7,0,1,0
52050,33517,2021-06-24T13:18:33.3733863Z,2021,38,11,33,16,0,1ro,0,0,22,0,0,27,5,0,38,0,0,0
52050,33518,2021-06-24T13:18:33.3743868Z,2021,42,15,38,22,0,2do,0,0,20,0,0,27,4,0,42,0,0,0
52050,33519,2021-06-24T13:18:33.3743868Z,2021,43,21,34,21,0,3ro,0,0,22,0,0,22,9,0,43,0,0,0
52050,33520,2021-06-24T13:18:33.3743868Z,2021,48,21,40,19,0,4to,1,0,29,0,0,27,8,0,47,0,0,0
52050,33521,2021-06-24T13:18:33.3743868Z,2021,50,13,42,23,0,5to,1,0,27,0,0,37,8,0,49,0,0,0
52050,33522,2021-06-24T13:18:33.3753882Z,2021,56,22,51,33,0,6to,1,0,23,0,0,34,5,0,55,0,0,0
52050,33523,2021-06-24T13:18:33.3753882Z,2021,59,17,49,28,0,7mo,1,0,31,0,0,42,10,0,58,0,0,0
52050,33524,2021-06-24T13:18:33.3753882Z,2021,56,21,46,23,0,8vo,1,0,33,0,0,35,10,0,55,0,0,0
52050,33525,2021-06-24T13:18:33.3763883Z,2021,32,8,28,16,0,K,0,0,16,0,0,24,4,0,32,0,0,0
52050,33526,2021-06-24T13:18:33.3763883Z,2021,28,27,25,8,0,Sin Grado,0,0,20,0,0,1,3,0,28,0,1,0
52050,3491,2020-11-18T16:21:02.5757519Z,2019,50,26,41,19,0,1ro,0,1,31,0,0,24,9,0,50,0,0,0
52050,3492,2020-11-18T16:21:02.5757519Z,2019,49,15,41,24,0,2do,1,1,25,0,0,34,8,0,48,0,0,0
52050,3493,2020-11-18T16:21:02.5757519Z,2019,60,23,45,26,0,3ro,1,0,34,0,0,37,15,0,59,0,0,0
52050,3494,2020-11-18T16:21:02.5767546Z,2019,54,19,49,31,0,4to,1,0,23,0,0,35,5,0,53,0,0,0
52050,3495,2020-11-18T16:21:02.5767546Z,2019,58,19,48,29,0,5to,1,0,29,0,0,39,10,0,57,0,0,0
52050,3496,2020-11-18T16:21:02.5767546Z,2019,63,22,53,27,0,6to,3,0,36,0,0,41,10,0,60,0,0,0
52050,3497,2020-11-18T16:21:02.5767546Z,2019,53,27,46,32,0,7mo,0,0,21,0,0,26,7,0,53,0,0,0
52050,3498,2020-11-18T16:21:02.5777528Z,2019,53,17,43,29,0,8vo,2,0,24,0,0,36,10,0,51,0,0,0
52050,3499,2020-11-18T16:21:02.5777528Z,2019,47,8,41,21,0,K,2,0,26,0,0,39,6,0,45,0,0,0
52050,3500,2020-11-18T16:21:02.5777528Z,2019,30,27,26,8,0,Sin Grado,2,0,22,0,0,3,4,0,28,0,1,0
52050,9512,2020-11-18T16:21:59.0764261Z,2020,49,14,42,23,0,1ro,1,1,26,0,0,35,7,0,48,0,0,0
52050,9513,2020-11-18T16:21:59.0774261Z,2020,46,22,39,20,0,2do,0,1,26,0,0,24,7,0,46,0,0,0
52050,9514,2020-11-18T16:21:59.0774261Z,2020,51,17,42,23,0,3ro,1,1,28,0,0,34,9,0,50,0,0,0
52050,9515,2020-11-18T16:21:59.0774261Z,2020,65,19,54,31,0,4to,2,0,34,0,0,46,11,0,63,0,0,0
52050,9516,2020-11-18T16:21:59.0774261Z,2020,61,21,53,37,0,5to,1,0,24,0,0,40,8,0,60,0,0,0
52050,9517,2020-11-18T16:21:59.0784266Z,2020,66,19,55,35,0,6to,1,1,31,0,0,47,11,0,65,0,0,0
52050,9518,2020-11-18T16:21:59.0784266Z,2020,62,26,49,24,0,7mo,1,0,38,0,0,36,13,0,61,0,0,0
52050,9519,2020-11-18T16:21:59.0784266Z,2020,47,22,39,30,0,8vo,0,2,17,0,0,25,8,0,47,0,0,0
52050,9520,2020-11-18T16:21:59.0784266Z,2020,39,9,36,12,0,K,0,1,27,0,0,30,3,0,39,0,0,0
52050,9521,2020-11-18T16:21:59.0794275Z,2020,27,27,24,9,0,Sin Grado,1,0,18,0,0,0,3,0,26,0,1,0
10702,30077,2021-06-24T13:18:05.892676Z,2021,174,52,143,100,0,10mo,1,0,74,0,0,122,31,0,173,0,0,0
10702,30078,2021-06-24T13:18:05.8936769Z,2021,156,50,126,80,0,11mo,2,0,76,0,0,106,30,0,154,0,1,0
10702,30079,2021-06-24T13:18:05.8936769Z,2021,140,43,114,82,0,12mo,1,0,58,0,0,97,26,0,139,0,0,0
10702,30080,2021-06-24T13:18:05.8936769Z,2021,142,36,119,79,0,9no,2,0,63,0,0,106,23,0,140,0,0,0
10702,30081,2021-06-24T13:18:05.8936769Z,2021,8,7,7,4,0,Sin Grado,0,0,4,0,0,1,1,0,8,0,0,0
10702,6078,2020-11-18T16:21:37.6971686Z,2020,173,53,138,90,0,10mo,3,0,83,0,0,120,35,0,169,0,0,1
10702,6079,2020-11-18T16:21:37.6971686Z,2020,144,46,110,82,0,11mo,1,0,62,0,0,98,34,0,143,0,0,0
10702,6080,2020-11-18T16:21:37.6971686Z,2020,168,55,136,89,0,12mo,0,0,79,0,0,113,32,0,168,0,0,0
10702,6081,2020-11-18T16:21:37.6971686Z,2020,182,61,151,105,0,9no,1,0,77,0,0,121,31,0,181,0,0,0
10702,6082,2020-11-18T16:21:37.6971686Z,2020,7,7,6,4,0,Sin Grado,0,0,3,0,0,0,1,0,7,0,0,0
10702,77,2020-11-18T16:20:36.7635389Z,2019,152,49,116,84,0,10mo,1,0,68,0,0,103,36,0,151,0,0,0
10702,78,2020-11-18T16:20:36.7635389Z,2019,177,56,140,96,0,11mo,0,0,81,0,0,121,37,1,176,0,0,0
10702,79,2020-11-18T16:20:36.7645402Z,2019,181,0,140,94,0,12mo,1,0,87,0,0,181,41,0,180,0,0,0
10702,80,2020-11-18T16:20:36.7645402Z,2019,190,55,148,100,0,9no,3,1,90,0,0,135,42,0,186,0,0,1
10702,81,2020-11-18T16:20:36.7645402Z,2019,7,4,6,2,0,Sin Grado,0,1,5,0,0,3,1,0,7,0,0,0
70904,11160,2020-11-18T16:22:08.325591Z,2020,58,13,48,31,0,1ro,0,10,27,0,0,45,10,0,58,0,0,0
70904,11161,2020-11-18T16:22:08.325591Z,2020,60,15,49,28,0,2do,0,11,32,0,0,45,11,0,60,2,0,0
70904,11162,2020-11-18T16:22:08.325591Z,2020,67,18,52,36,0,3ro,0,18,31,0,0,49,15,0,67,0,0,0
70904,11163,2020-11-18T16:22:08.3265915Z,2020,53,18,40,24,0,4to,1,10,29,0,0,35,13,0,52,0,0,0
70904,11164,2020-11-18T16:22:08.3265915Z,2020,77,23,52,33,0,5to,1,18,44,0,0,54,25,0,76,1,0,0
70904,11165,2020-11-18T16:22:08.3265915Z,2020,46,12,40,18,0,K,0,3,28,0,0,34,6,0,46,0,0,0
70904,35181,2021-06-24T13:18:44.5484001Z,2021,58,20,53,23,0,1ro,0,6,35,0,0,38,5,0,58,0,0,0
70904,35182,2021-06-24T13:18:44.5484001Z,2021,62,16,55,36,0,2do,0,1,26,0,0,46,7,1,61,0,0,0
70904,35183,2021-06-24T13:18:44.5494011Z,2021,58,15,51,30,0,3ro,0,7,28,0,0,43,7,0,58,2,0,0
70904,35184,2021-06-24T13:18:44.5494011Z,2021,66,23,57,36,0,4to,0,7,30,0,0,43,9,0,66,0,0,0
70904,35185,2021-06-24T13:18:44.5494011Z,2021,57,17,45,23,0,5to,1,6,34,0,0,40,12,0,56,0,0,0
70904,35186,2021-06-24T13:18:44.5494011Z,2021,58,17,50,27,0,K,0,4,31,0,0,41,8,0,57,0,0,1
70904,5154,2020-11-18T16:21:14.0353925Z,2019,68,19,55,30,0,1ro,0,19,38,0,0,49,13,0,68,2,0,0
70904,5155,2020-11-18T16:21:14.036393Z,2019,78,26,52,39,0,2do,0,15,39,0,0,52,26,0,78,0,0,0
70904,5156,2020-11-18T16:21:14.036393Z,2019,58,18,42,27,0,3ro,1,8,31,0,1,40,16,0,57,0,0,0
70904,5157,2020-11-18T16:21:14.036393Z,2019,90,27,64,42,1,4to,0,13,48,0,0,63,26,0,90,1,0,0
70904,5158,2020-11-18T16:21:14.036393Z,2019,88,27,61,43,0,5to,0,10,45,0,0,61,27,0,88,0,0,0
70904,5159,2020-11-18T16:21:14.037393Z,2019,1,0,0,1,0,6to,0,0,0,0,0,1,1,0,1,0,0,0
70904,5160,2020-11-18T16:21:14.037393Z,2019,54,11,29,32,0,K,0,2,22,0,0,43,25,0,54,0,0,0
33225,2141,2020-11-18T16:20:54.5744133Z,2019,76,19,65,44,0,6to,1,0,32,0,0,57,11,0,75,0,0,0
33225,2142,2020-11-18T16:20:54.5744133Z,2019,100,18,85,53,0,7mo,0,0,47,0,0,82,15,0,100,0,0,0
33225,2143,2020-11-18T16:20:54.5754133Z,2019,90,11,68,48,0,8vo,1,0,42,0,0,79,22,0,89,0,0,0
33225,2144,2020-11-18T16:20:54.5754133Z,2019,8,8,5,5,0,Sin Grado,0,0,3,0,0,0,3,0,8,0,0,0
33225,32148,2021-06-24T13:18:20.8964334Z,2021,73,15,65,40,0,6to,3,0,33,0,0,58,8,0,70,1,0,0
33225,32149,2021-06-24T13:18:20.8964334Z,2021,60,5,51,31,0,7mo,3,0,29,0,0,55,9,0,57,0,0,0
33225,32150,2021-06-24T13:18:20.8964334Z,2021,78,17,71,44,0,8vo,3,1,34,0,0,61,7,0,74,0,0,1
33225,32151,2021-06-24T13:18:20.8974339Z,2021,8,8,7,2,0,Sin Grado,0,0,6,0,0,0,1,0,8,0,0,0
33225,8154,2020-11-18T16:21:50.2235242Z,2020,63,8,55,33,0,6to,3,0,30,0,0,55,8,0,60,0,0,0
33225,8155,2020-11-18T16:21:50.2235242Z,2020,71,17,53,42,0,7mo,1,0,29,0,0,54,18,0,70,0,0,0
33225,8156,2020-11-18T16:21:50.2235242Z,2020,98,19,83,56,0,8vo,1,0,42,0,0,79,15,0,97,0,0,0
33225,8157,2020-11-18T16:21:50.2235242Z,2020,10,10,8,5,0,Sin Grado,0,0,5,0,0,0,2,0,10,0,0,0
35592,2348,2020-11-18T16:20:55.7321869Z,2019,135,28,103,73,0,10mo,1,0,62,0,0,107,32,0,134,0,0,0
35592,2349,2020-11-18T16:20:55.7331887Z,2019,106,23,80,45,0,11mo,0,0,61,0,0,83,26,1,105,0,0,0
35592,2350,2020-11-18T16:20:55.7331887Z,2019,106,0,81,57,0,12mo,0,0,49,0,0,106,25,0,105,0,0,1
35592,2351,2020-11-18T16:20:55.7331887Z,2019,110,26,83,58,0,9no,2,0,52,0,0,84,27,0,108,0,0,0
35592,2352,2020-11-18T16:20:55.7331887Z,2019,9,7,8,3,0,Sin Grado,0,0,6,0,0,2,1,0,9,0,0,0
35592,32355,2021-06-24T13:18:23.3391848Z,2021,120,44,102,56,0,10mo,2,0,64,0,0,76,18,0,118,0,2,0
35592,32356,2021-06-24T13:18:23.3401862Z,2021,92,23,70,55,0,11mo,1,0,37,0,0,69,22,0,91,0,0,0
35592,32357,2021-06-24T13:18:23.3401862Z,2021,95,21,76,52,0,12mo,1,0,43,0,0,74,19,0,94,0,0,0
35592,32358,2021-06-24T13:18:23.3401862Z,2021,114,31,91,49,0,9no,2,0,65,0,0,83,23,0,112,2,0,0
35592,32359,2021-06-24T13:18:23.3401862Z,2021,7,7,5,2,0,Sin Grado,0,0,5,0,0,0,2,0,7,0,0,0
35592,8360,2020-11-18T16:21:51.4043092Z,2020,98,23,74,55,0,10mo,1,1,43,0,0,75,24,0,97,0,0,0
35592,8361,2020-11-18T16:21:51.4043092Z,2020,112,26,84,61,0,11mo,2,0,51,0,0,86,28,0,110,0,0,0
35592,8362,2020-11-18T16:21:51.4043092Z,2020,93,22,69,39,0,12mo,0,0,54,0,0,71,24,0,93,0,0,0
35592,8363,2020-11-18T16:21:51.4053092Z,2020,112,38,99,49,0,9no,1,0,63,0,0,74,13,0,111,0,1,0
35592,8364,2020-11-18T16:21:51.4053092Z,2020,10,10,7,3,0,Sin Grado,0,0,7,0,0,0,3,0,10,0,0,0
55350,33838,2021-06-24T13:18:35.743086Z,2021,102,27,84,63,0,6to,1,0,39,0,0,75,18,0,101,0,0,0
55350,33839,2021-06-24T13:18:35.7440869Z,2021,131,33,101,66,0,7mo,6,1,65,0,0,98,30,0,125,1,2,0
55350,33840,2021-06-24T13:18:35.7440869Z,2021,114,29,87,54,0,8vo,9,0,60,0,0,85,27,0,105,2,0,0
55350,3815,2020-11-18T16:21:05.5597386Z,2019,112,29,82,48,0,6to,9,3,64,0,0,83,30,0,103,1,0,0
55350,3816,2020-11-18T16:21:05.5597386Z,2019,129,39,96,57,0,7mo,3,4,72,0,0,90,33,0,126,4,0,0
55350,3817,2020-11-18T16:21:05.560739Z,2019,103,23,71,39,0,8vo,4,2,64,0,0,80,32,0,99,3,0,0
55350,9832,2020-11-18T16:22:00.5153865Z,2020,122,34,88,62,0,6to,4,3,60,0,0,88,34,0,118,1,1,0
55350,9833,2020-11-18T16:22:00.5153865Z,2020,110,29,77,52,0,7mo,9,8,58,0,0,81,33,0,101,2,0,0
55350,9834,2020-11-18T16:22:00.5153865Z,2020,131,42,94,62,0,8vo,3,7,69,0,0,89,37,0,128,4,0,0
71704,11399,2020-11-18T16:22:10.196841Z,2020,25,6,22,16,0,1ro,1,0,9,0,0,19,3,0,24,0,0,0
71704,11400,2020-11-18T16:22:10.196841Z,2020,24,10,20,12,0,2do,3,0,12,0,0,14,4,0,21,0,0,0
71704,11401,2020-11-18T16:22:10.5640861Z,2020,17,6,14,9,0,3ro,1,0,8,0,0,11,3,0,16,0,0,0
71704,11402,2020-11-18T16:22:10.5640861Z,2020,21,4,18,13,0,4to,2,0,8,0,0,17,3,0,19,0,0,0
71704,11403,2020-11-18T16:22:10.5650875Z,2020,35,11,32,21,0,5to,2,0,14,0,0,24,3,0,33,0,0,0
71704,11404,2020-11-18T16:22:10.5650875Z,2020,37,12,34,18,0,6to,3,0,19,0,0,25,3,0,34,0,0,0
71704,11405,2020-11-18T16:22:10.5650875Z,2020,40,13,34,22,0,7mo,1,0,18,0,0,27,6,0,39,1,0,0
71704,11406,2020-11-18T16:22:10.5660879Z,2020,48,18,41,16,0,8vo,2,0,32,0,0,30,7,0,45,1,0,1
71704,11407,2020-11-18T16:22:10.5660879Z,2020,21,4,20,5,0,K,2,0,16,0,0,17,1,0,19,0,0,0
71704,11408,2020-11-18T16:22:10.5660879Z,2020,53,53,49,15,0,Sin Grado,3,1,38,0,0,0,4,0,50,0,0,0
71704,35421,2021-06-24T13:18:46.2145947Z,2021,19,3,19,5,0,1ro,2,0,14,0,0,16,0,0,17,0,0,0
71704,35422,2021-06-24T13:18:46.2145947Z,2021,22,4,21,13,0,2do,0,0,9,0,0,18,1,0,22,0,0,0
71704,35423,2021-06-24T13:18:46.2145947Z,2021,22,7,21,11,0,3ro,2,0,11,0,0,15,1,0,20,0,0,0
71704,35424,2021-06-24T13:18:46.2155951Z,2021,16,4,15,9,0,4to,2,0,7,0,0,12,1,0,14,0,0,0
71704,35425,2021-06-24T13:18:46.2155951Z,2021,21,4,20,10,0,5to,2,0,11,0,0,17,1,0,19,0,0,0
71704,35426,2021-06-24T13:18:46.2155951Z,2021,41,12,36,24,0,6to,2,0,17,0,0,29,5,0,39,0,0,0
71704,35427,2021-06-24T13:18:46.2155951Z,2021,43,12,38,21,0,7mo,4,0,22,0,0,31,5,0,39,0,0,0
71704,35428,2021-06-24T13:18:46.2155951Z,2021,43,12,39,21,0,8vo,1,0,22,0,0,31,4,0,42,1,0,0
71704,35429,2021-06-24T13:18:46.2165952Z,2021,21,5,20,16,0,K,2,0,5,0,0,16,1,0,19,0,0,0
71704,35430,2021-06-24T13:18:46.2165952Z,2021,45,45,41,8,0,Sin Grado,2,0,37,0,0,0,4,0,43,0,0,0
71704,5391,2020-11-18T16:21:15.0960959Z,2019,31,8,28,16,0,1ro,2,0,15,0,0,23,3,0,29,0,0,0
71704,5392,2020-11-18T16:21:15.0960959Z,2019,15,4,13,7,0,2do,2,0,8,0,0,11,2,0,13,0,0,0
71704,5393,2020-11-18T16:21:15.0960959Z,2019,24,7,20,16,0,3ro,2,0,8,0,0,17,4,0,22,0,0,0
71704,5394,2020-11-18T16:21:15.0970968Z,2019,26,6,25,18,0,4to,1,0,8,0,0,20,1,0,25,0,0,0
71704,5395,2020-11-18T16:21:15.0970968Z,2019,35,12,30,18,0,5to,1,0,17,0,0,23,5,0,34,0,0,0
71704,5396,2020-11-18T16:21:15.0970968Z,2019,46,20,41,25,0,6to,2,0,21,0,0,26,5,0,44,0,0,0
71704,5397,2020-11-18T16:21:15.0970968Z,2019,66,19,56,28,0,7mo,1,0,38,0,0,47,10,0,64,0,0,1
71704,5398,2020-11-18T16:21:15.0970968Z,2019,74,27,66,39,0,8vo,1,0,35,0,0,47,8,0,73,1,0,0
71704,5399,2020-11-18T16:21:15.0980973Z,2019,18,5,2,10,0,K,0,0,8,0,0,13,16,0,18,0,0,0
71704,5400,2020-11-18T16:21:15.0980973Z,2019,61,53,58,18,0,Sin Grado,1,0,43,0,0,8,3,0,60,0,0,0
27318,1612,2020-11-18T16:20:48.2531999Z,2019,32,11,17,17,0,1ro,0,0,15,0,0,21,15,0,31,0,0,1
27318,1613,2020-11-18T16:20:48.2531999Z,2019,19,3,16,13,0,2do,4,1,6,0,0,16,3,0,15,0,0,0
27318,1614,2020-11-18T16:20:48.2531999Z,2019,27,13,25,17,0,3ro,3,0,10,0,0,14,2,0,24,0,0,0
27318,1615,2020-11-18T16:20:48.2531999Z,2019,27,9,24,12,0,4to,0,0,15,0,0,18,3,0,27,0,0,0
27318,1616,2020-11-18T16:20:48.2542003Z,2019,26,7,22,13,0,5to,0,0,13,0,0,19,4,0,26,0,0,0
27318,1617,2020-11-18T16:20:48.2542003Z,2019,68,26,45,30,0,6to,0,1,38,0,0,42,23,0,68,0,0,0
27318,1618,2020-11-18T16:20:48.2542003Z,2019,60,26,48,21,0,7mo,2,0,39,0,0,34,12,2,56,0,1,0
27318,1619,2020-11-18T16:20:48.2542003Z,2019,53,17,39,20,0,8vo,2,0,33,0,0,36,14,0,51,0,0,0
27318,1620,2020-11-18T16:20:48.2552003Z,2019,16,3,2,12,0,K,0,0,4,0,0,13,14,0,15,0,0,1
27318,1621,2020-11-18T16:20:48.2552003Z,2019,42,41,37,8,0,Sin Grado,0,0,34,0,0,1,5,0,42,0,0,0
27318,31615,2021-06-24T13:18:16.1049981Z,2021,22,5,20,11,0,1ro,3,0,11,0,0,17,2,0,19,0,0,0
27318,31616,2021-06-24T13:18:16.1059986Z,2021,24,5,22,13,0,2do,0,0,11,0,0,19,2,1,22,0,0,1
27318,31617,2021-06-24T13:18:16.1059986Z,2021,42,13,38,20,0,3ro,1,0,22,0,0,29,4,0,41,0,0,0
27318,31618,2021-06-24T13:18:16.1059986Z,2021,22,3,20,14,0,4to,3,0,8,0,0,19,2,0,19,0,0,0
27318,31619,2021-06-24T13:18:16.1069996Z,2021,35,13,31,21,0,5to,3,0,14,0,0,22,4,0,32,0,0,0
27318,31620,2021-06-24T13:18:16.1069996Z,2021,64,16,53,34,0,6to,0,0,30,0,0,48,11,0,62,0,0,2
27318,31621,2021-06-24T13:18:16.1069996Z,2021,57,15,55,29,0,7mo,1,0,28,0,0,42,2,0,56,0,0,0
27318,31622,2021-06-24T13:18:16.1080009Z,2021,71,21,50,29,0,8vo,1,0,42,0,0,50,21,0,70,0,1,0
27318,31623,2021-06-24T13:18:16.1080009Z,2021,18,5,11,6,0,K,0,0,12,0,0,13,7,0,18,0,0,0
27318,31624,2021-06-24T13:18:16.1080009Z,2021,31,31,27,11,0,Sin Grado,0,0,20,0,0,0,4,0,31,0,0,0
27318,7618,2020-11-18T16:21:47.1854948Z,2020,24,7,13,14,0,1ro,0,0,10,0,0,17,11,1,22,0,0,1
27318,7619,2020-11-18T16:21:47.1864957Z,2020,39,13,33,20,0,2do,1,0,19,0,0,26,6,0,38,0,0,0
27318,7620,2020-11-18T16:21:47.1864957Z,2020,20,3,17,13,0,3ro,3,0,7,0,0,17,3,0,17,0,0,0
27318,7621,2020-11-18T16:21:47.1864957Z,2020,34,14,30,20,0,4to,3,0,14,0,0,20,4,0,31,0,0,0
27318,7622,2020-11-18T16:21:47.1874966Z,2020,40,12,31,19,0,5to,0,0,21,0,0,28,9,0,40,0,0,0
27318,7623,2020-11-18T16:21:47.1874966Z,2020,56,18,41,26,0,6to,0,0,30,0,0,38,15,0,56,0,0,0
27318,7624,2020-11-18T16:21:47.1874966Z,2020,66,20,36,27,0,7mo,1,0,39,0,0,46,30,0,65,0,1,0
27318,7625,2020-11-18T16:21:47.188497Z,2020,62,28,47,22,0,8vo,2,0,40,0,0,34,15,2,58,0,1,0
27318,7626,2020-11-18T16:21:47.188497Z,2020,17,3,14,9,0,K,2,0,8,0,0,14,3,0,15,0,0,0
27318,7627,2020-11-18T16:21:47.188497Z,2020,40,40,22,10,0,Sin Grado,0,0,30,0,0,0,18,0,40,0,0,0
78733,11723,2020-11-18T16:22:12.3142564Z,2020,113,43,86,56,0,10mo,1,5,57,0,0,70,27,0,112,0,0,0
78733,11724,2020-11-18T16:22:12.3142564Z,2020,106,34,92,53,0,11mo,4,4,53,0,0,72,14,0,102,0,0,0
78733,11725,2020-11-18T16:22:12.3142564Z,2020,117,32,88,55,0,12mo,4,2,62,0,0,85,29,0,113,0,1,0
78733,11726,2020-11-18T16:22:12.3152572Z,2020,113,41,91,48,0,9no,2,6,65,0,0,72,22,0,111,0,0,0
78733,35745,2021-06-24T13:18:47.7416897Z,2021,114,42,90,51,0,10mo,2,0,63,0,0,72,24,0,112,0,0,0
78733,35746,2021-06-24T13:18:47.7426906Z,2021,112,36,84,59,0,11mo,1,0,53,0,0,76,28,0,111,0,0,0
78733,35747,2021-06-24T13:18:47.7426906Z,2021,103,31,84,53,0,12mo,2,1,50,0,0,72,19,0,101,0,0,0
78733,35748,2021-06-24T13:18:47.7426906Z,2021,114,49,89,59,0,9no,0,0,55,0,0,65,25,0,114,1,0,0
78733,5717,2020-11-18T16:21:17.1454649Z,2019,110,34,90,51,0,10mo,2,7,59,0,0,76,20,0,108,0,0,0
78733,5718,2020-11-18T16:21:17.1454649Z,2019,128,33,97,57,0,11mo,2,5,71,0,0,95,31,0,126,1,1,0
78733,5719,2020-11-18T16:21:17.1454649Z,2019,116,1,90,73,0,12mo,1,1,43,0,0,115,26,0,115,0,0,0
78733,5720,2020-11-18T16:21:17.1454649Z,2019,110,42,83,53,0,9no,1,3,57,0,0,68,27,0,109,0,0,0
13326,30484,2021-06-24T13:18:09.5172737Z,2021,18,2,16,10,0,1ro,0,0,8,0,0,16,2,0,18,0,0,0
13326,30485,2021-06-24T13:18:09.5172737Z,2021,20,4,18,10,0,2do,0,0,10,0,0,16,2,0,20,0,0,0
13326,30486,2021-06-24T13:18:09.5172737Z,2021,22,5,20,12,0,3ro,0,0,10,0,0,17,2,0,22,0,0,0
13326,30487,2021-06-24T13:18:09.5182751Z,2021,16,3,14,7,0,4to,0,0,9,0,0,13,2,0,16,0,0,0
13326,30488,2021-06-24T13:18:09.5182751Z,2021,18,7,15,11,0,5to,0,0,7,0,0,11,3,0,18,0,1,0
13326,30489,2021-06-24T13:18:09.5182751Z,2021,25,5,22,13,0,6to,0,0,12,0,0,20,3,0,25,0,0,0
13326,30490,2021-06-24T13:18:09.5182751Z,2021,22,3,19,10,0,7mo,0,0,12,0,0,19,3,0,22,0,2,0
13326,30491,2021-06-24T13:18:09.5192751Z,2021,15,2,14,8,0,8vo,0,0,7,0,0,13,1,0,15,0,0,0
13326,30492,2021-06-24T13:18:09.5192751Z,2021,16,3,12,7,0,K,0,0,9,0,0,13,4,0,16,0,0,0
13326,487,2020-11-18T16:20:40.0747448Z,2019,20,4,16,13,0,1ro,0,0,7,0,0,16,4,0,20,0,0,0
13326,488,2020-11-18T16:20:40.0747448Z,2019,20,7,18,6,0,2do,0,0,14,0,0,13,2,0,20,0,0,0
13326,489,2020-11-18T16:20:40.0747448Z,2019,24,10,19,14,0,3ro,0,0,10,0,0,14,5,0,24,0,1,0
13326,490,2020-11-18T16:20:40.0747448Z,2019,24,6,16,14,0,4to,0,0,10,0,0,18,8,0,24,0,0,0
13326,491,2020-11-18T16:20:40.0757466Z,2019,29,8,21,13,0,5to,0,0,16,0,0,21,8,0,29,1,1,0
13326,492,2020-11-18T16:20:40.0757466Z,2019,20,4,20,11,0,6to,0,0,9,0,0,16,0,0,20,0,0,0
13326,493,2020-11-18T16:20:40.0757466Z,2019,18,8,16,12,0,7mo,0,0,6,0,0,10,2,0,18,0,0,0
13326,494,2020-11-18T16:20:40.076747Z,2019,30,10,23,16,0,8vo,0,0,14,0,0,20,7,0,30,0,0,0
13326,495,2020-11-18T16:20:40.076747Z,2019,23,2,18,8,0,K,0,0,15,0,0,21,5,0,23,1,0,0
13326,6486,2020-11-18T16:21:39.6814939Z,2020,19,1,16,8,0,1ro,0,0,11,0,0,18,3,0,19,0,0,0
13326,6487,2020-11-18T16:21:39.6814939Z,2020,25,5,22,15,0,2do,0,0,10,0,0,20,3,0,25,0,0,0
13326,6488,2020-11-18T16:21:39.6814939Z,2020,16,4,14,7,0,3ro,0,0,9,0,0,12,2,0,16,0,0,0
13326,6489,2020-11-18T16:21:39.6814939Z,2020,19,8,15,11,0,4to,0,0,8,0,0,11,4,0,19,0,1,0
13326,6490,2020-11-18T16:21:39.6814939Z,2020,29,6,23,16,0,5to,0,0,13,0,0,23,6,0,29,0,0,0
13326,6491,2020-11-18T16:21:39.6824948Z,2020,24,5,18,12,0,6to,0,0,12,0,0,19,6,0,24,1,1,0
13326,6492,2020-11-18T16:21:39.6824948Z,2020,18,3,18,11,0,7mo,0,0,7,0,0,15,0,0,18,0,0,0
13326,6493,2020-11-18T16:21:39.6824948Z,2020,20,7,16,14,0,8vo,0,0,6,0,0,13,4,0,20,0,0,0
13326,6494,2020-11-18T16:21:39.6824948Z,2020,25,4,22,13,0,K,1,0,12,0,0,21,3,0,24,0,0,0
78956,11747,2020-11-18T16:22:12.3212626Z,2020,49,16,43,28,0,1ro,0,0,21,0,0,33,6,0,49,0,0,0
78956,11748,2020-11-18T16:22:12.3212626Z,2020,71,27,63,36,0,2do,0,0,35,0,0,44,8,0,71,0,0,0
78956,11749,2020-11-18T16:22:12.3222613Z,2020,52,21,43,29,0,3ro,1,0,23,0,0,31,9,0,51,0,0,0
78956,11750,2020-11-18T16:22:12.3222613Z,2020,72,23,60,36,0,4to,0,0,36,0,0,49,12,0,72,1,0,0
78956,11751,2020-11-18T16:22:12.3222613Z,2020,57,22,50,24,0,5to,2,0,33,0,0,35,7,0,55,1,0,0
78956,11752,2020-11-18T16:22:12.3222613Z,2020,44,9,36,19,0,K,2,0,25,0,0,35,8,0,42,0,0,0
78956,11753,2020-11-18T16:22:12.3232621Z,2020,66,65,55,17,0,Sin Grado,3,0,49,0,0,1,11,0,63,1,0,0
78956,35769,2021-06-24T13:18:47.8207457Z,2021,40,9,37,14,0,1ro,1,0,26,0,0,31,3,0,39,0,0,0
78956,35770,2021-06-24T13:18:47.8217466Z,2021,43,13,38,24,0,2do,0,0,19,0,0,30,5,0,43,0,0,0
78956,35771,2021-06-24T13:18:47.8217466Z,2021,52,17,46,25,0,3ro,0,0,27,0,0,35,6,0,52,0,0,0
78956,35772,2021-06-24T13:18:47.8217466Z,2021,50,21,43,27,0,4to,1,0,23,0,0,29,7,0,49,0,1,0
78956,35773,2021-06-24T13:18:47.8217466Z,2021,71,21,64,35,0,5to,0,0,36,0,0,50,7,0,71,1,0,0
78956,35774,2021-06-24T13:18:47.8217466Z,2021,44,14,41,18,0,K,0,0,26,0,0,30,3,0,44,0,0,0
78956,35775,2021-06-24T13:18:47.8227476Z,2021,68,68,57,17,0,Sin Grado,3,0,51,0,0,0,11,0,65,1,0,0
78956,5741,2020-11-18T16:21:17.1534707Z,2019,60,26,52,31,0,1ro,0,0,29,0,0,34,8,0,60,0,0,0
78956,5742,2020-11-18T16:21:17.1534707Z,2019,49,19,40,24,0,2do,0,0,25,0,0,30,9,0,49,1,0,0
78956,5743,2020-11-18T16:21:17.1534707Z,2019,79,26,67,35,0,3ro,0,0,44,0,0,53,12,0,79,1,0,0
78956,5744,2020-11-18T16:21:17.1534707Z,2019,54,20,46,21,0,4to,2,0,33,0,0,34,8,0,52,2,0,0
78956,5745,2020-11-18T16:21:17.1534707Z,2019,65,25,50,31,0,5to,2,0,34,0,0,40,15,0,63,0,0,0
78956,5746,2020-11-18T16:21:17.1544707Z,2019,39,12,32,19,0,K,0,0,20,0,0,27,7,0,39,0,0,0
78956,5747,2020-11-18T16:21:17.1544707Z,2019,67,60,48,20,0,Sin Grado,1,1,47,0,0,7,19,0,66,0,0,0
70284,10951,2020-11-18T16:22:07.2108502Z,2020,93,31,78,37,0,10mo,0,0,56,0,0,62,15,0,93,0,0,0
70284,10952,2020-11-18T16:22:07.2118497Z,2020,100,20,85,51,0,11mo,1,1,49,0,0,80,15,0,99,0,0,0
70284,10953,2020-11-18T16:22:07.2118497Z,2020,112,32,94,66,0,12mo,0,0,46,0,0,80,18,0,112,0,1,0
70284,10954,2020-11-18T16:22:07.2118497Z,2020,118,38,102,58,0,6to,3,0,60,0,0,80,16,0,115,0,0,0
70284,10955,2020-11-18T16:22:07.2118497Z,2020,83,30,67,44,0,7mo,2,0,39,0,0,53,16,0,81,0,1,0
70284,10956,2020-11-18T16:22:07.2118497Z,2020,88,33,76,47,0,8vo,3,0,41,0,0,55,12,0,85,0,0,0
70284,10957,2020-11-18T16:22:07.2118497Z,2020,116,45,92,55,0,9no,1,2,61,0,0,71,24,0,114,0,0,1
70284,10958,2020-11-18T16:22:07.2128506Z,2020,56,56,53,12,0,Sin Grado,0,3,44,0,0,0,3,0,56,0,0,0
70284,34972,2021-06-24T13:18:43.3525415Z,2021,109,42,94,52,0,10mo,1,0,57,0,0,67,15,0,107,0,0,1
70284,34973,2021-06-24T13:18:43.3525415Z,2021,92,30,74,36,0,11mo,0,0,56,0,0,62,18,0,92,0,0,0
70284,34974,2021-06-24T13:18:43.3535429Z,2021,94,19,78,48,0,12mo,1,1,46,0,0,75,16,0,93,0,0,0
70284,34975,2021-06-24T13:18:43.3535429Z,2021,109,39,96,60,0,6to,3,0,49,0,0,70,13,0,106,0,0,0
70284,34976,2021-06-24T13:18:43.3535429Z,2021,119,38,104,58,0,7mo,2,0,61,0,0,81,15,0,117,0,0,0
70284,34977,2021-06-24T13:18:43.3535429Z,2021,92,36,80,51,0,8vo,3,0,41,0,0,56,12,0,89,0,2,0
70284,34978,2021-06-24T13:18:43.3535429Z,2021,107,35,94,53,0,9no,3,0,54,0,0,72,13,0,104,0,0,0
70284,34979,2021-06-24T13:18:43.3545434Z,2021,43,43,36,10,0,Sin Grado,1,2,33,0,0,0,7,0,42,0,0,0
70284,4943,2020-11-18T16:21:13.0157123Z,2019,102,24,86,48,0,10mo,1,0,54,0,0,78,16,0,101,0,0,0
70284,4944,2020-11-18T16:21:13.0157123Z,2019,118,34,99,68,0,11mo,0,0,50,0,0,84,19,0,118,0,1,0
70284,4945,2020-11-18T16:21:13.0157123Z,2019,104,1,78,55,0,12mo,4,0,49,0,0,103,26,0,100,0,1,0
70284,4946,2020-11-18T16:21:13.0167136Z,2019,85,33,67,46,0,6to,2,0,39,0,0,52,18,0,83,0,1,0
70284,4947,2020-11-18T16:21:13.0167136Z,2019,92,33,77,53,0,7mo,2,1,39,0,0,59,15,0,90,0,0,0
70284,4948,2020-11-18T16:21:13.0177141Z,2019,105,50,84,50,0,8vo,2,0,55,0,0,55,21,0,102,0,0,1
70284,4949,2020-11-18T16:21:13.0177141Z,2019,93,29,79,37,0,9no,0,0,56,0,0,64,14,0,93,0,0,0
70284,4950,2020-11-18T16:21:13.0177141Z,2019,45,43,40,7,0,Sin Grado,1,1,38,0,0,2,5,0,44,0,0,0
65987,10730,2020-11-18T16:22:06.0190567Z,2020,78,12,55,36,0,1ro,2,0,42,0,0,66,23,0,75,0,0,1
65987,10731,2020-11-18T16:22:06.0190567Z,2020,88,28,60,42,0,2do,2,0,46,0,0,60,28,0,86,0,0,0
65987,10732,2020-11-18T16:22:06.0190567Z,2020,68,16,43,42,0,3ro,1,0,26,0,0,52,25,0,67,0,0,0
65987,10733,2020-11-18T16:22:06.0200576Z,2020,96,31,70,53,0,4to,0,1,43,0,0,65,26,0,96,0,0,0
65987,10734,2020-11-18T16:22:06.0200576Z,2020,102,34,77,47,0,5to,1,0,55,0,0,68,25,0,100,0,0,1
65987,10735,2020-11-18T16:22:06.0200576Z,2020,17,8,9,9,0,6to,1,0,8,0,0,9,8,0,16,0,0,0
65987,10736,2020-11-18T16:22:06.0200576Z,2020,56,17,45,28,0,K,0,0,28,0,0,39,11,0,56,0,0,0
65987,10737,2020-11-18T16:22:06.0210589Z,2020,48,5,27,29,0,PK,0,0,19,0,0,43,21,1,47,0,0,0
65987,10738,2020-11-18T16:22:06.0210589Z,2020,12,12,7,1,0,Sin Grado,0,0,11,0,0,0,5,0,12,0,0,0
65987,34747,2021-06-24T13:18:41.4801992Z,2021,82,21,72,39,0,1ro,0,1,43,0,0,61,10,1,81,0,0,0
65987,34748,2021-06-24T13:18:41.4801992Z,2021,80,16,55,40,0,2do,1,0,40,0,0,64,25,0,78,0,0,1
65987,34749,2021-06-24T13:18:41.4811997Z,2021,91,30,64,45,0,3ro,2,0,46,0,0,61,27,0,89,0,0,0
65987,34750,2021-06-24T13:18:41.4811997Z,2021,81,20,51,49,0,4to,1,0,32,0,0,61,30,0,80,0,0,0
65987,34751,2021-06-24T13:18:41.4811997Z,2021,99,31,76,54,0,5to,0,1,45,0,0,68,23,0,99,0,0,0
65987,34752,2021-06-24T13:18:41.4811997Z,2021,15,7,11,6,0,6to,0,0,9,0,0,8,4,0,14,0,0,1
65987,34753,2021-06-24T13:18:41.482201Z,2021,88,14,70,45,0,K,1,0,43,0,0,74,18,0,87,0,0,0
65987,34754,2021-06-24T13:18:41.482201Z,2021,15,1,12,9,0,PK,0,0,6,0,0,14,3,2,13,0,0,0
65987,34755,2021-06-24T13:18:41.482201Z,2021,8,8,7,1,0,Sin Grado,0,0,7,0,0,0,1,0,8,0,0,0
65987,4721,2020-11-18T16:21:11.9099739Z,2019,77,27,51,36,0,1ro,2,0,41,0,0,50,26,0,75,0,0,0
65987,4722,2020-11-18T16:21:11.9099739Z,2019,71,17,44,37,0,2do,2,0,34,0,0,54,27,0,69,0,0,0
65987,4723,2020-11-18T16:21:11.9099739Z,2019,91,31,59,49,0,3ro,0,1,42,0,0,60,32,0,91,0,0,0
65987,4724,2020-11-18T16:21:11.9099739Z,2019,101,34,75,46,0,4to,0,0,55,0,0,67,26,0,100,0,0,1
65987,4725,2020-11-18T16:21:11.9099739Z,2019,115,31,78,56,0,5to,1,0,59,0,0,84,37,0,114,0,0,0
65987,4726,2020-11-18T16:21:11.9109747Z,2019,17,10,8,9,0,6to,0,0,8,0,0,7,9,0,17,1,0,0
65987,4727,2020-11-18T16:21:11.9109747Z,2019,57,9,40,44,0,K,1,0,13,0,0,48,17,0,56,0,0,0
65987,4728,2020-11-18T16:21:11.9109747Z,2019,51,8,26,29,0,PK,0,0,22,0,0,43,25,1,49,0,0,1
65987,4729,2020-11-18T16:21:11.9109747Z,2019,11,10,8,0,0,Sin Grado,0,0,11,0,0,1,3,0,11,0,0,0
15248,30593,2021-06-24T13:18:10.4009075Z,2021,178,51,118,86,0,10mo,2,0,92,0,0,127,60,0,175,2,0,1
15248,30594,2021-06-24T13:18:10.4009075Z,2021,124,23,82,61,0,11mo,4,0,63,0,0,101,42,0,119,1,0,1
15248,30595,2021-06-24T13:18:10.4009075Z,2021,188,46,122,97,0,12mo,7,0,91,0,0,142,66,0,181,6,2,0
15248,30596,2021-06-24T13:18:10.401908Z,2021,187,53,131,107,0,9no,4,0,80,0,0,134,56,0,182,0,1,1
15248,30597,2021-06-24T13:18:10.401908Z,2021,27,27,19,9,0,Sin Grado,1,0,18,0,0,0,8,0,26,0,2,0
15248,595,2020-11-18T16:20:40.7852194Z,2019,195,50,135,101,0,10mo,9,0,94,0,0,145,60,0,186,5,2,0
15248,596,2020-11-18T16:20:40.7852194Z,2019,189,33,136,100,0,11mo,7,0,89,0,0,156,53,0,182,8,1,0
15248,597,2020-11-18T16:20:40.7862216Z,2019,213,0,141,114,0,12mo,4,0,99,0,0,213,72,0,209,0,1,0
15248,598,2020-11-18T16:20:40.7862216Z,2019,153,35,108,76,0,9no,6,0,77,0,0,118,45,0,147,1,0,0
15248,599,2020-11-18T16:20:40.7862216Z,2019,10,9,7,5,0,Sin Grado,0,0,5,0,0,1,3,0,10,0,2,0
15248,6595,2020-11-18T16:21:40.3649516Z,2020,129,25,84,62,0,10mo,3,0,67,0,0,104,45,0,126,1,0,0
15248,6596,2020-11-18T16:21:40.3659511Z,2020,201,55,133,104,0,11mo,7,0,97,0,0,146,68,0,194,6,2,0
15248,6597,2020-11-18T16:21:40.3659511Z,2020,175,32,119,99,0,12mo,6,0,76,0,0,143,56,0,169,9,1,0
15248,6598,2020-11-18T16:21:40.3659511Z,2020,182,49,130,94,0,9no,3,0,88,0,0,133,52,0,178,2,0,1
15248,6599,2020-11-18T16:21:40.3659511Z,2020,10,10,9,4,0,Sin Grado,0,0,6,0,0,0,1,0,10,0,2,0
12062,275,2020-11-18T16:20:38.7968914Z,2019,14,8,13,5,0,1ro,0,0,9,0,0,6,1,0,14,0,0,0
12062,276,2020-11-18T16:20:38.7968914Z,2019,12,2,11,5,0,2do,0,0,7,0,0,10,1,0,12,0,0,0
12062,277,2020-11-18T16:20:38.7968914Z,2019,10,4,9,2,0,3ro,0,0,8,0,0,6,1,0,10,0,0,0
12062,278,2020-11-18T16:20:38.7978923Z,2019,14,4,14,8,0,4to,0,0,6,0,0,10,0,0,14,0,1,0
12062,279,2020-11-18T16:20:38.7978923Z,2019,13,5,11,5,0,5to,0,0,8,0,0,8,2,0,13,0,0,0
12062,280,2020-11-18T16:20:38.7978923Z,2019,13,5,13,6,0,K,0,0,7,0,0,8,0,0,13,0,0,0
12062,30273,2021-06-24T13:18:07.146574Z,2021,11,2,10,4,0,1ro,1,0,7,0,0,9,1,0,10,0,0,0
12062,30274,2021-06-24T13:18:07.1475749Z,2021,19,7,19,9,0,2do,0,0,10,0,0,12,0,0,19,0,0,0
12062,30275,2021-06-24T13:18:07.1475749Z,2021,15,8,14,4,0,3ro,0,0,11,0,0,7,1,0,15,0,0,0
12062,30276,2021-06-24T13:18:07.1475749Z,2021,13,3,12,7,0,4to,0,0,6,0,0,10,1,0,13,0,0,0
12062,30277,2021-06-24T13:18:07.1475749Z,2021,7,3,7,1,0,5to,0,0,6,0,0,4,0,0,7,0,0,0
12062,30278,2021-06-24T13:18:07.1485759Z,2021,14,3,12,7,0,K,0,0,7,0,0,11,2,0,14,0,0,0
12062,6276,2020-11-18T16:21:38.6407992Z,2020,19,6,17,8,0,1ro,0,0,11,0,0,13,2,0,19,0,0,0
12062,6277,2020-11-18T16:21:38.6407992Z,2020,13,7,13,4,0,2do,0,0,9,0,0,6,0,0,13,0,0,0
12062,6278,2020-11-18T16:21:38.6407992Z,2020,12,2,11,6,0,3ro,0,0,6,0,0,10,1,0,12,0,0,0
12062,6279,2020-11-18T16:21:38.6407992Z,2020,7,3,6,1,0,4to,0,0,6,0,0,4,1,0,7,0,0,0
12062,6280,2020-11-18T16:21:38.6418009Z,2020,12,3,12,7,0,5to,0,0,5,0,0,9,0,0,12,0,1,0
12062,6281,2020-11-18T16:21:38.6418009Z,2020,9,0,6,2,0,K,0,0,7,0,0,9,3,0,9,0,0,0
71225,11245,2020-11-18T16:22:09.5694217Z,2020,82,35,75,45,0,10mo,1,0,37,0,0,47,7,0,81,0,0,0
71225,11246,2020-11-18T16:22:09.5694217Z,2020,85,30,74,40,0,11mo,0,0,45,0,0,55,11,0,85,0,0,0
71225,11247,2020-11-18T16:22:09.5694217Z,2020,81,27,60,36,0,12mo,0,0,45,0,0,54,21,0,81,0,0,0
71225,11248,2020-11-18T16:22:09.5694217Z,2020,60,21,50,30,0,9no,1,0,30,0,0,39,10,0,59,1,0,0
71225,35266,2021-06-24T13:18:44.8346045Z,2021,68,25,60,37,0,10mo,1,0,31,0,0,43,8,0,67,1,0,0
71225,35267,2021-06-24T13:18:44.8346045Z,2021,77,30,71,44,0,11mo,1,0,33,0,0,47,6,0,76,0,0,0
71225,35268,2021-06-24T13:18:44.8346045Z,2021,82,27,71,41,0,12mo,0,0,41,0,0,55,11,0,82,0,0,0
71225,35269,2021-06-24T13:18:44.8346045Z,2021,102,54,89,44,0,9no,2,0,58,0,0,48,13,0,100,1,0,0
71225,5240,2020-11-18T16:21:14.4596728Z,2019,111,37,87,52,0,10mo,0,0,59,0,0,74,24,0,111,0,0,0
71225,5241,2020-11-18T16:21:14.4596728Z,2019,94,31,72,43,0,11mo,0,1,51,0,0,63,22,0,94,0,0,0
71225,5242,2020-11-18T16:21:14.4596728Z,2019,148,0,104,72,0,12mo,0,0,76,0,0,148,44,0,148,0,1,0
71225,5243,2020-11-18T16:21:14.4606733Z,2019,47,18,40,30,0,9no,1,0,17,0,0,29,7,0,46,1,0,0
70813,11141,2020-11-18T16:22:08.3205897Z,2020,162,39,137,77,0,10mo,3,2,85,0,0,123,25,1,158,0,0,0
70813,11142,2020-11-18T16:22:08.3205897Z,2020,133,31,108,75,0,11mo,4,0,58,0,0,102,25,0,129,0,0,0
70813,11143,2020-11-18T16:22:08.3215892Z,2020,140,31,117,86,0,12mo,6,0,54,0,0,109,23,0,134,0,0,0
70813,11144,2020-11-18T16:22:08.3215892Z,2020,173,53,145,89,0,9no,2,0,84,0,0,120,28,0,171,0,0,0
70813,35162,2021-06-24T13:18:44.5043681Z,2021,164,48,145,87,0,10mo,3,0,77,0,0,116,19,0,161,0,0,0
70813,35163,2021-06-24T13:18:44.5043681Z,2021,148,33,129,73,0,11mo,4,1,75,0,0,115,19,1,143,0,0,0
70813,35164,2021-06-24T13:18:44.5043681Z,2021,114,24,98,64,0,12mo,2,0,50,0,0,90,16,0,112,0,0,0
70813,35165,2021-06-24T13:18:44.5043681Z,2021,172,52,157,89,0,9no,4,0,83,0,0,120,15,0,167,0,0,1
70813,5135,2020-11-18T16:21:14.0283881Z,2019,145,27,122,76,0,10mo,3,0,69,0,0,118,23,1,141,0,0,0
70813,5136,2020-11-18T16:21:14.0293885Z,2019,142,29,122,85,0,11mo,4,0,57,0,0,113,20,0,138,0,0,0
70813,5137,2020-11-18T16:21:14.0293885Z,2019,156,3,137,87,0,12mo,3,0,69,0,0,153,19,0,153,0,0,0
70813,5138,2020-11-18T16:21:14.0293885Z,2019,156,39,138,75,0,9no,1,1,81,0,0,117,18,0,155,0,0,0
14787,30580,2021-06-24T13:18:10.3959037Z,2021,57,18,45,29,0,1ro,0,0,28,0,0,39,12,0,57,0,0,0
14787,30581,2021-06-24T13:18:10.3969051Z,2021,59,17,48,27,0,2do,0,0,32,0,0,42,11,0,59,0,0,0
14787,30582,2021-06-24T13:18:10.3969051Z,2021,52,21,42,23,0,3ro,1,0,29,0,0,31,10,0,50,0,0,1
14787,30583,2021-06-24T13:18:10.3969051Z,2021,66,23,57,35,0,4to,0,0,31,0,0,43,9,0,65,0,0,1
14787,30584,2021-06-24T13:18:10.3969051Z,2021,31,12,27,16,0,5to,0,0,15,0,0,19,4,0,30,0,0,1
14787,30585,2021-06-24T13:18:10.3969051Z,2021,42,12,30,19,0,K,0,0,23,0,0,30,12,0,42,0,0,0
14787,582,2020-11-18T16:20:40.7852194Z,2019,65,29,53,31,0,1ro,0,0,34,0,0,36,12,1,64,0,0,0
14787,583,2020-11-18T16:20:40.7852194Z,2019,79,33,58,40,0,2do,0,0,39,0,0,46,21,0,78,0,0,1
14787,584,2020-11-18T16:20:40.7852194Z,2019,60,20,48,34,0,3ro,1,0,26,0,0,40,12,1,57,0,1,1
14787,585,2020-11-18T16:20:40.7852194Z,2019,65,24,46,29,0,4to,0,0,36,0,0,41,19,0,65,0,0,0
14787,586,2020-11-18T16:20:40.7862216Z,2019,52,16,34,21,0,5to,0,0,31,0,0,36,18,0,52,0,0,0
14787,587,2020-11-18T16:20:40.7862216Z,2019,72,26,55,39,0,K,0,0,33,0,0,46,17,0,72,0,0,0
14787,6582,2020-11-18T16:21:40.3639502Z,2020,68,25,52,34,0,1ro,0,0,34,0,0,43,16,0,68,0,0,0
14787,6583,2020-11-18T16:21:40.3639502Z,2020,61,25,49,27,0,2do,1,0,34,0,0,36,12,0,60,0,0,0
14787,6584,2020-11-18T16:21:40.3639502Z,2020,69,26,51,37,0,3ro,0,0,32,0,0,43,18,0,68,0,0,1
14787,6585,2020-11-18T16:21:40.3639502Z,2020,49,17,39,27,0,4to,1,0,22,0,0,32,10,0,47,0,1,1
14787,6586,2020-11-18T16:21:40.3639502Z,2020,58,19,43,28,0,5to,1,0,30,0,0,39,15,0,57,0,0,0
14787,6587,2020-11-18T16:21:40.3649516Z,2020,64,10,53,32,0,K,0,0,32,0,0,54,11,0,64,0,0,0
58255,10065,2020-11-18T16:22:01.9513442Z,2020,24,4,19,6,0,1ro,0,0,18,0,0,20,5,0,24,0,0,0
58255,10066,2020-11-18T16:22:01.9523455Z,2020,21,6,21,8,0,2do,7,0,13,0,0,15,0,0,13,0,0,1
58255,10067,2020-11-18T16:22:01.9523455Z,2020,31,14,25,12,0,3ro,2,0,19,0,0,17,6,0,29,0,0,0
58255,10068,2020-11-18T16:22:01.9523455Z,2020,20,3,18,11,0,4to,0,0,9,0,0,17,2,0,20,0,0,0
58255,10069,2020-11-18T16:22:01.9533464Z,2020,22,9,19,9,0,5to,2,0,13,0,0,13,3,0,20,1,0,0
58255,10070,2020-11-18T16:22:01.9533464Z,2020,32,6,30,22,0,6to,8,0,10,0,0,26,2,0,24,2,0,0
58255,10071,2020-11-18T16:22:01.9533464Z,2020,43,16,39,18,0,7mo,3,0,25,0,0,27,4,0,40,1,0,0
58255,10072,2020-11-18T16:22:01.9533464Z,2020,25,5,23,17,0,8vo,13,0,8,0,0,20,2,0,12,1,0,0
58255,10073,2020-11-18T16:22:01.9543464Z,2020,25,2,22,10,0,K,0,0,15,0,0,23,3,0,25,0,0,0
58255,34073,2021-06-24T13:18:36.973969Z,2021,23,1,21,9,0,1ro,0,0,14,0,0,22,2,0,23,0,0,0
58255,34074,2021-06-24T13:18:36.973969Z,2021,26,5,22,6,0,2do,2,0,20,0,0,21,4,0,24,0,0,0
58255,34075,2021-06-24T13:18:36.973969Z,2021,16,6,16,8,0,3ro,5,0,8,0,0,10,0,0,10,0,0,1
58255,34076,2021-06-24T13:18:36.9749686Z,2021,32,14,29,12,0,4to,2,0,20,0,0,18,3,0,30,0,0,0
58255,34077,2021-06-24T13:18:36.9749686Z,2021,22,3,18,11,0,5to,0,0,11,0,0,19,4,0,22,0,0,0
58255,34078,2021-06-24T13:18:36.9749686Z,2021,29,11,24,15,0,6to,2,0,14,0,0,18,5,0,27,2,0,0
58255,34079,2021-06-24T13:18:36.97597Z,2021,37,7,32,25,0,7mo,8,0,12,0,0,30,5,0,29,2,0,0
58255,34080,2021-06-24T13:18:36.97597Z,2021,45,16,41,22,0,8vo,5,0,23,0,0,29,4,0,40,0,0,0
58255,34081,2021-06-24T13:18:36.9769705Z,2021,24,4,21,14,0,K,0,0,10,0,0,20,3,0,24,0,0,0
58255,4047,2020-11-18T16:21:07.3059043Z,2019,24,7,20,9,1,1ro,9,1,15,0,0,17,4,0,14,0,0,1
58255,4048,2020-11-18T16:21:07.3059043Z,2019,34,15,28,15,1,2do,3,1,19,0,0,19,6,0,30,0,0,1
58255,4049,2020-11-18T16:21:07.3059043Z,2019,24,6,21,11,0,3ro,0,0,13,0,0,18,3,0,24,0,1,0
58255,4050,2020-11-18T16:21:07.3069052Z,2019,24,10,21,9,1,4to,2,1,15,0,0,14,3,0,22,1,1,0
58255,4051,2020-11-18T16:21:07.3069052Z,2019,30,4,28,20,0,5to,10,0,10,0,0,26,2,0,20,2,0,0
58255,4052,2020-11-18T16:21:07.3069052Z,2019,38,14,34,18,0,6to,3,1,20,0,0,24,4,0,35,1,0,0
58255,4053,2020-11-18T16:21:07.3069052Z,2019,33,10,31,18,0,7mo,13,0,15,0,0,23,2,0,20,1,0,0
58255,4054,2020-11-18T16:21:07.3069052Z,2019,33,8,30,17,0,8vo,0,0,16,0,0,25,3,0,33,0,0,0
58255,4055,2020-11-18T16:21:07.3079066Z,2019,21,4,17,9,0,K,0,0,12,0,0,17,4,0,21,0,0,0
13151,30473,2021-06-24T13:18:09.5102689Z,2021,83,16,69,44,0,6to,2,0,39,0,0,67,14,0,81,0,0,0
13151,30474,2021-06-24T13:18:09.5102689Z,2021,96,16,76,41,0,7mo,1,0,55,0,0,80,20,0,95,0,1,0
13151,30475,2021-06-24T13:18:09.5102689Z,2021,108,22,83,57,0,8vo,0,0,51,0,0,86,25,1,107,0,0,0
13151,30476,2021-06-24T13:18:09.5102689Z,2021,12,12,10,4,0,Sin Grado,1,0,8,0,0,0,2,0,11,0,0,0
13151,475,2020-11-18T16:20:40.0677404Z,2019,110,21,90,54,0,6to,0,0,56,0,0,89,20,1,109,0,0,0
13151,476,2020-11-18T16:20:40.0687408Z,2019,108,19,65,52,0,7mo,0,0,56,0,0,89,43,0,108,0,0,0
13151,477,2020-11-18T16:20:40.0687408Z,2019,126,21,80,66,0,8vo,0,0,60,0,0,105,46,0,126,1,0,0
13151,478,2020-11-18T16:20:40.0687408Z,2019,1,0,0,0,0,K,0,0,1,0,0,1,1,0,1,0,0,0
13151,6476,2020-11-18T16:21:39.6674845Z,2020,105,20,88,44,0,6to,1,2,61,0,0,85,17,0,104,0,1,0
13151,6477,2020-11-18T16:21:39.6684859Z,2020,109,21,74,56,0,7mo,0,0,53,0,0,88,35,1,108,0,0,0
13151,6478,2020-11-18T16:21:39.6684859Z,2020,101,12,53,54,0,8vo,0,1,47,0,0,89,48,0,101,0,0,0
12245,30316,2021-06-24T13:18:08.794756Z,2021,94,31,81,38,0,6to,1,0,56,0,0,63,13,0,93,1,0,0
12245,30317,2021-06-24T13:18:08.794756Z,2021,112,41,100,54,0,7mo,3,0,58,0,0,71,12,0,109,0,0,0
12245,30318,2021-06-24T13:18:08.795757Z,2021,113,40,98,47,0,8vo,0,0,66,0,0,73,15,0,113,0,0,0
12245,30319,2021-06-24T13:18:08.795757Z,2021,6,5,6,2,0,Sin Grado,0,0,4,0,0,1,0,0,6,0,0,0
12245,318,2020-11-18T16:20:39.6244445Z,2019,112,42,95,48,0,6to,0,1,64,0,0,70,17,0,112,0,0,0
12245,319,2020-11-18T16:20:39.6244445Z,2019,117,35,94,50,0,7mo,2,1,67,0,0,82,23,0,115,0,2,0
12245,320,2020-11-18T16:20:39.6244445Z,2019,121,36,100,68,0,8vo,1,0,53,0,0,85,21,1,118,5,0,1
12245,321,2020-11-18T16:20:39.6254454Z,2019,8,8,8,3,0,Sin Grado,0,2,5,0,0,0,0,0,8,0,0,0
12245,6319,2020-11-18T16:21:39.2341962Z,2020,112,39,93,53,0,6to,3,0,59,0,0,73,19,0,109,0,0,0
12245,6320,2020-11-18T16:21:39.2341962Z,2020,117,41,96,49,0,7mo,0,0,68,0,0,76,21,0,117,0,0,0
12245,6321,2020-11-18T16:21:39.2351958Z,2020,111,32,95,52,0,8vo,3,0,59,0,0,79,16,0,108,0,2,0
12245,6322,2020-11-18T16:21:39.2351958Z,2020,5,5,5,1,0,Sin Grado,0,0,4,0,0,0,0,0,5,0,0,0
76356,11660,2020-11-18T16:22:11.7338687Z,2020,16,7,15,8,0,1ro,0,2,8,0,0,9,1,0,16,0,0,0
76356,11661,2020-11-18T16:22:11.7348687Z,2020,21,5,17,13,0,2do,0,0,8,0,0,16,4,0,21,0,0,0
76356,11662,2020-11-18T16:22:11.7348687Z,2020,21,12,16,7,0,3ro,0,3,14,0,0,9,5,0,21,0,0,0
76356,11663,2020-11-18T16:22:11.7348687Z,2020,25,11,21,11,0,4to,0,1,14,0,0,14,4,0,25,0,0,0
76356,11664,2020-11-18T16:22:11.73587Z,2020,14,6,11,8,0,5to,0,1,6,0,0,8,3,0,14,1,0,0
76356,11665,2020-11-18T16:22:11.73587Z,2020,17,4,14,7,0,K,0,0,10,0,0,13,3,0,17,0,0,0
76356,11666,2020-11-18T16:22:11.73587Z,2020,12,3,9,5,0,PK,0,0,7,0,0,9,3,0,12,0,0,0
76356,11667,2020-11-18T16:22:11.73587Z,2020,15,15,13,6,0,Sin Grado,0,0,9,0,0,0,2,0,15,0,0,0
76356,35683,2021-06-24T13:18:47.4424753Z,2021,16,4,16,6,0,1ro,0,0,10,0,0,12,0,0,16,0,0,0
76356,35684,2021-06-24T13:18:47.4434758Z,2021,14,7,14,7,0,2do,0,1,7,0,0,7,0,0,14,0,0,0
76356,35685,2021-06-24T13:18:47.4434758Z,2021,17,5,16,10,0,3ro,0,0,7,0,0,12,1,0,17,0,0,0
76356,35686,2021-06-24T13:18:47.4434758Z,2021,16,9,12,5,0,4to,0,1,11,0,0,7,4,0,16,0,0,0
76356,35687,2021-06-24T13:18:47.4434758Z,2021,23,10,21,11,0,5to,0,1,12,0,0,13,2,0,23,0,0,0
76356,35688,2021-06-24T13:18:47.4434758Z,2021,24,7,20,9,0,K,0,0,15,0,0,17,4,0,23,0,0,1
76356,35689,2021-06-24T13:18:47.4444768Z,2021,16,4,14,5,0,PK,0,0,11,0,0,12,2,0,16,0,0,0
76356,35690,2021-06-24T13:18:47.4444768Z,2021,11,11,9,6,0,Sin Grado,0,2,5,0,0,0,2,0,11,0,0,0
76356,5653,2020-11-18T16:21:16.6181138Z,2019,27,10,25,14,0,1ro,0,0,13,0,1,17,2,0,27,0,0,0
76356,5654,2020-11-18T16:21:16.6181138Z,2019,27,11,20,9,0,2do,0,5,18,0,0,16,7,0,27,0,0,0
76356,5655,2020-11-18T16:21:16.6181138Z,2019,28,11,25,15,0,3ro,0,2,13,0,0,17,3,0,28,0,0,0
76356,5656,2020-11-18T16:21:16.6191147Z,2019,16,8,13,9,0,4to,0,1,7,0,0,8,3,0,16,1,0,0
76356,5657,2020-11-18T16:21:16.6191147Z,2019,27,6,23,15,0,5to,1,1,12,0,0,21,4,0,26,0,0,0
76356,5658,2020-11-18T16:21:16.6191147Z,2019,17,4,15,9,0,K,0,2,8,0,0,13,2,0,17,0,0,0
76356,5659,2020-11-18T16:21:16.6191147Z,2019,16,5,13,8,0,PK,0,0,8,0,0,11,3,0,16,0,0,0
76356,5660,2020-11-18T16:21:16.6201156Z,2019,12,12,11,5,0,Sin Grado,0,0,7,0,0,0,1,0,12,0,0,0
21006,1128,2020-11-18T16:20:44.6277805Z,2019,37,13,32,19,0,1ro,0,4,18,0,0,24,5,0,37,0,0,0
21006,1129,2020-11-18T16:20:44.6287814Z,2019,29,13,26,14,0,2do,0,3,15,0,0,16,3,0,29,0,0,0
21006,1130,2020-11-18T16:20:44.6287814Z,2019,23,12,17,10,0,3ro,0,2,13,0,0,11,6,0,23,0,0,0
21006,1131,2020-11-18T16:20:44.6287814Z,2019,21,6,17,11,0,4to,0,2,10,0,0,15,4,0,21,0,0,0
21006,1132,2020-11-18T16:20:44.6287814Z,2019,26,14,24,10,0,5to,0,2,16,0,0,12,2,0,26,0,0,0
21006,1133,2020-11-18T16:20:44.6287814Z,2019,17,7,15,2,0,K,0,0,15,0,0,10,2,0,17,1,0,0
21006,1134,2020-11-18T16:20:44.6297818Z,2019,7,6,7,3,0,Sin Grado,0,0,4,0,0,1,0,0,7,0,0,0
21006,31129,2021-06-24T13:18:13.0818306Z,2021,24,10,20,13,0,1ro,0,0,11,0,0,14,4,0,24,0,0,0
21006,31130,2021-06-24T13:18:13.0818306Z,2021,17,5,14,5,0,2do,0,0,12,0,0,12,3,0,17,1,0,0
21006,31131,2021-06-24T13:18:13.0818306Z,2021,34,8,30,20,0,3ro,0,2,14,0,0,26,4,0,34,0,0,0
21006,31132,2021-06-24T13:18:13.0818306Z,2021,32,16,27,16,0,4to,0,0,16,0,0,16,5,0,32,0,0,0
21006,31133,2021-06-24T13:18:13.082831Z,2021,23,12,17,10,0,5to,0,1,13,0,0,11,6,0,23,0,0,0
21006,31134,2021-06-24T13:18:13.082831Z,2021,22,8,22,13,0,K,0,0,9,0,0,14,0,0,22,0,0,0
21006,31135,2021-06-24T13:18:13.0838315Z,2021,9,9,8,3,0,Sin Grado,0,2,6,0,0,0,1,0,9,0,0,0
21006,7133,2020-11-18T16:21:44.1945028Z,2020,18,6,16,4,0,1ro,0,0,14,0,0,12,2,0,18,1,0,0
21006,7134,2020-11-18T16:21:44.1945028Z,2020,37,11,32,21,0,2do,0,2,16,0,0,26,5,0,37,0,0,0
21006,7135,2020-11-18T16:21:44.1945028Z,2020,35,18,33,16,0,3ro,0,0,19,0,0,17,2,0,35,0,0,0
21006,7136,2020-11-18T16:21:44.1945028Z,2020,24,13,18,9,0,4to,0,1,15,0,0,11,6,0,24,0,0,0
21006,7137,2020-11-18T16:21:44.1945028Z,2020,18,5,16,10,0,5to,0,1,8,0,0,13,2,0,18,0,0,0
21006,7138,2020-11-18T16:21:44.1955037Z,2020,25,9,21,12,0,K,0,1,13,0,0,16,4,0,25,0,0,0
21006,7139,2020-11-18T16:21:44.1955037Z,2020,8,8,7,1,0,Sin Grado,0,1,7,0,0,0,1,0,8,0,0,0
53256,33685,2021-06-24T13:18:33.6886126Z,2021,111,32,85,51,0,6to,0,1,60,0,0,79,26,0,111,0,0,0
53256,33686,2021-06-24T13:18:33.6896131Z,2021,132,35,106,68,0,7mo,0,3,64,0,0,97,26,0,132,0,0,0
53256,33687,2021-06-24T13:18:33.6896131Z,2021,139,39,103,74,0,8vo,0,3,65,0,0,100,36,0,139,0,0,0
53256,33688,2021-06-24T13:18:33.690614Z,2021,30,30,23,8,0,Sin Grado,0,0,22,0,0,0,7,0,30,0,0,0
53256,3660,2020-11-18T16:21:04.328921Z,2019,145,44,103,74,0,6to,0,0,71,0,0,101,42,0,145,0,0,0
53256,3661,2020-11-18T16:21:04.3299192Z,2019,152,37,105,81,0,7mo,2,0,71,0,0,115,47,0,150,0,0,0
53256,3662,2020-11-18T16:21:04.3299192Z,2019,133,28,91,66,0,8vo,1,0,67,0,0,105,42,1,131,0,2,0
53256,3663,2020-11-18T16:21:04.3299192Z,2019,28,24,20,6,0,Sin Grado,0,0,22,0,0,4,8,0,28,0,0,0
53256,9679,2020-11-18T16:21:59.50271Z,2020,138,37,99,72,0,6to,0,0,66,0,0,101,39,0,138,0,0,0
53256,9680,2020-11-18T16:21:59.50271Z,2020,142,37,101,75,0,7mo,0,0,67,0,0,105,41,0,142,0,0,0
53256,9681,2020-11-18T16:21:59.50271Z,2020,141,28,97,76,0,8vo,1,0,65,0,0,113,44,0,139,0,0,1
53256,9682,2020-11-18T16:21:59.50271Z,2020,30,30,23,8,0,Sin Grado,0,0,22,0,0,0,7,0,30,0,0,0
66167,10760,2020-11-18T16:22:06.0290652Z,2020,45,11,45,27,0,1ro,0,0,18,0,0,34,0,0,45,0,0,0
66167,10761,2020-11-18T16:22:06.0290652Z,2020,47,19,45,23,0,2do,0,0,24,0,0,28,2,0,47,0,0,0
66167,10762,2020-11-18T16:22:06.0290652Z,2020,44,18,43,23,0,3ro,1,0,21,0,0,26,1,0,43,0,0,0
66167,10763,2020-11-18T16:22:06.0300643Z,2020,39,8,38,19,0,4to,0,0,20,0,0,31,1,1,38,0,0,0
66167,10764,2020-11-18T16:22:06.0300643Z,2020,45,15,45,18,0,5to,0,0,27,0,0,30,0,0,45,0,0,0
66167,10765,2020-11-18T16:22:06.0300643Z,2020,46,6,46,28,0,K,2,0,18,0,0,40,0,0,44,0,0,0
66167,10766,2020-11-18T16:22:06.0310643Z,2020,3,3,3,0,0,Sin Grado,0,0,3,0,0,0,0,0,3,0,0,0
66167,34777,2021-06-24T13:18:41.4972116Z,2021,45,6,45,25,0,1ro,1,0,20,0,0,39,0,0,44,0,0,0
66167,34778,2021-06-24T13:18:41.498213Z,2021,36,10,35,17,0,2do,0,0,19,0,0,26,1,0,36,0,0,0
66167,34779,2021-06-24T13:18:41.498213Z,2021,45,17,43,20,0,3ro,0,0,25,0,0,28,2,0,45,0,0,0
66167,34780,2021-06-24T13:18:41.498213Z,2021,50,20,48,25,0,4to,1,0,25,0,0,30,2,0,49,0,0,0
66167,34781,2021-06-24T13:18:41.498213Z,2021,37,11,36,18,0,5to,0,0,19,0,0,26,1,0,37,0,0,0
66167,34782,2021-06-24T13:18:41.498213Z,2021,16,2,16,8,0,K,1,0,8,0,0,14,0,0,15,0,0,0
66167,34783,2021-06-24T13:18:41.499213Z,2021,7,7,7,2,0,Sin Grado,0,0,5,0,0,0,0,0,7,0,0,0
66167,4751,2020-11-18T16:21:11.9149779Z,2019,49,19,47,22,0,1ro,0,0,27,0,0,30,2,0,49,0,0,0
66167,4752,2020-11-18T16:21:11.9149779Z,2019,52,21,48,29,0,2do,1,0,23,0,0,31,4,0,51,0,0,0
66167,4753,2020-11-18T16:21:11.9149779Z,2019,47,12,46,25,0,3ro,1,0,22,0,0,35,1,1,45,0,0,0
66167,4754,2020-11-18T16:21:11.9149779Z,2019,46,15,46,17,0,4to,0,0,29,0,0,31,0,0,46,0,0,0
66167,4755,2020-11-18T16:21:11.9149779Z,2019,30,3,30,17,0,5to,0,0,13,0,0,27,0,0,29,0,0,1
66167,4756,2020-11-18T16:21:11.9159779Z,2019,1,0,1,0,0,6to,0,0,1,0,0,1,0,0,1,0,0,0
66167,4757,2020-11-18T16:21:11.9159779Z,2019,37,6,36,28,0,K,0,0,9,0,0,31,1,0,37,0,0,0
66167,4758,2020-11-18T16:21:11.9159779Z,2019,9,8,9,1,0,Sin Grado,0,0,8,0,0,1,0,0,9,0,0,0
30197,1771,2020-11-18T16:20:48.8726098Z,2019,62,19,62,32,0,1ro,0,0,30,0,0,43,0,0,62,0,0,0
30197,1772,2020-11-18T16:20:48.8726098Z,2019,38,7,38,16,0,2do,0,0,22,0,0,31,0,0,38,0,0,0
30197,1773,2020-11-18T16:20:48.8726098Z,2019,31,9,30,17,0,3ro,0,0,14,0,0,22,1,0,31,0,0,0
30197,1774,2020-11-18T16:20:48.8726098Z,2019,22,9,20,9,0,4to,0,0,13,0,0,13,2,0,22,0,0,0
30197,1775,2020-11-18T16:20:48.8736107Z,2019,43,10,41,26,0,5to,0,0,17,0,0,33,2,0,43,0,0,0
30197,1776,2020-11-18T16:20:48.8736107Z,2019,30,2,30,14,0,K,0,0,16,0,0,28,0,0,30,0,0,0
30197,1777,2020-11-18T16:20:48.8736107Z,2019,7,7,6,2,0,Sin Grado,0,0,5,0,0,0,1,0,7,0,0,0
30197,31774,2021-06-24T13:18:17.2448148Z,2021,27,5,26,17,0,1ro,0,0,10,0,0,22,1,0,27,0,0,0
30197,31775,2021-06-24T13:18:17.2448148Z,2021,33,8,30,14,0,2do,0,0,19,0,0,25,3,0,33,0,0,0
30197,31776,2021-06-24T13:18:17.2458157Z,2021,43,10,39,28,0,3ro,0,0,15,0,0,33,4,0,43,0,0,0
30197,31777,2021-06-24T13:18:17.2458157Z,2021,39,9,39,21,0,4to,0,0,18,0,0,30,0,0,39,0,0,0
30197,31778,2021-06-24T13:18:17.2458157Z,2021,32,10,30,18,0,5to,0,0,14,0,0,22,2,0,32,0,0,0
30197,31779,2021-06-24T13:18:17.2458157Z,2021,18,6,16,8,0,K,0,0,10,0,0,12,2,0,18,0,0,0
30197,31780,2021-06-24T13:18:17.2458157Z,2021,6,6,6,3,0,Sin Grado,0,0,3,0,0,0,0,0,6,0,0,0
30197,7777,2020-11-18T16:21:47.9229872Z,2020,34,9,34,14,0,1ro,0,0,20,0,0,25,0,0,34,0,0,0
30197,7778,2020-11-18T16:21:47.9229872Z,2020,48,13,47,27,0,2do,0,0,21,0,0,35,1,0,48,0,0,0
30197,7779,2020-11-18T16:21:47.9229872Z,2020,35,6,35,20,0,3ro,0,0,15,0,0,29,0,0,35,0,0,0
30197,7780,2020-11-18T16:21:47.9229872Z,2020,30,9,28,18,0,4to,0,0,12,0,0,21,2,0,30,0,0,0
30197,7781,2020-11-18T16:21:47.9239876Z,2020,20,6,19,9,0,5to,0,1,11,0,0,14,1,0,20,0,0,0
30197,7782,2020-11-18T16:21:47.9239876Z,2020,37,6,36,17,0,K,0,0,20,0,0,31,1,0,37,0,0,0
30197,7783,2020-11-18T16:21:47.9239876Z,2020,4,4,3,2,0,Sin Grado,0,0,2,0,0,0,1,0,4,0,0,0
11593,215,2020-11-18T16:20:38.7658709Z,2019,29,6,27,13,0,10mo,0,0,16,0,0,23,2,0,29,2,0,0
11593,216,2020-11-18T16:20:38.7658709Z,2019,25,5,20,10,0,11mo,1,0,15,0,0,20,5,0,24,5,0,0
11593,217,2020-11-18T16:20:38.7658709Z,2019,23,0,19,11,0,12mo,0,0,12,0,0,23,4,0,23,0,0,0
11593,218,2020-11-18T16:20:38.7658709Z,2019,21,3,20,9,0,7mo,1,0,12,0,0,18,1,0,20,2,0,0
11593,219,2020-11-18T16:20:38.7658709Z,2019,16,5,14,7,0,8vo,0,0,9,0,0,11,2,0,16,0,0,0
11593,220,2020-11-18T16:20:38.7668714Z,2019,26,7,22,14,0,9no,0,0,12,0,0,19,4,0,26,1,0,0
11593,30215,2021-06-24T13:18:07.0835294Z,2021,30,10,27,13,0,10mo,0,1,17,0,0,20,3,1,29,2,0,0
11593,30216,2021-06-24T13:18:07.0835294Z,2021,18,4,16,11,0,11mo,0,0,7,0,0,14,2,0,18,1,0,0
11593,30217,2021-06-24T13:18:07.0845295Z,2021,27,5,26,13,0,12mo,0,0,14,0,0,22,1,0,27,4,0,0
11593,30218,2021-06-24T13:18:07.0845295Z,2021,40,10,37,16,0,7mo,0,1,24,0,0,30,3,0,40,0,0,0
11593,30219,2021-06-24T13:18:07.0845295Z,2021,36,5,33,19,0,8vo,1,1,17,0,0,31,3,0,35,0,0,0
11593,30220,2021-06-24T13:18:07.0845295Z,2021,28,4,26,14,0,9no,2,0,14,0,0,24,2,0,26,1,0,0
11593,6217,2020-11-18T16:21:38.6277907Z,2020,21,4,17,12,0,10mo,0,0,9,0,0,17,4,0,21,1,0,0
11593,6218,2020-11-18T16:21:38.6277907Z,2020,28,5,26,15,0,11mo,0,0,13,0,0,23,2,0,28,3,0,0
11593,6219,2020-11-18T16:21:38.6277907Z,2020,24,5,19,9,0,12mo,0,0,15,0,0,19,5,0,24,5,0,0
11593,6220,2020-11-18T16:21:38.6277907Z,2020,29,4,28,13,0,7mo,2,0,16,0,0,25,1,0,27,0,0,0
11593,6221,2020-11-18T16:21:38.6287907Z,2020,21,3,20,10,0,8vo,2,0,11,0,0,18,1,0,19,2,0,0
11593,6222,2020-11-18T16:21:38.6287907Z,2020,36,13,31,16,0,9no,0,0,20,0,0,23,5,1,35,2,0,0
61382,10208,2020-11-18T16:22:03.114116Z,2020,143,48,118,74,0,10mo,22,1,69,0,0,95,25,0,121,0,1,0
61382,10209,2020-11-18T16:22:03.114116Z,2020,139,32,47,73,0,11mo,24,2,66,0,0,107,92,0,113,0,0,2
61382,10210,2020-11-18T16:22:03.114116Z,2020,110,30,39,65,0,12mo,13,0,45,0,0,80,71,0,97,0,0,0
61382,10211,2020-11-18T16:22:03.1151169Z,2020,159,60,133,66,0,9no,18,6,93,0,0,99,26,0,139,0,0,2
61382,10212,2020-11-18T16:22:03.1151169Z,2020,19,17,16,6,0,Sin Grado,1,1,13,0,0,2,3,0,18,0,0,0
61382,34224,2021-06-24T13:18:38.0457369Z,2021,166,56,148,74,0,10mo,19,0,92,0,0,110,18,0,145,0,0,2
61382,34225,2021-06-24T13:18:38.0457369Z,2021,132,42,107,65,0,11mo,18,0,67,0,0,90,25,0,114,0,1,0
61382,34226,2021-06-24T13:18:38.0457369Z,2021,121,32,106,66,0,12mo,19,0,55,0,0,89,15,0,100,0,0,2
61382,34227,2021-06-24T13:18:38.0467374Z,2021,118,42,104,54,0,9no,9,0,64,0,0,76,14,0,109,1,0,0
61382,34228,2021-06-24T13:18:38.0467374Z,2021,7,7,7,1,0,Sin Grado,0,0,6,0,0,0,0,0,7,0,0,0
61382,4193,2020-11-18T16:21:08.0173812Z,2019,154,41,128,86,0,10mo,23,0,68,0,0,113,26,0,129,0,0,2
61382,4194,2020-11-18T16:21:08.0173812Z,2019,117,32,100,66,0,11mo,8,0,51,0,0,85,17,0,109,0,1,0
61382,4195,2020-11-18T16:21:08.0173812Z,2019,121,0,99,56,0,12mo,12,0,65,0,0,121,22,0,109,0,0,0
61382,4196,2020-11-18T16:21:08.0183807Z,2019,147,53,128,72,0,9no,14,0,75,0,0,94,19,0,133,0,1,0
61382,4197,2020-11-18T16:21:08.0183807Z,2019,22,20,21,6,0,Sin Grado,0,0,16,0,0,2,1,0,22,0,0,0
62562,10444,2020-11-18T16:22:04.1388005Z,2020,39,7,37,18,0,1ro,2,0,21,0,0,32,2,0,37,0,0,0
62562,10445,2020-11-18T16:22:04.1398009Z,2020,34,14,33,14,0,2do,3,0,20,0,0,20,1,0,31,0,0,0
62562,10446,2020-11-18T16:22:04.1398009Z,2020,29,7,28,17,0,3ro,1,2,12,0,0,22,1,0,28,0,0,0
62562,10447,2020-11-18T16:22:04.1398009Z,2020,22,11,22,13,0,4to,2,0,9,0,0,11,0,0,20,0,0,0
62562,10448,2020-11-18T16:22:04.1408031Z,2020,30,7,30,16,0,5to,1,0,14,0,0,23,0,0,29,0,0,0
62562,10449,2020-11-18T16:22:04.1408031Z,2020,24,6,22,11,0,K,1,0,13,0,0,18,2,0,23,0,0,0
62562,10450,2020-11-18T16:22:04.1408031Z,2020,26,26,26,4,0,Sin Grado,2,3,22,0,0,0,0,0,24,0,0,0
62562,34458,2021-06-24T13:18:39.4787649Z,2021,25,5,25,11,0,1ro,0,0,14,0,0,20,0,0,25,0,0,0
62562,34459,2021-06-24T13:18:39.4787649Z,2021,41,8,41,17,0,2do,2,0,24,0,0,33,0,0,39,0,0,0
62562,34460,2021-06-24T13:18:39.4787649Z,2021,38,14,36,17,0,3ro,1,0,21,0,0,24,2,0,37,0,0,0
62562,34461,2021-06-24T13:18:39.4787649Z,2021,29,7,29,19,0,4to,1,0,10,0,0,22,0,0,28,0,0,0
62562,34462,2021-06-24T13:18:39.4787649Z,2021,18,10,18,10,0,5to,1,0,8,0,0,8,0,0,17,0,0,0
62562,34463,2021-06-24T13:18:39.4797654Z,2021,30,5,29,21,0,K,1,0,9,0,0,25,1,0,29,0,0,0
62562,34464,2021-06-24T13:18:39.4797654Z,2021,19,19,19,1,0,Sin Grado,2,0,18,0,0,0,0,0,17,0,0,0
62562,4432,2020-11-18T16:21:10.1317862Z,2019,41,19,40,14,0,1ro,1,0,27,0,0,22,1,0,40,0,0,0
62562,4433,2020-11-18T16:21:10.1317862Z,2019,34,11,32,16,0,2do,1,2,18,0,0,23,2,0,33,0,0,0
62562,4434,2020-11-18T16:21:10.1327871Z,2019,21,13,21,12,0,3ro,1,0,9,0,0,8,0,0,20,0,0,0
62562,4435,2020-11-18T16:21:10.1327871Z,2019,30,7,30,15,0,4to,1,2,15,0,0,23,0,0,29,0,0,0
62562,4436,2020-11-18T16:21:10.1327871Z,2019,36,12,35,22,0,5to,0,0,14,0,0,24,1,0,36,0,0,0
62562,4437,2020-11-18T16:21:10.1337871Z,2019,39,7,37,22,0,K,2,1,17,0,0,32,2,0,37,0,0,0
62562,4438,2020-11-18T16:21:10.1337871Z,2019,22,21,22,5,0,Sin Grado,1,3,17,0,0,1,0,0,21,0,0,0
70912,11166,2020-11-18T16:22:08.3295941Z,2020,22,7,18,10,0,1ro,0,0,12,0,0,15,4,0,22,0,0,0
70912,11167,2020-11-18T16:22:08.3295941Z,2020,32,15,23,15,0,2do,0,0,17,0,0,17,9,0,32,0,0,0
70912,11168,2020-11-18T16:22:08.3295941Z,2020,18,7,14,9,0,3ro,0,0,9,0,0,11,4,0,18,1,0,0
70912,11169,2020-11-18T16:22:08.3305955Z,2020,35,13,24,12,0,4to,0,0,23,0,0,22,11,0,35,0,0,0
70912,11170,2020-11-18T16:22:08.3305955Z,2020,16,5,14,7,0,5to,0,1,9,0,0,11,2,0,16,0,0,0
70912,11171,2020-11-18T16:22:08.3305955Z,2020,33,9,25,17,0,K,0,0,16,0,0,24,8,0,33,0,0,0
70912,11172,2020-11-18T16:22:08.3305955Z,2020,25,25,25,5,0,Sin Grado,0,2,20,0,0,0,0,0,25,1,0,0
70912,35187,2021-06-24T13:18:44.5544031Z,2021,29,10,23,17,0,1ro,0,0,12,0,0,19,6,0,29,0,0,0
70912,35188,2021-06-24T13:18:44.5544031Z,2021,25,8,23,12,0,2do,0,0,13,0,0,17,2,0,25,0,0,0
70912,35189,2021-06-24T13:18:44.5544031Z,2021,28,14,24,13,0,3ro,0,0,15,0,0,14,4,0,28,0,0,0
70912,35190,2021-06-24T13:18:44.5554045Z,2021,15,6,13,6,0,4to,0,0,9,0,0,9,2,0,15,1,0,0
70912,35191,2021-06-24T13:18:44.5554045Z,2021,33,11,29,14,0,5to,1,0,19,0,0,22,4,0,32,0,0,0
70912,35192,2021-06-24T13:18:44.5554045Z,2021,23,7,20,10,0,K,0,0,13,0,0,16,3,0,23,0,0,0
70912,35193,2021-06-24T13:18:44.5564054Z,2021,23,23,22,5,0,Sin Grado,0,0,18,0,0,0,1,0,23,0,0,0
70912,5161,2020-11-18T16:21:14.036393Z,2019,27,13,19,12,0,1ro,0,1,15,0,0,14,8,0,27,0,0,0
70912,5162,2020-11-18T16:21:14.037393Z,2019,16,7,11,6,0,2do,0,1,10,0,0,9,5,0,16,0,0,0
70912,5163,2020-11-18T16:21:14.037393Z,2019,33,13,23,14,0,3ro,0,1,19,0,0,20,10,0,33,0,0,0
70912,5164,2020-11-18T16:21:14.037393Z,2019,17,6,15,6,0,4to,0,2,11,0,0,11,2,0,17,0,0,0
70912,5165,2020-11-18T16:21:14.037393Z,2019,19,8,18,11,0,5to,0,1,8,0,0,11,1,0,19,0,0,0
70912,5166,2020-11-18T16:21:14.0383943Z,2019,14,3,11,6,0,K,0,1,8,0,0,11,3,0,14,0,0,0
70912,5167,2020-11-18T16:21:14.0383943Z,2019,18,18,18,4,0,Sin Grado,0,2,14,0,0,0,0,0,18,1,0,0
24786,1438,2020-11-18T16:20:46.3329191Z,2019,42,4,15,29,0,10mo,0,3,13,0,0,38,27,0,42,0,0,0
24786,1439,2020-11-18T16:20:46.3339204Z,2019,53,2,18,34,0,11mo,0,0,19,0,0,51,35,0,53,1,0,0
24786,1440,2020-11-18T16:20:46.3339204Z,2019,60,0,26,34,0,12mo,0,1,26,0,0,60,34,0,60,0,0,0
24786,1441,2020-11-18T16:20:46.3339204Z,2019,54,4,29,25,0,6to,1,0,29,0,0,50,25,0,53,0,0,0
24786,1442,2020-11-18T16:20:46.3339204Z,2019,44,3,29,26,0,7mo,1,1,18,0,0,41,15,4,39,0,0,0
24786,1443,2020-11-18T16:20:46.3349213Z,2019,68,6,36,30,0,8vo,0,1,38,0,0,62,32,0,68,0,0,0
24786,1444,2020-11-18T16:20:46.3349213Z,2019,53,2,23,32,0,9no,2,0,21,0,0,51,30,0,51,0,0,0
24786,31438,2021-06-24T13:18:14.9141442Z,2021,76,6,47,37,0,10mo,1,1,39,0,0,70,29,0,75,0,0,0
24786,31439,2021-06-24T13:18:14.9141442Z,2021,50,2,24,30,0,11mo,1,1,20,0,0,48,26,0,49,0,0,0
24786,31440,2021-06-24T13:18:14.9141442Z,2021,40,3,17,30,0,12mo,0,0,10,0,0,37,23,0,40,0,0,0
24786,31441,2021-06-24T13:18:14.9151443Z,2021,38,6,27,18,0,6to,2,1,20,0,0,32,11,0,36,0,0,0
24786,31442,2021-06-24T13:18:14.9151443Z,2021,52,6,32,26,0,7mo,4,1,26,0,0,46,20,0,48,0,1,0
24786,31443,2021-06-24T13:18:14.9151443Z,2021,63,6,39,32,0,8vo,1,1,31,0,0,57,24,0,62,0,0,0
24786,31444,2021-06-24T13:18:14.9161452Z,2021,47,2,30,24,0,9no,2,1,23,0,0,45,17,4,41,0,0,0
24786,7441,2020-11-18T16:21:45.7645516Z,2020,53,2,26,31,0,10mo,2,1,22,0,0,51,27,0,51,0,0,0
24786,7442,2020-11-18T16:21:45.7645516Z,2020,38,4,17,29,0,11mo,0,1,9,0,0,34,21,0,38,0,0,0
24786,7443,2020-11-18T16:21:45.7655525Z,2020,53,2,23,33,0,12mo,0,0,20,0,0,51,30,0,53,0,0,0
24786,7444,2020-11-18T16:21:45.7655525Z,2020,47,6,31,23,0,6to,3,1,24,0,0,41,16,0,44,0,1,0
24786,7445,2020-11-18T16:21:45.7655525Z,2020,67,5,40,36,0,7mo,1,2,31,0,0,62,27,0,66,0,0,0
24786,7446,2020-11-18T16:21:45.7655525Z,2020,52,3,30,30,0,8vo,1,2,22,0,0,49,22,4,47,0,0,0
24786,7447,2020-11-18T16:21:45.7655525Z,2020,71,6,40,32,0,9no,1,1,39,0,0,65,31,0,70,0,0,0
23309,1369,2020-11-18T16:20:45.895629Z,2019,82,30,61,36,0,6to,0,0,46,0,0,52,21,0,82,0,0,0
23309,1370,2020-11-18T16:20:45.895629Z,2019,115,23,91,55,0,7mo,4,3,60,0,1,92,24,0,111,0,0,0
23309,1371,2020-11-18T16:20:45.895629Z,2019,90,22,69,45,0,8vo,2,3,45,0,0,68,21,0,88,0,0,0
23309,1372,2020-11-18T16:20:45.895629Z,2019,38,37,38,10,0,Sin Grado,0,1,28,0,0,1,0,0,38,0,0,0
23309,31370,2021-06-24T13:18:14.612928Z,2021,66,18,56,37,0,6to,0,0,29,0,0,48,10,0,66,0,0,0
23309,31371,2021-06-24T13:18:14.6139285Z,2021,72,20,63,29,0,7mo,2,0,43,0,0,52,9,0,70,0,0,0
23309,31372,2021-06-24T13:18:14.6139285Z,2021,79,27,64,35,0,8vo,1,1,44,0,0,52,15,0,78,0,0,0
23309,31373,2021-06-24T13:18:14.6139285Z,2021,18,18,17,4,0,Sin Grado,0,0,14,0,0,0,1,0,18,0,0,0
23309,7373,2020-11-18T16:21:45.3442706Z,2020,70,17,54,31,0,6to,2,3,39,0,0,53,16,0,68,0,0,0
23309,7374,2020-11-18T16:21:45.3442706Z,2020,90,28,70,41,0,7mo,1,2,49,0,0,62,20,0,89,0,0,0
23309,7375,2020-11-18T16:21:45.3442706Z,2020,104,23,77,55,0,8vo,3,5,49,0,0,81,27,0,101,0,0,0
23309,7376,2020-11-18T16:21:45.3452711Z,2020,33,33,32,7,0,Sin Grado,0,2,26,0,0,0,1,0,33,0,0,0
12005,269,2020-11-18T16:20:38.7948905Z,2019,25,12,24,11,0,1ro,0,0,14,0,0,13,1,0,25,0,0,0
12005,270,2020-11-18T16:20:38.795891Z,2019,28,8,16,13,0,2do,0,0,15,0,0,20,12,0,28,0,0,0
12005,271,2020-11-18T16:20:38.795891Z,2019,35,17,28,16,0,3ro,1,0,19,0,0,18,7,0,34,2,1,0
12005,272,2020-11-18T16:20:38.795891Z,2019,28,9,22,16,0,4to,1,0,12,0,0,19,6,0,27,0,0,0
12005,273,2020-11-18T16:20:38.795891Z,2019,27,8,20,12,0,5to,1,0,15,0,0,19,7,0,26,0,0,0
12005,274,2020-11-18T16:20:38.795891Z,2019,23,8,18,14,0,K,0,0,9,0,0,15,5,0,23,0,0,0
12005,30267,2021-06-24T13:18:07.1355667Z,2021,31,13,24,16,0,1ro,1,0,15,0,0,18,7,0,30,0,0,0
12005,30268,2021-06-24T13:18:07.1355667Z,2021,26,10,23,13,0,2do,0,0,13,0,0,16,3,0,26,0,0,0
12005,30269,2021-06-24T13:18:07.1355667Z,2021,26,14,26,11,0,3ro,0,0,15,0,0,12,0,0,26,0,0,0
12005,30270,2021-06-24T13:18:07.1355667Z,2021,32,9,23,13,0,4to,0,0,19,0,0,23,9,0,32,0,0,0
12005,30271,2021-06-24T13:18:07.1365677Z,2021,34,17,30,16,0,5to,0,0,18,0,0,17,4,0,34,2,0,0
12005,30272,2021-06-24T13:18:07.1365677Z,2021,24,4,22,13,0,K,0,0,11,0,0,20,2,0,24,0,0,0
12005,6270,2020-11-18T16:21:38.6387992Z,2020,23,8,18,13,0,1ro,1,0,10,0,0,15,5,0,22,0,0,0
12005,6271,2020-11-18T16:21:38.6387992Z,2020,27,14,25,11,0,2do,0,0,16,0,0,13,2,0,27,0,0,0
12005,6272,2020-11-18T16:21:38.6397992Z,2020,27,9,15,13,0,3ro,0,0,14,0,0,18,12,0,27,0,0,0
12005,6273,2020-11-18T16:21:38.6397992Z,2020,37,19,30,17,0,4to,0,0,20,0,0,18,7,0,37,2,0,0
12005,6274,2020-11-18T16:21:38.6397992Z,2020,27,7,20,18,0,5to,1,0,9,0,0,20,7,0,26,0,1,0
12005,6275,2020-11-18T16:21:38.6397992Z,2020,28,9,27,14,0,K,0,0,14,0,0,19,1,0,28,0,0,0
43257,2858,2020-11-18T16:20:59.1934917Z,2019,25,14,20,12,0,1ro,0,0,13,0,0,11,5,0,25,0,0,0
43257,2859,2020-11-18T16:20:59.1934917Z,2019,30,10,23,14,0,2do,0,0,16,0,0,20,7,0,30,0,0,0
43257,2860,2020-11-18T16:20:59.1934917Z,2019,32,8,22,18,0,3ro,0,0,14,0,0,24,10,0,32,0,0,0
43257,2861,2020-11-18T16:20:59.1934917Z,2019,26,8,18,7,0,4to,2,0,19,0,0,18,8,0,24,0,1,0
43257,2862,2020-11-18T16:20:59.1944926Z,2019,27,4,24,18,0,5to,0,1,9,0,0,23,3,0,27,1,0,0
43257,2863,2020-11-18T16:20:59.1944926Z,2019,30,10,26,14,0,K,0,0,16,0,0,20,4,0,30,0,0,0
43257,2864,2020-11-18T16:20:59.1944926Z,2019,13,0,6,3,0,PK,0,0,10,0,0,13,7,0,13,0,0,0
43257,2865,2020-11-18T16:20:59.1944926Z,2019,5,5,3,1,0,Sin Grado,0,0,4,0,0,0,2,0,5,0,0,0
43257,32866,2021-06-24T13:18:28.2116847Z,2021,24,4,23,8,0,1ro,0,0,16,0,0,20,1,0,24,0,0,0
43257,32867,2021-06-24T13:18:28.2116847Z,2021,27,10,25,13,0,2do,0,0,14,0,0,17,2,0,27,0,0,0
43257,32868,2021-06-24T13:18:28.2116847Z,2021,20,11,19,9,0,3ro,0,0,11,0,0,9,1,0,20,0,0,0
43257,32869,2021-06-24T13:18:28.2116847Z,2021,23,8,21,13,0,4to,0,0,10,0,0,15,2,0,23,0,0,0
43257,32870,2021-06-24T13:18:28.212686Z,2021,27,9,22,16,0,5to,0,0,11,0,0,18,5,0,27,0,0,0
43257,32871,2021-06-24T13:18:28.212686Z,2021,20,3,17,10,0,K,0,0,10,0,0,17,3,0,20,0,0,0
43257,32872,2021-06-24T13:18:28.212686Z,2021,11,1,9,4,0,PK,0,0,7,0,0,10,2,0,11,0,0,0
43257,32873,2021-06-24T13:18:28.212686Z,2021,5,5,5,1,0,Sin Grado,0,0,4,0,0,0,0,0,5,0,0,0
43257,8870,2020-11-18T16:21:54.2341966Z,2020,30,11,28,14,0,1ro,0,1,16,0,0,19,2,0,30,0,0,0
43257,8871,2020-11-18T16:21:54.2341966Z,2020,27,13,24,12,0,2do,0,2,15,0,0,14,3,0,27,0,0,0
43257,8872,2020-11-18T16:21:54.2341966Z,2020,29,9,23,13,0,3ro,0,0,16,0,0,20,6,0,29,0,0,0
43257,8873,2020-11-18T16:21:54.2351971Z,2020,33,7,27,18,0,4to,0,3,15,0,0,26,6,0,33,0,0,0
43257,8874,2020-11-18T16:21:54.2351971Z,2020,27,8,22,10,0,5to,2,1,17,0,0,19,5,0,25,0,1,0
43257,8875,2020-11-18T16:21:54.2351971Z,2020,27,4,21,8,0,K,0,1,19,0,0,23,6,0,27,0,0,0
43257,8876,2020-11-18T16:21:54.2351971Z,2020,15,4,14,6,0,PK,0,0,9,0,0,11,1,0,15,0,0,0
43257,8877,2020-11-18T16:21:54.236198Z,2020,6,6,5,1,0,Sin Grado,0,0,5,0,0,0,1,0,6,0,0,0
35048,2299,2020-11-18T16:20:55.0237123Z,2019,38,9,33,21,0,10mo,2,0,17,0,0,29,5,0,36,0,0,0
35048,2300,2020-11-18T16:20:55.0237123Z,2019,27,3,21,11,0,11mo,0,0,16,0,0,24,6,0,27,0,0,0
35048,2301,2020-11-18T16:20:55.7241811Z,2019,24,0,20,11,0,12mo,0,0,13,0,0,24,4,0,24,0,0,0
35048,2302,2020-11-18T16:20:55.7241811Z,2019,17,4,16,7,0,1ro,0,0,10,0,0,13,1,0,17,0,0,0
35048,2303,2020-11-18T16:20:55.725182Z,2019,25,8,24,18,0,2do,0,0,7,0,0,17,1,0,25,0,0,0
35048,2304,2020-11-18T16:20:55.725182Z,2019,22,5,18,11,0,3ro,1,0,11,0,0,17,4,0,21,0,0,0
35048,2305,2020-11-18T16:20:55.725182Z,2019,34,10,31,15,0,4to,0,0,19,0,0,24,3,0,34,0,0,0
35048,2306,2020-11-18T16:20:55.725182Z,2019,30,6,26,13,0,5to,0,0,17,0,0,24,4,0,30,0,0,0
35048,2307,2020-11-18T16:20:55.7261824Z,2019,35,8,28,16,0,6to,0,0,19,0,0,27,7,0,35,0,0,0
35048,2308,2020-11-18T16:20:55.7261824Z,2019,36,4,27,18,0,7mo,0,0,18,0,0,32,9,0,36,0,0,0
35048,2309,2020-11-18T16:20:55.7261824Z,2019,41,9,27,17,0,8vo,0,0,24,0,0,32,14,0,41,0,1,0
35048,2310,2020-11-18T16:20:55.7271829Z,2019,39,7,31,18,0,9no,0,0,21,0,0,32,8,0,39,0,1,0
35048,2311,2020-11-18T16:20:55.7271829Z,2019,13,3,10,3,0,K,0,0,10,0,0,10,3,0,13,0,0,0
35048,2312,2020-11-18T16:20:55.7281842Z,2019,4,3,2,1,0,Sin Grado,0,0,3,0,0,1,2,0,4,0,0,0
35048,32306,2021-06-24T13:18:23.2811432Z,2021,33,7,26,15,0,10mo,0,0,18,0,0,26,7,0,33,0,1,0
35048,32307,2021-06-24T13:18:23.2811432Z,2021,24,3,18,9,0,11mo,0,0,15,0,0,21,6,0,24,0,0,0
35048,32308,2021-06-24T13:18:23.2821436Z,2021,31,6,27,20,0,12mo,2,0,11,0,0,25,4,0,29,0,0,0
35048,32309,2021-06-24T13:18:23.2821436Z,2021,20,6,20,6,0,1ro,0,0,14,0,0,14,0,0,20,0,0,0
35048,32310,2021-06-24T13:18:23.2821436Z,2021,12,1,11,6,0,2do,0,0,6,0,0,11,1,0,12,0,0,0
35048,32311,2021-06-24T13:18:23.2821436Z,2021,16,4,16,8,0,3ro,0,0,8,0,0,12,0,0,16,0,0,0
35048,32312,2021-06-24T13:18:23.2831446Z,2021,19,6,18,14,0,4to,0,0,5,0,0,13,1,0,19,0,0,0
35048,32313,2021-06-24T13:18:23.2831446Z,2021,23,5,23,11,0,5to,1,0,12,0,0,18,0,0,22,0,0,0
35048,32314,2021-06-24T13:18:23.2831446Z,2021,31,7,28,17,0,6to,0,0,14,0,0,24,3,0,31,0,0,0
35048,32315,2021-06-24T13:18:23.2831446Z,2021,26,5,24,13,0,7mo,0,0,13,0,0,21,2,0,26,0,0,0
35048,32316,2021-06-24T13:18:23.2841455Z,2021,33,7,30,13,0,8vo,0,0,20,0,0,26,3,0,33,0,0,0
35048,32317,2021-06-24T13:18:23.2841455Z,2021,28,4,24,12,0,9no,0,0,16,0,0,24,4,0,28,0,0,0
35048,32318,2021-06-24T13:18:23.2841455Z,2021,8,2,8,4,0,K,0,0,4,0,0,6,0,0,8,0,0,0
35048,32319,2021-06-24T13:18:23.285146Z,2021,7,7,5,3,0,Sin Grado,0,1,4,0,0,0,2,0,7,0,0,0
35048,8311,2020-11-18T16:21:51.3983057Z,2020,31,4,25,14,0,10mo,0,0,17,0,0,27,6,0,31,0,1,0
35048,8312,2020-11-18T16:21:51.3983057Z,2020,37,7,31,21,0,11mo,3,0,16,0,0,30,6,0,34,0,0,0
35048,8313,2020-11-18T16:21:51.3993057Z,2020,27,3,18,11,0,12mo,0,0,16,0,0,24,9,0,27,0,0,0
35048,8314,2020-11-18T16:21:51.3993057Z,2020,14,2,13,6,0,1ro,0,0,8,0,0,12,1,0,14,0,0,0
35048,8315,2020-11-18T16:21:51.3993057Z,2020,16,3,16,8,0,2do,0,0,8,0,0,13,0,0,16,0,0,0
35048,8316,2020-11-18T16:21:51.4003066Z,2020,19,6,19,12,0,3ro,0,0,7,0,0,13,0,0,19,0,0,0
35048,8317,2020-11-18T16:21:51.4003066Z,2020,31,7,28,12,0,4to,1,0,19,0,0,24,3,0,30,0,0,0
35048,8318,2020-11-18T16:21:51.4003066Z,2020,32,6,29,15,0,5to,0,0,17,0,0,26,3,0,32,0,0,0
35048,8319,2020-11-18T16:21:51.4003066Z,2020,26,5,22,13,0,6to,0,0,13,0,0,21,4,0,26,0,0,0
35048,8320,2020-11-18T16:21:51.401307Z,2020,34,7,31,13,0,7mo,0,0,21,0,0,27,3,0,34,0,0,0
35048,8321,2020-11-18T16:21:51.401307Z,2020,30,4,21,15,0,8vo,0,0,15,0,0,26,9,0,30,0,0,0
35048,8322,2020-11-18T16:21:51.401307Z,2020,35,9,27,14,0,9no,0,0,21,0,0,26,8,0,35,0,1,0
35048,8323,2020-11-18T16:21:51.401307Z,2020,20,8,18,6,0,K,0,0,14,0,0,12,2,0,20,0,0,0
35048,8324,2020-11-18T16:21:51.402307Z,2020,8,7,5,3,0,Sin Grado,0,0,5,0,0,1,3,0,8,0,0,0
23598,1384,2020-11-18T16:20:45.9056352Z,2019,58,4,27,39,0,10mo,1,0,19,0,0,54,31,0,57,0,0,0
23598,1385,2020-11-18T16:20:45.9066352Z,2019,41,1,26,24,0,11mo,0,0,17,0,0,40,15,0,41,0,0,0
23598,1386,2020-11-18T16:20:45.9066352Z,2019,17,0,9,10,0,12mo,1,0,7,0,0,17,8,0,16,0,0,0
23598,1387,2020-11-18T16:20:45.9066352Z,2019,92,17,55,41,0,6to,0,0,51,0,0,75,37,0,92,0,0,0
23598,1388,2020-11-18T16:20:45.9066352Z,2019,58,14,36,27,0,7mo,0,0,31,0,0,44,22,0,58,0,0,0
23598,1389,2020-11-18T16:20:45.9076356Z,2019,63,13,37,31,0,8vo,0,0,32,0,0,50,26,0,63,0,0,0
23598,1390,2020-11-18T16:20:45.9076356Z,2019,43,3,21,28,0,9no,0,0,15,0,0,40,22,0,43,0,0,0
23598,31385,2021-06-24T13:18:14.6469519Z,2021,46,8,26,24,0,10mo,0,0,22,0,0,38,20,0,46,0,0,0
23598,31386,2021-06-24T13:18:14.6469519Z,2021,40,2,19,26,0,11mo,0,0,14,0,0,38,21,0,40,0,0,0
23598,31387,2021-06-24T13:18:14.6469519Z,2021,50,3,24,32,0,12mo,0,0,18,0,0,47,26,0,50,0,0,0
23598,31388,2021-06-24T13:18:14.6479524Z,2021,50,16,33,20,0,6to,2,0,30,0,0,34,17,0,48,0,0,0
23598,31389,2021-06-24T13:18:14.6479524Z,2021,38,3,28,19,0,7mo,0,0,19,0,0,35,10,0,37,0,0,1
23598,31390,2021-06-24T13:18:14.6479524Z,2021,71,11,51,36,0,8vo,0,0,35,0,0,60,20,0,71,0,0,0
23598,31391,2021-06-24T13:18:14.6489538Z,2021,43,8,26,18,0,9no,0,0,25,0,0,35,17,0,43,0,0,0
23598,7388,2020-11-18T16:21:45.3512751Z,2020,40,2,18,26,0,10mo,0,0,14,0,0,38,22,0,40,0,0,0
23598,7389,2020-11-18T16:21:45.3512751Z,2020,52,4,27,34,0,11mo,0,0,18,0,0,48,25,0,52,0,0,0
23598,7390,2020-11-18T16:21:45.3512751Z,2020,40,1,26,24,0,12mo,0,0,16,0,0,39,14,0,40,0,0,0
23598,7391,2020-11-18T16:21:45.3512751Z,2020,47,5,26,20,0,6to,0,0,27,0,0,42,21,0,47,0,0,0
23598,7392,2020-11-18T16:21:45.3522769Z,2020,75,12,46,37,0,7mo,0,0,38,0,0,63,29,0,75,0,0,0
23598,7393,2020-11-18T16:21:45.3522769Z,2020,52,11,35,23,0,8vo,0,0,29,0,0,41,17,0,52,0,0,0
23598,7394,2020-11-18T16:21:45.3522769Z,2020,48,7,31,25,0,9no,0,0,23,0,0,41,17,0,48,0,0,0
33043,2136,2020-11-18T16:20:54.5684084Z,2019,59,10,46,31,0,10mo,4,0,28,0,0,49,13,0,55,0,0,0
33043,2137,2020-11-18T16:20:54.5694092Z,2019,53,6,36,33,0,11mo,0,0,20,0,0,47,17,0,53,0,0,0
33043,2138,2020-11-18T16:20:54.5694092Z,2019,55,0,42,23,0,12mo,2,1,32,0,0,55,13,0,53,0,0,0
33043,2139,2020-11-18T16:20:54.5694092Z,2019,59,9,50,29,0,9no,1,1,30,0,0,50,9,0,58,0,1,0
33043,2140,2020-11-18T16:20:54.5694092Z,2019,13,12,13,1,0,Sin Grado,0,1,12,0,0,1,0,0,13,0,0,0
33043,32143,2021-06-24T13:18:20.8944329Z,2021,71,14,43,36,0,10mo,2,6,35,0,0,57,28,0,69,1,0,0
33043,32144,2021-06-24T13:18:20.8944329Z,2021,46,8,19,26,0,11mo,1,0,20,0,0,38,27,0,45,0,1,0
33043,32145,2021-06-24T13:18:20.8954325Z,2021,51,7,30,28,0,12mo,2,2,23,0,0,44,21,0,49,0,0,0
33043,32146,2021-06-24T13:18:20.8954325Z,2021,64,13,36,42,0,9no,4,0,22,0,0,51,28,0,59,0,0,1
33043,32147,2021-06-24T13:18:20.8954325Z,2021,14,14,10,2,0,Sin Grado,0,1,12,0,0,0,4,0,14,0,0,0
33043,8149,2020-11-18T16:21:50.2225229Z,2020,56,10,42,30,0,10mo,1,0,26,0,0,46,14,0,55,0,1,0
33043,8150,2020-11-18T16:21:50.2225229Z,2020,59,9,43,32,0,11mo,3,0,27,0,0,50,16,0,56,0,0,0
33043,8151,2020-11-18T16:21:50.2235242Z,2020,50,5,33,33,0,12mo,0,0,17,0,0,45,17,0,50,0,0,0
33043,8152,2020-11-18T16:21:50.2235242Z,2020,75,13,66,40,0,9no,2,0,35,0,0,62,9,0,73,1,0,0
33043,8153,2020-11-18T16:21:50.2235242Z,2020,12,12,12,3,0,Sin Grado,0,0,9,0,0,0,0,0,12,0,0,0
69930,10870,2020-11-18T16:22:06.544407Z,2020,196,43,136,102,0,10mo,4,1,94,0,0,153,60,0,192,0,0,0
69930,10871,2020-11-18T16:22:06.544407Z,2020,167,39,109,81,0,11mo,3,0,86,0,0,128,58,1,161,1,0,2
69930,10872,2020-11-18T16:22:06.544407Z,2020,222,24,139,126,0,12mo,9,1,96,0,0,198,83,0,213,2,0,0
69930,10873,2020-11-18T16:22:06.544407Z,2020,221,61,161,115,0,9no,10,0,106,0,0,160,60,0,211,2,1,0
69930,10874,2020-11-18T16:22:06.544407Z,2020,8,8,7,3,0,Sin Grado,0,1,5,0,0,0,1,0,8,0,0,0
69930,34892,2021-06-24T13:18:42.9702683Z,2021,224,63,177,114,0,10mo,12,0,110,0,0,161,47,0,212,2,1,0
69930,34893,2021-06-24T13:18:42.9702683Z,2021,187,43,134,100,0,11mo,4,0,87,0,0,144,53,0,183,0,0,0
69930,34894,2021-06-24T13:18:42.9712683Z,2021,163,38,107,79,0,12mo,3,0,84,0,0,125,56,1,157,1,0,2
69930,34895,2021-06-24T13:18:42.9712683Z,2021,219,50,181,119,0,9no,4,0,100,0,0,169,38,0,215,0,1,0
69930,34896,2021-06-24T13:18:42.9712683Z,2021,8,8,7,3,0,Sin Grado,0,0,5,0,0,0,1,0,8,0,0,0
69930,4862,2020-11-18T16:21:12.3952983Z,2019,176,40,128,87,0,10mo,3,1,89,0,0,136,48,1,171,0,0,1
69930,4863,2020-11-18T16:21:12.3952983Z,2019,224,25,155,125,0,11mo,12,0,99,0,0,199,69,0,212,2,0,0
69930,4864,2020-11-18T16:21:12.3952983Z,2019,260,0,172,148,0,12mo,7,0,112,0,0,260,88,0,252,0,0,1
69930,4865,2020-11-18T16:21:12.3962996Z,2019,188,42,145,94,0,9no,2,0,94,0,0,146,43,0,186,0,0,0
69930,4866,2020-11-18T16:21:12.3962996Z,2019,12,10,11,4,0,Sin Grado,0,1,8,0,0,2,1,0,12,0,0,0
58164,10031,2020-11-18T16:22:01.9513442Z,2020,55,10,39,30,0,1ro,1,0,25,0,0,45,16,0,54,0,0,0
58164,10032,2020-11-18T16:22:01.9513442Z,2020,47,14,38,20,0,2do,0,1,27,0,0,33,9,0,47,1,0,0
58164,10033,2020-11-18T16:22:01.9513442Z,2020,72,15,49,37,0,3ro,0,0,35,0,0,57,23,0,72,1,0,0
58164,10034,2020-11-18T16:22:01.9523455Z,2020,72,21,53,36,0,4to,0,1,36,0,0,51,19,0,72,1,0,0
58164,10035,2020-11-18T16:22:01.9523455Z,2020,69,18,49,28,0,5to,1,0,41,0,0,51,20,0,68,2,0,0
58164,10036,2020-11-18T16:22:01.9523455Z,2020,79,16,54,33,0,6to,1,0,46,0,0,63,25,0,78,1,1,0
58164,10037,2020-11-18T16:22:01.9533464Z,2020,91,16,68,54,0,7mo,2,0,37,0,0,75,23,0,89,0,0,0
58164,10038,2020-11-18T16:22:01.9533464Z,2020,92,22,65,41,0,8vo,1,0,51,0,0,70,27,0,91,1,0,0
58164,10039,2020-11-18T16:22:01.9533464Z,2020,64,6,46,34,0,K,0,0,30,0,0,58,18,0,64,0,0,0
58164,10040,2020-11-18T16:22:01.9543464Z,2020,8,8,7,4,0,Sin Grado,0,0,4,0,0,0,1,0,8,0,0,0
58164,34038,2021-06-24T13:18:36.9399438Z,2021,63,9,49,34,0,1ro,0,1,29,0,0,54,14,0,63,0,0,0
58164,34039,2021-06-24T13:18:36.9399438Z,2021,49,9,35,27,0,2do,1,0,22,0,0,40,14,0,47,0,0,1
58164,34040,2021-06-24T13:18:36.9409451Z,2021,47,14,38,20,0,3ro,0,1,27,0,0,33,9,0,47,1,0,0
58164,34041,2021-06-24T13:18:36.9409451Z,2021,73,16,55,34,0,4to,0,1,39,0,0,57,18,0,73,1,0,0
58164,34042,2021-06-24T13:18:36.9419461Z,2021,65,18,49,32,0,5to,0,0,33,0,0,47,16,0,65,1,0,0
58164,34043,2021-06-24T13:18:36.9419461Z,2021,73,24,54,32,0,6to,1,0,41,0,0,49,19,0,72,2,0,0
58164,34044,2021-06-24T13:18:36.9419461Z,2021,74,16,53,35,0,7mo,1,1,39,0,0,58,21,0,73,1,1,0
58164,34045,2021-06-24T13:18:36.9429466Z,2021,88,15,69,52,0,8vo,1,0,36,0,0,73,19,0,87,0,0,0
58164,34046,2021-06-24T13:18:36.9429466Z,2021,43,6,31,22,0,K,0,0,21,0,0,37,12,0,41,0,0,2
58164,34047,2021-06-24T13:18:36.9429466Z,2021,8,8,5,4,0,Sin Grado,0,0,4,0,0,0,3,0,8,0,0,0
58164,4014,2020-11-18T16:21:07.2958981Z,2019,50,15,37,24,0,1ro,0,2,26,0,0,35,13,0,50,1,0,0
58164,4015,2020-11-18T16:21:07.2958981Z,2019,76,21,59,39,1,2do,0,2,37,0,0,55,17,0,76,1,0,0
58164,4016,2020-11-18T16:21:07.2958981Z,2019,59,15,42,29,0,3ro,0,0,30,0,0,44,17,0,58,1,0,1
58164,4017,2020-11-18T16:21:07.2968985Z,2019,73,21,51,28,0,4to,1,0,45,0,0,52,22,0,72,2,0,0
58164,4018,2020-11-18T16:21:07.2968985Z,2019,77,16,55,30,0,5to,1,0,47,0,0,61,22,0,76,1,1,0
58164,4019,2020-11-18T16:21:07.2968985Z,2019,85,15,62,51,0,6to,1,0,34,0,0,70,23,0,84,0,0,0
58164,4020,2020-11-18T16:21:07.2968985Z,2019,97,23,71,43,0,7mo,0,1,54,0,0,74,26,0,97,1,0,0
58164,4021,2020-11-18T16:21:07.2968985Z,2019,86,14,55,41,0,8vo,0,0,45,0,0,72,31,0,86,3,0,0
58164,4022,2020-11-18T16:21:07.297899Z,2019,51,10,38,26,0,K,1,0,25,0,0,41,13,0,50,0,0,0
34272,2221,2020-11-18T16:20:55.0046998Z,2019,51,8,45,30,0,1ro,1,5,21,0,0,43,6,0,50,1,0,0
34272,2222,2020-11-18T16:20:55.0046998Z,2019,46,16,40,18,0,2do,1,11,28,0,0,30,6,0,45,0,0,0
34272,2223,2020-11-18T16:20:55.0057007Z,2019,60,16,53,26,0,3ro,2,14,34,0,0,44,7,0,58,0,0,0
34272,2224,2020-11-18T16:20:55.0057007Z,2019,68,12,48,36,0,4to,0,14,32,0,0,56,20,0,68,0,0,0
34272,2225,2020-11-18T16:20:55.0057007Z,2019,70,16,59,28,0,5to,1,6,42,0,0,54,11,0,69,0,0,0
34272,2226,2020-11-18T16:20:55.0057007Z,2019,55,12,45,27,0,6to,0,0,28,0,0,43,10,0,55,0,0,0
34272,2227,2020-11-18T16:20:55.0057007Z,2019,50,10,40,26,0,7mo,2,0,24,0,0,40,10,0,48,2,0,0
34272,2228,2020-11-18T16:20:55.006702Z,2019,69,13,51,37,0,8vo,1,0,32,0,0,56,18,0,68,1,0,0
34272,2229,2020-11-18T16:20:55.006702Z,2019,40,6,36,19,0,K,0,2,21,0,0,34,4,0,40,0,0,0
34272,2230,2020-11-18T16:20:55.006702Z,2019,4,4,4,1,0,Sin Grado,0,0,3,0,0,0,0,0,4,0,0,0
34272,32228,2021-06-24T13:18:21.7510475Z,2021,48,6,46,19,0,1ro,1,0,29,0,0,42,2,0,47,0,0,0
34272,32229,2021-06-24T13:18:21.7510475Z,2021,59,8,53,28,0,2do,1,1,31,0,0,51,6,0,58,0,0,0
34272,32230,2021-06-24T13:18:21.7520471Z,2021,66,16,59,37,0,3ro,1,3,29,0,0,50,7,0,65,1,0,0
34272,32231,2021-06-24T13:18:21.7520471Z,2021,71,20,66,29,0,4to,1,3,42,0,0,51,5,0,70,0,0,0
34272,32232,2021-06-24T13:18:21.7520471Z,2021,69,19,63,30,0,5to,2,4,39,0,0,50,6,0,66,0,0,1
34272,32233,2021-06-24T13:18:21.7520471Z,2021,75,14,57,41,0,6to,0,6,34,0,0,61,18,0,75,0,0,0
34272,32234,2021-06-24T13:18:21.7530481Z,2021,99,25,84,43,0,7mo,1,3,56,0,0,74,15,0,98,1,0,0
34272,32235,2021-06-24T13:18:21.7530481Z,2021,74,22,62,35,0,8vo,0,1,39,0,0,52,12,0,74,0,0,0
34272,32236,2021-06-24T13:18:21.7530481Z,2021,44,2,39,31,0,K,0,1,13,0,0,42,5,1,43,0,0,0
34272,32237,2021-06-24T13:18:21.7530481Z,2021,5,5,5,4,0,Sin Grado,0,0,1,0,0,0,0,0,5,0,0,0
34272,8233,2020-11-18T16:21:50.6828303Z,2020,48,5,42,25,0,1ro,1,1,23,0,0,43,6,0,47,0,0,0
34272,8234,2020-11-18T16:21:50.6838308Z,2020,60,16,50,35,0,2do,1,4,25,0,0,44,10,0,59,1,0,0
34272,8235,2020-11-18T16:21:50.6838308Z,2020,58,14,47,23,0,3ro,1,3,35,0,0,44,11,0,57,0,0,0
34272,8236,2020-11-18T16:21:50.6838308Z,2020,62,19,55,26,0,4to,2,2,36,0,0,43,7,0,60,0,0,0
34272,8237,2020-11-18T16:21:50.6838308Z,2020,74,14,53,40,0,5to,0,3,34,0,0,60,21,0,74,0,0,0
34272,8238,2020-11-18T16:21:50.6838308Z,2020,96,24,81,40,0,6to,1,2,56,0,0,72,15,0,95,1,0,0
34272,8239,2020-11-18T16:21:50.6848317Z,2020,65,15,55,32,0,7mo,0,1,33,0,0,50,10,0,65,0,0,0
34272,8240,2020-11-18T16:21:50.6848317Z,2020,57,11,47,28,0,8vo,3,0,29,0,0,46,10,0,54,2,0,0
34272,8241,2020-11-18T16:21:50.6848317Z,2020,44,5,35,17,0,K,1,0,27,0,0,39,9,0,43,0,0,0
34272,8242,2020-11-18T16:21:50.6848317Z,2020,3,3,3,2,0,Sin Grado,0,0,1,0,0,0,0,0,3,0,0,0
25197,1497,2020-11-18T16:20:46.3509315Z,2019,19,9,17,8,0,1ro,0,0,11,0,0,10,2,0,19,0,0,0
25197,1498,2020-11-18T16:20:46.3519324Z,2019,21,7,18,12,0,2do,0,0,9,0,0,14,3,0,21,0,0,0
25197,1499,2020-11-18T16:20:46.3519324Z,2019,10,5,6,3,0,3ro,0,0,7,0,0,5,4,0,10,0,0,0
25197,1500,2020-11-18T16:20:46.3519324Z,2019,17,8,11,6,0,4to,0,0,11,0,0,9,6,0,17,0,0,0
25197,1501,2020-11-18T16:20:47.632788Z,2019,20,8,16,7,0,5to,0,0,13,0,0,12,4,0,20,0,0,0
25197,1502,2020-11-18T16:20:47.632788Z,2019,11,5,7,2,0,6to,0,0,9,0,0,6,4,0,11,0,0,0
25197,1503,2020-11-18T16:20:47.633788Z,2019,23,14,18,7,0,K,0,0,16,0,0,9,5,0,23,0,0,0
25197,1504,2020-11-18T16:20:47.633788Z,2019,27,4,20,12,0,PK,0,0,15,0,0,23,7,0,27,0,0,0
25197,31498,2021-06-24T13:18:14.9331576Z,2021,20,7,16,6,0,1ro,2,0,14,0,0,13,4,0,18,0,0,0
25197,31499,2021-06-24T13:18:14.934159Z,2021,15,10,11,6,0,2do,1,0,9,0,0,5,4,0,14,0,0,0
25197,31500,2021-06-24T13:18:15.80078Z,2021,17,6,12,6,0,3ro,0,0,11,0,0,11,5,0,17,0,0,0
25197,31501,2021-06-24T13:18:15.80078Z,2021,16,5,12,9,0,4to,0,0,7,0,0,11,4,0,16,0,0,0
25197,31502,2021-06-24T13:18:15.80078Z,2021,10,4,8,4,0,5to,0,0,6,0,0,6,2,0,10,0,0,0
25197,31503,2021-06-24T13:18:15.80078Z,2021,12,6,10,4,0,6to,0,0,8,0,0,6,2,0,12,0,0,0
25197,31504,2021-06-24T13:18:15.80078Z,2021,29,7,24,12,0,K,0,0,17,0,0,22,5,0,29,0,0,0
25197,31505,2021-06-24T13:18:15.80178Z,2021,13,1,11,3,0,PK,0,0,10,0,0,12,2,0,13,0,0,0
25197,7501,2020-11-18T16:21:46.3619463Z,2020,14,9,10,6,0,1ro,0,0,8,0,0,5,4,0,14,0,0,0
25197,7502,2020-11-18T16:21:46.3619463Z,2020,18,4,15,6,0,2do,0,0,12,0,0,14,3,0,18,0,0,0
25197,7503,2020-11-18T16:21:46.3619463Z,2020,17,5,12,9,0,3ro,0,0,8,0,0,12,5,0,17,0,0,0
25197,7504,2020-11-18T16:21:46.3619463Z,2020,11,4,9,4,0,4to,0,0,7,0,0,7,2,0,11,0,0,0
25197,7505,2020-11-18T16:21:46.3619463Z,2020,14,7,11,4,0,5to,0,0,10,0,0,7,3,0,14,0,0,0
25197,7506,2020-11-18T16:21:46.3619463Z,2020,14,5,11,3,0,6to,0,0,11,0,0,9,3,0,14,0,0,0
25197,7507,2020-11-18T16:21:46.3629467Z,2020,17,5,14,3,0,K,2,0,14,0,0,12,3,0,15,0,0,0
25197,7508,2020-11-18T16:21:46.3629467Z,2020,30,5,20,16,0,PK,0,0,14,0,0,25,10,0,30,0,0,0
64527,10664,2020-11-18T16:22:05.3536133Z,2020,33,14,33,19,0,1ro,0,2,14,0,0,19,0,0,33,0,0,0
64527,10665,2020-11-18T16:22:05.3536133Z,2020,31,10,31,11,0,2do,2,2,20,0,0,21,0,0,29,0,0,0
64527,10666,2020-11-18T16:22:05.3536133Z,2020,29,9,27,19,0,3ro,2,0,10,0,0,20,2,0,26,0,0,1
64527,10667,2020-11-18T16:22:05.3536133Z,2020,28,6,28,19,0,4to,1,0,9,0,0,22,0,0,27,0,0,0
64527,10668,2020-11-18T16:22:05.3546133Z,2020,21,8,20,9,0,5to,1,0,12,0,0,13,1,0,19,0,0,1
64527,10669,2020-11-18T16:22:05.3546133Z,2020,19,3,5,10,0,K,0,1,9,0,0,16,14,0,19,0,0,0
64527,10670,2020-11-18T16:22:05.3546133Z,2020,9,9,9,3,0,Sin Grado,0,0,6,0,0,0,0,0,9,0,0,0
64527,34681,2021-06-24T13:18:41.1069317Z,2021,13,2,13,8,0,1ro,0,0,5,0,0,11,0,0,13,0,0,0
64527,34682,2021-06-24T13:18:41.1069317Z,2021,26,11,24,15,0,2do,0,0,11,0,0,15,2,0,26,0,0,0
64527,34683,2021-06-24T13:18:41.1069317Z,2021,24,9,21,9,0,3ro,2,0,15,0,0,15,3,0,22,0,0,0
64527,34684,2021-06-24T13:18:41.1079322Z,2021,20,6,15,13,0,4to,2,0,7,0,0,14,5,0,18,0,0,0
64527,34685,2021-06-24T13:18:41.1079322Z,2021,22,3,20,14,0,5to,2,0,8,0,0,19,2,0,20,0,0,0
64527,34686,2021-06-24T13:18:41.1079322Z,2021,11,1,9,2,0,K,0,0,9,0,0,10,2,0,11,0,0,0
64527,34687,2021-06-24T13:18:41.1079322Z,2021,7,7,7,2,0,Sin Grado,0,0,5,0,0,0,0,0,7,0,0,0
64527,4652,2020-11-18T16:21:11.2585389Z,2019,30,11,30,11,0,1ro,2,0,19,0,0,19,0,0,28,0,0,0
64527,4653,2020-11-18T16:21:11.2585389Z,2019,30,7,28,18,0,2do,3,0,12,0,0,23,2,0,25,0,0,2
64527,4654,2020-11-18T16:21:11.2585389Z,2019,39,11,39,27,0,3ro,1,0,12,0,0,28,0,0,38,0,0,0
64527,4655,2020-11-18T16:21:11.2595398Z,2019,22,7,21,11,0,4to,1,0,11,0,0,15,1,0,19,0,0,2
64527,4656,2020-11-18T16:21:11.2595398Z,2019,28,10,25,12,0,5to,2,0,16,0,0,18,3,0,26,0,0,0
64527,4657,2020-11-18T16:21:11.2595398Z,2019,25,10,25,13,0,K,0,0,12,0,0,15,0,0,25,0,0,0
64527,4658,2020-11-18T16:21:11.2595398Z,2019,6,6,5,1,0,Sin Grado,0,0,5,0,0,0,1,0,6,0,0,0
11239,139,2020-11-18T16:20:37.5630696Z,2019,19,5,15,14,0,1ro,0,0,5,0,0,14,4,0,19,0,0,0
11239,140,2020-11-18T16:20:37.5630696Z,2019,16,6,13,6,0,2do,0,0,10,0,0,10,3,0,16,0,0,0
11239,141,2020-11-18T16:20:37.5640696Z,2019,12,5,10,4,0,3ro,0,0,8,0,0,7,2,0,12,0,0,0
11239,142,2020-11-18T16:20:37.5640696Z,2019,27,11,21,12,0,4to,0,0,15,0,0,16,6,0,27,0,0,0
11239,143,2020-11-18T16:20:37.5640696Z,2019,19,5,15,7,0,5to,0,0,12,0,0,14,4,0,19,0,0,0
11239,144,2020-11-18T16:20:37.5640696Z,2019,14,5,10,8,0,K,0,0,6,0,0,9,4,0,14,0,0,0
11239,30138,2021-06-24T13:18:06.298966Z,2021,17,8,15,6,0,1ro,0,0,11,0,0,9,2,0,17,0,0,0
11239,30139,2021-06-24T13:18:06.298966Z,2021,17,6,16,11,0,2do,0,0,6,0,0,11,1,0,17,0,0,0
11239,30140,2021-06-24T13:18:06.298966Z,2021,21,7,18,16,0,3ro,0,0,5,0,0,14,3,0,21,0,0,0
11239,30141,2021-06-24T13:18:06.298966Z,2021,16,4,13,7,0,4to,0,0,9,0,0,12,3,0,16,0,0,0
11239,30142,2021-06-24T13:18:06.2999669Z,2021,12,4,11,3,0,5to,0,0,9,0,0,8,1,0,12,0,0,0
11239,30143,2021-06-24T13:18:06.2999669Z,2021,20,8,16,10,0,K,0,0,10,0,0,12,4,0,20,0,0,0
11239,6140,2020-11-18T16:21:38.243534Z,2020,17,6,13,9,0,1ro,0,0,8,0,0,11,4,0,17,0,0,0
11239,6141,2020-11-18T16:21:38.243534Z,2020,16,5,15,12,0,2do,0,0,4,0,0,11,1,0,16,0,0,0
11239,6142,2020-11-18T16:21:38.243534Z,2020,18,7,13,7,0,3ro,0,0,11,0,0,11,5,0,18,0,0,0
11239,6143,2020-11-18T16:21:38.243534Z,2020,11,4,7,3,0,4to,0,0,8,0,0,7,4,0,11,0,0,0
11239,6144,2020-11-18T16:21:38.243534Z,2020,23,9,17,10,0,5to,0,0,13,0,0,14,6,0,23,0,0,0
11239,6145,2020-11-18T16:21:38.244534Z,2020,15,7,8,3,0,K,0,0,12,0,0,8,7,0,15,0,0,0
23119,1344,2020-11-18T16:20:45.888624Z,2019,73,36,56,39,0,6to,0,0,34,0,0,37,17,0,73,0,0,0
23119,1345,2020-11-18T16:20:45.888624Z,2019,94,40,78,51,0,7mo,2,1,43,0,0,54,16,0,92,0,0,0
23119,1346,2020-11-18T16:20:45.8896249Z,2019,126,64,103,54,0,8vo,0,0,72,0,0,62,23,0,126,0,0,0
23119,1347,2020-11-18T16:20:45.8896249Z,2019,71,65,68,13,0,Sin Grado,0,1,58,0,0,6,3,0,71,0,0,0
23119,31346,2021-06-24T13:18:14.5929136Z,2021,52,32,47,27,0,6to,1,0,25,0,0,20,5,1,50,0,0,0
23119,31347,2021-06-24T13:18:14.5929136Z,2021,37,15,31,18,0,7mo,0,0,19,0,0,22,6,0,37,0,0,0
23119,31348,2021-06-24T13:18:14.593915Z,2021,68,35,53,36,0,8vo,0,0,32,0,0,33,15,0,68,0,0,0
23119,31349,2021-06-24T13:18:14.593915Z,2021,49,49,45,14,0,Sin Grado,0,0,35,0,0,0,4,0,49,0,0,0
23119,7349,2020-11-18T16:21:45.3302613Z,2020,37,11,33,16,0,6to,0,0,21,0,0,26,4,0,37,0,0,0
23119,7350,2020-11-18T16:21:45.3302613Z,2020,67,34,52,37,0,7mo,0,0,30,0,0,33,15,0,67,0,0,0
23119,7351,2020-11-18T16:21:45.3312617Z,2020,84,32,74,50,0,8vo,2,0,34,0,0,52,10,0,82,0,0,0
23119,7352,2020-11-18T16:21:45.3312617Z,2020,80,80,76,29,0,Sin Grado,0,0,51,0,0,0,4,0,80,0,0,0
18226,30818,2021-06-24T13:18:11.451661Z,2021,70,17,57,37,0,1ro,3,0,33,0,0,53,13,0,67,0,0,0
18226,30819,2021-06-24T13:18:11.451661Z,2021,56,18,51,28,0,2do,1,0,28,0,0,38,5,0,55,0,0,0
18226,30820,2021-06-24T13:18:11.451661Z,2021,71,22,61,40,0,3ro,1,0,31,0,0,49,10,0,70,0,0,0
18226,30821,2021-06-24T13:18:11.4526615Z,2021,61,17,57,27,0,4to,0,0,34,0,0,44,4,0,61,0,0,0
18226,30822,2021-06-24T13:18:11.4526615Z,2021,77,25,62,36,0,5to,2,0,41,0,0,52,15,0,75,0,0,0
18226,30823,2021-06-24T13:18:11.4526615Z,2021,70,11,62,33,0,K,0,0,37,0,0,59,8,0,70,0,0,0
18226,6821,2020-11-18T16:21:42.0370616Z,2020,59,18,44,32,0,1ro,0,0,27,0,0,41,15,0,59,0,0,0
18226,6822,2020-11-18T16:21:42.0370616Z,2020,72,19,59,40,0,2do,2,0,32,0,0,53,13,0,70,0,0,0
18226,6823,2020-11-18T16:21:42.038063Z,2020,60,15,46,24,0,3ro,0,0,36,0,0,45,14,0,60,0,0,0
18226,6824,2020-11-18T16:21:42.038063Z,2020,69,21,53,29,0,4to,2,0,40,0,0,48,16,0,67,0,0,0
18226,6825,2020-11-18T16:21:42.038063Z,2020,53,12,42,31,0,5to,2,0,22,0,0,41,11,0,51,0,0,0
18226,6826,2020-11-18T16:21:42.038063Z,2020,73,17,49,37,0,K,3,0,36,0,0,56,24,0,70,0,0,0
18226,6827,2020-11-18T16:21:42.039063Z,2020,5,5,5,2,0,Sin Grado,0,0,3,0,0,0,0,0,5,0,0,0
18226,820,2020-11-18T16:20:42.6404532Z,2019,73,22,62,40,0,1ro,2,1,33,0,0,51,11,0,71,0,0,0
18226,821,2020-11-18T16:20:42.6404532Z,2019,61,14,51,25,0,2do,0,0,36,0,0,47,10,0,61,0,0,0
18226,822,2020-11-18T16:20:42.6404532Z,2019,58,19,49,24,0,3ro,2,0,34,0,0,39,9,0,56,0,0,0
18226,823,2020-11-18T16:20:42.6404532Z,2019,50,12,42,27,0,4to,2,0,23,0,0,38,8,0,48,0,0,0
18226,824,2020-11-18T16:20:42.6414541Z,2019,66,14,50,29,0,5to,1,0,37,0,0,52,16,0,65,2,0,0
18226,825,2020-11-18T16:20:42.6414541Z,2019,59,14,46,33,0,K,0,0,26,0,0,45,13,0,59,0,0,0
18226,826,2020-11-18T16:20:42.6414541Z,2019,6,5,6,3,0,Sin Grado,0,0,3,0,0,1,0,0,6,0,0,0
50229,3231,2020-11-18T16:21:01.4540024Z,2019,44,12,39,20,0,1ro,0,5,24,0,0,32,5,0,44,0,0,0
50229,3232,2020-11-18T16:21:01.4540024Z,2019,36,7,32,19,0,2do,1,4,17,0,0,29,4,0,34,0,0,1
50229,3233,2020-11-18T16:21:01.4540024Z,2019,40,7,32,23,0,3ro,1,8,17,0,0,33,8,0,39,0,0,0
50229,3234,2020-11-18T16:21:01.4550028Z,2019,52,14,46,23,0,4to,0,5,29,0,0,38,6,0,52,0,0,0
50229,3235,2020-11-18T16:21:01.4550028Z,2019,47,9,41,18,0,5to,1,6,29,0,0,38,6,0,46,0,0,0
50229,3236,2020-11-18T16:21:01.4550028Z,2019,43,8,32,24,0,6to,0,5,19,0,0,35,11,0,43,0,0,0
50229,3237,2020-11-18T16:21:01.4550028Z,2019,41,7,36,19,0,7mo,0,3,22,0,0,34,5,0,41,0,0,0
50229,3238,2020-11-18T16:21:01.4550028Z,2019,45,8,36,18,0,8vo,0,5,27,0,0,37,9,0,45,2,0,0
50229,3239,2020-11-18T16:21:01.4560042Z,2019,36,5,24,31,0,K,0,1,5,0,0,31,12,0,36,0,0,0
50229,33259,2021-06-24T13:18:30.8886057Z,2021,25,2,24,12,0,1ro,0,1,13,0,0,23,1,0,25,0,0,0
50229,33260,2021-06-24T13:18:30.8886057Z,2021,24,6,21,10,0,2do,0,0,14,0,0,18,3,0,24,0,0,0
50229,33261,2021-06-24T13:18:30.8896053Z,2021,24,4,23,12,0,3ro,1,0,12,0,0,20,1,0,23,0,0,0
50229,33262,2021-06-24T13:18:30.8896053Z,2021,21,2,20,9,0,4to,1,0,12,0,0,19,1,0,19,0,0,1
50229,33263,2021-06-24T13:18:30.8896053Z,2021,26,6,22,14,0,5to,2,0,12,0,0,20,4,0,24,0,0,0
50229,33264,2021-06-24T13:18:30.8896053Z,2021,48,13,41,26,0,6to,0,0,22,0,0,35,7,0,48,0,0,0
50229,33265,2021-06-24T13:18:30.8906067Z,2021,35,10,31,12,0,7mo,0,0,23,0,0,25,4,0,35,0,0,0
50229,33266,2021-06-24T13:18:30.8906067Z,2021,32,8,27,17,0,8vo,0,0,15,0,0,24,5,0,32,0,0,0
50229,33267,2021-06-24T13:18:30.8906067Z,2021,15,2,12,10,0,K,0,0,5,0,0,13,3,0,15,0,0,0
50229,9253,2020-11-18T16:21:57.3292603Z,2020,29,5,27,27,0,1ro,0,1,2,0,0,24,2,0,29,0,0,0
50229,9254,2020-11-18T16:21:57.330262Z,2020,35,6,33,17,0,2do,0,2,18,0,0,29,2,0,35,0,0,0
50229,9255,2020-11-18T16:21:57.330262Z,2020,36,8,32,20,0,3ro,1,3,16,0,0,28,4,0,34,0,0,1
50229,9256,2020-11-18T16:21:57.330262Z,2020,38,8,30,22,0,4to,1,4,16,0,0,30,8,0,37,0,0,0
50229,9257,2020-11-18T16:21:57.3312625Z,2020,50,13,42,25,0,5to,0,1,25,0,0,37,8,0,50,0,0,0
50229,9258,2020-11-18T16:21:57.3312625Z,2020,42,9,35,17,0,6to,1,3,25,0,0,33,7,0,41,0,0,0
50229,9259,2020-11-18T16:21:57.3312625Z,2020,42,8,30,25,0,7mo,0,4,17,0,0,34,12,0,42,0,0,0
50229,9260,2020-11-18T16:21:57.3322634Z,2020,35,5,31,18,0,8vo,0,0,17,0,0,30,4,0,35,0,0,0
50229,9261,2020-11-18T16:21:57.3322634Z,2020,38,3,32,19,0,K,0,0,19,0,0,35,6,0,38,0,0,0
52142,33542,2021-06-24T13:18:33.3843944Z,2021,93,37,79,49,0,6to,1,0,44,0,0,56,14,0,92,0,0,0
52142,33543,2021-06-24T13:18:33.3843944Z,2021,78,22,71,48,0,7mo,1,0,30,0,0,56,7,0,77,0,0,0
52142,33544,2021-06-24T13:18:33.3853949Z,2021,82,25,65,36,0,8vo,0,0,46,0,0,57,17,0,81,1,0,1
52142,3517,2020-11-18T16:21:03.2542047Z,2019,103,30,71,47,0,6to,1,1,56,0,0,73,32,0,101,1,0,1
52142,3518,2020-11-18T16:21:03.2542047Z,2019,116,38,92,61,0,7mo,0,0,55,0,0,78,24,0,116,0,0,0
52142,3519,2020-11-18T16:21:03.2552047Z,2019,81,20,60,45,0,8vo,1,0,36,0,0,61,21,0,80,0,0,0
52142,9537,2020-11-18T16:21:59.0784266Z,2020,97,28,79,59,0,6to,2,0,38,0,0,69,18,0,95,1,0,0
52142,9538,2020-11-18T16:21:59.0784266Z,2020,97,28,70,42,0,7mo,0,0,55,0,0,69,27,0,96,1,0,1
52142,9539,2020-11-18T16:21:59.0784266Z,2020,114,34,91,59,0,8vo,0,0,55,0,0,80,23,0,114,0,0,0
43323,2894,2020-11-18T16:20:59.2014975Z,2019,62,23,56,25,0,1ro,2,2,37,0,0,39,6,0,60,0,0,0
43323,2895,2020-11-18T16:20:59.2014975Z,2019,63,31,57,24,0,2do,1,1,39,0,0,32,6,0,62,0,0,0
43323,2896,2020-11-18T16:20:59.2014975Z,2019,46,16,43,22,0,3ro,2,0,24,0,0,30,3,0,44,0,0,0
43323,2897,2020-11-18T16:20:59.2014975Z,2019,47,16,38,29,0,4to,0,0,18,0,0,31,9,0,47,0,0,0
43323,2898,2020-11-18T16:20:59.2024979Z,2019,53,21,48,27,0,5to,0,0,26,0,0,32,5,0,52,1,0,1
43323,2899,2020-11-18T16:20:59.2024979Z,2019,53,21,44,29,0,K,1,1,24,0,0,32,9,0,52,0,0,0
43323,2900,2020-11-18T16:20:59.2024979Z,2019,25,4,23,15,0,PK,1,0,10,0,0,21,2,0,24,0,0,0
43323,2901,2020-11-18T16:20:59.8869547Z,2019,15,13,11,6,0,Sin Grado,1,1,9,0,0,2,4,0,14,0,0,0
43323,32902,2021-06-24T13:18:28.8311299Z,2021,62,17,56,31,0,1ro,2,1,31,0,0,45,6,0,59,0,0,1
43323,32903,2021-06-24T13:18:28.8311299Z,2021,36,14,34,19,0,2do,0,0,17,0,0,22,2,0,36,0,0,0
43323,32904,2021-06-24T13:18:28.8311299Z,2021,56,16,50,24,0,3ro,2,0,32,0,0,40,6,0,54,0,0,0
43323,32905,2021-06-24T13:18:28.8321309Z,2021,63,27,54,27,0,4to,2,0,36,0,0,36,9,0,60,0,0,1
43323,32906,2021-06-24T13:18:28.8321309Z,2021,38,13,36,18,0,5to,1,0,20,0,0,25,2,0,37,0,0,0
43323,32907,2021-06-24T13:18:28.8321309Z,2021,50,13,41,24,0,K,1,0,26,0,0,37,9,0,48,0,0,1
43323,32908,2021-06-24T13:18:28.8321309Z,2021,15,4,13,9,0,PK,0,0,6,0,0,11,2,0,15,0,0,0
43323,32909,2021-06-24T13:18:28.8321309Z,2021,7,7,7,2,0,Sin Grado,0,0,5,0,0,0,0,0,7,0,0,0
43323,8906,2020-11-18T16:21:54.9806953Z,2020,40,18,34,20,0,1ro,0,0,20,0,0,22,6,0,40,0,0,0
43323,8907,2020-11-18T16:21:54.9806953Z,2020,59,23,48,24,0,2do,2,3,35,0,0,36,11,0,57,0,0,0
43323,8908,2020-11-18T16:21:54.9816958Z,2020,60,29,50,25,0,3ro,2,1,35,0,0,31,10,0,57,0,0,1
43323,8909,2020-11-18T16:21:54.9816958Z,2020,42,15,40,20,0,4to,1,0,22,0,0,27,2,0,41,0,0,0
43323,8910,2020-11-18T16:21:54.9816958Z,2020,36,16,28,23,0,5to,0,0,13,0,0,20,8,0,36,0,0,0
43323,8911,2020-11-18T16:21:54.9816958Z,2020,68,17,65,33,0,K,2,4,35,0,0,51,3,0,65,0,0,1
43323,8912,2020-11-18T16:21:54.9826962Z,2020,30,3,24,14,0,PK,0,3,16,0,0,27,6,0,30,0,0,0
43323,8913,2020-11-18T16:21:54.9826962Z,2020,8,8,7,1,0,Sin Grado,0,1,7,0,0,0,1,0,8,0,0,0
43307,2883,2020-11-18T16:20:59.200497Z,2019,45,13,34,22,0,1ro,1,0,23,0,0,32,11,0,44,0,0,0
43307,2884,2020-11-18T16:20:59.2014975Z,2019,45,22,36,21,0,2do,0,0,24,0,0,23,9,0,45,0,0,0
43307,2885,2020-11-18T16:20:59.2014975Z,2019,38,9,25,23,0,3ro,2,0,15,0,0,29,13,0,36,0,0,0
43307,2886,2020-11-18T16:20:59.2014975Z,2019,25,7,22,11,0,4to,1,0,14,0,0,18,3,0,24,0,0,0
43307,2887,2020-11-18T16:20:59.2024979Z,2019,34,8,25,16,0,5to,1,0,18,0,0,26,9,0,33,0,0,0
43307,2888,2020-11-18T16:20:59.2024979Z,2019,22,12,15,7,0,K,0,0,15,0,0,10,7,0,22,0,0,0
43307,2889,2020-11-18T16:20:59.2024979Z,2019,17,2,13,9,0,PK,0,0,8,0,0,15,4,0,17,0,0,0
43307,32891,2021-06-24T13:18:28.2166885Z,2021,33,5,27,19,0,1ro,0,0,14,0,0,28,6,0,33,0,0,0
43307,32892,2021-06-24T13:18:28.217689Z,2021,25,13,18,12,0,2do,0,0,13,0,0,12,7,0,25,0,0,0
43307,32893,2021-06-24T13:18:28.217689Z,2021,50,14,39,28,0,3ro,1,0,22,0,0,36,11,0,49,0,0,0
43307,32894,2021-06-24T13:18:28.217689Z,2021,41,21,31,16,0,4to,0,0,25,0,0,20,10,0,41,0,0,0
43307,32895,2021-06-24T13:18:28.217689Z,2021,45,12,31,26,0,5to,2,0,19,0,0,33,14,0,43,0,0,0
43307,32896,2021-06-24T13:18:28.217689Z,2021,31,13,30,11,0,K,0,0,20,0,0,18,1,0,31,0,0,0
43307,8895,2020-11-18T16:21:54.2472051Z,2020,26,13,18,12,0,1ro,0,1,14,0,0,13,8,0,26,0,0,0
43307,8896,2020-11-18T16:21:54.2472051Z,2020,42,11,29,23,0,2do,0,0,19,0,0,31,13,0,42,0,0,0
43307,8897,2020-11-18T16:21:54.2472051Z,2020,40,22,33,16,0,3ro,1,0,24,0,0,18,7,0,39,0,0,0
43307,8898,2020-11-18T16:21:54.2472051Z,2020,42,12,27,23,0,4to,2,0,19,0,0,30,15,0,40,0,0,0
43307,8899,2020-11-18T16:21:54.2472051Z,2020,25,8,21,11,0,5to,1,0,14,0,0,17,4,0,24,0,0,0
43307,8900,2020-11-18T16:21:54.2472051Z,2020,28,5,20,16,0,K,0,0,12,0,0,23,8,0,28,0,0,0
43307,8901,2020-11-18T16:21:54.9736904Z,2020,13,2,13,4,0,PK,1,0,9,0,0,11,0,0,12,0,0,0
69138,10862,2020-11-18T16:22:06.5434065Z,2020,26,6,20,16,0,1ro,1,0,10,0,0,20,6,0,25,0,0,0
69138,10863,2020-11-18T16:22:06.5434065Z,2020,30,10,25,16,0,2do,0,0,14,0,0,20,5,0,30,0,0,0
69138,10864,2020-11-18T16:22:06.544407Z,2020,29,8,26,13,0,3ro,2,0,16,0,0,21,3,0,27,0,0,0
69138,10865,2020-11-18T16:22:06.544407Z,2020,32,9,27,14,0,4to,1,0,18,0,0,23,5,0,31,0,0,0
69138,10866,2020-11-18T16:22:06.544407Z,2020,31,11,26,14,0,5to,1,0,17,0,0,20,5,0,30,0,0,0
69138,10867,2020-11-18T16:22:06.544407Z,2020,32,18,27,14,0,6to,1,0,18,0,0,14,5,0,31,0,0,0
69138,10868,2020-11-18T16:22:06.544407Z,2020,28,5,21,15,0,K,0,0,13,0,0,23,7,0,28,0,0,0
69138,10869,2020-11-18T16:22:06.5454088Z,2020,16,0,10,10,0,PK,0,0,6,0,0,16,6,0,16,0,0,0
69138,34884,2021-06-24T13:18:42.9592597Z,2021,30,9,26,17,0,1ro,0,0,13,0,0,21,4,0,30,0,0,0
69138,34885,2021-06-24T13:18:42.9592597Z,2021,23,5,20,12,0,2do,1,0,11,0,0,18,3,0,22,0,0,0
69138,34886,2021-06-24T13:18:42.9602607Z,2021,28,10,24,15,0,3ro,2,0,13,0,0,18,4,0,26,0,0,0
69138,34887,2021-06-24T13:18:42.9602607Z,2021,33,8,28,14,0,4to,2,0,19,0,0,25,5,0,31,0,0,0
69138,34888,2021-06-24T13:18:42.9602607Z,2021,33,9,30,16,0,5to,1,0,17,0,0,24,3,0,32,0,0,0
69138,34889,2021-06-24T13:18:42.9602607Z,2021,36,12,31,18,0,6to,2,0,18,0,0,24,5,0,34,0,0,0
69138,34890,2021-06-24T13:18:42.9602607Z,2021,36,8,31,17,0,K,0,0,19,0,0,28,5,0,36,0,0,0
69138,34891,2021-06-24T13:18:42.9612621Z,2021,11,3,6,4,0,PK,0,0,7,0,0,8,5,0,11,0,0,0
69138,4854,2020-11-18T16:21:12.3952983Z,2019,34,16,29,19,0,1ro,1,0,15,0,0,18,5,0,33,0,0,0
69138,4855,2020-11-18T16:21:12.3952983Z,2019,35,10,35,21,0,2do,2,0,14,0,0,25,0,0,33,0,0,0
69138,4856,2020-11-18T16:21:12.3952983Z,2019,28,11,24,12,0,3ro,1,0,16,0,0,17,4,0,27,0,0,0
69138,4857,2020-11-18T16:21:12.3952983Z,2019,29,10,25,13,0,4to,1,0,16,0,0,19,4,0,28,0,0,0
69138,4858,2020-11-18T16:21:12.3962996Z,2019,29,15,24,14,0,5to,1,0,15,0,0,14,5,0,28,0,0,0
69138,4859,2020-11-18T16:21:12.3962996Z,2019,26,8,21,13,0,6to,0,0,13,0,0,18,5,0,26,0,0,0
69138,4860,2020-11-18T16:21:12.3962996Z,2019,29,5,26,18,0,K,0,0,11,0,0,24,3,0,29,0,0,0
69138,4861,2020-11-18T16:21:12.3962996Z,2019,18,1,13,10,0,PK,0,0,8,0,0,17,5,0,18,0,0,0
54635,33808,2021-06-24T13:18:35.7200693Z,2021,67,11,56,34,0,1ro,0,0,33,0,0,56,11,0,66,0,0,1
54635,33809,2021-06-24T13:18:35.7200693Z,2021,80,24,68,36,0,2do,0,1,44,0,0,56,12,0,78,0,0,2
54635,33810,2021-06-24T13:18:35.7210698Z,2021,95,20,81,48,0,3ro,0,0,47,0,0,75,14,0,94,1,0,1
54635,33811,2021-06-24T13:18:35.7210698Z,2021,91,28,76,48,0,4to,0,0,43,0,0,63,15,0,90,0,0,1
54635,33812,2021-06-24T13:18:35.7210698Z,2021,93,31,77,51,0,5to,3,0,42,0,0,62,16,0,90,0,0,0
54635,33813,2021-06-24T13:18:35.7220711Z,2021,77,11,57,37,0,K,0,1,40,0,0,66,20,0,76,0,0,1
54635,3785,2020-11-18T16:21:05.1304516Z,2019,94,17,78,54,0,1ro,0,0,40,0,0,77,16,0,94,0,0,0
54635,3786,2020-11-18T16:21:05.1304516Z,2019,99,32,82,50,0,2do,0,0,49,0,0,67,17,0,98,0,0,1
54635,3787,2020-11-18T16:21:05.1314525Z,2019,110,37,91,56,0,3ro,3,0,54,0,0,73,19,0,107,0,0,0
54635,3788,2020-11-18T16:21:05.1314525Z,2019,116,29,100,61,0,4to,4,0,55,0,1,87,16,0,112,0,0,0
54635,3789,2020-11-18T16:21:05.1314525Z,2019,89,31,73,49,0,5to,3,0,40,0,1,58,16,0,86,1,0,0
54635,3790,2020-11-18T16:21:05.1314525Z,2019,81,19,59,37,0,K,1,0,44,0,0,62,22,0,80,0,0,0
54635,9802,2020-11-18T16:22:00.5053816Z,2020,80,21,69,38,0,1ro,1,0,42,0,0,59,11,0,78,0,0,1
54635,9803,2020-11-18T16:22:00.5053816Z,2020,98,18,83,51,0,2do,0,3,47,0,0,80,15,0,97,1,0,1
54635,9804,2020-11-18T16:22:00.5063798Z,2020,101,34,85,50,0,3ro,0,2,51,0,0,67,16,0,100,0,0,1
54635,9805,2020-11-18T16:22:00.5063798Z,2020,98,30,83,54,0,4to,2,2,44,0,0,68,15,0,96,0,0,0
54635,9806,2020-11-18T16:22:00.5063798Z,2020,115,30,102,61,0,5to,3,0,54,0,0,85,13,0,112,2,0,0
54635,9807,2020-11-18T16:22:00.5063798Z,2020,61,8,49,25,0,K,0,2,36,0,0,53,12,0,60,0,0,1
70664,11092,2020-11-18T16:22:07.6441407Z,2020,37,8,31,29,0,1ro,0,0,8,0,0,29,6,0,37,0,0,0
70664,11093,2020-11-18T16:22:07.6441407Z,2020,33,11,29,16,0,2do,1,0,17,0,0,22,4,0,31,0,0,1
70664,11094,2020-11-18T16:22:07.6441407Z,2020,41,16,30,19,0,3ro,0,0,22,0,0,25,11,0,41,0,0,0
70664,11095,2020-11-18T16:22:07.6451394Z,2020,30,10,22,10,0,4to,0,0,20,0,0,20,8,0,30,0,0,0
70664,11096,2020-11-18T16:22:07.6451394Z,2020,31,9,22,16,0,5to,0,0,15,0,0,22,9,0,31,0,0,0
70664,11097,2020-11-18T16:22:07.6451394Z,2020,47,17,37,22,0,6to,0,0,25,0,0,30,10,0,47,0,0,0
70664,11098,2020-11-18T16:22:07.6451394Z,2020,44,15,39,26,0,7mo,1,0,18,0,0,29,5,0,43,0,0,0
70664,11099,2020-11-18T16:22:07.6461385Z,2020,37,9,30,18,0,8vo,0,0,19,0,0,28,7,0,37,0,0,0
70664,11100,2020-11-18T16:22:07.6461385Z,2020,27,9,25,13,0,K,0,0,14,0,0,18,2,0,27,0,0,0
70664,11101,2020-11-18T16:22:08.3045768Z,2020,23,23,23,6,0,Sin Grado,0,1,17,0,0,0,0,1,22,0,0,0
70664,35113,2021-06-24T13:18:44.5173777Z,2021,24,9,22,12,0,1ro,0,0,12,0,0,15,2,0,24,0,0,0
70664,35114,2021-06-24T13:18:44.518379Z,2021,34,8,30,25,0,2do,0,0,9,0,0,26,4,0,34,0,0,0
70664,35115,2021-06-24T13:18:44.518379Z,2021,36,13,33,16,0,3ro,1,0,20,0,0,23,3,0,34,0,0,1
70664,35116,2021-06-24T13:18:44.518379Z,2021,36,14,31,16,0,4to,0,0,20,0,0,22,5,0,36,0,0,0
70664,35117,2021-06-24T13:18:44.518379Z,2021,26,10,19,10,0,5to,0,0,16,0,0,16,7,0,26,0,0,0
70664,35118,2021-06-24T13:18:44.518379Z,2021,39,11,31,19,0,6to,0,0,20,0,0,28,8,0,39,0,0,0
70664,35119,2021-06-24T13:18:44.5193791Z,2021,43,14,38,20,0,7mo,1,0,23,0,0,29,5,0,42,0,0,0
70664,35120,2021-06-24T13:18:44.5193791Z,2021,43,15,35,24,0,8vo,0,0,19,0,0,28,8,0,43,0,0,0
70664,35121,2021-06-24T13:18:44.5193791Z,2021,32,9,26,19,0,K,0,0,13,0,0,23,6,0,32,0,0,0
70664,35122,2021-06-24T13:18:44.5193791Z,2021,13,13,13,3,0,Sin Grado,0,0,10,0,0,0,0,0,13,0,0,0
70664,5086,2020-11-18T16:21:13.4439984Z,2019,28,10,25,15,0,1ro,1,0,13,0,0,18,3,1,25,0,0,1
70664,5087,2020-11-18T16:21:13.4439984Z,2019,41,17,30,19,0,2do,1,1,22,0,0,24,11,0,40,0,0,0
70664,5088,2020-11-18T16:21:13.4439984Z,2019,36,16,26,14,0,3ro,0,0,22,0,0,20,10,0,36,0,0,0
70664,5089,2020-11-18T16:21:13.4439984Z,2019,34,14,23,17,0,4to,0,0,17,0,0,20,11,0,34,0,0,0
70664,5090,2020-11-18T16:21:13.4449988Z,2019,38,12,25,15,0,5to,1,0,23,0,0,26,13,0,37,0,0,0
70664,5091,2020-11-18T16:21:13.4449988Z,2019,41,14,36,23,0,6to,1,1,18,0,0,27,5,0,40,0,0,0
70664,5092,2020-11-18T16:21:13.4449988Z,2019,36,7,29,18,0,7mo,0,0,18,0,0,29,7,0,36,0,0,0
70664,5093,2020-11-18T16:21:13.4449988Z,2019,54,18,40,31,0,8vo,0,0,23,0,0,36,14,0,54,0,0,0
70664,5094,2020-11-18T16:21:13.4449988Z,2019,39,10,28,32,0,K,0,0,7,0,0,29,11,0,39,0,0,0
70664,5095,2020-11-18T16:21:13.4449988Z,2019,21,20,21,6,0,Sin Grado,0,2,15,0,0,1,0,1,19,0,0,1
57828,33988,2021-06-24T13:18:36.6897644Z,2021,71,21,46,34,0,6to,3,0,37,0,0,50,25,0,68,0,0,0
57828,33989,2021-06-24T13:18:36.6897644Z,2021,92,26,74,49,0,7mo,1,0,43,0,0,66,18,0,91,1,0,0
57828,33990,2021-06-24T13:18:36.6897644Z,2021,100,31,75,51,0,8vo,1,0,49,0,0,69,25,0,99,2,0,0
57828,3964,2020-11-18T16:21:06.8826218Z,2019,106,31,69,54,0,6to,1,2,52,0,1,75,37,0,105,2,0,0
57828,3965,2020-11-18T16:21:06.8836227Z,2019,76,17,52,36,0,7mo,1,2,40,0,0,59,24,0,75,0,0,0
57828,3966,2020-11-18T16:21:06.8836227Z,2019,95,26,57,48,0,8vo,0,0,47,0,0,69,38,1,94,1,0,0
57828,9981,2020-11-18T16:22:01.5550808Z,2020,98,28,70,52,0,6to,1,0,46,0,0,70,28,0,97,2,0,0
57828,9982,2020-11-18T16:22:01.5550808Z,2020,100,30,63,52,0,7mo,1,1,48,0,0,70,37,0,99,2,0,0
57828,9983,2020-11-18T16:22:01.5550808Z,2020,66,15,42,34,0,8vo,1,1,32,0,0,51,24,0,65,0,0,0
51177,33365,2021-06-24T13:18:31.5730956Z,2021,16,1,14,9,0,1ro,1,0,7,0,0,15,2,0,15,0,0,0
51177,33366,2021-06-24T13:18:31.5730956Z,2021,22,5,20,13,0,2do,1,1,9,0,0,17,2,0,21,0,0,0
51177,33367,2021-06-24T13:18:31.5740961Z,2021,15,4,14,6,0,3ro,0,0,9,0,0,11,1,0,15,0,0,0
51177,33368,2021-06-24T13:18:31.5740961Z,2021,29,6,25,11,0,4to,1,0,18,0,0,23,4,0,28,1,0,0
51177,33369,2021-06-24T13:18:31.5740961Z,2021,32,5,29,18,0,5to,0,1,14,0,0,27,3,0,32,0,0,0
51177,33370,2021-06-24T13:18:31.5750975Z,2021,39,8,27,15,0,6to,0,0,24,0,0,31,12,0,39,0,0,0
51177,33371,2021-06-24T13:18:31.5750975Z,2021,33,9,28,19,0,7mo,1,2,14,0,0,24,5,0,32,0,0,0
51177,33372,2021-06-24T13:18:31.5750975Z,2021,31,7,25,20,0,8vo,0,1,11,0,0,24,6,0,31,0,0,0
51177,33373,2021-06-24T13:18:31.5750975Z,2021,12,1,8,6,0,K,0,0,6,0,0,11,4,0,12,0,0,0
51177,3340,2020-11-18T16:21:02.1394605Z,2019,24,5,20,10,0,1ro,0,2,14,0,0,19,4,0,24,0,0,0
51177,3341,2020-11-18T16:21:02.14046Z,2019,31,8,22,12,0,2do,1,1,19,0,0,23,9,0,30,0,0,0
51177,3342,2020-11-18T16:21:02.14046Z,2019,35,6,26,20,0,3ro,0,1,15,0,0,29,9,0,35,0,0,0
51177,3343,2020-11-18T16:21:02.14046Z,2019,48,14,29,21,0,4to,1,4,27,0,0,34,19,0,47,0,0,0
51177,3344,2020-11-18T16:21:02.14046Z,2019,36,9,27,18,0,5to,2,3,18,0,0,27,9,0,34,0,0,0
51177,3345,2020-11-18T16:21:02.1414614Z,2019,36,7,28,21,0,6to,0,3,15,0,0,29,8,0,36,0,0,0
51177,3346,2020-11-18T16:21:02.1414614Z,2019,38,6,27,20,0,7mo,2,2,18,0,0,32,11,0,36,0,1,0
51177,3347,2020-11-18T16:21:02.1414614Z,2019,27,3,22,15,0,8vo,0,0,12,0,0,24,5,0,27,1,0,0
51177,3348,2020-11-18T16:21:02.1414614Z,2019,26,3,22,15,0,K,1,1,11,0,0,23,4,0,25,0,0,0
51177,9360,2020-11-18T16:21:58.0087118Z,2020,24,3,19,13,0,1ro,1,2,11,0,0,21,5,0,23,0,0,0
51177,9361,2020-11-18T16:21:58.0087118Z,2020,22,3,20,8,0,2do,0,0,14,0,0,19,2,0,22,0,0,0
51177,9362,2020-11-18T16:21:58.0097136Z,2020,29,6,21,11,0,3ro,1,0,18,0,0,23,8,0,28,0,0,0
51177,9363,2020-11-18T16:21:58.0097136Z,2020,33,6,25,19,0,4to,0,1,14,0,0,27,8,0,33,0,0,0
51177,9364,2020-11-18T16:21:58.0097136Z,2020,48,14,37,18,0,5to,1,1,30,0,0,34,11,0,47,0,0,0
51177,9365,2020-11-18T16:21:58.0097136Z,2020,35,8,26,18,0,6to,1,3,17,0,0,27,9,0,34,0,0,0
51177,9366,2020-11-18T16:21:58.0107136Z,2020,35,8,28,21,0,7mo,0,2,14,0,0,27,7,0,35,0,0,0
51177,9367,2020-11-18T16:21:58.0107136Z,2020,32,5,25,16,0,8vo,1,2,16,0,0,27,7,0,31,0,0,0
51177,9368,2020-11-18T16:21:58.0107136Z,2020,27,1,17,13,0,K,1,0,14,0,0,26,10,0,26,0,0,0
40295,2551,2020-11-18T16:20:57.6364583Z,2019,60,25,58,27,0,1ro,2,2,33,0,0,35,2,0,58,0,0,0
40295,2552,2020-11-18T16:20:57.6364583Z,2019,42,14,39,21,0,2do,0,2,21,0,0,28,3,0,42,0,1,0
40295,2553,2020-11-18T16:20:57.6364583Z,2019,52,20,47,26,0,3ro,1,1,26,0,0,32,5,0,51,0,0,0
40295,2554,2020-11-18T16:20:57.6364583Z,2019,61,22,58,31,0,4to,1,0,30,0,0,39,3,0,60,0,0,0
40295,2555,2020-11-18T16:20:57.6374587Z,2019,47,19,40,16,0,5to,1,0,31,0,0,28,7,0,46,0,1,0
40295,2556,2020-11-18T16:20:57.6374587Z,2019,2,0,2,1,0,6to,0,0,1,0,0,2,0,0,2,0,0,0
40295,2557,2020-11-18T16:20:57.6374587Z,2019,41,15,36,20,0,K,0,0,21,0,0,26,5,0,41,0,0,0
40295,32560,2021-06-24T13:18:25.2255439Z,2021,45,14,42,26,0,1ro,0,1,19,0,0,31,3,0,45,0,0,0
40295,32561,2021-06-24T13:18:25.2255439Z,2021,43,18,39,22,0,2do,0,0,21,0,0,25,4,0,43,0,0,0
40295,32562,2021-06-24T13:18:25.2265444Z,2021,43,13,41,22,0,3ro,2,0,21,0,0,30,2,0,41,0,0,0
40295,32563,2021-06-24T13:18:25.2265444Z,2021,33,15,30,19,0,4to,0,0,14,0,0,18,3,0,33,0,0,0
40295,32564,2021-06-24T13:18:25.2265444Z,2021,45,16,38,22,0,5to,1,0,23,0,0,29,7,0,44,0,0,0
40295,32565,2021-06-24T13:18:25.2265444Z,2021,63,13,51,30,0,K,0,2,33,0,0,50,12,0,63,0,0,0
40295,8564,2020-11-18T16:21:52.6371302Z,2020,40,17,35,20,0,1ro,0,0,20,0,0,23,5,0,40,0,0,0
40295,8565,2020-11-18T16:21:52.6371302Z,2020,42,13,39,23,0,2do,2,0,19,0,0,29,3,0,40,0,0,0
40295,8566,2020-11-18T16:21:52.6371302Z,2020,37,13,33,19,0,3ro,0,0,18,0,0,24,4,0,37,0,1,0
40295,8567,2020-11-18T16:21:52.6381302Z,2020,53,18,46,28,0,4to,1,0,25,0,0,35,7,0,52,0,0,0
40295,8568,2020-11-18T16:21:52.6381302Z,2020,54,18,48,27,0,5to,1,0,27,0,0,36,6,0,53,0,0,0
40295,8569,2020-11-18T16:21:52.6381302Z,2020,54,18,49,28,0,K,0,0,26,0,0,36,5,0,54,0,0,0
71753,11429,2020-11-18T16:22:10.5690897Z,2020,53,10,51,23,0,1ro,0,0,30,0,0,43,2,0,53,0,0,0
71753,11430,2020-11-18T16:22:10.5690897Z,2020,57,19,48,28,0,2do,0,0,29,0,0,38,9,0,56,0,0,1
71753,11431,2020-11-18T16:22:10.5690897Z,2020,50,15,45,24,0,3ro,0,0,26,0,0,35,5,0,50,0,0,0
71753,11432,2020-11-18T16:22:10.5700906Z,2020,51,13,46,25,0,4to,2,0,26,0,0,38,5,0,49,0,0,0
71753,11433,2020-11-18T16:22:10.5700906Z,2020,49,17,40,18,0,5to,0,0,31,0,0,32,9,0,49,0,0,0
71753,11434,2020-11-18T16:22:10.5700906Z,2020,43,9,38,17,0,K,0,0,26,0,0,34,5,0,43,0,0,0
71753,35451,2021-06-24T13:18:46.234609Z,2021,41,10,40,16,0,1ro,0,1,25,0,0,31,1,0,41,0,0,0
71753,35452,2021-06-24T13:18:46.2356095Z,2021,54,10,53,24,0,2do,0,1,30,0,0,44,1,0,54,0,0,0
71753,35453,2021-06-24T13:18:46.2356095Z,2021,55,18,50,27,0,3ro,0,0,28,0,0,37,5,0,54,0,0,1
71753,35454,2021-06-24T13:18:46.2356095Z,2021,51,17,50,27,0,4to,0,0,24,0,0,34,1,0,51,0,0,0
71753,35455,2021-06-24T13:18:46.2356095Z,2021,48,10,45,22,0,5to,2,0,26,0,0,38,3,0,46,0,0,0
71753,35456,2021-06-24T13:18:46.23661Z,2021,46,6,44,19,0,K,0,0,27,0,0,40,2,0,46,0,0,0
71753,5420,2020-11-18T16:21:15.4733477Z,2019,61,24,52,26,0,1ro,0,0,35,0,0,37,9,0,61,0,0,0
71753,5421,2020-11-18T16:21:15.4733477Z,2019,59,22,54,29,0,2do,0,0,30,0,0,37,5,0,59,0,0,0
71753,5422,2020-11-18T16:21:15.4743482Z,2019,57,15,50,27,0,3ro,2,0,30,0,0,42,7,0,55,0,0,0
71753,5423,2020-11-18T16:21:15.4743482Z,2019,61,23,52,25,0,4to,0,0,36,0,0,38,9,0,61,0,0,0
71753,5424,2020-11-18T16:21:15.4743482Z,2019,63,12,47,28,0,5to,1,0,35,0,0,51,16,0,61,0,0,1
71753,5425,2020-11-18T16:21:15.4743482Z,2019,46,8,46,22,0,K,0,0,24,0,0,38,0,0,46,0,0,0
79038,11754,2020-11-18T16:22:12.3222613Z,2020,79,18,73,47,0,10mo,2,0,32,0,0,61,6,0,76,0,1,1
79038,11755,2020-11-18T16:22:12.3232621Z,2020,78,19,66,40,0,11mo,0,0,38,0,0,59,12,0,78,0,0,0
79038,11756,2020-11-18T16:22:12.3232621Z,2020,106,19,90,60,0,12mo,2,0,46,0,0,87,16,0,104,0,0,0
79038,11757,2020-11-18T16:22:12.3232621Z,2020,112,35,102,60,0,9no,1,0,52,0,0,77,10,0,110,0,0,1
79038,11758,2020-11-18T16:22:12.324263Z,2020,12,11,12,8,0,Sin Grado,1,0,4,0,0,1,0,0,11,0,0,0
79038,35776,2021-06-24T13:18:47.8357571Z,2021,173,52,153,79,0,10mo,1,0,94,0,0,121,20,0,172,0,0,0
79038,35777,2021-06-24T13:18:47.8357571Z,2021,152,39,134,60,0,11mo,2,0,92,0,0,113,18,0,149,0,1,1
79038,35778,2021-06-24T13:18:47.8357571Z,2021,43,8,32,17,0,12mo,0,0,26,0,0,35,11,0,43,0,0,0
79038,35779,2021-06-24T13:18:47.8367576Z,2021,251,70,204,118,0,9no,2,0,133,0,0,181,47,0,249,1,0,0
79038,35780,2021-06-24T13:18:47.8367576Z,2021,13,10,12,9,0,Sin Grado,1,0,4,0,0,3,1,0,12,0,0,0
79038,5748,2020-11-18T16:21:17.1524698Z,2019,99,22,83,53,0,10mo,2,0,46,0,0,77,16,0,97,0,0,0
79038,5749,2020-11-18T16:21:17.1534707Z,2019,142,22,120,79,0,11mo,3,0,63,0,0,120,22,0,139,0,0,0
79038,5750,2020-11-18T16:21:17.1534707Z,2019,138,1,110,63,0,12mo,3,0,75,0,1,137,28,0,135,0,1,0
79038,5751,2020-11-18T16:21:17.1534707Z,2019,75,20,68,44,0,9no,2,0,31,0,0,55,7,0,72,0,1,1
79038,5752,2020-11-18T16:21:17.1534707Z,2019,12,10,12,6,0,Sin Grado,1,0,6,0,0,2,0,0,11,0,0,0
10744,30089,2021-06-24T13:18:05.8436397Z,2021,48,12,43,25,0,1ro,0,0,23,0,0,36,5,0,48,0,0,0
10744,30090,2021-06-24T13:18:05.8436397Z,2021,65,21,61,33,0,2do,1,0,32,0,0,44,4,0,64,0,0,0
10744,30091,2021-06-24T13:18:05.8446406Z,2021,65,18,61,27,0,3ro,0,0,38,0,0,47,4,0,65,0,0,0
10744,30092,2021-06-24T13:18:05.8446406Z,2021,45,11,40,18,0,4to,0,0,27,0,0,34,5,0,45,0,0,0
10744,30093,2021-06-24T13:18:05.8446406Z,2021,66,32,58,26,0,5to,0,0,40,0,0,34,8,0,66,0,0,0
10744,30094,2021-06-24T13:18:05.8446406Z,2021,48,8,42,23,0,K,0,0,25,0,0,40,6,0,48,0,0,0
10744,30095,2021-06-24T13:18:05.8456411Z,2021,6,6,5,3,0,Sin Grado,0,0,3,0,0,0,1,0,6,0,0,0
10744,6090,2020-11-18T16:21:37.7011717Z,2020,58,18,51,40,0,1ro,0,0,18,0,0,40,7,0,58,0,0,0
10744,6091,2020-11-18T16:21:37.7011717Z,2020,66,16,58,25,0,2do,0,0,41,0,0,50,8,0,66,0,0,0
10744,6092,2020-11-18T16:21:37.7011717Z,2020,46,14,40,17,0,3ro,0,0,29,0,0,32,6,0,46,0,0,0
10744,6093,2020-11-18T16:21:37.7021721Z,2020,67,32,56,24,0,4to,0,0,43,0,0,35,11,0,67,0,0,0
10744,6094,2020-11-18T16:21:37.7021721Z,2020,55,19,50,26,0,5to,0,0,29,0,0,36,5,0,54,0,0,1
10744,6095,2020-11-18T16:21:37.7021721Z,2020,49,13,48,23,0,K,0,0,26,0,0,36,1,0,49,0,0,0
10744,6096,2020-11-18T16:21:37.7021721Z,2020,9,9,8,5,0,Sin Grado,0,0,4,0,0,0,1,0,9,0,0,0
10744,89,2020-11-18T16:20:36.7004974Z,2019,62,16,50,23,0,1ro,0,0,39,0,0,46,12,0,62,0,0,0
10744,90,2020-11-18T16:20:36.7014983Z,2019,55,14,49,21,0,2do,1,1,34,0,0,41,6,0,54,0,0,0
10744,91,2020-11-18T16:20:36.7014983Z,2019,64,29,52,25,0,3ro,0,0,39,0,0,35,12,0,64,0,0,0
10744,92,2020-11-18T16:20:36.7014983Z,2019,58,20,52,28,0,4to,0,0,30,0,0,38,6,0,57,0,0,1
10744,93,2020-11-18T16:20:36.7014983Z,2019,54,16,47,19,0,5to,1,0,35,0,0,38,7,0,53,0,0,0
10744,94,2020-11-18T16:20:36.7014983Z,2019,56,16,2,39,0,K,0,1,17,0,0,40,54,0,56,0,0,0
10744,95,2020-11-18T16:20:36.7024992Z,2019,10,10,6,5,0,Sin Grado,0,0,5,0,0,0,4,0,10,0,0,0
41913,2705,2020-11-18T16:20:58.7361873Z,2019,9,0,8,5,0,1ro,0,0,4,0,0,9,1,0,9,0,0,0
41913,2706,2020-11-18T16:20:58.7361873Z,2019,10,3,10,5,0,2do,1,0,5,0,0,7,0,0,9,0,0,0
41913,2707,2020-11-18T16:20:58.7371873Z,2019,9,2,8,5,0,3ro,0,0,4,0,0,7,1,0,9,0,0,0
41913,2708,2020-11-18T16:20:58.7371873Z,2019,9,3,8,6,0,4to,1,0,3,0,0,6,1,0,8,0,0,0
41913,2709,2020-11-18T16:20:58.7371873Z,2019,6,0,5,2,0,5to,1,0,4,0,0,6,1,0,5,0,0,0
41913,2710,2020-11-18T16:20:58.7371873Z,2019,15,3,14,11,0,K,0,0,4,0,0,12,1,0,15,0,0,0
41913,2711,2020-11-18T16:20:58.7371873Z,2019,3,3,3,1,0,Sin Grado,0,0,2,0,0,0,0,0,3,0,0,0
41913,32712,2021-06-24T13:18:27.1319111Z,2021,8,3,7,4,0,1ro,0,0,4,0,0,5,1,0,8,0,0,0
41913,32713,2021-06-24T13:18:27.1319111Z,2021,14,4,13,9,0,2do,0,0,5,0,0,10,1,0,14,0,0,0
41913,32714,2021-06-24T13:18:27.1319111Z,2021,10,2,9,5,0,3ro,0,0,5,0,0,8,1,0,10,0,0,0
41913,32715,2021-06-24T13:18:27.132912Z,2021,8,3,8,4,0,4to,1,0,4,0,0,5,0,0,7,0,0,0
41913,32716,2021-06-24T13:18:27.132912Z,2021,9,2,7,5,0,5to,0,0,4,0,0,7,2,0,9,0,0,0
41913,32717,2021-06-24T13:18:27.132912Z,2021,7,0,6,3,0,K,0,0,4,0,0,7,1,0,7,0,0,0
41913,32718,2021-06-24T13:18:27.132912Z,2021,2,2,2,0,0,Sin Grado,0,0,2,0,0,0,0,0,2,0,0,0
41913,8716,2020-11-18T16:21:53.794903Z,2020,16,4,16,10,0,1ro,0,0,6,0,0,12,0,0,16,0,0,0
41913,8717,2020-11-18T16:21:53.7959043Z,2020,9,0,8,5,0,2do,0,0,4,0,0,9,1,0,9,0,0,0
41913,8718,2020-11-18T16:21:53.7959043Z,2020,8,3,8,4,0,3ro,1,0,4,0,0,5,0,0,7,0,0,0
41913,8719,2020-11-18T16:21:53.7959043Z,2020,8,2,7,4,0,4to,0,0,4,0,0,6,1,0,8,0,0,0
41913,8720,2020-11-18T16:21:53.796907Z,2020,9,2,9,7,0,5to,1,0,2,0,0,7,0,0,8,0,0,0
41913,8721,2020-11-18T16:21:53.796907Z,2020,11,2,10,5,0,K,0,0,6,0,0,9,1,0,11,0,0,0
41913,8722,2020-11-18T16:21:53.796907Z,2020,2,2,2,0,0,Sin Grado,0,0,2,0,0,0,0,0,2,0,0,0
30189,1764,2020-11-18T16:20:48.8716107Z,2019,35,11,33,17,0,1ro,0,1,18,0,0,24,2,0,35,0,0,0
30189,1765,2020-11-18T16:20:48.8716107Z,2019,25,4,24,12,0,2do,0,0,13,0,0,21,1,0,25,0,0,0
30189,1766,2020-11-18T16:20:48.8716107Z,2019,20,9,17,13,0,3ro,1,2,7,0,0,11,3,0,19,0,0,0
30189,1767,2020-11-18T16:20:48.8716107Z,2019,18,9,17,6,0,4to,0,0,12,0,0,9,1,0,18,0,0,0
30189,1768,2020-11-18T16:20:48.8726098Z,2019,23,10,19,13,0,5to,1,0,10,0,0,13,4,0,22,0,1,0
30189,1769,2020-11-18T16:20:48.8726098Z,2019,24,8,23,12,0,K,0,0,12,0,0,16,1,0,24,0,0,0
30189,1770,2020-11-18T16:20:48.8726098Z,2019,29,29,23,6,0,Sin Grado,2,0,23,0,0,0,6,0,27,0,1,0
30189,31767,2021-06-24T13:18:17.2418128Z,2021,31,11,28,9,0,1ro,1,0,22,0,0,20,3,0,30,0,0,0
30189,31768,2021-06-24T13:18:17.2428138Z,2021,22,7,18,12,0,2do,0,0,10,0,0,15,4,0,22,0,0,0
30189,31769,2021-06-24T13:18:17.2428138Z,2021,29,5,27,11,0,3ro,1,1,18,0,0,24,2,0,28,0,0,0
30189,31770,2021-06-24T13:18:17.2428138Z,2021,29,4,26,15,0,4to,0,0,14,0,0,25,3,0,29,0,0,0
30189,31771,2021-06-24T13:18:17.2428138Z,2021,22,9,21,12,0,5to,2,0,10,0,0,13,1,0,20,0,0,0
30189,31772,2021-06-24T13:18:17.2428138Z,2021,22,9,18,9,0,K,0,1,13,0,0,13,4,0,22,0,0,0
30189,31773,2021-06-24T13:18:17.2438147Z,2021,22,22,19,5,0,Sin Grado,2,0,17,0,0,0,3,0,20,0,0,0
30189,7770,2020-11-18T16:21:47.9209854Z,2020,25,9,20,14,0,1ro,1,0,11,0,0,16,5,0,23,0,0,1
30189,7771,2020-11-18T16:21:47.9209854Z,2020,28,5,25,11,0,2do,0,0,17,0,0,23,3,0,28,0,0,0
30189,7772,2020-11-18T16:21:47.9209854Z,2020,29,6,26,16,0,3ro,0,0,13,0,0,23,3,0,29,0,0,0
30189,7773,2020-11-18T16:21:47.9219863Z,2020,21,8,18,11,0,4to,2,0,10,0,0,13,3,0,19,0,0,0
30189,7774,2020-11-18T16:21:47.9219863Z,2020,16,7,14,7,0,5to,1,0,9,0,0,9,2,0,15,0,0,0
30189,7775,2020-11-18T16:21:47.9219863Z,2020,24,6,19,7,0,K,0,0,17,0,0,18,5,0,24,0,0,0
30189,7776,2020-11-18T16:21:47.9219863Z,2020,31,30,25,6,0,Sin Grado,2,0,25,0,0,1,6,0,29,0,1,0
23655,1391,2020-11-18T16:20:45.9086361Z,2019,28,7,24,17,0,1ro,1,0,11,0,0,21,4,0,27,0,1,0
23655,1392,2020-11-18T16:20:45.9086361Z,2019,13,3,11,8,0,2do,0,1,5,0,0,10,2,0,13,0,0,0
23655,1393,2020-11-18T16:20:45.9086361Z,2019,20,10,18,8,0,3ro,1,0,12,0,0,10,2,0,19,0,0,0
23655,1394,2020-11-18T16:20:45.9096374Z,2019,21,6,19,9,0,4to,0,0,12,0,0,15,2,0,21,0,0,0
23655,1395,2020-11-18T16:20:45.9096374Z,2019,23,12,19,12,0,5to,0,0,11,0,0,11,4,0,23,0,0,0
23655,1396,2020-11-18T16:20:45.9096374Z,2019,26,11,20,14,0,6to,0,0,12,0,0,15,6,0,26,0,0,0
23655,1397,2020-11-18T16:20:45.9106374Z,2019,24,4,21,10,0,K,0,0,14,0,0,20,3,0,24,0,0,0
23655,1398,2020-11-18T16:20:45.9106374Z,2019,70,12,55,35,0,PK,2,1,35,0,0,58,15,0,68,0,0,0
23655,31392,2021-06-24T13:18:14.6809759Z,2021,19,8,18,9,0,1ro,0,0,10,0,0,11,1,0,19,0,0,0
23655,31393,2021-06-24T13:18:14.6809759Z,2021,26,7,23,12,0,2do,1,0,14,0,0,19,3,0,25,0,0,0
23655,31394,2021-06-24T13:18:14.6809759Z,2021,18,6,14,10,0,3ro,1,0,8,0,0,12,4,0,17,0,0,0
23655,31395,2021-06-24T13:18:14.6819782Z,2021,14,7,11,9,0,4to,0,0,5,0,0,7,3,0,14,0,0,0
23655,31396,2021-06-24T13:18:14.6819782Z,2021,10,3,9,4,0,5to,0,0,6,0,0,7,1,0,10,0,0,0
23655,31397,2021-06-24T13:18:14.6819782Z,2021,13,5,12,8,0,6to,0,0,5,0,0,8,1,0,13,0,0,0
23655,31398,2021-06-24T13:18:14.6829773Z,2021,40,12,29,19,0,K,0,0,21,0,0,28,11,0,40,0,0,0
23655,31399,2021-06-24T13:18:14.6829773Z,2021,25,2,18,13,0,PK,0,0,12,0,0,23,7,0,25,0,0,0
23655,7395,2020-11-18T16:21:45.3742907Z,2020,22,5,18,9,0,1ro,0,0,13,0,0,17,4,0,22,0,0,0
23655,7396,2020-11-18T16:21:45.3742907Z,2020,18,6,16,9,0,2do,1,0,9,0,0,12,2,0,17,0,0,0
23655,7397,2020-11-18T16:21:45.3742907Z,2020,15,6,11,8,0,3ro,0,1,7,0,0,9,4,0,15,0,0,0
23655,7398,2020-11-18T16:21:45.3752929Z,2020,12,4,11,4,0,4to,1,0,8,0,0,8,1,0,11,0,0,0
23655,7399,2020-11-18T16:21:45.3752929Z,2020,14,5,13,8,0,5to,0,0,6,0,0,9,1,0,14,0,0,0
23655,7400,2020-11-18T16:21:45.3752929Z,2020,10,6,10,4,0,6to,1,1,6,0,0,4,0,0,9,0,0,0
23655,7401,2020-11-18T16:21:45.743538Z,2020,24,10,23,10,0,K,1,0,14,0,0,14,1,0,23,0,0,0
23655,7402,2020-11-18T16:21:45.743538Z,2020,48,9,31,26,0,PK,2,0,22,0,0,39,17,0,46,0,0,0
27078,1605,2020-11-18T16:20:48.2451941Z,2019,30,11,26,12,0,1ro,0,1,18,0,1,19,4,0,30,0,0,0
27078,1606,2020-11-18T16:20:48.2451941Z,2019,33,10,23,18,0,2do,0,2,15,0,0,23,10,0,33,0,0,0
27078,1607,2020-11-18T16:20:48.246195Z,2019,38,18,31,18,0,3ro,1,3,20,0,0,20,7,0,37,0,0,0
27078,1608,2020-11-18T16:20:48.246195Z,2019,36,12,22,21,0,4to,0,1,15,0,1,24,14,0,36,0,0,0
27078,1609,2020-11-18T16:20:48.246195Z,2019,36,8,26,12,0,5to,0,0,24,0,0,28,10,0,36,0,0,0
27078,1610,2020-11-18T16:20:48.246195Z,2019,37,10,24,25,0,K,1,2,12,0,0,27,13,0,36,0,0,0
27078,1611,2020-11-18T16:20:48.247195Z,2019,2,2,1,0,0,Sin Grado,1,0,2,0,0,0,1,0,1,0,0,0
27078,31608,2021-06-24T13:18:16.064969Z,2021,36,6,29,23,0,1ro,0,1,13,0,0,30,7,0,36,0,0,0
27078,31609,2021-06-24T13:18:16.064969Z,2021,31,8,25,18,0,2do,1,4,13,0,0,23,6,0,30,0,0,0
27078,31610,2021-06-24T13:18:16.0659699Z,2021,25,12,23,10,0,3ro,0,2,15,0,0,13,2,0,25,0,0,0
27078,31611,2021-06-24T13:18:16.0659699Z,2021,32,10,26,19,0,4to,0,4,13,0,0,22,6,0,31,0,0,1
27078,31612,2021-06-24T13:18:16.0669704Z,2021,35,15,27,16,0,5to,1,2,19,0,0,20,8,0,34,0,0,0
27078,31613,2021-06-24T13:18:16.0669704Z,2021,22,5,18,8,0,K,0,0,14,0,0,17,4,0,21,0,0,1
27078,31614,2021-06-24T13:18:16.0669704Z,2021,1,1,0,1,0,Sin Grado,0,0,0,0,0,0,1,0,1,0,0,0
27078,7611,2020-11-18T16:21:47.1804917Z,2020,35,10,26,19,0,1ro,0,7,16,0,0,25,9,0,35,0,0,0
27078,7612,2020-11-18T16:21:47.1804917Z,2020,24,10,23,11,0,2do,1,3,13,0,0,14,1,0,23,0,0,0
27078,7613,2020-11-18T16:21:47.1804917Z,2020,29,10,21,17,0,3ro,0,4,12,0,0,19,8,0,29,0,0,0
27078,7614,2020-11-18T16:21:47.1804917Z,2020,39,19,31,19,0,4to,1,7,20,0,0,20,8,0,38,0,0,0
27078,7615,2020-11-18T16:21:47.1814925Z,2020,33,12,21,18,0,5to,0,0,15,0,0,21,12,0,33,0,0,0
27078,7616,2020-11-18T16:21:47.1814925Z,2020,33,7,27,23,0,K,0,6,10,0,0,26,6,0,33,0,0,0
27078,7617,2020-11-18T16:21:47.1814925Z,2020,1,1,1,1,0,Sin Grado,0,0,0,0,0,0,0,0,1,0,0,0
46821,3102,2020-11-18T16:21:01.0107056Z,2019,103,27,79,50,0,10mo,5,0,53,0,0,76,24,0,97,0,0,1
46821,3103,2020-11-18T16:21:01.0107056Z,2019,123,33,91,67,0,11mo,2,0,56,0,0,90,32,0,120,0,1,1
46821,3104,2020-11-18T16:21:01.0107056Z,2019,109,0,71,57,0,12mo,0,0,52,0,0,109,38,0,109,0,0,0
46821,3105,2020-11-18T16:21:01.0107056Z,2019,148,52,121,74,0,9no,5,1,74,0,0,96,27,0,143,0,2,0
46821,33114,2021-06-24T13:18:30.3081882Z,2021,137,43,109,74,0,10mo,3,0,63,0,0,94,28,0,132,0,1,2
46821,33115,2021-06-24T13:18:30.3081882Z,2021,123,42,110,61,0,11mo,5,0,62,0,0,81,13,0,118,0,3,0
46821,33116,2021-06-24T13:18:30.3081882Z,2021,91,20,72,47,0,12mo,4,0,44,0,0,71,19,0,86,0,0,1
46821,33117,2021-06-24T13:18:30.3081882Z,2021,150,36,112,71,0,9no,5,1,79,0,0,114,38,0,145,0,2,0
46821,33118,2021-06-24T13:18:30.3091887Z,2021,15,15,12,5,0,Sin Grado,3,0,10,0,0,0,3,0,12,0,0,0
46821,9116,2020-11-18T16:21:56.1264605Z,2020,132,45,103,67,0,10mo,5,1,65,0,0,87,29,0,126,0,3,1
46821,9117,2020-11-18T16:21:56.1274614Z,2020,92,23,69,48,0,11mo,4,0,44,0,0,69,23,0,87,0,0,1
46821,9118,2020-11-18T16:21:56.1274614Z,2020,107,27,76,68,0,12mo,2,1,39,0,0,80,31,0,105,0,0,0
46821,9119,2020-11-18T16:21:56.1274614Z,2020,136,48,110,79,0,9no,3,0,57,0,0,88,26,0,131,0,1,2
57331,33969,2021-06-24T13:18:36.6617443Z,2021,33,7,25,15,0,1ro,0,0,18,0,0,26,8,0,33,0,0,0
57331,33970,2021-06-24T13:18:36.6627448Z,2021,40,16,28,21,0,2do,0,0,19,0,0,24,12,0,40,0,0,0
57331,33971,2021-06-24T13:18:36.6627448Z,2021,34,10,31,23,0,3ro,1,0,11,0,0,24,3,0,33,1,0,0
57331,33972,2021-06-24T13:18:36.6627448Z,2021,33,9,21,18,0,4to,0,0,15,0,0,24,12,0,33,0,0,0
57331,33973,2021-06-24T13:18:36.6637462Z,2021,35,11,25,19,0,5to,0,0,16,0,0,24,10,0,35,0,0,0
57331,33974,2021-06-24T13:18:36.6637462Z,2021,22,6,12,12,0,K,0,0,10,0,0,16,10,0,22,0,0,0
57331,33975,2021-06-24T13:18:36.6637462Z,2021,3,3,2,1,0,Sin Grado,0,0,2,0,0,0,1,0,3,0,0,0
57331,3945,2020-11-18T16:21:06.8526022Z,2019,50,17,39,30,0,1ro,1,0,20,0,0,33,11,0,49,1,0,0
57331,3946,2020-11-18T16:21:06.8526022Z,2019,47,17,27,23,0,2do,0,0,24,0,0,30,20,0,47,0,0,0
57331,3947,2020-11-18T16:21:06.8536026Z,2019,40,12,27,23,0,3ro,0,0,17,0,0,28,13,0,40,0,0,0
57331,3948,2020-11-18T16:21:06.8536026Z,2019,43,12,31,27,0,4to,0,0,16,0,0,31,12,0,42,0,1,1
57331,3949,2020-11-18T16:21:06.8536026Z,2019,50,14,31,31,0,5to,0,1,19,0,0,36,19,0,50,1,0,0
57331,3950,2020-11-18T16:21:06.8536026Z,2019,50,17,31,21,0,K,0,0,29,0,0,33,19,0,50,0,0,0
57331,3951,2020-11-18T16:21:06.8546035Z,2019,7,5,6,1,0,Sin Grado,0,0,6,0,0,2,1,0,7,0,0,0
57331,9962,2020-11-18T16:22:01.5540808Z,2020,51,18,33,23,0,1ro,0,0,28,0,0,33,18,0,51,0,0,0
57331,9963,2020-11-18T16:22:01.5540808Z,2020,48,16,37,28,0,2do,2,2,20,0,0,32,11,0,46,1,0,0
57331,9964,2020-11-18T16:22:01.5550808Z,2020,47,17,26,22,0,3ro,0,1,25,0,0,30,21,0,47,0,0,0
57331,9965,2020-11-18T16:22:01.5550808Z,2020,43,15,30,24,0,4to,0,1,19,0,0,28,13,0,43,0,0,0
57331,9966,2020-11-18T16:22:01.5550808Z,2020,43,10,31,26,0,5to,0,1,17,0,0,33,12,0,42,0,1,1
57331,9967,2020-11-18T16:22:01.5560817Z,2020,45,8,23,23,0,K,1,0,22,0,0,37,22,0,44,0,0,0
57331,9968,2020-11-18T16:22:01.5560817Z,2020,4,4,3,0,0,Sin Grado,0,0,4,0,0,0,1,0,4,0,0,0
62901,10519,2020-11-18T16:22:04.9223245Z,2020,88,21,76,52,0,10mo,0,0,36,0,0,67,12,0,88,0,0,0
62901,10520,2020-11-18T16:22:04.9223245Z,2020,56,22,41,23,0,11mo,0,0,33,0,0,34,15,0,56,0,0,0
62901,10521,2020-11-18T16:22:04.9223245Z,2020,62,18,46,33,0,12mo,0,0,29,0,0,44,16,0,62,0,0,0
62901,10522,2020-11-18T16:22:04.9223245Z,2020,46,13,34,20,0,1ro,0,3,26,0,0,33,12,0,46,0,0,0
62901,10523,2020-11-18T16:22:04.9233245Z,2020,54,14,42,30,0,2do,0,1,24,0,0,40,12,0,54,0,0,0
62901,10524,2020-11-18T16:22:04.9233245Z,2020,43,15,34,22,0,3ro,1,0,21,0,0,28,9,0,42,0,0,0
62901,10525,2020-11-18T16:22:04.9233245Z,2020,48,17,38,25,0,4to,0,0,23,0,0,31,10,0,48,0,0,0
62901,10526,2020-11-18T16:22:04.9233245Z,2020,65,16,50,38,0,5to,2,0,27,0,0,49,15,0,62,0,0,1
62901,10527,2020-11-18T16:22:04.9233245Z,2020,74,27,55,36,0,6to,1,0,38,0,0,47,19,0,73,0,0,0
62901,10528,2020-11-18T16:22:04.9243254Z,2020,74,24,52,31,0,7mo,0,1,43,0,0,50,22,0,74,0,0,0
62901,10529,2020-11-18T16:22:04.9243254Z,2020,82,25,71,38,0,8vo,0,0,44,0,0,57,11,0,82,0,0,0
62901,10530,2020-11-18T16:22:04.9243254Z,2020,87,21,59,41,0,9no,0,0,46,0,0,66,28,0,87,0,0,0
62901,10531,2020-11-18T16:22:04.9243254Z,2020,43,4,34,24,0,K,0,3,19,0,0,39,9,0,43,0,0,0
62901,10532,2020-11-18T16:22:04.9243254Z,2020,51,6,24,22,0,PK,0,0,29,0,0,45,27,0,51,0,0,0
62901,10533,2020-11-18T16:22:04.9243254Z,2020,27,27,25,6,0,Sin Grado,0,0,21,0,0,0,2,0,27,0,0,0
62901,34532,2021-06-24T13:18:40.2182945Z,2021,86,25,68,39,0,10mo,0,0,47,0,0,61,18,0,86,0,0,0
62901,34533,2021-06-24T13:18:40.2192955Z,2021,85,21,75,53,0,11mo,1,0,32,0,0,64,10,0,84,0,0,0
62901,34534,2021-06-24T13:18:40.2192955Z,2021,56,21,46,22,0,12mo,0,0,34,0,0,35,10,0,56,0,0,0
62901,34535,2021-06-24T13:18:40.2192955Z,2021,44,9,33,25,0,1ro,0,0,19,0,0,35,11,0,44,0,0,0
62901,34536,2021-06-24T13:18:40.2192955Z,2021,41,11,33,18,0,2do,0,0,23,0,0,30,8,0,41,0,0,0
62901,34537,2021-06-24T13:18:40.220296Z,2021,53,16,40,28,0,3ro,0,0,25,0,0,37,13,0,53,0,0,0
62901,34538,2021-06-24T13:18:40.220296Z,2021,47,17,39,24,0,4to,2,0,23,0,0,30,8,0,45,0,0,0
62901,34539,2021-06-24T13:18:40.220296Z,2021,54,20,43,29,0,5to,0,0,25,0,0,34,11,0,54,0,0,0
62901,34540,2021-06-24T13:18:40.220296Z,2021,85,29,69,50,0,6to,3,0,35,0,0,56,16,0,81,0,1,1
62901,34541,2021-06-24T13:18:40.2212969Z,2021,80,32,69,35,0,7mo,0,0,45,0,0,48,11,0,80,0,0,0
62901,34542,2021-06-24T13:18:40.2212969Z,2021,75,23,59,33,0,8vo,1,1,42,0,0,52,16,0,74,0,0,0
62901,34543,2021-06-24T13:18:40.2212969Z,2021,86,29,76,41,0,9no,0,0,45,0,0,57,10,0,86,0,0,0
62901,34544,2021-06-24T13:18:40.2212969Z,2021,37,8,28,19,0,K,0,0,18,0,0,29,9,0,37,0,0,0
62901,34545,2021-06-24T13:18:40.2222974Z,2021,59,4,44,27,0,PK,0,0,32,0,0,55,15,0,59,0,0,0
62901,34546,2021-06-24T13:18:40.2222974Z,2021,21,21,21,4,0,Sin Grado,0,0,17,0,0,0,0,0,21,0,0,0
62901,4508,2020-11-18T16:21:10.8352573Z,2019,63,23,48,27,0,10mo,0,0,36,0,0,40,15,0,63,0,0,0
62901,4509,2020-11-18T16:21:10.8352573Z,2019,69,20,48,33,0,11mo,0,0,36,0,0,49,21,0,69,0,0,0
62901,4510,2020-11-18T16:21:10.8362577Z,2019,57,0,41,31,0,12mo,0,0,26,0,0,57,16,0,57,0,0,0
62901,4511,2020-11-18T16:21:10.8362577Z,2019,51,13,35,25,0,1ro,0,0,26,0,0,38,16,0,51,0,0,0
62901,4512,2020-11-18T16:21:10.8362577Z,2019,48,22,36,19,0,2do,0,1,29,0,0,26,12,0,48,0,0,0
62901,4513,2020-11-18T16:21:10.8362577Z,2019,48,18,35,23,0,3ro,0,0,25,0,0,30,13,0,48,0,0,0
62901,4514,2020-11-18T16:21:10.8372577Z,2019,60,13,43,36,0,4to,3,0,24,0,0,47,17,0,56,0,0,1
62901,4515,2020-11-18T16:21:10.8372577Z,2019,67,26,50,28,0,5to,1,0,39,0,0,41,17,0,66,0,0,0
62901,4516,2020-11-18T16:21:10.8372577Z,2019,62,17,47,30,0,6to,0,1,32,0,0,45,15,0,62,0,0,0
62901,4517,2020-11-18T16:21:10.8382582Z,2019,80,23,73,37,0,7mo,0,0,43,0,0,57,7,0,80,0,0,0
62901,4518,2020-11-18T16:21:10.8382582Z,2019,89,16,66,46,0,8vo,1,0,43,0,0,73,23,0,88,0,0,0
62901,4519,2020-11-18T16:21:10.8382582Z,2019,110,30,90,61,0,9no,1,1,49,0,0,80,20,0,109,0,0,0
62901,4520,2020-11-18T16:21:10.8382582Z,2019,43,9,31,22,0,K,0,3,21,0,0,34,12,0,43,0,0,0
62901,4521,2020-11-18T16:21:10.8392591Z,2019,54,4,34,29,0,PK,0,2,25,0,0,50,20,0,54,0,0,0
62901,4522,2020-11-18T16:21:10.8392591Z,2019,29,27,28,6,0,Sin Grado,0,0,23,0,0,2,1,0,29,0,0,0
70458,11016,2020-11-18T16:22:07.6131168Z,2020,52,20,40,32,0,1ro,0,0,20,0,0,32,12,0,52,0,0,0
70458,11017,2020-11-18T16:22:07.6131168Z,2020,41,21,30,13,0,2do,0,0,28,0,0,20,11,0,41,0,0,0
70458,11018,2020-11-18T16:22:07.6131168Z,2020,64,24,47,34,0,3ro,0,0,30,0,0,40,17,0,64,0,0,0
70458,11019,2020-11-18T16:22:07.6141177Z,2020,49,15,38,19,0,4to,0,0,30,0,0,34,11,0,49,0,0,0
70458,11020,2020-11-18T16:22:07.6141177Z,2020,48,19,38,30,0,5to,2,0,18,0,0,29,10,0,46,0,0,0
70458,11021,2020-11-18T16:22:07.6141177Z,2020,44,15,38,14,0,K,0,0,30,0,0,29,6,0,44,0,0,0
70458,11022,2020-11-18T16:22:07.6141177Z,2020,37,37,22,11,0,Sin Grado,0,0,26,0,0,0,15,0,37,0,0,0
70458,35037,2021-06-24T13:18:43.7087979Z,2021,46,17,41,20,0,1ro,0,0,26,0,0,29,5,0,46,0,0,0
70458,35038,2021-06-24T13:18:43.7087979Z,2021,55,24,45,34,0,2do,0,0,21,0,0,31,10,0,55,0,0,0
70458,35039,2021-06-24T13:18:43.7087979Z,2021,39,20,35,11,0,3ro,0,1,28,0,0,19,4,0,39,0,0,0
70458,35040,2021-06-24T13:18:43.7087979Z,2021,62,26,51,31,0,4to,0,0,31,0,0,36,11,0,62,0,0,0
70458,35041,2021-06-24T13:18:43.7097988Z,2021,51,15,40,20,0,5to,0,0,31,0,0,36,11,0,51,0,0,0
70458,35042,2021-06-24T13:18:43.7097988Z,2021,43,13,38,19,0,K,0,1,24,0,0,30,5,0,43,0,0,0
70458,35043,2021-06-24T13:18:43.7097988Z,2021,40,40,28,10,0,Sin Grado,0,1,30,0,0,0,12,0,40,0,0,0
70458,5007,2020-11-18T16:21:13.4169805Z,2019,60,33,42,23,0,1ro,0,0,37,0,0,27,18,0,60,0,0,0
70458,5008,2020-11-18T16:21:13.4179819Z,2019,64,22,45,33,0,2do,0,0,31,0,0,42,19,0,64,0,0,0
70458,5009,2020-11-18T16:21:13.4179819Z,2019,48,17,36,20,0,3ro,0,0,28,0,0,31,12,0,48,0,0,0
70458,5010,2020-11-18T16:21:13.4179819Z,2019,62,28,45,37,0,4to,2,0,25,0,0,34,17,0,60,0,0,0
70458,5011,2020-11-18T16:21:13.4179819Z,2019,57,24,45,34,0,5to,2,0,23,0,0,33,12,0,55,1,2,0
70458,5012,2020-11-18T16:21:13.4189819Z,2019,1,0,1,0,0,6to,0,0,1,0,0,1,0,0,1,0,1,0
70458,5013,2020-11-18T16:21:13.4189819Z,2019,41,15,21,27,0,K,0,0,14,0,0,26,20,0,41,0,0,0
70458,5014,2020-11-18T16:21:13.4189819Z,2019,32,30,23,6,0,Sin Grado,0,0,26,0,0,2,9,0,32,0,0,0
20479,30978,2021-06-24T13:18:11.8169227Z,2021,25,6,20,15,0,1ro,0,0,10,0,0,19,5,0,25,0,0,0
20479,30979,2021-06-24T13:18:11.8169227Z,2021,20,3,14,7,0,2do,0,0,13,0,0,17,6,0,20,0,0,0
20479,30980,2021-06-24T13:18:11.8179236Z,2021,20,8,17,5,0,3ro,0,0,15,0,0,12,3,0,20,0,0,0
20479,30981,2021-06-24T13:18:11.8179236Z,2021,25,4,21,12,0,4to,0,0,13,0,0,21,4,0,25,0,0,0
20479,30982,2021-06-24T13:18:11.8179236Z,2021,10,5,7,4,0,5to,0,0,6,0,0,5,3,0,10,0,0,0
20479,30983,2021-06-24T13:18:11.8179236Z,2021,5,1,4,2,0,6to,0,0,3,0,0,4,1,0,5,0,0,0
20479,30984,2021-06-24T13:18:11.8189245Z,2021,28,4,20,14,0,K,0,0,14,0,0,24,8,0,28,0,0,0
20479,30985,2021-06-24T13:18:11.8189245Z,2021,25,1,17,16,0,PK,0,0,9,0,0,24,8,0,25,0,0,0
20479,6981,2020-11-18T16:21:42.5994373Z,2020,18,4,13,8,0,1ro,0,0,10,0,0,14,5,0,18,0,0,0
20479,6982,2020-11-18T16:21:42.5994373Z,2020,21,9,18,7,0,2do,0,0,14,0,0,12,3,0,21,0,0,0
20479,6983,2020-11-18T16:21:42.5994373Z,2020,25,2,18,11,0,3ro,0,0,14,0,0,23,7,0,25,0,0,0
20479,6984,2020-11-18T16:21:42.5994373Z,2020,11,5,6,4,0,4to,0,0,7,0,0,6,5,0,11,0,0,0
20479,6985,2020-11-18T16:21:42.5994373Z,2020,7,3,5,2,0,5to,0,0,5,0,0,4,2,0,7,0,0,0
20479,6986,2020-11-18T16:21:42.6004377Z,2020,8,1,5,5,0,6to,0,0,3,0,0,7,3,0,8,0,0,0
20479,6987,2020-11-18T16:21:42.6004377Z,2020,20,3,12,12,0,K,0,0,8,0,0,17,8,0,20,0,0,0
20479,6988,2020-11-18T16:21:42.6004377Z,2020,27,2,18,16,0,PK,0,0,11,0,0,25,9,0,27,0,0,0
20479,980,2020-11-18T16:20:43.3889538Z,2019,18,6,10,5,0,1ro,0,0,13,0,0,12,8,0,18,0,0,0
20479,981,2020-11-18T16:20:43.3899547Z,2019,34,4,22,14,0,2do,0,0,20,0,0,30,12,0,34,0,0,0
20479,982,2020-11-18T16:20:43.3899547Z,2019,16,8,9,6,0,3ro,0,0,10,0,0,8,7,0,16,0,0,0
20479,983,2020-11-18T16:20:43.3899547Z,2019,8,2,5,4,0,4to,0,0,4,0,0,6,3,0,8,0,0,0
20479,984,2020-11-18T16:20:43.3899547Z,2019,20,3,17,10,0,5to,0,0,10,0,0,17,3,0,20,0,0,0
20479,985,2020-11-18T16:20:43.3899547Z,2019,27,6,16,13,0,K,1,0,14,0,0,21,11,0,26,0,0,0
20479,986,2020-11-18T16:20:43.3909551Z,2019,28,1,13,18,0,PK,0,0,10,0,0,27,15,0,28,0,0,0
13359,30512,2021-06-24T13:18:10.3858965Z,2021,20,2,18,13,0,1ro,0,0,7,0,0,18,2,0,20,0,0,0
13359,30513,2021-06-24T13:18:10.3858965Z,2021,22,3,20,9,0,2do,0,0,13,0,0,19,2,0,22,0,0,0
13359,30514,2021-06-24T13:18:10.3858965Z,2021,23,8,20,14,0,3ro,1,0,9,0,0,15,3,0,22,0,0,0
13359,30515,2021-06-24T13:18:10.3858965Z,2021,38,9,34,18,0,4to,0,0,20,0,0,29,4,0,38,0,0,0
13359,30516,2021-06-24T13:18:10.3868975Z,2021,31,11,29,15,0,5to,0,0,16,0,0,20,2,0,31,0,0,0
13359,30517,2021-06-24T13:18:10.3868975Z,2021,38,10,30,17,0,6to,0,0,21,0,0,28,8,0,38,0,0,0
13359,30518,2021-06-24T13:18:10.3868975Z,2021,47,13,41,20,0,7mo,0,0,27,0,0,34,6,0,47,0,0,0
13359,30519,2021-06-24T13:18:10.3868975Z,2021,41,7,36,28,0,8vo,0,1,13,0,0,34,5,0,41,0,0,0
13359,30520,2021-06-24T13:18:10.3878993Z,2021,22,1,21,11,0,K,5,0,11,0,0,21,1,0,17,0,0,0
13359,515,2020-11-18T16:20:40.7652065Z,2019,23,8,19,12,0,1ro,1,0,11,0,0,15,4,0,22,0,0,0
13359,516,2020-11-18T16:20:40.7652065Z,2019,32,9,28,15,0,2do,1,0,17,0,0,23,4,0,31,0,0,0
13359,517,2020-11-18T16:20:40.7652065Z,2019,29,8,27,16,0,3ro,1,1,13,0,0,21,2,0,28,0,0,0
13359,518,2020-11-18T16:20:40.7652065Z,2019,34,11,29,15,0,4to,0,0,19,0,0,23,5,0,34,0,0,0
13359,519,2020-11-18T16:20:40.7662074Z,2019,39,10,29,15,0,5to,0,0,24,0,0,29,10,0,39,0,0,0
13359,520,2020-11-18T16:20:40.7662074Z,2019,41,11,33,23,0,6to,0,1,18,0,0,30,8,0,41,0,0,0
13359,521,2020-11-18T16:20:40.7662074Z,2019,34,7,22,15,0,7mo,0,0,19,0,0,27,12,0,34,0,0,0
13359,522,2020-11-18T16:20:40.7662074Z,2019,34,10,24,16,0,8vo,0,1,18,0,0,24,10,0,34,0,0,0
13359,523,2020-11-18T16:20:40.7662074Z,2019,16,1,14,9,0,K,0,0,7,0,0,15,2,0,16,0,0,0
13359,6514,2020-11-18T16:21:40.3519422Z,2020,18,1,17,10,0,1ro,0,0,8,0,0,17,1,0,18,0,0,0
13359,6515,2020-11-18T16:21:40.3519422Z,2020,21,11,16,11,0,2do,1,0,10,0,0,10,5,0,20,0,0,0
13359,6516,2020-11-18T16:21:40.3519422Z,2020,32,7,23,17,0,3ro,1,0,15,0,0,25,9,0,31,0,0,0
13359,6517,2020-11-18T16:21:40.3519422Z,2020,31,11,25,15,0,4to,0,0,16,0,0,20,6,0,31,0,0,0
13359,6518,2020-11-18T16:21:40.3519422Z,2020,30,9,22,13,0,5to,0,0,17,0,0,21,8,0,30,0,0,0
13359,6519,2020-11-18T16:21:40.3529422Z,2020,50,13,33,21,0,6to,0,0,29,0,0,37,17,0,50,0,0,0
13359,6520,2020-11-18T16:21:40.3529422Z,2020,41,11,33,24,0,7mo,0,1,17,0,0,30,8,0,41,0,0,0
13359,6521,2020-11-18T16:21:40.3529422Z,2020,33,8,20,15,0,8vo,0,1,18,0,0,25,13,0,33,0,0,0
13359,6522,2020-11-18T16:21:40.3529422Z,2020,19,0,16,13,0,K,0,0,6,0,0,19,3,0,19,0,0,0
64279,10640,2020-11-18T16:22:05.3486089Z,2020,16,4,16,10,0,1ro,0,0,6,0,0,12,0,0,16,0,0,0
64279,10641,2020-11-18T16:22:05.3486089Z,2020,20,7,18,8,0,2do,3,0,12,0,0,13,2,1,16,0,0,0
64279,10642,2020-11-18T16:22:05.3496093Z,2020,19,13,17,8,0,3ro,0,0,11,0,0,6,2,0,19,0,0,0
64279,10643,2020-11-18T16:22:05.3496093Z,2020,15,11,14,7,0,4to,3,0,8,0,0,4,1,0,12,0,0,0
64279,10644,2020-11-18T16:22:05.3496093Z,2020,21,14,20,10,0,5to,4,0,11,0,0,7,1,0,17,0,0,0
64279,10645,2020-11-18T16:22:05.3496093Z,2020,30,17,30,11,0,6to,1,1,19,0,0,13,0,0,29,1,0,0
64279,10646,2020-11-18T16:22:05.3496093Z,2020,34,21,29,14,0,7mo,2,0,20,0,0,13,5,0,32,0,1,0
64279,10647,2020-11-18T16:22:05.3506106Z,2020,16,12,12,6,0,8vo,1,0,10,0,0,4,4,0,15,0,0,0
64279,10648,2020-11-18T16:22:05.3506106Z,2020,21,12,20,8,0,K,0,1,13,0,0,9,1,0,21,0,0,0
64279,10649,2020-11-18T16:22:05.3506106Z,2020,88,81,81,30,0,Sin Grado,4,2,58,0,0,7,7,0,84,0,1,0
64279,34657,2021-06-24T13:18:41.1009279Z,2021,22,13,19,8,0,1ro,0,0,14,0,0,9,3,0,22,0,0,0
64279,34658,2021-06-24T13:18:41.1009279Z,2021,14,5,14,7,0,2do,0,0,7,0,0,9,0,0,14,0,0,0
64279,34659,2021-06-24T13:18:41.1019284Z,2021,19,8,15,7,0,3ro,3,0,12,0,0,11,4,1,15,0,0,0
64279,34660,2021-06-24T13:18:41.1019284Z,2021,21,12,19,10,0,4to,1,0,11,0,0,9,2,0,20,0,0,0
64279,34661,2021-06-24T13:18:41.1019284Z,2021,13,10,12,6,0,5to,3,0,7,0,0,3,1,0,10,0,0,0
64279,34662,2021-06-24T13:18:41.1019284Z,2021,30,18,24,17,0,6to,4,0,13,0,0,12,6,0,26,0,1,0
64279,34663,2021-06-24T13:18:41.1019284Z,2021,36,24,33,12,0,7mo,2,0,24,0,0,12,3,0,34,1,0,0
64279,34664,2021-06-24T13:18:41.1029289Z,2021,32,20,25,14,0,8vo,2,0,18,0,0,12,7,0,30,0,1,0
64279,34665,2021-06-24T13:18:41.1029289Z,2021,17,6,16,4,0,K,1,0,13,0,0,11,1,0,16,0,0,0
64279,34666,2021-06-24T13:18:41.1029289Z,2021,77,73,69,27,0,Sin Grado,3,0,50,0,0,4,8,0,73,0,0,1
64279,4628,2020-11-18T16:21:11.2575376Z,2019,22,8,20,9,0,1ro,3,0,13,0,0,14,2,1,18,0,0,0
64279,4629,2020-11-18T16:21:11.2575376Z,2019,21,14,19,7,0,2do,1,0,14,0,0,7,2,0,20,0,0,0
64279,4630,2020-11-18T16:21:11.2575376Z,2019,13,7,11,6,0,3ro,2,0,7,0,0,6,2,0,11,0,0,0
64279,4631,2020-11-18T16:21:11.2575376Z,2019,14,9,13,10,0,4to,4,0,4,0,0,5,1,0,10,0,0,0
64279,4632,2020-11-18T16:21:11.2575376Z,2019,18,8,15,8,0,5to,1,1,10,0,0,10,3,0,17,1,0,0
64279,4633,2020-11-18T16:21:11.2585389Z,2019,24,16,20,11,0,6to,2,0,13,0,0,8,4,0,22,0,0,0
64279,4634,2020-11-18T16:21:11.2585389Z,2019,18,12,12,6,0,7mo,0,0,12,0,0,6,6,0,18,0,0,0
64279,4635,2020-11-18T16:21:11.2585389Z,2019,12,9,12,1,0,8vo,0,0,11,0,0,3,0,0,12,0,0,0
64279,4636,2020-11-18T16:21:11.2585389Z,2019,8,2,7,6,0,K,0,0,2,0,0,6,1,0,8,0,0,0
64279,4637,2020-11-18T16:21:11.2595398Z,2019,99,84,89,33,0,Sin Grado,5,2,66,0,0,15,10,0,94,0,1,0
77461,11688,2020-11-18T16:22:11.7448758Z,2020,65,28,52,31,0,1ro,0,0,34,0,0,37,13,1,64,0,0,0
77461,11689,2020-11-18T16:22:11.7448758Z,2020,58,14,46,31,0,2do,2,0,27,0,0,44,12,0,56,0,0,0
77461,11690,2020-11-18T16:22:11.7458762Z,2020,71,23,52,39,0,3ro,0,0,32,0,0,48,19,0,71,0,0,0
77461,11691,2020-11-18T16:22:11.7458762Z,2020,89,24,69,47,0,4to,0,0,42,0,0,65,20,0,89,1,0,0
77461,11692,2020-11-18T16:22:11.7458762Z,2020,70,15,48,40,0,5to,0,0,30,0,0,55,22,0,70,0,0,0
77461,11693,2020-11-18T16:22:11.7468762Z,2020,116,32,84,65,0,6to,4,0,51,0,0,84,32,0,112,0,0,0
77461,11694,2020-11-18T16:22:11.7468762Z,2020,124,30,84,70,0,7mo,1,0,54,0,0,94,40,0,123,1,0,0
77461,11695,2020-11-18T16:22:11.7468762Z,2020,106,26,79,65,0,8vo,1,0,41,0,0,80,27,0,105,0,0,0
77461,11696,2020-11-18T16:22:11.7468762Z,2020,57,9,41,29,0,K,1,0,28,0,0,48,16,0,56,0,0,0
77461,11697,2020-11-18T16:22:11.7478776Z,2020,6,6,4,2,0,Sin Grado,0,0,4,0,0,0,2,0,6,0,0,0
77461,35711,2021-06-24T13:18:47.7276792Z,2021,56,13,45,27,0,1ro,1,1,29,0,0,43,11,0,55,0,0,0
77461,35712,2021-06-24T13:18:47.7276792Z,2021,59,28,47,30,0,2do,0,0,29,0,0,31,12,0,59,0,0,0
77461,35713,2021-06-24T13:18:47.7276792Z,2021,62,17,52,32,0,3ro,1,0,30,0,0,45,10,0,61,0,0,0
77461,35714,2021-06-24T13:18:47.7276792Z,2021,73,24,56,39,0,4to,0,0,34,0,0,49,17,0,73,0,0,0
77461,35715,2021-06-24T13:18:47.7286801Z,2021,83,25,70,45,0,5to,0,0,38,0,0,58,13,0,83,1,0,0
77461,35716,2021-06-24T13:18:47.7286801Z,2021,112,21,81,65,0,6to,1,2,47,0,0,91,31,0,111,1,0,0
77461,35717,2021-06-24T13:18:47.7286801Z,2021,113,32,81,60,0,7mo,0,1,53,0,0,81,32,0,113,0,0,0
77461,35718,2021-06-24T13:18:47.7286801Z,2021,114,26,90,65,0,8vo,1,1,49,0,0,88,24,0,113,1,0,0
77461,35719,2021-06-24T13:18:47.7286801Z,2021,51,16,48,25,0,K,1,0,26,0,0,35,3,0,50,0,0,0
77461,5681,2020-11-18T16:21:16.6301222Z,2019,56,16,44,29,0,1ro,2,1,27,0,0,40,12,0,54,0,0,0
77461,5682,2020-11-18T16:21:16.6301222Z,2019,71,26,50,40,0,2do,0,1,31,0,0,45,21,0,71,0,0,0
77461,5683,2020-11-18T16:21:16.6311218Z,2019,82,26,61,41,0,3ro,1,0,41,0,0,56,21,0,81,0,0,0
77461,5684,2020-11-18T16:21:16.6311218Z,2019,74,17,54,37,0,4to,0,2,37,0,0,57,20,0,74,0,0,0
77461,5685,2020-11-18T16:21:16.6311218Z,2019,76,23,53,40,0,5to,3,0,36,0,0,53,23,0,73,0,0,0
77461,5686,2020-11-18T16:21:16.6311218Z,2019,127,31,99,69,0,6to,1,1,58,0,0,96,28,0,126,0,0,0
77461,5687,2020-11-18T16:21:16.6321231Z,2019,114,27,82,66,0,7mo,1,0,48,0,0,87,32,0,113,0,0,0
77461,5688,2020-11-18T16:21:16.6321231Z,2019,123,22,85,70,0,8vo,1,1,53,0,0,101,38,0,122,1,0,0
77461,5689,2020-11-18T16:21:16.6321231Z,2019,44,19,35,27,0,K,0,0,17,0,0,25,9,1,43,0,0,0
77461,5690,2020-11-18T16:21:16.6331231Z,2019,10,10,7,4,0,Sin Grado,0,0,6,0,0,0,3,0,10,0,0,0
28456,1705,2020-11-18T16:20:48.8576004Z,2019,28,8,25,13,0,1ro,0,0,15,0,0,20,3,0,28,0,0,0
28456,1706,2020-11-18T16:20:48.8586009Z,2019,19,4,14,13,0,2do,0,0,6,0,0,15,5,0,19,0,0,0
28456,1707,2020-11-18T16:20:48.8586009Z,2019,24,4,18,8,0,3ro,0,0,16,0,0,20,6,0,24,0,0,0
28456,1708,2020-11-18T16:20:48.8586009Z,2019,31,9,25,17,0,4to,0,0,14,0,0,22,6,0,31,0,0,0
28456,1709,2020-11-18T16:20:48.8586009Z,2019,43,9,35,20,0,5to,1,0,23,0,0,34,8,0,42,0,0,0
28456,1710,2020-11-18T16:20:48.8586009Z,2019,92,24,75,50,0,6to,0,0,42,0,0,68,17,0,92,0,0,0
28456,1711,2020-11-18T16:20:48.8596013Z,2019,101,22,67,50,0,7mo,1,0,51,0,0,79,34,0,99,0,0,1
28456,1712,2020-11-18T16:20:48.8596013Z,2019,119,30,92,58,0,8vo,1,0,61,0,0,89,27,0,118,1,0,0
28456,1713,2020-11-18T16:20:48.8596013Z,2019,27,7,18,19,0,K,0,0,8,0,0,20,9,0,27,0,0,0
28456,1714,2020-11-18T16:20:48.8596013Z,2019,10,10,9,5,0,Sin Grado,0,0,5,0,0,0,1,0,10,0,0,0
28456,31707,2021-06-24T13:18:17.1447434Z,2021,28,3,25,16,0,1ro,1,0,12,0,0,25,3,0,27,0,0,0
28456,31708,2021-06-24T13:18:17.1457448Z,2021,34,12,29,14,0,2do,0,0,20,0,0,22,5,0,34,0,0,0
28456,31709,2021-06-24T13:18:17.1457448Z,2021,28,6,21,10,0,3ro,0,0,18,0,0,22,7,0,28,0,0,0
28456,31710,2021-06-24T13:18:17.1457448Z,2021,30,7,26,16,0,4to,0,0,14,0,0,23,4,0,30,1,0,0
28456,31711,2021-06-24T13:18:17.1457448Z,2021,31,9,24,12,0,5to,0,0,19,0,0,22,7,0,31,0,0,0
28456,31712,2021-06-24T13:18:17.1457448Z,2021,65,18,49,34,0,6to,0,0,31,0,0,47,16,0,65,1,0,0
28456,31713,2021-06-24T13:18:17.1467453Z,2021,108,20,84,46,0,7mo,0,0,62,0,0,88,24,0,108,0,0,0
28456,31714,2021-06-24T13:18:17.1467453Z,2021,109,24,82,54,0,8vo,0,0,55,0,0,85,27,0,109,0,0,0
28456,31715,2021-06-24T13:18:17.1467453Z,2021,22,5,21,12,0,K,1,0,10,0,0,17,1,0,21,0,0,0
28456,31716,2021-06-24T13:18:17.1477458Z,2021,5,5,4,2,0,Sin Grado,0,0,3,0,0,0,1,0,5,0,0,0
28456,7710,2020-11-18T16:21:47.9059761Z,2020,33,9,24,13,0,1ro,0,0,20,0,0,24,9,0,33,0,0,0
28456,7711,2020-11-18T16:21:47.9059761Z,2020,23,6,21,10,0,2do,0,0,13,0,0,17,2,0,23,0,0,0
28456,7712,2020-11-18T16:21:47.9059761Z,2020,27,8,21,16,0,3ro,0,0,11,0,0,19,6,0,27,0,0,0
28456,7713,2020-11-18T16:21:47.9069783Z,2020,31,7,22,13,0,4to,0,0,18,0,0,24,9,0,31,0,0,0
28456,7714,2020-11-18T16:21:47.9069783Z,2020,46,14,33,24,0,5to,0,0,22,0,0,32,13,0,46,0,0,0
28456,7715,2020-11-18T16:21:47.9069783Z,2020,93,17,71,41,0,6to,0,0,52,0,0,76,22,0,93,0,0,0
28456,7716,2020-11-18T16:21:47.9069783Z,2020,110,29,83,57,0,7mo,1,0,53,0,0,81,27,0,109,0,0,0
28456,7717,2020-11-18T16:21:47.9069783Z,2020,103,21,65,52,0,8vo,1,0,51,0,0,82,38,0,101,0,0,1
28456,7718,2020-11-18T16:21:47.9069783Z,2020,23,2,15,13,0,K,0,0,10,0,0,21,8,0,23,0,0,0
28456,7719,2020-11-18T16:21:47.9079769Z,2020,5,5,4,2,0,Sin Grado,0,0,3,0,0,0,1,0,5,0,0,0
34462,2250,2020-11-18T16:20:55.006702Z,2019,94,16,72,54,0,6to,0,2,40,0,0,78,22,0,94,0,0,0
34462,2251,2020-11-18T16:20:55.0077025Z,2019,92,23,75,43,0,7mo,2,2,49,0,0,69,17,0,89,1,2,1
34462,2252,2020-11-18T16:20:55.0077025Z,2019,116,31,92,47,0,8vo,1,5,69,0,0,85,24,0,115,0,0,0
34462,2253,2020-11-18T16:20:55.0077025Z,2019,7,7,7,1,0,Sin Grado,0,0,6,0,0,0,0,0,7,0,0,0
34462,32257,2021-06-24T13:18:21.7620534Z,2021,83,23,70,46,0,6to,1,2,37,0,0,60,13,0,82,0,0,0
34462,32258,2021-06-24T13:18:21.7620534Z,2021,95,24,80,51,0,7mo,2,1,44,0,0,71,15,0,93,0,0,0
34462,32259,2021-06-24T13:18:21.7620534Z,2021,99,17,74,55,0,8vo,1,3,44,0,0,82,25,0,98,0,0,0
34462,32260,2021-06-24T13:18:21.7620534Z,2021,8,7,6,2,0,Sin Grado,0,1,6,0,0,1,2,0,8,0,0,0
34462,8262,2020-11-18T16:21:50.6858339Z,2020,95,27,79,48,0,6to,2,3,47,0,0,68,16,0,93,0,0,0
34462,8263,2020-11-18T16:21:50.6868348Z,2020,90,18,67,49,0,7mo,0,1,41,0,0,72,23,0,90,0,0,0
34462,8264,2020-11-18T16:21:50.6868348Z,2020,84,22,66,45,0,8vo,3,0,39,0,0,62,18,0,81,0,2,0
34462,8265,2020-11-18T16:21:50.6868348Z,2020,8,8,8,3,0,Sin Grado,0,0,5,0,0,0,0,0,8,0,0,0
54429,33774,2021-06-24T13:18:35.2677445Z,2021,28,5,26,20,0,6to,0,0,8,0,0,23,2,0,27,0,0,1
54429,33775,2021-06-24T13:18:35.2687459Z,2021,45,16,39,23,0,7mo,0,0,22,0,0,29,6,0,44,1,0,1
54429,33776,2021-06-24T13:18:35.2687459Z,2021,34,6,30,18,0,8vo,0,0,16,0,0,28,4,0,34,0,0,0
54429,3751,2020-11-18T16:21:05.11244Z,2019,35,7,31,20,0,6to,0,1,15,0,0,28,4,0,35,0,0,0
54429,3752,2020-11-18T16:21:05.11244Z,2019,59,22,52,40,0,7mo,0,1,19,0,0,37,7,0,58,0,0,1
54429,3753,2020-11-18T16:21:05.11244Z,2019,48,13,41,24,0,8vo,0,0,24,0,0,35,7,0,48,0,0,0
54429,9768,2020-11-18T16:22:00.1241262Z,2020,46,17,38,24,0,6to,0,8,22,0,0,29,8,0,45,0,0,1
54429,9769,2020-11-18T16:22:00.1241262Z,2020,37,8,34,20,0,7mo,0,2,17,0,0,29,3,0,37,0,0,0
54429,9770,2020-11-18T16:22:00.1251262Z,2020,57,22,51,38,0,8vo,0,2,19,0,0,35,6,0,56,0,0,1
15750,30640,2021-06-24T13:18:10.6480845Z,2021,116,44,89,57,0,6to,1,0,59,0,0,72,27,0,115,0,0,0
15750,30641,2021-06-24T13:18:10.6490855Z,2021,120,41,99,63,0,7mo,4,0,57,0,0,79,21,0,116,0,2,0
15750,30642,2021-06-24T13:18:10.6490855Z,2021,124,41,93,56,0,8vo,1,0,68,0,0,83,31,0,123,0,0,0
15750,30643,2021-06-24T13:18:10.6490855Z,2021,5,5,4,4,0,Sin Grado,0,0,1,0,0,0,1,0,5,0,0,0
15750,642,2020-11-18T16:20:41.1804841Z,2019,124,40,97,54,0,6to,2,0,70,0,0,84,27,0,122,0,0,0
15750,643,2020-11-18T16:20:41.1804841Z,2019,152,56,124,81,0,7mo,5,0,71,0,0,96,28,0,147,0,0,0
15750,644,2020-11-18T16:20:41.1804841Z,2019,151,56,121,74,0,8vo,2,0,77,0,1,95,30,0,149,1,0,0
15750,645,2020-11-18T16:20:41.1804841Z,2019,5,5,5,3,0,Sin Grado,0,0,2,0,0,0,0,0,5,0,0,0
15750,6642,2020-11-18T16:21:40.7502095Z,2020,129,44,106,64,0,6to,5,0,65,0,0,85,23,0,123,0,1,1
15750,6643,2020-11-18T16:21:40.7502095Z,2020,129,41,102,56,0,7mo,1,0,73,0,0,88,27,0,127,0,0,1
15750,6644,2020-11-18T16:21:40.7502095Z,2020,143,54,112,75,0,8vo,2,0,68,0,0,89,31,0,141,0,1,0
15750,6645,2020-11-18T16:21:40.751209Z,2020,3,3,3,3,0,Sin Grado,0,0,0,0,0,0,0,0,3,0,0,0
70755,11122,2020-11-18T16:22:08.3195883Z,2020,95,23,83,58,0,1ro,0,11,37,0,0,72,12,0,95,0,0,0
70755,11123,2020-11-18T16:22:08.3205897Z,2020,81,26,72,35,0,2do,2,12,46,0,0,55,9,1,78,0,0,0
70755,11124,2020-11-18T16:22:08.3205897Z,2020,73,33,57,38,0,3ro,1,8,35,0,0,40,16,0,72,0,0,0
70755,11125,2020-11-18T16:22:08.3205897Z,2020,73,29,63,43,0,4to,1,14,30,0,0,44,10,0,72,0,0,0
70755,11126,2020-11-18T16:22:08.3205897Z,2020,93,31,82,52,0,5to,3,10,41,0,0,62,11,0,90,0,0,0
70755,11127,2020-11-18T16:22:08.3215892Z,2020,96,14,82,45,0,K,0,8,51,0,0,82,14,0,96,0,0,0
70755,11128,2020-11-18T16:22:08.3215892Z,2020,27,5,20,13,0,PK,0,0,14,0,0,22,7,0,27,0,0,0
70755,11129,2020-11-18T16:22:08.3225897Z,2020,30,30,29,13,0,Sin Grado,0,0,17,0,0,0,1,0,30,0,0,0
70755,35143,2021-06-24T13:18:44.4943605Z,2021,89,15,84,40,0,1ro,0,6,49,0,0,74,5,0,89,0,0,0
70755,35144,2021-06-24T13:18:44.4943605Z,2021,91,22,88,56,0,2do,0,13,35,0,0,69,3,0,91,0,0,0
70755,35145,2021-06-24T13:18:44.4943605Z,2021,79,26,75,36,0,3ro,2,12,43,0,0,53,4,0,77,0,0,0
70755,35146,2021-06-24T13:18:44.495361Z,2021,68,30,63,34,0,4to,1,8,34,0,0,38,5,0,67,0,0,0
70755,35147,2021-06-24T13:18:44.495361Z,2021,77,27,74,43,0,5to,2,15,34,0,0,50,3,0,75,0,0,0
70755,35148,2021-06-24T13:18:44.495361Z,2021,74,11,64,41,0,K,0,4,33,0,0,63,10,2,72,0,0,0
70755,35149,2021-06-24T13:18:44.495361Z,2021,22,2,16,10,0,PK,0,0,12,0,0,20,6,0,21,0,0,1
70755,35150,2021-06-24T13:18:44.4963624Z,2021,17,17,17,6,0,Sin Grado,0,0,11,0,0,0,0,0,17,0,0,0
70755,5116,2020-11-18T16:21:14.0243846Z,2019,96,36,84,36,0,1ro,0,22,60,0,0,60,12,2,94,0,0,0
70755,5117,2020-11-18T16:21:14.0243846Z,2019,93,40,82,44,0,2do,0,15,49,0,0,53,11,0,93,0,0,0
70755,5118,2020-11-18T16:21:14.0253859Z,2019,77,32,67,45,1,3ro,1,17,32,0,0,45,10,0,76,0,0,0
70755,5119,2020-11-18T16:21:14.0253859Z,2019,101,39,85,55,1,4to,3,12,46,0,0,62,16,0,98,0,0,0
70755,5120,2020-11-18T16:21:14.0253859Z,2019,86,26,74,46,0,5to,0,8,40,0,0,60,12,0,86,0,0,0
70755,5121,2020-11-18T16:21:14.0263863Z,2019,83,14,58,57,0,K,0,7,26,0,0,69,25,0,83,0,0,0
70755,5122,2020-11-18T16:21:14.0263863Z,2019,29,4,17,12,0,PK,0,0,17,0,0,25,12,0,29,0,0,0
70755,5123,2020-11-18T16:21:14.0263863Z,2019,25,25,23,11,0,Sin Grado,0,3,14,0,0,0,2,0,25,0,0,0
54452,33783,2021-06-24T13:18:35.282755Z,2021,35,5,30,23,0,1ro,1,0,12,0,0,30,5,0,34,0,0,0
54452,33784,2021-06-24T13:18:35.282755Z,2021,46,16,39,25,0,2do,0,0,21,0,0,30,7,0,46,0,0,0
54452,33785,2021-06-24T13:18:35.283756Z,2021,44,16,37,20,0,3ro,0,3,24,0,0,28,7,0,44,2,0,0
54452,33786,2021-06-24T13:18:35.283756Z,2021,37,14,34,23,0,4to,0,3,14,0,0,23,3,0,37,1,0,0
54452,33787,2021-06-24T13:18:35.283756Z,2021,47,15,39,26,0,5to,0,0,21,0,0,32,8,0,47,1,0,0
54452,33788,2021-06-24T13:18:35.2847569Z,2021,35,16,26,17,0,6to,0,0,18,0,0,19,9,0,35,1,0,0
54452,33789,2021-06-24T13:18:35.2847569Z,2021,47,18,39,19,0,7mo,0,2,28,0,0,29,8,0,47,1,0,0
54452,33790,2021-06-24T13:18:35.2847569Z,2021,54,12,40,40,0,8vo,0,0,14,0,0,42,14,0,54,1,1,0
54452,33791,2021-06-24T13:18:35.2857574Z,2021,43,12,31,16,0,K,0,1,27,0,0,31,12,0,43,0,0,0
54452,33792,2021-06-24T13:18:35.2857574Z,2021,9,9,5,2,0,Sin Grado,0,0,7,0,0,0,4,0,9,0,0,0
54452,3760,2020-11-18T16:21:05.1254485Z,2019,40,18,33,16,0,1ro,0,0,24,0,0,22,7,0,40,2,0,0
54452,3761,2020-11-18T16:21:05.1264485Z,2019,37,14,31,23,0,2do,0,1,14,0,0,23,6,0,37,1,0,0
54452,3762,2020-11-18T16:21:05.1264485Z,2019,44,14,30,25,0,3ro,0,1,19,0,0,30,14,0,44,1,0,0
54452,3763,2020-11-18T16:21:05.1264485Z,2019,34,15,24,15,0,4to,0,1,19,0,0,19,10,0,34,1,0,0
54452,3764,2020-11-18T16:21:05.1264485Z,2019,49,19,39,19,0,5to,0,1,30,0,0,30,10,0,49,1,0,0
54452,3765,2020-11-18T16:21:05.1264485Z,2019,57,13,41,42,0,6to,0,0,15,0,0,44,16,0,57,1,0,0
54452,3766,2020-11-18T16:21:05.1274493Z,2019,58,14,43,31,0,7mo,0,3,27,0,0,44,15,0,57,1,1,1
54452,3767,2020-11-18T16:21:05.1274493Z,2019,61,20,48,33,0,8vo,1,0,28,0,0,41,13,0,60,0,0,0
54452,3768,2020-11-18T16:21:05.1274493Z,2019,36,12,25,18,0,K,0,0,18,0,0,24,11,0,36,0,0,0
54452,3769,2020-11-18T16:21:05.1274493Z,2019,13,10,6,3,0,Sin Grado,0,0,10,0,0,3,7,0,13,0,0,0
54452,9777,2020-11-18T16:22:00.1351329Z,2020,44,15,34,22,0,1ro,0,0,22,0,0,29,10,0,44,0,0,0
54452,9778,2020-11-18T16:22:00.1361334Z,2020,42,15,31,20,0,2do,0,1,22,0,0,27,11,0,42,2,0,0
54452,9779,2020-11-18T16:22:00.1361334Z,2020,36,12,29,22,0,3ro,0,2,14,0,0,24,7,0,36,1,0,0
54452,9780,2020-11-18T16:22:00.1361334Z,2020,49,17,33,26,0,4to,0,0,23,0,0,32,16,0,49,1,0,0
54452,9781,2020-11-18T16:22:00.1371338Z,2020,29,11,23,13,0,5to,0,2,16,0,0,18,6,0,29,1,0,0
54452,9782,2020-11-18T16:22:00.1371338Z,2020,50,19,39,20,0,6to,0,2,30,0,0,31,11,0,50,1,0,0
54452,9783,2020-11-18T16:22:00.1371338Z,2020,50,11,32,39,0,7mo,0,0,11,0,0,39,18,0,50,1,0,0
54452,9784,2020-11-18T16:22:00.1371338Z,2020,55,15,45,31,0,8vo,0,0,24,0,0,40,10,0,55,1,1,0
54452,9785,2020-11-18T16:22:00.1371338Z,2020,43,10,30,25,0,K,0,0,18,0,0,33,13,0,43,0,0,0
54452,9786,2020-11-18T16:22:00.1381351Z,2020,10,10,5,2,0,Sin Grado,0,0,8,0,0,0,5,0,10,0,0,0
34363,2245,2020-11-18T16:20:55.0077025Z,2019,108,22,80,64,0,10mo,1,0,44,0,0,86,28,0,107,0,0,0
34363,2246,2020-11-18T16:20:55.0077025Z,2019,92,21,78,38,0,11mo,2,0,54,0,0,71,14,0,90,1,0,0
34363,2247,2020-11-18T16:20:55.0087025Z,2019,109,0,88,64,0,12mo,0,0,45,0,0,109,21,0,109,0,0,0
34363,2248,2020-11-18T16:20:55.0087025Z,2019,103,19,83,63,0,9no,2,0,40,0,0,84,20,0,101,0,0,0
34363,2249,2020-11-18T16:20:55.0087025Z,2019,31,27,28,13,0,Sin Grado,0,0,18,0,0,4,3,0,31,0,0,0
34363,32252,2021-06-24T13:18:21.7580519Z,2021,117,41,102,61,0,10mo,1,0,56,0,0,76,15,0,116,0,0,0
34363,32253,2021-06-24T13:18:21.7590519Z,2021,83,16,68,53,0,11mo,1,1,30,0,0,67,15,0,82,0,0,0
34363,32254,2021-06-24T13:18:21.7590519Z,2021,86,15,63,55,0,12mo,0,0,31,0,0,71,23,0,86,0,0,0
34363,32255,2021-06-24T13:18:21.7590519Z,2021,91,35,73,52,0,9no,0,0,39,0,0,56,18,0,91,1,0,0
34363,32256,2021-06-24T13:18:21.7600529Z,2021,28,28,20,8,0,Sin Grado,1,0,20,0,0,0,8,0,27,0,0,0
34363,8257,2020-11-18T16:21:50.6878339Z,2020,87,20,67,55,0,10mo,1,0,32,0,0,67,20,0,86,0,0,0
34363,8258,2020-11-18T16:21:50.6878339Z,2020,92,17,76,59,0,11mo,0,0,33,0,0,75,16,0,92,0,0,0
34363,8259,2020-11-18T16:21:50.6888348Z,2020,87,20,75,37,0,12mo,1,0,50,0,0,67,12,0,86,1,0,0
34363,8260,2020-11-18T16:21:50.6888348Z,2020,120,40,106,64,0,9no,1,0,56,0,0,80,14,0,119,0,0,0
34363,8261,2020-11-18T16:21:50.6888348Z,2020,30,30,26,10,0,Sin Grado,0,0,20,0,0,0,4,0,30,0,0,0
40667,2614,2020-11-18T16:20:58.0517337Z,2019,126,45,114,63,0,6to,5,1,63,0,0,81,12,0,121,0,1,0
40667,2615,2020-11-18T16:20:58.0517337Z,2019,126,49,113,53,0,7mo,6,0,73,0,0,77,13,0,120,0,0,0
40667,2616,2020-11-18T16:20:58.0517337Z,2019,144,45,123,68,0,8vo,8,0,76,0,0,99,21,0,136,0,0,0
40667,2617,2020-11-18T16:20:58.0527337Z,2019,16,14,13,7,0,Sin Grado,2,0,9,0,0,2,3,0,14,0,0,0
40667,32621,2021-06-24T13:18:26.2432739Z,2021,126,49,118,66,0,6to,2,0,60,0,0,77,8,0,124,0,0,0
40667,32622,2021-06-24T13:18:26.2432739Z,2021,111,39,105,54,0,7mo,4,0,57,0,0,72,6,0,107,0,0,0
40667,32623,2021-06-24T13:18:26.2442748Z,2021,106,37,97,48,0,8vo,3,0,58,0,0,69,9,0,103,0,1,0
40667,32624,2021-06-24T13:18:26.2442748Z,2021,4,4,4,1,0,Sin Grado,0,0,3,0,0,0,0,0,4,0,0,0
40667,8625,2020-11-18T16:21:53.0484052Z,2020,110,41,98,57,0,6to,4,0,53,0,0,69,12,0,106,0,0,0
40667,8626,2020-11-18T16:21:53.0484052Z,2020,110,33,89,55,0,7mo,3,1,55,0,0,77,21,0,107,0,1,0
40667,8627,2020-11-18T16:21:53.049407Z,2020,120,48,101,52,0,8vo,8,0,68,0,0,72,19,0,112,0,0,0
40667,8628,2020-11-18T16:21:53.049407Z,2020,11,11,9,3,0,Sin Grado,0,0,8,0,0,0,2,0,11,0,0,0
52621,33598,2021-06-24T13:18:33.4194198Z,2021,12,1,11,6,0,1ro,1,0,6,0,0,11,1,0,11,0,0,0
52621,33599,2021-06-24T13:18:33.4194198Z,2021,21,4,20,11,0,2do,1,0,10,0,0,17,1,0,20,0,0,0
52621,33600,2021-06-24T13:18:33.6535873Z,2021,13,4,13,10,0,3ro,0,0,3,0,0,9,0,0,13,0,0,0
52621,33601,2021-06-24T13:18:33.6545886Z,2021,11,3,11,4,0,4to,0,0,7,0,0,8,0,0,11,0,0,0
52621,33602,2021-06-24T13:18:33.6545886Z,2021,16,10,16,4,0,5to,0,0,12,0,0,6,0,0,16,0,0,0
52621,33603,2021-06-24T13:18:33.6555891Z,2021,55,17,50,24,0,6to,1,0,31,0,0,38,5,0,54,0,0,0
52621,33604,2021-06-24T13:18:33.6555891Z,2021,54,20,51,25,0,7mo,0,0,29,0,0,34,3,0,54,0,0,0
52621,33605,2021-06-24T13:18:33.6555891Z,2021,46,14,40,24,0,8vo,0,0,22,0,0,32,6,0,46,0,0,0
52621,33606,2021-06-24T13:18:33.6555891Z,2021,17,0,16,7,0,K,0,0,10,0,0,17,1,0,17,0,0,0
52621,3573,2020-11-18T16:21:03.2792212Z,2019,12,0,12,8,0,1ro,1,0,4,0,0,12,0,0,11,0,0,0
52621,3574,2020-11-18T16:21:03.2792212Z,2019,12,5,11,6,0,2do,0,0,6,0,0,7,1,0,11,0,0,1
52621,3575,2020-11-18T16:21:03.2792212Z,2019,16,6,16,5,0,3ro,0,0,11,0,0,10,0,0,16,0,0,0
52621,3576,2020-11-18T16:21:03.2802221Z,2019,19,6,19,7,0,4to,0,0,12,0,0,13,0,0,19,0,0,0
52621,3577,2020-11-18T16:21:03.2802221Z,2019,16,5,14,8,0,5to,0,1,8,0,0,11,2,0,16,0,0,0
52621,3578,2020-11-18T16:21:03.2802221Z,2019,51,15,49,26,0,6to,0,0,25,0,0,36,2,0,51,0,0,0
52621,3579,2020-11-18T16:21:03.2802221Z,2019,67,21,64,37,0,7mo,0,0,30,0,0,46,3,0,67,1,1,0
52621,3580,2020-11-18T16:21:03.2802221Z,2019,87,29,73,44,0,8vo,0,0,43,0,0,58,14,1,86,0,0,0
52621,3581,2020-11-18T16:21:03.2812248Z,2019,17,1,16,7,0,K,0,0,10,0,0,16,1,0,17,0,0,0
52621,9592,2020-11-18T16:21:59.1064462Z,2020,20,2,18,10,0,1ro,0,1,10,0,0,18,2,0,20,0,0,0
52621,9593,2020-11-18T16:21:59.1064462Z,2020,17,2,17,11,0,2do,0,0,6,0,0,15,0,0,17,0,0,0
52621,9594,2020-11-18T16:21:59.1074458Z,2020,13,4,13,5,0,3ro,0,0,8,0,0,9,0,0,13,0,0,0
52621,9595,2020-11-18T16:21:59.1074458Z,2020,18,8,18,7,0,4to,0,0,11,0,0,10,0,0,18,0,0,0
52621,9596,2020-11-18T16:21:59.1074458Z,2020,31,10,30,11,0,5to,0,0,20,0,0,21,1,0,31,0,0,0
52621,9597,2020-11-18T16:21:59.1074458Z,2020,63,18,57,33,0,6to,0,2,30,0,0,45,6,0,63,0,0,0
52621,9598,2020-11-18T16:21:59.1084466Z,2020,51,15,48,25,0,7mo,0,0,26,0,0,36,3,0,51,0,0,0
52621,9599,2020-11-18T16:21:59.1084466Z,2020,66,18,58,38,0,8vo,0,0,28,0,0,48,8,0,66,1,1,0
52621,9600,2020-11-18T16:21:59.1084466Z,2020,15,0,15,8,0,K,0,1,7,0,0,15,0,0,15,0,0,0
71076,11218,2020-11-18T16:22:09.5644186Z,2020,48,19,43,26,0,1ro,2,0,22,0,0,29,5,0,46,0,0,0
71076,11219,2020-11-18T16:22:09.5644186Z,2020,58,29,47,22,0,2do,2,0,36,0,0,29,11,0,56,0,0,0
71076,11220,2020-11-18T16:22:09.5644186Z,2020,74,40,61,26,0,3ro,1,0,48,0,0,34,13,0,73,0,1,0
71076,11221,2020-11-18T16:22:09.5644186Z,2020,52,29,39,26,0,4to,0,0,26,0,0,23,13,0,52,0,0,0
71076,11222,2020-11-18T16:22:09.5644186Z,2020,59,27,48,32,0,5to,1,0,27,0,0,32,11,0,58,0,0,0
71076,11223,2020-11-18T16:22:09.565419Z,2020,60,29,58,28,0,K,2,0,32,0,0,31,2,0,58,0,0,0
71076,11224,2020-11-18T16:22:09.565419Z,2020,70,69,59,22,0,Sin Grado,1,0,48,0,0,1,11,0,69,0,0,0
71076,35239,2021-06-24T13:18:44.8105877Z,2021,46,24,42,24,0,1ro,2,0,22,0,0,22,4,0,44,0,0,0
71076,35240,2021-06-24T13:18:44.8105877Z,2021,45,18,40,20,0,2do,1,0,25,0,0,27,5,0,44,0,0,0
71076,35241,2021-06-24T13:18:44.8115882Z,2021,49,23,43,19,0,3ro,1,0,30,0,0,26,6,0,48,0,0,0
71076,35242,2021-06-24T13:18:44.8115882Z,2021,68,38,60,26,0,4to,1,0,42,0,0,30,8,0,67,0,1,0
71076,35243,2021-06-24T13:18:44.8115882Z,2021,49,28,40,21,0,5to,1,0,28,0,0,21,9,0,48,0,0,0
71076,35244,2021-06-24T13:18:44.8115882Z,2021,49,23,45,22,0,K,3,0,27,0,0,26,4,0,46,0,0,0
71076,35245,2021-06-24T13:18:44.8115882Z,2021,44,44,39,12,0,Sin Grado,1,0,32,0,0,0,5,0,43,0,0,0
71076,5213,2020-11-18T16:21:14.4396596Z,2019,70,37,64,25,0,1ro,3,0,45,0,0,33,6,0,67,0,0,0
71076,5214,2020-11-18T16:21:14.4396596Z,2019,76,44,63,26,0,2do,1,0,50,0,0,32,13,0,75,0,1,0
71076,5215,2020-11-18T16:21:14.4396596Z,2019,55,28,45,29,0,3ro,1,0,26,0,0,27,10,0,54,0,0,0
71076,5216,2020-11-18T16:21:14.4406605Z,2019,62,31,54,31,0,4to,0,0,31,0,0,31,8,0,62,0,0,0
71076,5217,2020-11-18T16:21:14.4406605Z,2019,81,41,73,31,0,5to,1,0,50,0,0,40,8,0,80,0,0,0
71076,5218,2020-11-18T16:21:14.4406605Z,2019,41,15,39,29,0,K,1,0,12,0,0,26,2,0,40,0,0,0
71076,5219,2020-11-18T16:21:14.4416627Z,2019,75,72,69,22,0,Sin Grado,2,0,53,0,0,3,6,0,73,0,0,0
12377,30349,2021-06-24T13:18:08.8377876Z,2021,158,39,135,83,0,10mo,0,0,75,0,0,119,23,0,158,3,0,0
12377,30350,2021-06-24T13:18:08.8377876Z,2021,143,30,116,76,0,11mo,0,0,67,0,0,113,27,0,143,3,0,0
12377,30351,2021-06-24T13:18:08.8377876Z,2021,137,25,102,69,0,12mo,0,0,68,0,0,112,35,0,137,7,0,0
12377,30352,2021-06-24T13:18:08.8377876Z,2021,158,50,133,66,0,9no,2,0,92,0,0,108,25,0,156,1,1,0
12377,351,2020-11-18T16:20:39.6364534Z,2019,154,28,110,80,0,10mo,0,2,74,0,0,126,44,0,154,8,1,0
12377,352,2020-11-18T16:20:39.6364534Z,2019,159,31,111,81,0,11mo,0,0,78,0,0,128,48,0,159,7,3,0
12377,353,2020-11-18T16:20:39.6374534Z,2019,157,1,114,79,0,12mo,0,0,78,0,0,156,43,0,157,0,0,0
12377,354,2020-11-18T16:20:39.6374534Z,2019,166,36,127,78,0,9no,0,1,88,0,0,130,39,0,166,3,0,0
12377,6352,2020-11-18T16:21:39.2432011Z,2020,151,33,114,79,0,10mo,0,0,72,0,0,118,37,0,151,3,0,0
12377,6353,2020-11-18T16:21:39.2432011Z,2020,140,25,99,70,0,11mo,0,0,70,0,0,115,41,0,140,8,0,0
12377,6354,2020-11-18T16:21:39.2432011Z,2020,149,28,102,79,0,12mo,0,0,70,0,0,121,47,0,149,7,1,0
12377,6355,2020-11-18T16:21:39.244202Z,2020,160,45,116,81,0,9no,0,0,79,0,0,115,44,1,159,5,0,0
32763,2126,2020-11-18T16:20:54.5694092Z,2019,16,4,10,10,0,1ro,1,0,6,0,0,12,6,0,15,0,0,0
32763,2127,2020-11-18T16:20:54.5694092Z,2019,19,5,14,15,0,2do,2,0,4,0,0,14,5,0,17,0,0,0
32763,2128,2020-11-18T16:20:54.5694092Z,2019,15,4,13,9,0,3ro,1,0,6,0,0,11,2,0,14,0,0,0
32763,2129,2020-11-18T16:20:54.5694092Z,2019,24,11,22,14,0,4to,0,0,10,0,0,13,2,0,24,0,0,0
32763,2130,2020-11-18T16:20:54.5704097Z,2019,28,11,23,15,0,5to,2,0,13,0,1,17,5,0,26,0,0,0
32763,2131,2020-11-18T16:20:54.5704097Z,2019,20,7,17,9,0,6to,0,0,11,0,0,13,3,0,20,0,0,0
32763,2132,2020-11-18T16:20:54.5704097Z,2019,53,9,26,24,0,PK,0,0,29,0,0,44,27,0,53,0,0,0
32763,32132,2021-06-24T13:18:20.8934315Z,2021,10,1,7,7,0,1ro,0,0,3,0,0,9,3,0,10,0,0,0
32763,32133,2021-06-24T13:18:20.8934315Z,2021,11,1,8,4,0,2do,0,0,7,0,0,10,3,0,11,0,0,0
32763,32134,2021-06-24T13:18:20.8934315Z,2021,13,4,10,9,0,3ro,1,0,4,0,0,9,3,0,12,0,0,0
32763,32135,2021-06-24T13:18:20.8944329Z,2021,16,5,14,10,0,4to,2,0,6,0,0,11,2,0,14,0,0,0
32763,32136,2021-06-24T13:18:20.8944329Z,2021,18,6,14,11,0,5to,0,0,7,0,0,12,4,0,18,0,0,0
32763,32137,2021-06-24T13:18:20.8944329Z,2021,23,7,17,16,0,6to,0,0,7,0,0,16,6,0,23,0,0,0
32763,32138,2021-06-24T13:18:20.8944329Z,2021,12,4,10,5,0,K,0,0,7,0,0,8,2,0,12,0,0,0
32763,32139,2021-06-24T13:18:20.8944329Z,2021,35,5,28,18,0,PK,1,0,17,0,0,30,7,0,34,0,0,0
32763,8138,2020-11-18T16:21:50.2245242Z,2020,10,1,6,4,0,1ro,0,0,6,0,0,9,4,0,10,0,0,0
32763,8139,2020-11-18T16:21:50.2245242Z,2020,8,2,3,7,0,2do,0,0,1,0,0,6,5,0,8,0,0,0
32763,8140,2020-11-18T16:21:50.2245242Z,2020,14,5,11,9,0,3ro,2,0,5,0,0,9,3,0,12,0,0,0
32763,8141,2020-11-18T16:21:50.2245242Z,2020,16,6,13,8,0,4to,0,0,8,0,0,10,3,0,16,0,0,0
32763,8142,2020-11-18T16:21:50.2245242Z,2020,19,7,15,14,0,5to,0,0,5,0,0,12,4,0,19,0,0,0
32763,8143,2020-11-18T16:21:50.2255251Z,2020,20,10,18,9,0,6to,0,0,11,0,0,10,2,0,20,0,0,0
32763,8144,2020-11-18T16:21:50.2255251Z,2020,8,2,3,4,0,K,0,0,4,0,0,6,5,0,8,0,0,0
32763,8145,2020-11-18T16:21:50.2255251Z,2020,41,3,27,22,0,PK,1,0,19,0,0,38,14,0,40,0,0,0
17889,30792,2021-06-24T13:18:11.2144911Z,2021,25,8,24,10,0,1ro,0,0,15,0,0,17,1,0,25,0,0,0
17889,30793,2021-06-24T13:18:11.2144911Z,2021,17,6,15,9,0,2do,0,0,8,0,0,11,2,0,17,0,0,0
17889,30794,2021-06-24T13:18:11.2144911Z,2021,24,9,21,12,0,3ro,0,0,12,0,0,15,3,0,24,0,0,0
17889,30795,2021-06-24T13:18:11.2154916Z,2021,19,8,16,7,0,4to,0,0,12,0,0,11,3,0,19,0,0,0
17889,30796,2021-06-24T13:18:11.2154916Z,2021,20,9,17,10,0,5to,0,0,10,0,0,11,3,0,20,0,0,0
17889,30797,2021-06-24T13:18:11.2154916Z,2021,25,5,19,14,0,6to,0,0,11,0,0,20,6,0,25,0,0,0
17889,30798,2021-06-24T13:18:11.2164934Z,2021,19,4,17,11,0,7mo,1,0,8,0,0,15,2,0,18,0,0,0
17889,30799,2021-06-24T13:18:11.2164934Z,2021,13,5,10,4,0,8vo,0,0,9,0,0,8,3,0,13,0,0,0
17889,30800,2021-06-24T13:18:11.4236413Z,2021,17,2,15,10,0,K,0,0,7,0,0,15,2,0,17,0,0,0
17889,30801,2021-06-24T13:18:11.4246414Z,2021,15,3,13,6,0,PK,0,0,9,0,0,12,2,0,15,0,0,0
17889,6795,2020-11-18T16:21:41.4576765Z,2020,15,5,9,8,0,1ro,0,0,7,0,0,10,6,0,15,0,0,0
17889,6796,2020-11-18T16:21:41.4576765Z,2020,26,11,19,12,0,2do,0,0,14,0,0,15,7,0,26,0,0,0
17889,6797,2020-11-18T16:21:41.4576765Z,2020,24,9,19,8,0,3ro,0,0,16,0,0,15,5,0,24,0,0,0
17889,6798,2020-11-18T16:21:41.458677Z,2020,22,10,15,10,0,4to,0,0,12,0,0,12,7,1,21,0,0,0
17889,6799,2020-11-18T16:21:41.458677Z,2020,27,5,18,15,0,5to,0,0,12,0,0,22,9,0,27,0,0,0
17889,6800,2020-11-18T16:21:41.458677Z,2020,22,5,17,11,0,6to,1,0,11,0,0,17,5,0,21,0,0,0
17889,6801,2020-11-18T16:21:42.0260545Z,2020,15,7,9,4,0,7mo,0,0,11,0,0,8,6,0,15,0,0,0
17889,6802,2020-11-18T16:21:42.0260545Z,2020,16,5,13,10,0,8vo,0,0,6,0,0,11,3,0,16,0,0,0
17889,6803,2020-11-18T16:21:42.0260545Z,2020,30,10,25,12,0,K,0,0,18,0,0,20,5,0,28,0,0,2
17889,6804,2020-11-18T16:21:42.0270545Z,2020,13,0,9,6,0,PK,0,0,7,0,0,13,4,0,13,0,0,0
17889,794,2020-11-18T16:20:42.128116Z,2019,25,11,19,12,0,1ro,0,0,13,0,0,14,6,0,25,0,0,0
17889,795,2020-11-18T16:20:42.128116Z,2019,24,10,21,9,0,2do,0,0,15,0,0,14,3,0,24,0,0,0
17889,796,2020-11-18T16:20:42.128116Z,2019,20,9,17,10,0,3ro,1,0,10,0,0,11,3,0,19,0,0,0
17889,797,2020-11-18T16:20:42.1291151Z,2019,29,6,19,15,0,4to,0,0,14,0,0,23,10,0,29,0,0,0
17889,798,2020-11-18T16:20:42.1291151Z,2019,26,7,22,11,0,5to,1,0,15,0,0,19,4,0,25,0,0,0
17889,799,2020-11-18T16:20:42.1291151Z,2019,15,7,8,4,0,6to,0,0,11,0,0,8,7,0,15,0,0,0
17889,800,2020-11-18T16:20:42.1291151Z,2019,15,4,12,10,0,7mo,0,0,5,0,0,11,3,0,15,0,0,0
17889,801,2020-11-18T16:20:42.6294462Z,2019,15,3,12,9,0,8vo,0,0,6,0,0,12,3,0,15,0,0,0
17889,802,2020-11-18T16:20:42.6294462Z,2019,16,7,12,10,0,K,0,0,6,0,0,9,4,0,16,0,0,0
17889,803,2020-11-18T16:20:42.6304475Z,2019,15,6,12,7,0,PK,0,0,8,0,0,9,3,0,15,0,0,0
52225,33551,2021-06-24T13:18:33.3954026Z,2021,51,13,48,22,0,1ro,1,0,29,0,0,38,3,0,50,0,0,0
52225,33552,2021-06-24T13:18:33.3954026Z,2021,34,9,33,14,0,2do,0,0,20,0,0,25,1,0,34,0,0,0
52225,33553,2021-06-24T13:18:33.3954026Z,2021,28,10,25,13,0,3ro,0,0,15,0,0,18,3,0,28,0,0,0
52225,33554,2021-06-24T13:18:33.3964026Z,2021,44,25,42,20,0,4to,2,0,24,0,0,19,2,0,42,0,0,0
52225,33555,2021-06-24T13:18:33.3964026Z,2021,31,11,29,17,0,5to,1,0,14,0,0,20,2,0,30,0,0,0
52225,33556,2021-06-24T13:18:33.3964026Z,2021,38,10,35,16,0,K,1,0,22,0,0,28,3,0,37,0,0,0
52225,33557,2021-06-24T13:18:33.3964026Z,2021,7,7,7,1,0,Sin Grado,0,0,6,0,0,0,0,0,7,0,0,0
52225,3527,2020-11-18T16:21:03.3052386Z,2019,49,18,48,22,0,1ro,0,0,27,0,0,31,1,0,49,0,0,0
52225,3528,2020-11-18T16:21:03.3052386Z,2019,56,25,54,23,0,2do,0,0,33,0,0,31,2,0,56,0,0,0
52225,3529,2020-11-18T16:21:03.3052386Z,2019,41,14,41,25,0,3ro,1,0,16,0,0,27,0,0,40,0,0,0
52225,3530,2020-11-18T16:21:03.3062386Z,2019,46,21,44,19,0,4to,2,0,27,0,0,25,2,0,44,0,0,0
52225,3531,2020-11-18T16:21:03.3062386Z,2019,38,10,35,17,0,5to,2,0,21,0,0,28,3,0,36,1,0,0
52225,3532,2020-11-18T16:21:03.3062386Z,2019,47,11,45,26,0,K,0,0,21,0,0,36,2,0,47,0,0,0
52225,3533,2020-11-18T16:21:03.3062386Z,2019,24,24,23,8,0,Sin Grado,0,0,16,0,0,0,1,0,24,0,0,0
52225,9546,2020-11-18T16:21:59.0934382Z,2020,41,11,40,21,0,1ro,1,1,20,0,0,30,1,0,40,0,0,0
52225,9547,2020-11-18T16:21:59.0934382Z,2020,33,12,32,16,0,2do,0,1,17,0,0,21,1,0,33,0,0,0
52225,9548,2020-11-18T16:21:59.0944377Z,2020,50,24,49,23,0,3ro,1,2,27,0,0,26,1,1,48,0,0,0
52225,9549,2020-11-18T16:21:59.0944377Z,2020,35,15,35,20,0,4to,1,1,15,0,0,20,0,0,34,0,0,0
52225,9550,2020-11-18T16:21:59.0944377Z,2020,44,19,42,19,0,5to,2,2,25,0,0,25,2,0,42,0,0,0
52225,9551,2020-11-18T16:21:59.0944377Z,2020,58,16,56,22,0,K,1,1,36,0,0,42,2,0,57,0,0,0
52225,9552,2020-11-18T16:21:59.0944377Z,2020,25,25,24,9,0,Sin Grado,0,0,16,0,0,0,1,0,25,0,0,0
40915,2618,2020-11-18T16:20:58.0537346Z,2019,52,20,43,30,0,1ro,1,0,22,0,0,32,9,0,51,0,0,0
40915,2619,2020-11-18T16:20:58.0547359Z,2019,44,21,41,23,0,2do,1,0,21,0,0,23,3,0,43,0,0,0
40915,2620,2020-11-18T16:20:58.0547359Z,2019,28,6,24,19,0,3ro,2,0,9,0,0,22,4,0,26,0,0,0
40915,2621,2020-11-18T16:20:58.0547359Z,2019,36,18,33,20,0,4to,1,0,16,0,0,18,3,0,35,0,0,0
40915,2622,2020-11-18T16:20:58.0557364Z,2019,40,11,34,20,0,5to,5,0,20,0,0,29,6,0,35,0,0,0
40915,2623,2020-11-18T16:20:58.0557364Z,2019,41,9,36,30,0,K,1,0,11,0,0,32,5,0,40,0,0,0
40915,2624,2020-11-18T16:20:58.0567359Z,2019,34,29,30,12,0,Sin Grado,1,0,22,0,0,5,4,0,33,0,0,0
40915,32625,2021-06-24T13:18:26.25128Z,2021,47,14,44,22,0,1ro,1,0,25,0,0,33,3,0,46,0,0,0
40915,32626,2021-06-24T13:18:26.2522801Z,2021,34,15,30,18,0,2do,1,0,16,0,0,19,4,0,33,0,0,0
40915,32627,2021-06-24T13:18:26.2522801Z,2021,49,21,46,25,0,3ro,0,0,24,0,0,28,3,0,49,0,0,0
40915,32628,2021-06-24T13:18:26.2522801Z,2021,36,12,34,17,0,4to,0,0,19,0,0,24,2,0,36,0,0,0
40915,32629,2021-06-24T13:18:26.253281Z,2021,31,11,25,18,0,5to,3,0,13,0,0,20,6,0,28,0,0,0
40915,32630,2021-06-24T13:18:26.253281Z,2021,41,10,36,24,0,K,0,0,17,0,0,31,5,0,41,0,0,0
40915,32631,2021-06-24T13:18:26.253281Z,2021,27,27,23,11,0,Sin Grado,0,0,16,0,0,0,4,0,27,0,0,0
40915,8629,2020-11-18T16:21:53.0524079Z,2020,33,11,29,23,0,1ro,1,0,10,0,0,22,4,0,32,0,0,0
40915,8630,2020-11-18T16:21:53.0534083Z,2020,52,21,44,27,0,2do,0,0,25,0,0,31,8,0,52,0,0,0
40915,8631,2020-11-18T16:21:53.0534083Z,2020,35,15,31,18,0,3ro,1,0,17,0,0,20,4,0,34,0,0,0
40915,8632,2020-11-18T16:21:53.0534083Z,2020,35,9,29,22,0,4to,3,0,13,0,0,26,6,0,32,0,0,0
40915,8633,2020-11-18T16:21:53.0544088Z,2020,39,17,35,22,0,5to,1,0,17,0,0,22,4,0,38,0,0,0
40915,8634,2020-11-18T16:21:53.0544088Z,2020,46,15,42,25,0,K,2,0,21,0,0,31,4,0,44,0,0,0
40915,8635,2020-11-18T16:21:53.0544088Z,2020,47,31,43,22,0,Sin Grado,0,0,25,0,0,16,4,0,47,0,0,0
56424,33904,2021-06-24T13:18:36.6127089Z,2021,118,29,113,71,0,6to,1,0,47,0,0,89,5,0,117,1,0,0
56424,33905,2021-06-24T13:18:36.6127089Z,2021,103,36,91,59,0,7mo,3,0,44,0,0,67,12,0,100,1,1,0
56424,33906,2021-06-24T13:18:36.6127089Z,2021,115,29,98,62,0,8vo,1,0,53,0,0,86,17,0,114,1,0,0
56424,33907,2021-06-24T13:18:36.6127089Z,2021,8,7,6,1,0,Sin Grado,0,0,7,0,0,1,2,0,8,0,0,0
56424,3881,2020-11-18T16:21:05.5917595Z,2019,135,37,123,75,0,6to,0,0,60,0,0,98,12,0,135,1,0,0
56424,3882,2020-11-18T16:21:05.5917595Z,2019,118,32,99,54,0,7mo,2,0,64,0,0,86,19,0,116,4,0,0
56424,3883,2020-11-18T16:21:05.5927604Z,2019,101,24,83,52,0,8vo,1,0,49,0,0,77,18,0,100,0,0,0
56424,3884,2020-11-18T16:21:05.5927604Z,2019,5,5,5,1,0,Sin Grado,0,0,4,0,0,0,0,0,5,0,1,0
56424,9898,2020-11-18T16:22:00.5333985Z,2020,104,37,95,56,0,6to,3,0,48,0,0,67,9,0,101,0,1,0
56424,9899,2020-11-18T16:22:00.5333985Z,2020,136,34,124,76,0,7mo,0,2,60,0,0,102,12,0,136,1,0,0
56424,9900,2020-11-18T16:22:00.534399Z,2020,107,36,92,53,0,8vo,0,0,54,0,0,71,15,0,107,4,1,0
56424,9901,2020-11-18T16:22:01.5210576Z,2020,8,7,6,3,0,Sin Grado,0,0,5,0,0,1,2,0,8,0,0,0
60228,10129,2020-11-18T16:22:02.6988386Z,2020,25,2,23,21,0,1ro,0,0,4,0,0,23,2,0,25,0,0,0
60228,10130,2020-11-18T16:22:02.6988386Z,2020,38,16,36,15,0,2do,1,0,23,0,0,22,2,0,36,0,1,1
60228,10131,2020-11-18T16:22:02.6998391Z,2020,44,15,37,24,0,3ro,0,0,20,0,0,29,7,0,44,0,0,0
60228,10132,2020-11-18T16:22:02.6998391Z,2020,34,11,30,17,0,4to,0,0,17,0,0,23,4,0,34,0,0,0
60228,10133,2020-11-18T16:22:02.6998391Z,2020,36,11,29,24,0,5to,0,0,12,0,0,25,7,0,36,0,0,0
60228,10134,2020-11-18T16:22:02.6998391Z,2020,40,12,34,24,0,6to,0,0,16,0,0,28,6,0,40,0,0,0
60228,10135,2020-11-18T16:22:02.70084Z,2020,28,6,21,14,0,K,0,0,14,0,0,22,7,0,28,0,0,0
60228,10136,2020-11-18T16:22:02.70084Z,2020,4,3,2,1,0,Sin Grado,0,0,3,0,0,1,2,0,4,0,0,0
60228,34146,2021-06-24T13:18:37.4483087Z,2021,27,5,24,13,0,1ro,0,0,14,0,0,22,3,0,27,0,0,0
60228,34147,2021-06-24T13:18:37.4493088Z,2021,24,3,24,17,0,2do,0,0,7,0,0,21,0,0,24,0,0,0
60228,34148,2021-06-24T13:18:37.4493088Z,2021,37,12,34,16,0,3ro,0,0,21,0,0,25,3,0,37,0,0,0
60228,34149,2021-06-24T13:18:37.4493088Z,2021,45,16,36,22,0,4to,0,0,23,0,0,29,9,0,45,0,0,0
60228,34150,2021-06-24T13:18:37.4493088Z,2021,27,11,22,15,0,5to,0,0,12,0,0,16,5,0,27,0,0,0
60228,34151,2021-06-24T13:18:37.4493088Z,2021,41,12,32,24,0,6to,0,0,17,0,0,29,9,0,41,0,0,0
60228,34152,2021-06-24T13:18:37.4503102Z,2021,26,3,26,14,0,K,0,0,12,0,0,23,0,0,26,0,0,0
60228,34153,2021-06-24T13:18:37.4503102Z,2021,2,2,2,0,0,Sin Grado,0,0,2,0,0,0,0,0,2,0,0,0
60228,4110,2020-11-18T16:21:07.9903629Z,2019,38,13,35,13,0,1ro,0,3,25,0,0,25,3,0,37,0,1,1
60228,4111,2020-11-18T16:21:07.9903629Z,2019,36,12,29,19,1,2do,0,1,17,0,0,24,7,0,36,0,0,0
60228,4112,2020-11-18T16:21:07.9903629Z,2019,30,8,25,13,0,3ro,0,1,17,0,0,22,5,0,30,0,0,0
60228,4113,2020-11-18T16:21:07.9913625Z,2019,34,11,28,21,0,4to,0,0,13,0,0,23,6,0,34,0,0,0
60228,4114,2020-11-18T16:21:07.9913625Z,2019,30,11,23,17,0,5to,0,0,13,0,0,19,7,0,30,0,0,0
60228,4115,2020-11-18T16:21:07.9913625Z,2019,25,3,21,23,0,K,0,0,2,0,0,22,4,0,25,0,0,0
60228,4116,2020-11-18T16:21:07.9923633Z,2019,5,5,3,1,1,Sin Grado,0,1,4,0,0,0,2,0,5,0,0,0
65078,10704,2020-11-18T16:22:06.0110514Z,2020,63,9,60,35,0,1ro,1,0,28,0,0,54,3,0,62,0,0,0
65078,10705,2020-11-18T16:22:06.0110514Z,2020,41,7,41,20,0,2do,1,0,21,0,0,34,0,0,39,0,0,1
65078,10706,2020-11-18T16:22:06.0120527Z,2020,56,17,52,24,0,3ro,1,0,32,0,0,39,4,0,54,0,0,1
65078,10707,2020-11-18T16:22:06.0120527Z,2020,59,20,52,26,0,4to,0,0,33,0,0,39,7,0,59,0,0,0
65078,10708,2020-11-18T16:22:06.0120527Z,2020,53,14,47,26,0,5to,1,0,27,0,0,39,6,0,51,0,0,1
65078,10709,2020-11-18T16:22:06.0130523Z,2020,39,3,37,22,0,K,0,0,17,0,0,36,2,0,39,0,0,0
65078,10710,2020-11-18T16:22:06.0130523Z,2020,34,34,31,8,0,Sin Grado,1,0,26,0,0,0,3,0,33,0,1,0
65078,34721,2021-06-24T13:18:41.4541805Z,2021,46,6,43,27,0,1ro,0,0,19,0,0,40,3,0,46,0,0,0
65078,34722,2021-06-24T13:18:41.4541805Z,2021,54,8,52,31,0,2do,1,0,23,0,0,46,2,0,53,0,0,0
65078,34723,2021-06-24T13:18:41.4541805Z,2021,40,5,39,20,0,3ro,2,0,20,0,0,35,1,0,38,0,0,0
65078,34724,2021-06-24T13:18:41.4551823Z,2021,54,17,46,25,0,4to,0,0,29,0,0,37,8,0,54,0,0,0
65078,34725,2021-06-24T13:18:41.4551823Z,2021,53,17,51,21,0,5to,0,0,32,0,0,36,2,0,53,0,0,0
65078,34726,2021-06-24T13:18:41.4551823Z,2021,45,2,41,28,0,K,1,0,17,0,0,43,4,0,44,0,0,0
65078,34727,2021-06-24T13:18:41.4551823Z,2021,40,40,39,10,0,Sin Grado,0,0,30,0,0,0,1,0,40,0,0,0
65078,4692,2020-11-18T16:21:11.2705469Z,2019,54,10,52,21,0,1ro,1,0,33,0,0,44,2,0,53,0,0,0
65078,4693,2020-11-18T16:21:11.2715478Z,2019,54,16,44,21,0,2do,1,0,33,0,0,38,10,0,53,0,0,0
65078,4694,2020-11-18T16:21:11.2715478Z,2019,67,19,61,30,0,3ro,0,0,37,0,0,48,6,0,67,0,0,0
65078,4695,2020-11-18T16:21:11.2715478Z,2019,58,15,52,27,0,4to,2,0,31,0,0,43,6,0,56,0,0,0
65078,4696,2020-11-18T16:21:11.2725478Z,2019,48,12,43,26,0,5to,0,0,22,0,0,36,5,0,48,0,0,0
65078,4697,2020-11-18T16:21:11.2725478Z,2019,59,11,59,31,0,K,0,0,28,0,0,48,0,0,59,0,0,0
65078,4698,2020-11-18T16:21:11.2725478Z,2019,35,35,33,9,0,Sin Grado,0,0,26,0,0,0,2,0,35,0,1,0
70508,11034,2020-11-18T16:22:07.6211221Z,2020,174,69,117,99,0,6to,5,1,75,0,0,105,57,0,169,2,1,0
70508,11035,2020-11-18T16:22:07.6221221Z,2020,182,43,121,85,0,7mo,4,0,97,0,0,139,61,0,178,0,2,0
70508,11036,2020-11-18T16:22:07.6221221Z,2020,185,66,132,99,0,8vo,0,1,86,0,0,119,53,0,185,2,1,0
70508,35055,2021-06-24T13:18:43.7087979Z,2021,151,64,127,72,0,6to,0,0,79,0,0,87,24,0,151,0,0,0
70508,35056,2021-06-24T13:18:43.7097988Z,2021,172,65,138,95,0,7mo,6,1,77,0,0,107,34,0,166,2,1,0
70508,35057,2021-06-24T13:18:43.7097988Z,2021,169,40,121,78,0,8vo,4,0,91,0,0,129,48,0,165,0,2,0
70508,5026,2020-11-18T16:21:13.4179819Z,2019,186,44,118,85,0,6to,4,1,101,0,0,142,68,0,182,0,2,0
70508,5027,2020-11-18T16:21:13.4179819Z,2019,206,76,149,106,0,7mo,1,11,100,0,0,130,57,0,205,2,2,0
70508,5028,2020-11-18T16:21:13.4179819Z,2019,181,62,114,100,0,8vo,1,5,81,0,0,119,67,0,180,0,0,0
69112,10854,2020-11-18T16:22:06.5404048Z,2020,60,18,57,37,0,1ro,0,0,23,0,0,42,3,0,60,0,0,0
69112,10855,2020-11-18T16:22:06.5404048Z,2020,51,17,49,25,0,2do,0,0,26,0,0,34,2,0,51,0,0,0
69112,10856,2020-11-18T16:22:06.5414052Z,2020,48,13,42,21,0,3ro,1,0,27,0,0,35,6,0,46,0,0,1
69112,10857,2020-11-18T16:22:06.5414052Z,2020,60,27,54,21,0,4to,0,1,39,0,0,33,6,0,60,0,0,0
69112,10858,2020-11-18T16:22:06.5414052Z,2020,43,18,35,18,0,5to,1,1,25,0,0,25,8,0,42,0,0,0
69112,10859,2020-11-18T16:22:06.5414052Z,2020,71,18,62,25,0,6to,1,0,46,0,0,53,9,0,70,0,0,0
69112,10860,2020-11-18T16:22:06.5414052Z,2020,46,7,43,22,0,K,0,0,24,0,0,39,3,0,46,0,0,0
69112,10861,2020-11-18T16:22:06.5424079Z,2020,27,27,25,8,0,Sin Grado,0,2,19,0,0,0,2,0,26,0,0,1
69112,34875,2021-06-24T13:18:42.9572583Z,2021,49,5,47,25,0,1ro,0,0,24,0,0,44,2,0,49,0,0,0
69112,34876,2021-06-24T13:18:42.9572583Z,2021,54,19,52,32,0,2do,0,0,22,0,0,35,2,0,54,0,0,0
69112,34877,2021-06-24T13:18:42.9572583Z,2021,53,20,49,28,0,3ro,0,0,25,0,0,33,4,0,53,0,0,0
69112,34878,2021-06-24T13:18:42.9572583Z,2021,45,16,38,21,0,4to,0,0,24,0,0,29,7,0,45,0,0,0
69112,34879,2021-06-24T13:18:42.9582597Z,2021,59,24,49,23,0,5to,0,0,36,0,0,35,10,0,59,0,0,0
69112,34880,2021-06-24T13:18:42.9582597Z,2021,59,24,47,23,0,6to,2,0,36,0,0,35,12,0,57,0,0,0
69112,34881,2021-06-24T13:18:42.9582597Z,2021,101,27,88,39,0,7mo,1,0,62,0,0,74,13,0,100,0,0,0
69112,34882,2021-06-24T13:18:42.9592597Z,2021,51,15,49,28,0,K,1,0,23,0,0,36,2,0,50,0,0,0
69112,34883,2021-06-24T13:18:42.9592597Z,2021,26,26,23,8,0,Sin Grado,0,0,18,0,0,0,3,0,26,0,0,0
69112,4847,2020-11-18T16:21:12.3912965Z,2019,78,30,73,40,0,1ro,0,3,38,0,0,48,5,0,78,0,0,0
69112,4848,2020-11-18T16:21:12.3912965Z,2019,33,11,29,12,0,2do,1,0,21,0,0,22,4,0,32,0,0,0
69112,4849,2020-11-18T16:21:12.3922969Z,2019,56,24,50,23,0,3ro,0,0,33,0,0,32,6,0,56,0,0,0
69112,4850,2020-11-18T16:21:12.3922969Z,2019,50,18,42,23,0,4to,0,1,27,0,0,32,8,0,50,0,0,0
69112,4851,2020-11-18T16:21:12.3922969Z,2019,62,19,58,18,0,5to,0,1,44,0,0,43,4,0,62,0,0,0
69112,4852,2020-11-18T16:21:12.3932974Z,2019,46,9,45,29,0,K,0,1,17,0,0,37,1,0,46,0,0,0
69112,4853,2020-11-18T16:21:12.3932974Z,2019,13,13,13,4,0,Sin Grado,0,0,9,0,0,0,0,0,13,0,0,0
12096,293,2020-11-18T16:20:38.7998932Z,2019,87,30,79,53,0,6to,2,0,34,0,0,57,8,0,85,0,0,0
12096,294,2020-11-18T16:20:38.8008945Z,2019,81,37,75,44,0,7mo,1,1,37,0,0,44,6,0,80,0,0,0
12096,295,2020-11-18T16:20:38.8008945Z,2019,83,24,78,34,0,8vo,1,2,49,0,0,59,5,0,82,0,0,0
12096,296,2020-11-18T16:20:38.8008945Z,2019,15,14,14,1,0,Sin Grado,0,0,14,0,0,1,1,0,15,0,0,0
12096,30291,2021-06-24T13:18:07.1555811Z,2021,85,44,75,41,0,6to,4,0,44,0,0,41,10,0,81,0,0,0
12096,30292,2021-06-24T13:18:07.1565811Z,2021,69,31,63,36,0,7mo,3,0,33,0,0,38,6,0,66,0,0,0
12096,30293,2021-06-24T13:18:07.1565811Z,2021,70,23,59,39,0,8vo,2,0,31,0,0,47,11,0,68,0,0,0
12096,30294,2021-06-24T13:18:07.1575821Z,2021,15,15,14,6,0,Sin Grado,0,0,9,0,0,0,1,0,15,0,0,0
12096,6294,2020-11-18T16:21:38.6438023Z,2020,76,32,72,38,0,6to,3,0,38,0,0,44,4,0,73,0,0,0
12096,6295,2020-11-18T16:21:38.6438023Z,2020,75,28,67,43,0,7mo,1,0,32,0,0,47,8,0,74,0,0,0
12096,6296,2020-11-18T16:21:38.6438023Z,2020,81,31,72,43,0,8vo,1,0,38,0,0,50,9,0,80,0,0,0
12096,6297,2020-11-18T16:21:38.6448023Z,2020,22,22,19,3,0,Sin Grado,0,0,19,0,0,0,3,0,22,0,0,0
20784,1081,2020-11-18T16:20:43.8192421Z,2019,25,9,23,13,0,1ro,0,2,12,0,0,16,2,0,25,0,0,0
20784,1082,2020-11-18T16:20:43.8202421Z,2019,16,7,16,2,0,2do,0,6,14,0,0,9,0,0,16,0,0,0
20784,1083,2020-11-18T16:20:43.8202421Z,2019,16,9,15,12,0,3ro,0,6,4,0,0,7,1,0,16,0,0,0
20784,1084,2020-11-18T16:20:43.8202421Z,2019,18,10,18,10,0,4to,0,5,8,0,0,8,0,0,18,0,0,0
20784,1085,2020-11-18T16:20:43.8212439Z,2019,15,5,13,8,0,5to,0,2,7,0,0,10,2,0,15,0,0,0
20784,1086,2020-11-18T16:20:43.8212439Z,2019,7,0,5,3,0,K,0,0,4,0,0,7,2,0,7,0,0,0
20784,1087,2020-11-18T16:20:43.8212439Z,2019,23,1,18,14,0,PK,0,0,9,0,0,22,5,0,23,0,0,0
20784,31081,2021-06-24T13:18:12.0891196Z,2021,16,1,15,6,0,1ro,0,1,10,0,0,15,1,0,16,0,0,0
20784,31082,2021-06-24T13:18:12.0891196Z,2021,13,3,11,6,0,2do,0,1,7,0,0,10,2,0,13,0,0,0
20784,31083,2021-06-24T13:18:12.0891196Z,2021,25,11,20,13,0,3ro,0,0,12,0,0,14,5,0,25,0,0,0
20784,31084,2021-06-24T13:18:12.0901197Z,2021,13,5,12,3,0,4to,0,1,10,0,0,8,1,0,13,0,0,0
20784,31085,2021-06-24T13:18:12.0901197Z,2021,18,10,15,13,0,5to,0,1,5,0,0,8,3,0,18,0,0,0
20784,31086,2021-06-24T13:18:12.0901197Z,2021,25,10,20,13,0,K,0,1,12,0,0,15,5,0,25,0,0,0
20784,31087,2021-06-24T13:18:12.0911197Z,2021,27,3,21,7,0,PK,1,0,20,0,0,24,6,0,26,0,0,0
20784,7085,2020-11-18T16:21:43.645136Z,2020,10,2,8,5,0,1ro,0,0,5,0,0,8,2,0,10,0,0,0
20784,7086,2020-11-18T16:21:43.645136Z,2020,22,10,19,12,0,2do,0,0,10,0,0,12,3,0,22,0,0,0
20784,7087,2020-11-18T16:21:43.645136Z,2020,12,4,12,2,0,3ro,0,1,10,0,0,8,0,0,12,0,0,0
20784,7088,2020-11-18T16:21:43.6461365Z,2020,16,10,14,11,0,4to,0,1,5,0,0,6,2,0,16,0,0,0
20784,7089,2020-11-18T16:21:43.6461365Z,2020,15,9,14,7,0,5to,0,1,8,0,0,6,1,0,15,0,0,0
20784,7090,2020-11-18T16:21:43.6461365Z,2020,13,1,13,7,0,K,0,0,6,0,0,12,0,0,13,0,0,0
20784,7091,2020-11-18T16:21:43.6461365Z,2020,33,6,27,16,0,PK,1,0,17,0,0,27,6,0,32,0,0,0
21550,1218,2020-11-18T16:20:45.0820839Z,2019,69,19,40,43,0,10mo,0,3,26,0,0,50,29,0,69,0,0,0
21550,1219,2020-11-18T16:20:45.0820839Z,2019,44,12,25,16,0,11mo,0,0,28,0,0,32,19,0,44,0,0,0
21550,1220,2020-11-18T16:20:45.0820839Z,2019,49,10,32,22,0,6to,0,2,27,0,0,39,17,0,49,0,0,0
21550,1221,2020-11-18T16:20:45.0820839Z,2019,89,21,58,44,0,7mo,0,3,45,0,0,68,31,0,89,0,0,0
21550,1222,2020-11-18T16:20:45.0830844Z,2019,72,12,44,40,0,8vo,0,1,32,0,0,60,28,0,72,0,0,0
21550,1223,2020-11-18T16:20:45.0830844Z,2019,82,17,51,40,0,9no,1,1,42,0,0,65,31,0,81,0,0,0
21550,1224,2020-11-18T16:20:45.0830844Z,2019,51,48,41,11,0,Sin Grado,1,1,40,0,0,3,10,0,50,0,1,0
21550,31218,2021-06-24T13:18:14.0064931Z,2021,60,8,36,31,0,10mo,0,1,29,0,0,52,24,0,60,1,0,0
21550,31219,2021-06-24T13:18:14.0064931Z,2021,59,9,43,31,0,11mo,0,1,28,0,0,50,16,0,59,0,0,0
21550,31220,2021-06-24T13:18:14.0064931Z,2021,62,15,47,41,0,12mo,0,0,21,0,0,47,15,0,62,0,0,0
21550,31221,2021-06-24T13:18:14.0064931Z,2021,54,13,38,25,0,6to,1,1,29,0,0,41,16,0,53,0,0,0
21550,31222,2021-06-24T13:18:14.007495Z,2021,55,5,30,28,0,7mo,0,0,27,0,0,50,25,0,55,0,0,0
21550,31223,2021-06-24T13:18:14.007495Z,2021,49,9,29,21,0,8vo,0,0,28,0,0,40,20,0,49,0,0,0
21550,31224,2021-06-24T13:18:14.007495Z,2021,106,50,87,53,0,9no,0,6,53,0,0,56,19,0,106,0,1,0
21550,31225,2021-06-24T13:18:14.007495Z,2021,7,7,7,1,0,Sin Grado,0,1,6,0,0,0,0,0,7,0,0,0
21550,7222,2020-11-18T16:21:44.5877662Z,2020,62,9,35,31,0,10mo,0,0,31,0,0,53,27,0,62,0,0,0
21550,7223,2020-11-18T16:21:44.5877662Z,2020,62,15,36,41,0,11mo,0,0,21,0,0,47,26,0,62,0,0,0
21550,7224,2020-11-18T16:21:44.5887662Z,2020,45,11,29,16,0,12mo,0,0,29,0,0,34,16,0,45,0,0,0
21550,7225,2020-11-18T16:21:44.5887662Z,2020,48,4,20,27,0,6to,0,1,21,0,0,44,28,0,48,0,0,0
21550,7226,2020-11-18T16:21:44.5897671Z,2020,48,9,26,22,0,7mo,0,0,26,0,0,39,22,0,48,0,0,0
21550,7227,2020-11-18T16:21:44.5897671Z,2020,79,17,48,42,0,8vo,0,3,37,0,0,62,31,0,79,0,0,0
21550,7228,2020-11-18T16:21:44.5897671Z,2020,63,9,34,34,0,9no,0,1,29,0,0,54,29,0,63,1,0,0
21550,7229,2020-11-18T16:21:44.5897671Z,2020,50,50,41,13,0,Sin Grado,0,3,37,0,0,0,9,0,50,0,1,0
60335,10143,2020-11-18T16:22:02.7048435Z,2020,25,7,22,13,0,1ro,0,0,12,0,0,18,3,0,25,0,0,0
60335,10144,2020-11-18T16:22:02.7048435Z,2020,25,11,23,10,0,2do,0,0,15,0,0,14,2,0,25,0,0,0
60335,10145,2020-11-18T16:22:02.7048435Z,2020,35,8,28,15,0,3ro,0,0,20,0,0,27,7,0,35,0,0,0
60335,10146,2020-11-18T16:22:02.7058435Z,2020,38,13,34,20,0,4to,0,0,18,0,0,25,4,0,38,0,0,0
60335,10147,2020-11-18T16:22:02.7058435Z,2020,39,10,35,19,0,5to,0,0,20,0,0,29,4,0,39,0,0,0
60335,10148,2020-11-18T16:22:02.7058435Z,2020,51,15,44,24,0,6to,0,0,27,0,0,36,7,0,51,0,0,0
60335,10149,2020-11-18T16:22:02.7058435Z,2020,45,16,40,22,0,7mo,0,0,23,0,0,29,5,0,45,0,0,0
60335,10150,2020-11-18T16:22:02.7058435Z,2020,42,16,37,12,0,8vo,0,0,30,0,0,26,5,0,42,0,0,0
60335,10151,2020-11-18T16:22:02.7058435Z,2020,31,8,30,19,0,K,0,0,12,0,0,23,1,0,31,0,0,0
60335,10152,2020-11-18T16:22:02.7068439Z,2020,6,6,4,1,0,Sin Grado,0,0,5,0,0,0,2,0,6,0,0,0
60335,34160,2021-06-24T13:18:37.4693236Z,2021,31,12,27,19,0,1ro,0,1,12,0,0,19,4,0,31,0,0,0
60335,34161,2021-06-24T13:18:37.4693236Z,2021,26,9,20,12,0,2do,0,1,14,0,0,17,6,0,26,0,0,0
60335,34162,2021-06-24T13:18:37.4703245Z,2021,22,14,20,7,0,3ro,0,1,15,0,0,8,2,0,22,0,0,0
60335,34163,2021-06-24T13:18:37.4703245Z,2021,36,11,29,16,0,4to,0,0,20,0,0,25,7,0,36,0,0,0
60335,34164,2021-06-24T13:18:37.4703245Z,2021,37,11,29,20,0,5to,1,0,17,0,0,26,8,0,36,0,0,0
60335,34165,2021-06-24T13:18:37.4703245Z,2021,38,10,33,18,0,6to,1,0,20,0,0,28,5,0,37,0,0,0
60335,34166,2021-06-24T13:18:37.471325Z,2021,43,11,39,20,0,7mo,0,0,23,0,0,32,4,0,43,0,0,0
60335,34167,2021-06-24T13:18:37.471325Z,2021,44,16,38,23,0,8vo,0,0,21,0,0,28,6,0,44,0,0,0
60335,34168,2021-06-24T13:18:37.471325Z,2021,24,4,21,15,0,K,0,0,9,0,0,20,3,0,24,0,0,0
60335,34169,2021-06-24T13:18:37.471325Z,2021,6,6,5,1,0,Sin Grado,0,0,5,0,0,0,1,0,6,0,0,0
60335,4123,2020-11-18T16:21:07.9963665Z,2019,34,18,30,14,0,1ro,1,4,20,0,0,16,4,0,33,0,0,0
60335,4124,2020-11-18T16:21:07.9963665Z,2019,34,9,24,15,0,2do,0,2,19,0,0,25,10,0,34,0,0,0
60335,4125,2020-11-18T16:21:07.9963665Z,2019,46,14,40,19,0,3ro,0,3,27,0,0,32,6,0,46,0,0,0
60335,4126,2020-11-18T16:21:07.9973674Z,2019,36,8,31,18,0,4to,0,2,18,0,0,28,5,0,36,0,0,0
60335,4127,2020-11-18T16:21:07.9973674Z,2019,42,12,36,17,0,5to,0,0,25,0,0,30,6,0,42,0,0,0
60335,4128,2020-11-18T16:21:07.9983696Z,2019,52,19,45,26,0,6to,0,0,26,0,0,33,7,0,52,0,0,0
60335,4129,2020-11-18T16:21:07.9983696Z,2019,42,16,37,11,0,7mo,0,0,31,0,0,26,5,0,42,0,0,0
60335,4130,2020-11-18T16:21:07.9983696Z,2019,43,13,40,19,0,8vo,0,0,24,0,0,30,3,0,43,0,0,0
60335,4131,2020-11-18T16:21:07.9993687Z,2019,21,2,19,12,0,K,0,0,9,0,0,19,2,0,21,0,0,0
60335,4132,2020-11-18T16:21:07.9993687Z,2019,6,6,4,1,0,Sin Grado,0,0,5,0,0,0,2,0,6,0,0,0
31252,1931,2020-11-18T16:20:53.3976282Z,2019,50,8,46,24,0,1ro,1,0,26,0,0,42,4,0,47,0,0,2
31252,1932,2020-11-18T16:20:53.3976282Z,2019,42,5,37,19,0,2do,0,0,23,0,0,37,5,1,41,0,0,0
31252,1933,2020-11-18T16:20:53.3976282Z,2019,49,2,48,25,0,3ro,0,0,24,0,0,47,1,1,48,0,0,0
31252,1934,2020-11-18T16:20:53.398629Z,2019,41,4,39,15,0,4to,1,0,26,0,0,37,2,2,38,0,1,0
31252,1935,2020-11-18T16:20:53.398629Z,2019,31,10,29,14,0,5to,0,0,17,0,0,21,2,0,31,0,0,0
31252,1936,2020-11-18T16:20:53.398629Z,2019,43,3,34,35,0,K,0,0,8,0,0,40,9,0,43,0,0,0
31252,1937,2020-11-18T16:20:53.398629Z,2019,13,1,9,5,0,PK,0,0,8,0,0,12,4,0,13,0,0,0
31252,31939,2021-06-24T13:18:18.6798438Z,2021,35,5,34,16,0,1ro,0,0,19,0,0,30,1,0,35,0,0,0
31252,31940,2021-06-24T13:18:18.6798438Z,2021,53,7,52,25,0,2do,0,0,28,0,0,46,1,0,52,0,0,1
31252,31941,2021-06-24T13:18:18.6808451Z,2021,39,7,37,21,0,3ro,0,0,18,0,0,32,2,0,38,0,0,1
31252,31942,2021-06-24T13:18:18.6808451Z,2021,44,6,40,19,0,4to,0,0,25,0,0,38,4,1,43,0,0,0
31252,31943,2021-06-24T13:18:18.6808451Z,2021,43,3,42,21,0,5to,0,0,22,0,0,40,1,1,42,0,1,0
31252,31944,2021-06-24T13:18:18.6808451Z,2021,39,4,31,16,0,K,0,0,23,0,0,35,8,1,37,0,0,1
31252,31945,2021-06-24T13:18:18.6818452Z,2021,16,1,14,7,0,PK,0,0,9,0,0,15,2,2,14,0,0,0
31252,31946,2021-06-24T13:18:18.6818452Z,2021,2,2,2,1,0,Sin Grado,0,0,1,0,0,0,0,0,2,0,0,0
31252,7942,2020-11-18T16:21:49.1317947Z,2020,52,6,51,24,0,1ro,0,0,28,0,0,46,1,0,51,0,0,1
31252,7943,2020-11-18T16:21:49.1317947Z,2020,36,4,35,19,0,2do,0,0,17,0,0,32,1,0,35,0,0,1
31252,7944,2020-11-18T16:21:49.1317947Z,2020,46,5,41,21,0,3ro,0,0,25,0,0,41,5,1,45,0,0,0
31252,7945,2020-11-18T16:21:49.1327951Z,2020,46,2,45,24,0,4to,0,0,22,0,0,44,1,1,45,0,0,0
31252,7946,2020-11-18T16:21:49.1327951Z,2020,34,3,33,14,0,5to,1,0,20,0,0,31,1,1,32,0,0,0
31252,7947,2020-11-18T16:21:49.1327951Z,2020,36,3,33,16,0,K,0,0,20,0,0,33,3,0,36,0,0,0
31252,7948,2020-11-18T16:21:49.1327951Z,2020,16,0,14,6,0,PK,0,0,10,0,0,16,2,0,16,0,0,0
31252,7949,2020-11-18T16:21:49.133796Z,2020,4,4,4,1,0,Sin Grado,0,0,3,0,0,0,0,0,4,0,0,0
10355,28,2020-11-18T16:20:36.7315182Z,2019,50,17,50,28,0,1ro,1,1,22,0,0,33,0,0,49,0,0,0
10355,29,2020-11-18T16:20:36.7315182Z,2019,36,20,36,12,0,2do,0,0,24,0,0,16,0,0,36,0,0,0
10355,30,2020-11-18T16:20:36.7315182Z,2019,33,13,33,17,0,3ro,0,0,16,0,0,20,0,0,33,0,0,0
10355,30028,2021-06-24T13:18:05.8186229Z,2021,41,16,41,20,0,1ro,1,0,21,0,0,25,0,0,40,0,0,0
10355,30029,2021-06-24T13:18:05.8196234Z,2021,40,17,39,21,0,2do,0,0,19,0,0,23,1,0,40,0,0,0
10355,30030,2021-06-24T13:18:05.8196234Z,2021,28,4,28,12,0,3ro,0,0,16,0,0,24,0,0,28,1,0,0
10355,30031,2021-06-24T13:18:05.8196234Z,2021,31,17,31,11,0,4to,0,0,20,0,0,14,0,0,31,0,0,0
10355,30032,2021-06-24T13:18:05.8196234Z,2021,27,9,27,15,0,5to,1,0,12,0,0,18,0,0,26,0,0,0
10355,30033,2021-06-24T13:18:05.8206239Z,2021,30,11,29,12,0,K,1,0,18,0,0,19,1,1,28,0,0,0
10355,30034,2021-06-24T13:18:05.8206239Z,2021,8,0,2,6,0,PK,0,0,2,0,0,8,6,0,8,0,0,0
10355,30035,2021-06-24T13:18:05.8216244Z,2021,26,26,23,4,0,Sin Grado,1,0,22,0,0,0,3,0,25,0,1,0
10355,31,2020-11-18T16:20:36.7315182Z,2019,26,6,25,14,0,4to,2,0,12,0,0,20,1,0,24,0,0,0
10355,32,2020-11-18T16:20:36.7315182Z,2019,31,14,30,20,0,5to,1,0,11,0,0,17,1,0,30,0,0,0
10355,33,2020-11-18T16:20:36.7325195Z,2019,47,16,46,26,0,K,3,1,21,0,0,31,1,0,44,0,0,0
10355,34,2020-11-18T16:20:36.7325195Z,2019,42,38,38,11,0,Sin Grado,0,0,31,0,0,4,4,0,42,0,1,0
10355,6029,2020-11-18T16:21:37.6811579Z,2020,47,18,46,27,0,1ro,2,0,20,0,0,29,1,0,45,0,0,0
10355,6030,2020-11-18T16:21:37.6811579Z,2020,31,4,31,17,0,2do,0,1,14,0,0,27,0,0,31,0,0,0
10355,6031,2020-11-18T16:21:37.6811579Z,2020,38,20,38,15,0,3ro,0,0,23,0,0,18,0,0,38,0,0,0
10355,6032,2020-11-18T16:21:37.6821592Z,2020,25,7,24,16,0,4to,0,0,9,0,0,18,1,0,25,0,0,0
10355,6033,2020-11-18T16:21:37.6821592Z,2020,32,5,30,18,0,5to,2,0,14,0,0,27,2,0,30,0,0,0
10355,6034,2020-11-18T16:21:37.6821592Z,2020,49,17,48,25,0,K,1,0,24,0,0,32,1,0,48,0,0,0
10355,6035,2020-11-18T16:21:37.6821592Z,2020,12,0,3,5,0,PK,0,0,7,0,0,12,9,0,12,0,0,0
10355,6036,2020-11-18T16:21:37.6831597Z,2020,31,31,29,6,0,Sin Grado,1,0,25,0,0,0,2,0,30,0,1,0
35972,2422,2020-11-18T16:20:56.2795532Z,2019,38,9,27,13,0,10mo,1,1,25,0,0,29,11,0,37,0,0,0
35972,2423,2020-11-18T16:20:56.2795532Z,2019,34,9,30,17,0,11mo,0,0,17,0,0,25,4,0,34,0,0,0
35972,2424,2020-11-18T16:20:56.2795532Z,2019,37,0,31,19,0,12mo,0,1,18,0,1,37,6,0,37,0,0,0
35972,2425,2020-11-18T16:20:56.2805523Z,2019,36,7,18,17,0,1ro,1,0,19,0,0,29,18,0,35,0,0,0
35972,2426,2020-11-18T16:20:56.2805523Z,2019,39,10,33,20,0,2do,0,1,19,0,0,29,6,1,38,0,0,0
35972,2427,2020-11-18T16:20:56.2805523Z,2019,33,10,22,20,0,3ro,2,4,13,0,0,23,11,1,30,0,0,0
35972,2428,2020-11-18T16:20:56.2815532Z,2019,42,6,31,21,0,4to,2,0,21,0,0,36,11,0,40,0,0,0
35972,2429,2020-11-18T16:20:56.2815532Z,2019,47,13,38,23,0,5to,1,0,24,0,0,34,9,0,46,0,0,0
35972,2430,2020-11-18T16:20:56.2815532Z,2019,40,6,32,19,0,6to,0,0,21,0,0,34,8,1,39,0,1,0
35972,2431,2020-11-18T16:20:56.2825541Z,2019,41,6,33,18,0,7mo,1,0,23,0,0,35,8,0,40,0,1,0
35972,2432,2020-11-18T16:20:56.2825541Z,2019,50,11,37,17,0,8vo,1,1,33,0,0,39,13,0,49,0,0,0
35972,2433,2020-11-18T16:20:56.2835541Z,2019,29,8,26,14,0,9no,0,0,15,0,0,21,3,0,29,0,0,0
35972,2434,2020-11-18T16:20:56.2835541Z,2019,34,8,3,19,0,K,0,0,15,0,0,26,31,0,34,0,0,0
35972,2435,2020-11-18T16:20:56.2835541Z,2019,23,18,17,8,0,Sin Grado,0,2,15,0,0,5,6,0,23,0,0,0
35972,32429,2021-06-24T13:18:24.7141751Z,2021,35,10,29,16,0,10mo,1,1,19,0,0,25,6,0,34,0,0,0
35972,32430,2021-06-24T13:18:24.7141751Z,2021,25,6,21,11,0,11mo,0,0,14,0,0,19,4,0,25,0,0,0
35972,32431,2021-06-24T13:18:24.7151761Z,2021,29,5,23,8,0,12mo,0,0,21,0,0,24,6,0,29,0,0,0
35972,32432,2021-06-24T13:18:24.7151761Z,2021,20,3,17,10,0,1ro,0,0,10,0,0,17,3,0,20,0,0,0
35972,32433,2021-06-24T13:18:24.7161779Z,2021,30,9,25,14,0,2do,0,0,16,0,0,21,5,0,30,0,0,0
35972,32434,2021-06-24T13:18:24.7161779Z,2021,36,8,29,20,0,3ro,1,0,16,0,0,28,7,0,35,0,0,0
35972,32435,2021-06-24T13:18:24.7171771Z,2021,32,7,27,19,0,4to,0,0,13,0,0,25,5,0,32,0,0,0
35972,32436,2021-06-24T13:18:24.7171771Z,2021,20,6,16,15,0,5to,0,0,5,0,0,14,4,1,19,0,0,0
35972,32437,2021-06-24T13:18:24.719179Z,2021,43,8,32,21,0,6to,2,0,22,0,0,35,11,0,41,0,0,0
35972,32438,2021-06-24T13:18:24.719179Z,2021,43,12,34,19,0,7mo,0,0,24,0,0,31,9,0,43,0,0,0
35972,32439,2021-06-24T13:18:24.7201799Z,2021,37,6,27,17,0,8vo,0,0,20,0,0,31,10,0,37,0,1,0
35972,32440,2021-06-24T13:18:24.7201799Z,2021,34,4,29,12,0,9no,0,0,22,0,0,30,5,0,34,0,2,0
35972,32441,2021-06-24T13:18:24.7201799Z,2021,26,6,20,16,0,K,0,0,10,0,0,20,6,0,26,0,0,0
35972,32442,2021-06-24T13:18:24.7201799Z,2021,4,4,3,4,0,Sin Grado,0,0,0,0,0,0,1,0,4,0,0,0
35972,8434,2020-11-18T16:21:51.8035745Z,2020,27,7,24,11,0,10mo,0,0,16,0,0,20,3,0,27,0,0,0
35972,8435,2020-11-18T16:21:51.8045732Z,2020,34,9,25,12,0,11mo,0,0,22,0,0,25,9,0,34,0,0,0
35972,8436,2020-11-18T16:21:51.8045732Z,2020,32,8,29,16,0,12mo,0,0,16,0,0,24,3,0,32,0,0,0
35972,8437,2020-11-18T16:21:51.8045732Z,2020,34,10,24,12,0,1ro,0,0,22,0,0,24,10,0,34,0,0,0
35972,8438,2020-11-18T16:21:51.8055754Z,2020,37,7,28,18,0,2do,1,0,19,0,0,30,9,0,36,0,0,0
35972,8439,2020-11-18T16:21:51.8055754Z,2020,32,7,25,20,0,3ro,0,0,12,0,0,25,7,0,32,0,0,0
35972,8440,2020-11-18T16:21:51.8055754Z,2020,26,7,19,16,0,4to,1,0,10,0,0,19,7,1,24,0,0,0
35972,8441,2020-11-18T16:21:51.8065754Z,2020,44,6,33,21,0,5to,2,0,23,0,0,38,11,0,42,0,0,0
35972,8442,2020-11-18T16:21:51.8065754Z,2020,47,13,38,22,0,6to,1,0,25,0,0,34,9,0,46,0,0,0
35972,8443,2020-11-18T16:21:51.8065754Z,2020,37,7,27,17,0,7mo,0,0,20,0,0,30,10,1,36,0,1,0
35972,8444,2020-11-18T16:21:51.8075759Z,2020,36,3,29,16,0,8vo,1,0,20,0,0,33,7,0,35,0,1,0
35972,8445,2020-11-18T16:21:51.8075759Z,2020,37,11,30,15,0,9no,2,0,22,0,0,26,7,0,35,0,0,0
35972,8446,2020-11-18T16:21:51.8075759Z,2020,44,6,34,21,0,K,0,0,23,0,0,38,10,0,44,0,0,0
35972,8447,2020-11-18T16:21:51.8085763Z,2020,10,9,10,5,0,Sin Grado,0,1,5,0,0,1,0,0,10,0,0,0
34777,2261,2020-11-18T16:20:55.0147069Z,2019,44,14,42,20,0,1ro,0,0,24,0,0,30,2,0,44,0,0,0
34777,2262,2020-11-18T16:20:55.0147069Z,2019,36,13,35,15,0,2do,0,0,21,0,0,23,1,0,36,0,0,0
34777,2263,2020-11-18T16:20:55.0157074Z,2019,44,18,40,20,0,3ro,0,0,24,0,0,26,4,0,44,0,0,0
34777,2264,2020-11-18T16:20:55.0157074Z,2019,29,8,27,16,0,4to,0,0,13,0,0,21,2,0,29,0,0,0
34777,2265,2020-11-18T16:20:55.0157074Z,2019,45,11,42,28,0,5to,1,0,17,0,0,34,3,0,44,0,0,0
34777,2266,2020-11-18T16:20:55.0157074Z,2019,26,2,26,14,0,K,0,0,12,0,0,24,0,0,26,0,0,0
34777,2267,2020-11-18T16:20:55.0167087Z,2019,15,0,15,5,0,PK,0,0,10,0,0,15,0,0,15,0,0,0
34777,2268,2020-11-18T16:20:55.0167087Z,2019,28,27,27,12,0,Sin Grado,1,0,16,0,0,1,1,0,27,0,0,0
34777,32268,2021-06-24T13:18:21.7620534Z,2021,19,4,19,7,0,1ro,0,0,12,0,0,15,0,0,19,0,0,0
34777,32269,2021-06-24T13:18:21.7620534Z,2021,26,8,25,12,0,2do,0,0,14,0,0,18,1,0,26,0,0,0
34777,32270,2021-06-24T13:18:21.7620534Z,2021,31,9,29,16,0,3ro,0,0,15,0,0,22,2,0,31,0,0,0
34777,32271,2021-06-24T13:18:21.7620534Z,2021,24,9,23,8,0,4to,0,0,16,0,0,15,1,0,24,0,0,0
34777,32272,2021-06-24T13:18:21.7630544Z,2021,20,7,19,11,0,5to,0,0,9,0,0,13,1,0,20,0,0,0
34777,32273,2021-06-24T13:18:21.7630544Z,2021,23,2,23,10,0,K,0,0,13,0,0,21,0,0,23,0,0,0
34777,32274,2021-06-24T13:18:21.7630544Z,2021,8,0,7,4,0,PK,0,0,4,0,0,8,1,0,8,0,0,0
34777,32275,2021-06-24T13:18:21.7630544Z,2021,10,10,10,6,0,Sin Grado,0,2,4,0,0,0,0,0,10,0,0,0
34777,8273,2020-11-18T16:21:50.6978406Z,2020,33,8,31,15,0,1ro,0,0,18,0,0,25,2,0,33,0,0,0
34777,8274,2020-11-18T16:21:50.6978406Z,2020,34,10,33,18,0,2do,0,0,16,0,0,24,1,0,34,0,0,0
34777,8275,2020-11-18T16:21:50.6978406Z,2020,33,16,31,13,0,3ro,0,0,20,0,0,17,2,0,32,0,0,1
34777,8276,2020-11-18T16:21:50.6988419Z,2020,23,7,22,11,0,4to,0,0,12,0,0,16,1,0,22,0,0,1
34777,8277,2020-11-18T16:21:50.6988419Z,2020,23,6,22,12,0,5to,0,0,11,0,0,17,1,0,23,0,0,0
34777,8278,2020-11-18T16:21:50.6988419Z,2020,26,1,25,13,0,K,0,0,13,0,0,25,1,0,25,0,0,1
34777,8279,2020-11-18T16:21:50.6988419Z,2020,16,1,15,8,0,PK,0,0,8,0,0,15,1,0,16,0,0,0
34777,8280,2020-11-18T16:21:50.6988419Z,2020,25,25,23,14,0,Sin Grado,1,2,11,0,0,0,2,0,24,0,0,0
15446,30619,2021-06-24T13:18:10.6500864Z,2021,22,3,20,10,0,1ro,2,0,12,0,0,19,2,0,20,0,0,0
15446,30620,2021-06-24T13:18:10.6500864Z,2021,28,7,27,18,0,2do,1,0,10,0,0,21,1,0,27,0,0,0
15446,30621,2021-06-24T13:18:10.6500864Z,2021,35,7,33,12,0,3ro,0,0,23,0,0,28,2,0,35,0,1,0
15446,30622,2021-06-24T13:18:10.6500864Z,2021,23,8,19,8,0,4to,1,0,15,0,0,15,4,0,22,1,0,0
15446,30623,2021-06-24T13:18:10.6510869Z,2021,54,15,45,24,0,5to,1,0,30,0,0,39,9,0,53,1,0,0
15446,30624,2021-06-24T13:18:10.6510869Z,2021,113,34,95,44,0,6to,6,0,69,0,0,79,18,0,107,0,0,0
15446,30625,2021-06-24T13:18:10.6510869Z,2021,153,63,128,69,0,7mo,7,0,84,0,0,90,25,1,145,0,2,0
15446,30626,2021-06-24T13:18:10.6520883Z,2021,132,36,107,69,0,8vo,6,0,63,0,0,96,25,0,126,1,1,0
15446,30627,2021-06-24T13:18:10.6520883Z,2021,14,2,13,9,0,K,0,0,5,0,0,12,1,0,14,0,0,0
15446,30628,2021-06-24T13:18:10.6520883Z,2021,11,11,10,1,0,Sin Grado,1,0,10,0,0,0,1,0,10,0,0,0
15446,621,2020-11-18T16:20:41.1784837Z,2019,35,11,33,12,0,1ro,4,0,23,0,0,24,2,0,31,0,0,0
15446,622,2020-11-18T16:20:41.1784837Z,2019,31,10,24,11,0,2do,1,0,20,0,0,21,7,0,30,0,0,0
15446,623,2020-11-18T16:20:41.1784837Z,2019,57,14,48,23,0,3ro,0,0,34,0,1,43,9,0,57,2,0,0
15446,624,2020-11-18T16:20:41.1794841Z,2019,74,20,64,24,0,4to,2,0,50,0,0,54,10,0,72,0,0,0
15446,625,2020-11-18T16:20:41.1794841Z,2019,82,31,67,42,1,5to,4,1,40,0,1,51,15,0,78,0,1,0
15446,626,2020-11-18T16:20:41.1794841Z,2019,139,49,108,68,0,6to,6,0,71,0,1,90,31,0,133,1,1,0
15446,627,2020-11-18T16:20:41.1804841Z,2019,167,55,126,90,0,7mo,6,0,77,0,0,112,41,0,161,1,0,0
15446,628,2020-11-18T16:20:41.1804841Z,2019,141,39,100,72,0,8vo,5,0,69,0,0,102,41,0,136,0,0,0
15446,629,2020-11-18T16:20:41.1804841Z,2019,27,6,23,17,0,K,2,0,10,0,0,21,4,0,25,0,0,0
15446,630,2020-11-18T16:20:41.1804841Z,2019,34,30,24,5,0,Sin Grado,1,0,29,0,0,4,10,0,33,0,2,0
15446,6621,2020-11-18T16:21:40.7522099Z,2020,29,10,26,17,0,1ro,1,0,12,0,0,19,3,0,28,0,0,0
15446,6622,2020-11-18T16:21:40.7532108Z,2020,30,6,29,12,0,2do,2,0,18,0,0,24,1,0,28,0,0,0
15446,6623,2020-11-18T16:21:40.7532108Z,2020,28,10,22,9,0,3ro,1,0,19,0,0,18,6,0,27,1,0,0
15446,6624,2020-11-18T16:21:40.7532108Z,2020,57,17,47,25,0,4to,1,0,32,0,0,40,10,0,56,1,0,0
15446,6625,2020-11-18T16:21:40.7542108Z,2020,71,18,58,25,0,5to,3,0,46,0,0,53,13,0,68,0,0,0
15446,6626,2020-11-18T16:21:40.7542108Z,2020,149,62,117,70,0,6to,7,0,79,0,0,87,32,1,141,0,1,0
15446,6627,2020-11-18T16:21:40.7542108Z,2020,136,39,103,73,0,7mo,7,1,63,0,0,97,33,0,129,1,1,0
15446,6628,2020-11-18T16:21:40.7552117Z,2020,149,43,108,85,0,8vo,6,1,64,0,0,106,41,1,142,2,0,0
15446,6629,2020-11-18T16:21:40.7552117Z,2020,17,2,16,9,0,K,3,0,8,0,0,15,1,0,14,0,0,0
15446,6630,2020-11-18T16:21:40.7552117Z,2020,28,28,22,5,0,Sin Grado,2,0,23,0,0,0,6,0,26,0,0,0
31070,1908,2020-11-18T16:20:53.3936255Z,2019,27,9,26,13,0,1ro,0,1,14,0,0,18,1,0,27,0,0,0
31070,1909,2020-11-18T16:20:53.3946264Z,2019,31,5,26,13,0,2do,0,0,18,0,0,26,5,0,31,0,0,0
31070,1910,2020-11-18T16:20:53.3946264Z,2019,31,8,29,13,0,3ro,0,0,18,0,0,23,2,0,31,1,0,0
31070,1911,2020-11-18T16:20:53.3946264Z,2019,29,7,26,16,0,4to,1,0,13,0,0,22,3,0,28,0,0,0
31070,1912,2020-11-18T16:20:53.3946264Z,2019,27,6,25,14,0,5to,0,0,13,0,0,21,2,0,27,0,0,0
31070,1913,2020-11-18T16:20:53.3956273Z,2019,27,10,25,16,0,6to,0,0,11,0,0,17,2,0,27,0,0,0
31070,1914,2020-11-18T16:20:53.3956273Z,2019,33,11,29,15,0,7mo,0,0,18,0,0,22,4,0,33,0,0,0
31070,1915,2020-11-18T16:20:53.3956273Z,2019,35,9,29,17,0,8vo,0,0,18,0,0,26,6,0,35,0,0,0
31070,1916,2020-11-18T16:20:53.3966277Z,2019,30,5,28,22,0,K,0,0,8,0,0,25,2,0,30,0,0,0
31070,1917,2020-11-18T16:20:53.3966277Z,2019,14,1,12,7,0,PK,0,0,7,0,0,13,2,0,14,0,0,0
31070,1918,2020-11-18T16:20:53.3966277Z,2019,19,18,15,4,0,Sin Grado,0,0,15,0,0,1,4,1,18,0,0,0
31070,31913,2021-06-24T13:18:18.6738399Z,2021,29,4,27,15,0,1ro,0,0,14,0,0,25,2,0,29,0,0,0
31070,31914,2021-06-24T13:18:18.6738399Z,2021,21,6,21,11,0,2do,0,0,10,0,0,15,0,0,21,0,0,0
31070,31915,2021-06-24T13:18:18.6738399Z,2021,24,2,20,16,0,3ro,0,0,8,0,0,22,4,0,24,0,0,0
31070,31916,2021-06-24T13:18:18.6748404Z,2021,27,5,23,10,0,4to,0,0,17,0,0,22,4,0,27,0,0,0
31070,31917,2021-06-24T13:18:18.6748404Z,2021,29,10,25,12,0,5to,0,0,17,0,0,19,4,0,29,1,0,0
31070,31918,2021-06-24T13:18:18.6748404Z,2021,32,8,25,17,0,6to,1,0,15,0,0,24,7,0,31,0,0,0
31070,31919,2021-06-24T13:18:18.6748404Z,2021,28,7,24,14,0,7mo,0,0,14,0,0,21,4,0,28,1,0,0
31070,31920,2021-06-24T13:18:18.6758413Z,2021,25,5,21,14,0,8vo,0,0,11,0,0,20,4,0,25,0,0,0
31070,31921,2021-06-24T13:18:18.6758413Z,2021,23,4,18,10,0,K,0,0,13,0,0,19,5,0,23,0,0,0
31070,31922,2021-06-24T13:18:18.6758413Z,2021,6,0,5,3,0,PK,0,0,3,0,0,6,1,0,6,0,0,0
31070,31923,2021-06-24T13:18:18.6758413Z,2021,23,23,22,4,0,Sin Grado,1,0,19,0,0,0,1,0,22,0,0,0
31070,7916,2020-11-18T16:21:49.1277929Z,2020,23,5,21,12,0,1ro,0,0,11,0,0,18,2,0,23,0,0,0
31070,7917,2020-11-18T16:21:49.1277929Z,2020,26,4,25,16,0,2do,0,0,10,0,0,22,1,0,26,0,0,0
31070,7918,2020-11-18T16:21:49.1287929Z,2020,24,7,21,9,0,3ro,0,0,15,0,0,17,3,0,24,0,0,0
31070,7919,2020-11-18T16:21:49.1287929Z,2020,32,9,30,14,0,4to,0,0,18,0,0,23,2,0,32,1,0,0
31070,7920,2020-11-18T16:21:49.1287929Z,2020,30,8,27,15,0,5to,1,0,15,0,0,22,3,0,29,0,0,0
31070,7921,2020-11-18T16:21:49.1287929Z,2020,28,6,25,14,0,6to,0,0,14,0,0,22,3,0,28,1,0,0
31070,7922,2020-11-18T16:21:49.1297942Z,2020,29,8,25,19,0,7mo,0,0,10,0,0,21,4,0,29,0,0,0
31070,7923,2020-11-18T16:21:49.1297942Z,2020,28,9,22,12,0,8vo,0,0,16,0,0,19,6,0,28,0,0,0
31070,7924,2020-11-18T16:21:49.1297942Z,2020,35,5,32,18,0,K,0,0,17,0,0,30,3,1,34,0,0,0
31070,7925,2020-11-18T16:21:49.1307947Z,2020,11,0,11,3,0,PK,0,0,8,0,0,11,0,0,11,0,0,0
31070,7926,2020-11-18T16:21:49.1307947Z,2020,28,28,24,6,0,Sin Grado,1,0,22,0,0,0,4,0,27,0,0,0
22582,1332,2020-11-18T16:20:45.8876232Z,2019,123,22,93,59,0,10mo,3,3,64,0,0,101,30,0,120,0,0,0
22582,1333,2020-11-18T16:20:45.8876232Z,2019,154,32,122,79,0,11mo,2,4,75,0,0,122,32,0,152,0,0,0
22582,1334,2020-11-18T16:20:45.8876232Z,2019,158,0,123,81,1,12mo,5,3,77,0,0,158,35,0,153,0,2,0
22582,1335,2020-11-18T16:20:45.888624Z,2019,114,39,94,56,0,9no,1,4,58,0,0,75,20,0,113,0,0,0
22582,1336,2020-11-18T16:20:45.888624Z,2019,5,4,5,1,0,Sin Grado,0,1,4,0,0,1,0,0,5,0,0,0
22582,31333,2021-06-24T13:18:14.5869093Z,2021,96,35,77,49,0,10mo,1,9,47,0,0,61,19,0,95,0,1,0
22582,31334,2021-06-24T13:18:14.5869093Z,2021,111,35,96,60,0,11mo,1,1,51,0,0,76,15,0,110,0,0,0
22582,31335,2021-06-24T13:18:14.5879103Z,2021,100,18,72,54,0,12mo,1,0,46,0,0,82,28,0,99,0,0,0
22582,31336,2021-06-24T13:18:14.5879103Z,2021,138,39,117,68,0,9no,5,4,70,0,0,99,21,0,133,0,0,0
22582,31337,2021-06-24T13:18:14.5879103Z,2021,23,23,21,4,0,Sin Grado,0,3,19,0,0,0,2,0,23,0,0,0
22582,7337,2020-11-18T16:21:45.3262608Z,2020,118,38,96,60,0,10mo,1,2,58,0,0,80,22,0,117,0,0,0
22582,7338,2020-11-18T16:21:45.3262608Z,2020,107,21,79,55,0,11mo,2,0,52,0,0,86,28,0,105,0,0,0
22582,7339,2020-11-18T16:21:45.3262608Z,2020,146,31,113,79,0,12mo,2,0,67,0,0,115,33,0,144,0,0,0
22582,7340,2020-11-18T16:21:45.3272599Z,2020,100,31,77,46,0,9no,2,5,54,0,0,69,23,0,98,0,1,0
22582,7341,2020-11-18T16:21:45.3272599Z,2020,4,4,4,2,0,Sin Grado,0,1,2,0,0,0,0,0,4,0,0,0
70482,11023,2020-11-18T16:22:07.616119Z,2020,34,10,22,19,0,1ro,0,0,15,0,0,24,12,0,34,0,0,0
70482,11024,2020-11-18T16:22:07.6171199Z,2020,42,11,26,22,0,2do,0,0,20,0,0,31,16,0,42,0,0,0
70482,11025,2020-11-18T16:22:07.6171199Z,2020,43,11,28,26,0,3ro,0,0,17,0,0,32,15,0,43,0,0,0
70482,11026,2020-11-18T16:22:07.6171199Z,2020,49,16,33,27,0,4to,0,0,22,0,0,33,16,0,49,1,0,0
70482,11027,2020-11-18T16:22:07.618119Z,2020,46,15,32,19,0,5to,0,0,27,0,0,31,14,0,46,0,0,0
70482,11028,2020-11-18T16:22:07.618119Z,2020,36,5,29,21,0,K,0,0,15,0,0,31,7,1,35,0,0,0
70482,11029,2020-11-18T16:22:07.618119Z,2020,14,14,14,10,0,Sin Grado,0,0,4,0,0,0,0,0,14,0,0,0
70482,35044,2021-06-24T13:18:43.7097988Z,2021,34,5,28,19,0,1ro,0,0,15,0,0,29,6,1,33,0,0,0
70482,35045,2021-06-24T13:18:43.7097988Z,2021,31,7,26,20,0,2do,0,0,11,0,0,24,5,0,31,0,0,0
70482,35046,2021-06-24T13:18:43.7107988Z,2021,41,10,29,24,0,3ro,0,0,17,0,0,31,12,0,41,0,0,0
70482,35047,2021-06-24T13:18:43.7107988Z,2021,41,11,28,23,0,4to,0,0,18,0,0,30,13,0,41,0,0,0
70482,35048,2021-06-24T13:18:43.7107988Z,2021,42,9,30,26,0,5to,0,0,16,0,0,33,12,0,42,1,0,0
70482,35049,2021-06-24T13:18:43.7107988Z,2021,18,7,15,7,0,K,0,0,11,0,0,11,3,0,18,0,0,0
70482,35050,2021-06-24T13:18:43.7117993Z,2021,10,10,8,6,0,Sin Grado,0,0,4,0,0,0,2,0,10,0,0,0
70482,5015,2020-11-18T16:21:13.4189819Z,2019,46,13,28,31,0,1ro,0,0,15,0,0,33,18,0,46,0,0,0
70482,5016,2020-11-18T16:21:13.4189819Z,2019,48,15,33,27,0,2do,0,0,21,0,0,33,15,0,48,0,0,0
70482,5017,2020-11-18T16:21:13.4199823Z,2019,48,16,33,30,0,3ro,1,0,18,0,0,32,15,0,47,1,0,0
70482,5018,2020-11-18T16:21:13.4199823Z,2019,50,17,36,20,0,4to,0,0,30,0,0,33,14,0,50,0,0,0
70482,5019,2020-11-18T16:21:13.4199823Z,2019,56,14,31,34,0,5to,0,0,22,0,0,42,25,0,56,0,0,0
70482,5020,2020-11-18T16:21:13.4199823Z,2019,37,12,24,18,0,K,0,0,19,0,0,25,13,0,37,0,0,0
70482,5021,2020-11-18T16:21:13.4199823Z,2019,13,13,12,7,0,Sin Grado,0,0,6,0,0,0,1,0,13,0,0,0
34785,2269,2020-11-18T16:20:55.0117043Z,2019,135,28,87,69,0,10mo,5,0,66,0,0,107,48,0,130,0,1,0
34785,2270,2020-11-18T16:20:55.0117043Z,2019,150,21,95,80,0,11mo,1,0,70,0,0,129,55,0,149,0,0,0
34785,2271,2020-11-18T16:20:55.0117043Z,2019,131,0,88,63,0,12mo,3,0,68,0,0,131,43,0,128,0,0,0
34785,2272,2020-11-18T16:20:55.0127051Z,2019,166,30,121,85,0,9no,7,0,81,0,0,136,45,0,159,0,0,0
34785,32276,2021-06-24T13:18:21.7630544Z,2021,175,41,133,93,0,10mo,1,0,82,0,0,134,42,0,174,0,0,0
34785,32277,2021-06-24T13:18:21.7640558Z,2021,149,29,113,77,0,11mo,5,0,72,0,0,120,36,0,144,0,1,0
34785,32278,2021-06-24T13:18:21.7640558Z,2021,115,24,79,66,0,12mo,5,0,49,0,0,91,36,0,110,0,0,0
34785,32279,2021-06-24T13:18:21.7640558Z,2021,168,30,143,86,0,9no,1,0,82,0,0,138,25,0,167,1,0,0
34785,8281,2020-11-18T16:21:50.7018437Z,2020,149,28,104,78,0,10mo,5,0,71,0,0,121,45,0,144,0,0,0
34785,8282,2020-11-18T16:21:50.7018437Z,2020,126,24,81,69,0,11mo,5,0,57,0,0,102,45,0,121,0,1,0
34785,8283,2020-11-18T16:21:50.7018437Z,2020,145,18,92,79,0,12mo,1,0,66,0,0,127,53,0,144,0,0,0
34785,8284,2020-11-18T16:21:50.7028442Z,2020,168,40,119,94,0,9no,1,0,74,0,0,128,49,0,167,0,0,0
20396,30951,2021-06-24T13:18:11.8179236Z,2021,72,18,60,34,0,1ro,1,0,38,0,0,54,12,0,71,0,0,0
20396,30952,2021-06-24T13:18:11.8189245Z,2021,74,18,61,40,0,2do,1,0,34,0,0,56,13,0,72,0,0,1
20396,30953,2021-06-24T13:18:11.8189245Z,2021,65,18,53,28,0,3ro,1,0,37,0,0,47,12,0,64,0,0,0
20396,30954,2021-06-24T13:18:11.8189245Z,2021,67,20,52,37,0,4to,1,0,30,0,0,47,15,0,66,0,0,0
20396,30955,2021-06-24T13:18:11.8189245Z,2021,59,12,45,26,0,5to,2,0,33,0,0,47,14,0,57,0,0,0
20396,30956,2021-06-24T13:18:11.8199259Z,2021,51,10,37,31,0,6to,0,0,20,0,0,41,14,0,51,0,0,0
20396,30957,2021-06-24T13:18:11.8199259Z,2021,19,0,11,11,0,7mo,0,0,8,0,0,19,8,1,18,0,0,0
20396,30958,2021-06-24T13:18:11.8209264Z,2021,15,1,11,10,0,8vo,1,0,5,0,0,14,4,0,14,0,0,0
20396,30959,2021-06-24T13:18:11.8209264Z,2021,64,18,57,26,0,K,0,0,38,0,0,46,7,0,63,0,0,1
20396,30960,2021-06-24T13:18:11.8209264Z,2021,34,34,24,10,0,Sin Grado,0,0,24,0,0,0,10,0,34,0,0,0
20396,6955,2020-11-18T16:21:42.5894302Z,2020,74,19,47,42,0,1ro,1,0,32,0,0,55,27,0,73,0,0,0
20396,6956,2020-11-18T16:21:42.5894302Z,2020,68,18,46,32,0,2do,2,0,36,0,0,50,22,0,66,0,0,0
20396,6957,2020-11-18T16:21:42.5904311Z,2020,66,21,40,37,0,3ro,2,0,29,0,0,45,26,0,64,0,0,0
20396,6958,2020-11-18T16:21:42.5904311Z,2020,58,13,34,26,0,4to,2,0,32,0,0,45,24,0,56,0,0,0
20396,6959,2020-11-18T16:21:42.5904311Z,2020,55,11,34,33,0,5to,0,0,22,0,0,44,21,0,55,0,0,0
20396,6960,2020-11-18T16:21:42.5904311Z,2020,54,8,37,24,0,6to,1,0,30,0,0,46,17,3,50,0,0,0
20396,6961,2020-11-18T16:21:42.5914337Z,2020,19,1,9,11,0,7mo,2,0,8,0,0,18,10,0,17,0,0,0
20396,6962,2020-11-18T16:21:42.5914337Z,2020,73,19,56,33,0,K,1,0,40,0,0,54,17,0,72,0,0,0
20396,6963,2020-11-18T16:21:42.5914337Z,2020,30,30,21,11,0,Sin Grado,0,0,19,0,0,0,9,0,30,0,0,0
20396,955,2020-11-18T16:20:43.3789462Z,2019,65,20,45,32,0,1ro,2,0,33,0,0,45,20,1,62,0,0,0
20396,956,2020-11-18T16:20:43.3789462Z,2019,58,18,37,33,0,2do,1,0,25,0,0,40,21,0,57,0,0,0
20396,957,2020-11-18T16:20:43.3799467Z,2019,51,15,33,20,0,3ro,2,0,31,0,0,36,18,0,49,0,0,0
20396,958,2020-11-18T16:20:43.3799467Z,2019,56,11,36,31,0,4to,0,0,25,0,0,45,20,0,56,0,0,0
20396,959,2020-11-18T16:20:43.3799467Z,2019,65,13,45,28,0,5to,2,0,37,0,0,52,20,4,59,0,0,0
20396,960,2020-11-18T16:20:43.3799467Z,2019,37,8,24,20,0,6to,3,0,17,0,0,29,13,0,34,0,0,0
20396,961,2020-11-18T16:20:43.3809476Z,2019,65,12,42,51,0,K,1,1,14,0,0,53,23,0,64,0,0,0
20396,962,2020-11-18T16:20:43.3809476Z,2019,37,36,30,9,0,Sin Grado,0,0,28,0,0,1,7,0,36,0,0,1
30874,1872,2020-11-18T16:20:52.4850229Z,2019,40,15,31,22,0,1ro,0,0,18,0,0,25,9,0,40,0,0,0
30874,1873,2020-11-18T16:20:52.4850229Z,2019,27,8,21,15,0,2do,0,0,12,0,0,19,6,0,27,0,0,0
30874,1874,2020-11-18T16:20:52.4850229Z,2019,39,7,33,17,0,3ro,0,0,22,0,0,32,6,0,39,0,0,0
30874,1875,2020-11-18T16:20:52.4860238Z,2019,21,4,18,11,0,4to,0,0,10,0,0,17,3,0,21,0,0,0
30874,1876,2020-11-18T16:20:52.4860238Z,2019,37,10,31,13,0,5to,0,0,24,0,0,27,6,0,36,0,0,1
30874,1877,2020-11-18T16:20:52.4860238Z,2019,40,8,33,23,0,K,0,0,17,0,0,32,7,0,40,0,0,0
30874,1878,2020-11-18T16:20:52.4860238Z,2019,32,4,22,15,0,PK,0,0,17,0,0,28,10,0,32,0,0,0
30874,31877,2021-06-24T13:18:17.7721931Z,2021,39,6,34,21,0,1ro,0,0,18,0,0,33,5,0,39,0,0,0
30874,31878,2021-06-24T13:18:17.7721931Z,2021,36,11,31,17,0,2do,0,0,19,0,0,25,5,0,36,0,0,0
30874,31879,2021-06-24T13:18:17.7721931Z,2021,32,9,27,17,0,3ro,0,0,15,0,0,23,5,0,32,0,0,0
30874,31880,2021-06-24T13:18:17.7721931Z,2021,23,8,18,12,0,4to,0,0,11,0,0,15,5,0,23,0,0,0
30874,31881,2021-06-24T13:18:17.7731936Z,2021,35,7,30,14,0,5to,0,0,21,0,0,28,5,0,35,0,0,0
30874,31882,2021-06-24T13:18:17.7731936Z,2021,35,4,30,13,0,K,0,0,22,0,0,31,5,0,35,0,0,0
30874,31883,2021-06-24T13:18:17.7731936Z,2021,38,0,31,16,0,PK,0,0,22,0,0,38,7,0,38,0,0,0
30874,7880,2020-11-18T16:21:48.4833615Z,2020,40,11,33,21,0,1ro,0,0,19,0,0,29,7,0,40,0,0,0
30874,7881,2020-11-18T16:21:48.4833615Z,2020,32,10,24,16,0,2do,0,0,16,0,0,22,8,0,32,0,0,0
30874,7882,2020-11-18T16:21:48.4833615Z,2020,26,7,19,15,0,3ro,0,0,11,0,0,19,7,0,26,0,0,0
30874,7883,2020-11-18T16:21:48.484362Z,2020,34,7,31,15,0,4to,0,0,19,0,0,27,3,0,34,0,0,0
30874,7884,2020-11-18T16:21:48.484362Z,2020,23,5,18,10,0,5to,0,0,13,0,0,18,5,0,22,0,0,1
30874,7885,2020-11-18T16:21:48.484362Z,2020,31,3,27,18,0,K,0,0,13,0,0,28,4,0,31,0,0,0
30874,7886,2020-11-18T16:21:48.484362Z,2020,48,3,35,26,0,PK,0,0,22,0,0,45,13,0,48,0,0,0
40378,2558,2020-11-18T16:20:57.6374587Z,2019,34,8,34,20,0,1ro,1,0,14,0,0,26,0,0,33,0,0,0
40378,2559,2020-11-18T16:20:57.6374587Z,2019,28,14,27,7,0,2do,0,0,21,0,0,14,1,0,28,0,0,0
40378,2560,2020-11-18T16:20:57.6374587Z,2019,32,10,31,16,0,3ro,1,0,16,0,0,22,1,0,31,0,0,0
40378,2561,2020-11-18T16:20:57.6374587Z,2019,27,11,26,14,0,4to,0,0,13,0,0,16,1,0,27,0,0,0
40378,2562,2020-11-18T16:20:57.6384592Z,2019,30,15,29,13,0,5to,0,0,17,0,0,15,1,0,30,0,0,0
40378,2563,2020-11-18T16:20:57.6384592Z,2019,44,15,41,20,0,6to,0,0,24,0,0,29,3,0,44,0,0,0
40378,2564,2020-11-18T16:20:57.6384592Z,2019,53,24,50,28,0,7mo,1,0,25,0,0,29,3,0,52,0,0,0
40378,2565,2020-11-18T16:20:57.6384592Z,2019,50,15,46,24,0,8vo,1,0,26,0,0,35,4,0,49,0,0,0
40378,2566,2020-11-18T16:20:57.6384592Z,2019,18,4,16,11,0,K,1,0,7,0,0,14,2,0,17,0,0,0
40378,2567,2020-11-18T16:20:57.6394605Z,2019,11,11,9,1,0,Sin Grado,0,0,10,0,0,0,2,0,11,0,0,0
40378,32566,2021-06-24T13:18:25.2375525Z,2021,25,5,22,12,0,1ro,0,0,13,0,0,20,3,0,25,0,0,0
40378,32567,2021-06-24T13:18:25.2375525Z,2021,23,5,21,13,0,2do,1,0,10,0,0,18,2,1,21,0,0,0
40378,32568,2021-06-24T13:18:25.2385525Z,2021,32,7,25,19,0,3ro,1,0,13,0,0,25,7,0,31,0,0,0
40378,32569,2021-06-24T13:18:25.2385525Z,2021,29,12,22,11,0,4to,0,1,18,0,0,17,7,1,28,0,0,0
40378,32570,2021-06-24T13:18:25.2385525Z,2021,30,10,29,14,0,5to,1,0,16,0,0,20,1,0,29,0,0,0
40378,32571,2021-06-24T13:18:25.2385525Z,2021,27,11,24,13,0,6to,0,1,14,0,0,16,3,1,26,0,0,0
40378,32572,2021-06-24T13:18:25.2395535Z,2021,25,10,23,12,0,7mo,0,0,13,0,0,15,2,0,25,0,0,0
40378,32573,2021-06-24T13:18:25.2395535Z,2021,39,17,34,18,0,8vo,0,0,21,0,0,22,5,0,39,0,0,0
40378,32574,2021-06-24T13:18:25.2395535Z,2021,20,8,14,11,0,K,0,1,9,0,0,12,6,0,20,0,0,0
40378,32575,2021-06-24T13:18:25.2395535Z,2021,4,4,4,1,0,Sin Grado,0,0,3,0,0,0,0,0,4,0,0,0
40378,8570,2020-11-18T16:21:52.6411325Z,2020,21,4,20,11,0,1ro,1,0,10,0,0,17,1,0,20,0,0,0
40378,8571,2020-11-18T16:21:52.6421334Z,2020,33,8,33,19,0,2do,1,0,14,0,0,25,0,0,32,0,0,0
40378,8572,2020-11-18T16:21:52.6421334Z,2020,33,17,32,12,0,3ro,0,0,21,0,0,16,1,0,33,0,0,0
40378,8573,2020-11-18T16:21:52.6421334Z,2020,32,11,30,14,0,4to,1,0,18,0,0,21,2,0,31,0,0,0
40378,8574,2020-11-18T16:21:52.6421334Z,2020,29,14,29,12,0,5to,0,0,17,0,0,15,0,0,29,0,0,0
40378,8575,2020-11-18T16:21:52.6431343Z,2020,38,17,37,18,0,6to,0,0,20,0,0,21,1,0,38,0,0,0
40378,8576,2020-11-18T16:21:52.6431343Z,2020,43,16,41,20,0,7mo,0,0,23,0,0,27,2,0,43,0,0,0
40378,8577,2020-11-18T16:21:52.6431343Z,2020,48,19,46,25,0,8vo,2,0,23,0,0,29,2,0,46,0,0,0
40378,8578,2020-11-18T16:21:52.6431343Z,2020,30,4,30,17,0,K,0,0,13,0,0,26,0,0,30,0,0,0
40378,8579,2020-11-18T16:21:52.6441347Z,2020,11,11,10,1,0,Sin Grado,0,0,10,0,0,0,1,0,11,0,0,0
50294,3248,2020-11-18T16:21:01.4570046Z,2019,129,16,101,65,0,10mo,1,0,64,0,0,113,28,0,128,2,1,0
50294,3249,2020-11-18T16:21:01.4580051Z,2019,134,15,103,65,0,11mo,0,0,69,0,0,119,31,0,134,0,0,0
50294,3250,2020-11-18T16:21:01.4580051Z,2019,147,0,114,95,0,12mo,0,0,52,0,0,147,33,0,147,0,0,0
50294,3251,2020-11-18T16:21:01.4580051Z,2019,148,20,129,71,0,9no,1,0,77,0,0,128,19,0,147,0,0,0
50294,3252,2020-11-18T16:21:01.4580051Z,2019,8,6,8,0,0,Sin Grado,0,1,8,0,0,2,0,0,8,0,0,0
50294,33274,2021-06-24T13:18:30.8936082Z,2021,125,21,100,58,0,10mo,0,0,67,0,0,104,25,0,125,1,1,0
50294,33275,2021-06-24T13:18:30.8936082Z,2021,142,15,108,67,0,11mo,1,0,75,0,0,127,34,0,141,4,0,0
50294,33276,2021-06-24T13:18:30.8946091Z,2021,98,14,74,55,0,12mo,1,0,43,0,0,84,24,0,97,4,1,0
50294,33277,2021-06-24T13:18:30.8946091Z,2021,133,25,110,65,0,9no,2,0,68,0,0,108,23,0,131,0,0,0
50294,33278,2021-06-24T13:18:30.8956101Z,2021,5,4,5,1,0,Sin Grado,0,0,4,0,0,1,0,0,5,0,0,0
50294,9268,2020-11-18T16:21:57.3272594Z,2020,156,19,125,74,0,10mo,1,1,82,0,0,137,31,0,155,4,0,0
50294,9269,2020-11-18T16:21:57.3272594Z,2020,109,17,83,56,0,11mo,1,0,53,0,0,92,26,0,108,4,1,0
50294,9270,2020-11-18T16:21:57.3282598Z,2020,127,16,99,64,0,12mo,0,0,63,0,0,111,28,0,127,12,0,0
50294,9271,2020-11-18T16:21:57.3282598Z,2020,130,21,105,61,0,9no,0,0,69,0,0,109,25,0,130,1,1,0
50294,9272,2020-11-18T16:21:57.3282598Z,2020,9,9,8,1,0,Sin Grado,0,0,8,0,0,0,1,0,9,0,0,0
32573,2087,2020-11-18T16:20:53.9149721Z,2019,33,11,31,15,0,1ro,1,1,18,0,0,22,2,0,32,0,0,0
32573,2088,2020-11-18T16:20:53.9149721Z,2019,31,12,29,17,0,2do,0,1,14,0,0,19,2,0,31,0,0,0
32573,2089,2020-11-18T16:20:53.9149721Z,2019,23,8,19,8,0,3ro,0,0,15,0,0,15,4,0,23,0,0,0
32573,2090,2020-11-18T16:20:53.9159725Z,2019,28,9,25,9,0,4to,0,0,19,0,0,19,3,0,28,0,0,0
32573,2091,2020-11-18T16:20:53.9159725Z,2019,33,5,30,12,0,5to,0,0,21,0,0,28,3,1,32,1,0,0
32573,2092,2020-11-18T16:20:53.9159725Z,2019,38,7,37,19,0,K,1,0,19,0,0,31,1,0,37,0,0,0
32573,2093,2020-11-18T16:20:53.9159725Z,2019,4,4,4,1,0,Sin Grado,0,0,3,0,0,0,0,0,4,0,0,0
32573,32093,2021-06-24T13:18:20.1118704Z,2021,26,5,23,11,0,1ro,1,0,15,0,0,21,3,0,25,0,0,0
32573,32094,2021-06-24T13:18:20.1118704Z,2021,25,6,24,8,0,2do,1,0,17,0,0,19,1,0,24,0,0,0
32573,32095,2021-06-24T13:18:20.1128713Z,2021,30,13,28,14,0,3ro,1,0,16,0,0,17,2,0,29,0,0,0
32573,32096,2021-06-24T13:18:20.1128713Z,2021,22,7,19,14,0,4to,0,0,8,0,0,15,3,0,22,0,0,0
32573,32097,2021-06-24T13:18:20.1128713Z,2021,19,7,18,7,0,5to,0,0,12,0,0,12,1,0,19,0,0,0
32573,32098,2021-06-24T13:18:20.1128713Z,2021,18,0,11,11,0,K,0,0,7,0,0,18,7,0,18,0,0,0
32573,32099,2021-06-24T13:18:20.1128713Z,2021,3,3,3,1,0,Sin Grado,0,0,2,0,0,0,0,0,3,0,0,0
32573,8099,2020-11-18T16:21:49.574091Z,2020,35,6,34,14,0,1ro,1,0,21,0,0,29,1,0,34,0,0,0
32573,8100,2020-11-18T16:21:49.574091Z,2020,30,12,28,15,0,2do,1,0,15,0,0,18,2,0,29,0,0,0
32573,8101,2020-11-18T16:21:50.2115157Z,2020,23,9,20,14,0,3ro,0,0,9,0,0,14,3,0,23,0,0,0
32573,8102,2020-11-18T16:21:50.2115157Z,2020,20,7,17,9,0,4to,0,0,11,0,0,13,3,0,20,0,0,0
32573,8103,2020-11-18T16:21:50.2115157Z,2020,22,10,20,6,0,5to,0,0,16,0,0,12,2,0,22,0,0,0
32573,8104,2020-11-18T16:21:50.2125175Z,2020,35,8,30,15,0,K,0,0,20,0,0,27,5,0,35,0,0,0
32573,8105,2020-11-18T16:21:50.2125175Z,2020,2,2,2,1,0,Sin Grado,0,0,1,0,0,0,0,0,2,0,0,0
69054,10844,2020-11-18T16:22:06.5404048Z,2020,38,12,35,15,0,1ro,0,0,23,0,0,26,3,0,38,0,0,0
69054,10845,2020-11-18T16:22:06.5414052Z,2020,42,13,36,15,0,2do,0,0,27,0,0,29,6,0,42,0,0,0
69054,10846,2020-11-18T16:22:06.5414052Z,2020,44,14,35,17,0,3ro,0,0,27,0,0,30,9,0,44,0,0,0
69054,10847,2020-11-18T16:22:06.5414052Z,2020,51,27,41,24,0,4to,0,0,27,0,0,24,10,0,51,0,0,0
69054,10848,2020-11-18T16:22:06.5414052Z,2020,56,24,44,23,0,5to,0,2,33,0,0,32,12,0,56,0,0,0
69054,10849,2020-11-18T16:22:06.5414052Z,2020,70,29,58,37,0,6to,1,3,33,0,0,41,12,0,69,0,0,0
69054,10850,2020-11-18T16:22:06.5424079Z,2020,85,35,76,41,0,7mo,1,2,44,0,0,50,9,0,82,0,0,2
69054,10851,2020-11-18T16:22:06.5424079Z,2020,64,26,55,23,0,8vo,0,0,41,0,0,38,9,0,64,0,0,0
69054,10852,2020-11-18T16:22:06.5424079Z,2020,46,15,40,18,0,K,0,0,28,0,0,31,6,0,46,0,0,0
69054,10853,2020-11-18T16:22:06.5424079Z,2020,50,50,39,15,0,Sin Grado,0,1,35,0,0,0,11,0,50,0,0,0
69054,34865,2021-06-24T13:18:42.9042214Z,2021,43,13,37,22,0,1ro,0,3,21,0,0,30,6,0,43,0,0,0
69054,34866,2021-06-24T13:18:42.9052219Z,2021,44,14,40,18,0,2do,0,1,26,0,0,30,4,0,44,0,0,0
69054,34867,2021-06-24T13:18:42.9052219Z,2021,45,15,38,15,0,3ro,0,0,30,0,0,30,7,0,44,0,0,1
69054,34868,2021-06-24T13:18:42.9052219Z,2021,49,16,39,19,0,4to,0,0,30,0,0,33,10,0,49,0,0,0
69054,34869,2021-06-24T13:18:42.9052219Z,2021,54,27,45,25,0,5to,0,0,29,0,0,27,9,0,54,0,0,0
69054,34870,2021-06-24T13:18:42.9062219Z,2021,72,31,61,26,0,6to,0,3,46,0,0,41,11,0,72,0,0,0
69054,34871,2021-06-24T13:18:42.9062219Z,2021,71,29,59,36,0,7mo,0,2,35,0,0,42,12,0,71,0,0,0
69054,34872,2021-06-24T13:18:42.9062219Z,2021,81,35,69,37,0,8vo,1,4,44,0,0,46,12,0,79,0,0,1
69054,34873,2021-06-24T13:18:42.9062219Z,2021,25,8,23,5,0,K,0,1,20,0,0,17,2,0,25,0,0,0
69054,34874,2021-06-24T13:18:42.9062219Z,2021,34,33,27,5,0,Sin Grado,0,0,29,0,0,1,7,0,34,0,0,0
69054,4837,2020-11-18T16:21:12.3912965Z,2019,35,11,29,10,0,1ro,2,0,25,0,0,24,6,0,33,0,0,0
69054,4838,2020-11-18T16:21:12.3912965Z,2019,40,16,34,15,0,2do,2,1,25,0,0,24,6,0,38,0,0,0
69054,4839,2020-11-18T16:21:12.3912965Z,2019,39,16,30,22,0,3ro,0,0,17,0,0,23,9,0,39,0,0,0
69054,4840,2020-11-18T16:21:12.3922969Z,2019,37,14,28,17,0,4to,2,1,20,0,0,23,9,0,35,0,0,0
69054,4841,2020-11-18T16:21:12.3922969Z,2019,40,12,32,23,0,5to,1,1,17,0,0,28,8,0,39,0,0,0
69054,4842,2020-11-18T16:21:12.3922969Z,2019,76,32,67,34,0,6to,2,4,42,0,0,44,9,0,72,0,0,2
69054,4843,2020-11-18T16:21:12.3932974Z,2019,69,30,59,27,0,7mo,0,3,42,0,0,39,10,0,69,0,0,0
69054,4844,2020-11-18T16:21:12.3932974Z,2019,59,24,48,29,0,8vo,1,0,30,0,0,35,11,0,58,0,0,0
69054,4845,2020-11-18T16:21:12.3932974Z,2019,40,10,35,18,0,K,0,0,22,0,0,30,5,0,40,0,0,0
69054,4846,2020-11-18T16:21:12.3942983Z,2019,50,49,39,13,0,Sin Grado,0,4,37,0,0,1,11,0,50,0,0,0
56226,33899,2021-06-24T13:18:36.020285Z,2021,159,53,125,72,0,10mo,2,0,87,0,0,106,34,0,157,7,0,0
56226,33900,2021-06-24T13:18:36.6157122Z,2021,136,37,117,61,0,11mo,0,0,75,0,0,99,19,0,136,3,1,0
56226,33901,2021-06-24T13:18:36.6157122Z,2021,129,29,106,60,0,12mo,1,0,69,0,0,100,23,0,128,0,0,0
56226,33902,2021-06-24T13:18:36.6157122Z,2021,179,66,144,72,0,9no,4,0,107,0,0,113,35,0,175,0,0,0
56226,33903,2021-06-24T13:18:36.6157122Z,2021,9,9,8,3,0,Sin Grado,0,0,6,0,0,0,1,0,9,0,0,0
56226,3876,2020-11-18T16:21:05.5877604Z,2019,174,45,135,73,0,10mo,2,0,101,0,0,129,39,0,172,0,0,0
56226,3877,2020-11-18T16:21:05.5877604Z,2019,164,49,122,80,0,11mo,0,2,84,0,0,115,42,0,164,1,0,0
56226,3878,2020-11-18T16:21:05.5887577Z,2019,136,0,102,53,0,12mo,1,0,83,0,0,136,34,0,135,0,0,0
56226,3879,2020-11-18T16:21:05.5887577Z,2019,148,44,112,63,0,9no,0,0,85,0,0,104,36,0,148,3,1,0
56226,3880,2020-11-18T16:21:05.5887577Z,2019,2,2,2,0,0,Sin Grado,0,0,2,0,0,0,0,0,2,0,0,0
56226,9893,2020-11-18T16:22:00.5323976Z,2020,144,44,119,66,0,10mo,0,0,78,0,0,100,25,0,144,3,1,0
56226,9894,2020-11-18T16:22:00.5323976Z,2020,130,31,107,61,0,11mo,1,4,69,0,0,99,23,0,129,0,0,0
56226,9895,2020-11-18T16:22:00.5333985Z,2020,161,46,134,82,0,12mo,1,6,79,0,0,115,27,0,160,2,0,0
56226,9896,2020-11-18T16:22:00.5333985Z,2020,161,53,115,71,0,9no,2,0,90,0,0,108,46,0,159,7,0,0
56226,9897,2020-11-18T16:22:00.5333985Z,2020,11,11,11,5,0,Sin Grado,0,0,6,0,0,0,0,0,11,0,0,0
20800,1088,2020-11-18T16:20:43.8212439Z,2019,95,36,81,56,0,10mo,1,2,39,0,0,59,14,0,94,0,0,0
20800,1089,2020-11-18T16:20:43.8212439Z,2019,139,41,110,80,0,11mo,4,1,59,0,0,98,29,0,135,0,0,0
20800,1090,2020-11-18T16:20:43.8212439Z,2019,79,2,67,44,0,12mo,3,0,35,0,0,77,12,0,76,0,0,0
20800,1091,2020-11-18T16:20:43.822243Z,2019,130,53,102,61,0,9no,4,0,69,0,0,77,28,0,126,0,0,0
20800,1092,2020-11-18T16:20:43.822243Z,2019,10,9,9,3,0,Sin Grado,0,0,7,0,0,1,1,0,10,0,0,0
20800,31088,2021-06-24T13:18:12.1041288Z,2021,122,57,98,55,0,10mo,1,1,67,0,0,65,24,0,120,0,1,1
20800,31089,2021-06-24T13:18:12.1041288Z,2021,124,47,99,65,0,11mo,4,0,59,0,0,77,25,1,118,0,0,1
20800,31090,2021-06-24T13:18:12.1051298Z,2021,95,34,77,52,0,12mo,3,0,43,0,0,61,18,0,92,0,0,0
20800,31091,2021-06-24T13:18:12.1051298Z,2021,133,68,104,73,0,9no,1,0,60,0,0,65,29,0,132,1,0,0
20800,31092,2021-06-24T13:18:12.1061307Z,2021,23,23,20,7,0,Sin Grado,0,0,16,0,0,0,3,0,23,0,0,0
20800,7092,2020-11-18T16:21:43.6491383Z,2020,125,51,98,63,0,10mo,4,0,62,0,0,74,27,1,119,0,0,1
20800,7093,2020-11-18T16:21:43.6491383Z,2020,98,36,78,55,0,11mo,3,0,43,0,0,62,20,0,95,0,0,0
20800,7094,2020-11-18T16:21:43.6501392Z,2020,137,40,105,84,0,12mo,5,0,53,0,0,97,32,0,132,0,0,0
20800,7095,2020-11-18T16:21:43.6501392Z,2020,125,56,108,57,0,9no,2,0,68,0,0,69,17,0,122,0,1,1
20800,7096,2020-11-18T16:21:43.6501392Z,2020,14,14,12,3,0,Sin Grado,0,0,11,0,0,0,2,0,14,0,0,0
42176,2734,2020-11-18T16:20:58.7481944Z,2019,44,25,41,25,0,1ro,2,0,19,0,0,19,3,0,42,0,0,0
42176,2735,2020-11-18T16:20:58.7481944Z,2019,27,6,25,14,0,2do,2,0,13,0,0,21,2,0,25,0,0,0
42176,2736,2020-11-18T16:20:58.7481944Z,2019,30,13,29,19,0,3ro,0,0,11,0,0,17,1,0,30,0,0,0
42176,2737,2020-11-18T16:20:58.7481944Z,2019,29,10,24,16,0,4to,0,0,13,0,0,19,5,0,29,0,0,0
42176,2738,2020-11-18T16:20:58.7491949Z,2019,33,15,29,18,0,5to,1,0,15,0,0,18,4,0,32,0,0,0
42176,2739,2020-11-18T16:20:58.7491949Z,2019,74,25,69,39,0,6to,2,0,35,0,0,49,5,0,72,0,0,0
42176,2740,2020-11-18T16:20:58.7491949Z,2019,68,24,58,30,0,7mo,0,0,38,0,0,44,10,0,68,0,0,0
42176,2741,2020-11-18T16:20:58.7501962Z,2019,63,20,55,29,0,8vo,1,0,34,0,0,43,8,0,62,0,0,0
42176,2742,2020-11-18T16:20:58.7501962Z,2019,31,14,27,15,0,K,1,0,16,0,0,17,4,0,30,0,0,0
42176,32741,2021-06-24T13:18:27.1459207Z,2021,27,6,25,16,0,1ro,0,0,11,0,0,21,2,0,27,0,0,0
42176,32742,2021-06-24T13:18:27.1469221Z,2021,23,10,18,14,0,2do,0,0,9,0,0,13,5,0,23,0,0,0
42176,32743,2021-06-24T13:18:27.1469221Z,2021,33,16,31,18,0,3ro,1,0,15,0,0,17,2,0,32,0,0,0
42176,32744,2021-06-24T13:18:27.1469221Z,2021,36,11,35,18,0,4to,0,0,18,0,0,25,1,0,36,0,0,0
42176,32745,2021-06-24T13:18:27.1469221Z,2021,31,15,29,19,0,5to,0,0,12,0,0,16,2,0,31,0,0,0
42176,32746,2021-06-24T13:18:27.1479221Z,2021,67,23,57,36,0,6to,1,0,31,0,0,44,10,0,66,0,0,0
42176,32747,2021-06-24T13:18:27.1479221Z,2021,68,30,58,37,0,7mo,3,0,31,0,0,38,10,0,65,0,0,0
42176,32748,2021-06-24T13:18:27.1479221Z,2021,71,26,64,36,0,8vo,1,0,35,0,0,45,7,0,69,0,1,1
42176,32749,2021-06-24T13:18:27.1479221Z,2021,16,3,11,5,0,K,0,0,11,0,0,13,5,0,16,0,0,0
42176,8745,2020-11-18T16:21:53.8049097Z,2020,25,11,25,13,0,1ro,0,0,12,0,0,14,0,0,25,0,0,0
42176,8746,2020-11-18T16:21:53.8049097Z,2020,32,16,32,21,0,2do,2,0,11,0,0,16,0,0,30,0,0,0
42176,8747,2020-11-18T16:21:53.8049097Z,2020,34,10,33,17,0,3ro,1,0,17,0,0,24,1,0,33,0,0,0
42176,8748,2020-11-18T16:21:53.8049097Z,2020,29,13,28,20,0,4to,0,0,9,0,0,16,1,0,28,0,0,1
42176,8749,2020-11-18T16:21:53.8059105Z,2020,32,10,25,16,0,5to,0,0,16,0,0,22,7,0,32,0,0,0
42176,8750,2020-11-18T16:21:53.8059105Z,2020,67,30,59,36,0,6to,2,0,31,0,0,37,8,0,65,0,0,0
42176,8751,2020-11-18T16:21:53.8069114Z,2020,74,28,66,39,0,7mo,1,0,35,0,0,46,8,0,72,0,1,1
42176,8752,2020-11-18T16:21:53.8069114Z,2020,59,19,51,28,0,8vo,1,0,31,0,0,40,8,0,58,0,0,0
42176,8753,2020-11-18T16:21:53.8069114Z,2020,27,8,26,14,0,K,0,0,13,0,0,19,1,0,27,0,0,0
40121,2508,2020-11-18T16:20:57.6354569Z,2019,18,6,13,6,0,1ro,2,0,12,0,1,12,5,0,16,0,0,0
40121,2509,2020-11-18T16:20:57.6364583Z,2019,22,7,19,13,0,2do,0,0,9,0,0,15,3,0,22,0,0,0
40121,2510,2020-11-18T16:20:57.6364583Z,2019,34,7,24,16,0,3ro,1,0,18,0,1,27,10,0,33,1,0,0
40121,2511,2020-11-18T16:20:57.6364583Z,2019,11,5,8,2,0,4to,0,0,9,0,0,6,3,0,11,0,0,0
40121,2512,2020-11-18T16:20:57.6364583Z,2019,11,3,9,5,0,5to,0,0,6,0,0,8,2,0,11,0,0,0
40121,2513,2020-11-18T16:20:57.6364583Z,2019,8,2,7,4,0,K,0,0,4,0,0,6,1,0,8,0,0,0
40121,32516,2021-06-24T13:18:25.2175381Z,2021,15,3,14,5,0,1ro,0,0,10,0,0,12,1,0,15,0,0,0
40121,32517,2021-06-24T13:18:25.2185386Z,2021,18,9,17,7,0,2do,0,0,11,0,0,9,1,0,18,0,0,0
40121,32518,2021-06-24T13:18:25.2185386Z,2021,23,5,18,10,0,3ro,1,0,13,0,0,18,5,0,22,0,0,0
40121,32519,2021-06-24T13:18:25.2185386Z,2021,26,6,23,13,0,4to,0,0,13,0,0,20,3,0,26,0,0,0
40121,32520,2021-06-24T13:18:25.2185386Z,2021,40,10,32,18,0,5to,1,0,22,0,0,30,8,0,39,1,0,0
40121,32521,2021-06-24T13:18:25.2195396Z,2021,18,4,16,8,0,K,0,0,10,0,0,14,2,0,18,0,0,0
40121,8521,2020-11-18T16:21:52.6191178Z,2020,17,7,14,5,0,1ro,0,0,12,0,0,10,3,0,17,0,0,0
40121,8522,2020-11-18T16:21:52.6201195Z,2020,20,6,17,8,0,2do,2,0,12,0,0,14,3,0,18,0,0,0
40121,8523,2020-11-18T16:21:52.6201195Z,2020,22,6,16,11,0,3ro,0,0,11,0,0,16,6,0,22,0,0,0
40121,8524,2020-11-18T16:21:52.6201195Z,2020,35,8,26,16,0,4to,1,0,19,0,0,27,9,0,34,1,0,0
40121,8525,2020-11-18T16:21:52.6201195Z,2020,12,5,10,3,0,5to,0,0,9,0,0,7,2,0,12,0,0,0
40121,8526,2020-11-18T16:21:52.6211191Z,2020,10,1,9,2,0,K,0,0,8,0,0,9,1,0,10,0,0,0
24752,1427,2020-11-18T16:20:46.3299177Z,2019,66,15,49,26,0,6to,1,6,40,0,0,51,17,0,65,0,0,0
24752,1428,2020-11-18T16:20:46.3309186Z,2019,60,18,44,33,0,7mo,1,11,27,0,0,42,16,0,58,0,0,1
24752,1429,2020-11-18T16:20:46.3309186Z,2019,87,19,67,46,0,8vo,2,4,41,0,0,68,20,0,85,0,0,0
24752,1430,2020-11-18T16:20:46.3309186Z,2019,11,11,8,2,0,Sin Grado,0,0,9,0,0,0,3,0,11,0,0,0
24752,31427,2021-06-24T13:18:14.9081399Z,2021,66,14,60,27,0,6to,0,0,39,0,0,52,6,0,66,1,0,0
24752,31428,2021-06-24T13:18:14.9081399Z,2021,63,16,53,36,0,7mo,2,0,27,0,0,47,10,0,61,1,0,0
24752,31429,2021-06-24T13:18:14.9081399Z,2021,73,17,58,32,0,8vo,4,0,41,0,0,56,15,0,69,0,0,0
24752,31430,2021-06-24T13:18:14.9091404Z,2021,13,13,12,3,0,Sin Grado,0,0,10,0,0,0,1,0,13,0,0,0
24752,7430,2020-11-18T16:21:45.7605499Z,2020,60,14,47,35,0,6to,1,3,25,0,0,46,13,0,59,1,0,0
24752,7431,2020-11-18T16:21:45.761549Z,2020,74,16,53,31,0,7mo,1,3,43,0,0,58,21,0,73,0,0,0
24752,7432,2020-11-18T16:21:45.761549Z,2020,62,20,45,33,0,8vo,0,2,29,0,0,42,17,0,62,0,0,0
24752,7433,2020-11-18T16:21:45.761549Z,2020,12,12,9,3,0,Sin Grado,0,0,9,0,0,0,3,0,12,0,0,0
61671,10343,2020-11-18T16:22:03.7155202Z,2020,29,5,16,23,0,10mo,0,0,6,0,0,24,13,0,28,0,0,1
61671,10344,2020-11-18T16:22:03.7155202Z,2020,30,1,20,22,0,11mo,3,0,8,0,0,29,10,0,27,0,0,0
61671,10345,2020-11-18T16:22:03.7155202Z,2020,20,1,9,18,0,12mo,0,0,2,0,0,19,11,0,20,0,0,0
61671,10346,2020-11-18T16:22:03.7165197Z,2020,24,5,15,16,0,6to,0,0,8,0,0,19,9,0,24,0,0,0
61671,10347,2020-11-18T16:22:03.7165197Z,2020,26,3,10,21,0,7mo,0,0,5,0,0,23,16,0,26,0,0,0
61671,10348,2020-11-18T16:22:03.7165197Z,2020,36,7,22,26,0,8vo,0,0,10,0,0,29,14,0,36,1,0,0
61671,10349,2020-11-18T16:22:03.7175206Z,2020,23,6,13,15,0,9no,0,0,8,0,0,17,10,0,23,0,0,0
61671,34358,2021-06-24T13:18:38.6271531Z,2021,24,6,18,16,0,10mo,0,0,8,0,0,18,6,0,24,0,0,0
61671,34359,2021-06-24T13:18:38.6281541Z,2021,27,5,18,21,0,11mo,0,0,6,0,0,22,9,0,26,0,0,1
61671,34360,2021-06-24T13:18:38.6281541Z,2021,28,1,21,21,0,12mo,3,0,7,0,0,27,7,0,25,0,0,0
61671,34361,2021-06-24T13:18:38.6281541Z,2021,20,4,12,12,0,6to,1,0,8,0,0,16,8,0,19,0,0,0
61671,34362,2021-06-24T13:18:38.6281541Z,2021,30,4,20,20,0,7mo,1,0,10,0,0,26,10,0,29,0,0,0
61671,34363,2021-06-24T13:18:38.629155Z,2021,25,3,15,19,0,8vo,0,0,6,0,0,22,10,0,25,0,0,0
61671,34364,2021-06-24T13:18:38.629155Z,2021,32,8,18,24,0,9no,0,0,8,0,0,24,14,0,32,1,0,0
61671,4330,2020-11-18T16:21:09.6964958Z,2019,33,3,25,24,0,10mo,3,0,9,0,0,30,8,0,30,0,0,0
61671,4331,2020-11-18T16:21:09.6964958Z,2019,22,1,11,20,0,11mo,0,0,2,0,0,21,11,0,22,0,0,0
61671,4332,2020-11-18T16:21:09.6974967Z,2019,27,0,19,23,0,12mo,0,0,4,0,0,27,8,0,27,0,0,0
61671,4333,2020-11-18T16:21:09.6974967Z,2019,25,3,13,19,0,6to,0,0,6,0,0,22,12,0,25,0,0,0
61671,4334,2020-11-18T16:21:09.6974967Z,2019,29,7,19,23,0,7mo,0,0,6,0,0,22,10,0,29,0,0,0
61671,4335,2020-11-18T16:21:09.6974967Z,2019,24,6,18,15,0,8vo,0,0,9,0,0,18,6,0,24,0,0,0
61671,4336,2020-11-18T16:21:09.6984967Z,2019,33,5,20,28,0,9no,0,0,5,0,0,28,13,0,32,0,0,1
71399,11298,2020-11-18T16:22:09.5874342Z,2020,47,18,40,23,0,1ro,1,1,24,0,0,29,7,0,46,0,0,0
71399,11299,2020-11-18T16:22:09.5874342Z,2020,58,21,47,20,0,2do,0,5,38,0,0,37,11,0,58,0,0,0
71399,11300,2020-11-18T16:22:09.5884346Z,2020,59,24,49,34,0,3ro,0,1,25,0,0,35,10,0,59,0,0,0
71399,11301,2020-11-18T16:22:10.1538125Z,2020,56,19,46,25,0,4to,3,4,31,0,0,37,10,0,53,0,0,0
71399,11302,2020-11-18T16:22:10.1548125Z,2020,43,16,34,22,0,5to,2,4,21,0,0,27,9,0,41,0,1,0
71399,11303,2020-11-18T16:22:10.1548125Z,2020,50,16,44,20,0,K,0,1,30,0,0,34,6,0,50,0,0,0
71399,35319,2021-06-24T13:18:45.5701325Z,2021,39,19,36,14,0,1ro,0,2,25,0,0,20,3,0,39,0,0,0
71399,35320,2021-06-24T13:18:45.5701325Z,2021,40,18,34,22,0,2do,2,7,18,0,0,22,6,0,38,0,0,0
71399,35321,2021-06-24T13:18:45.5701325Z,2021,48,19,42,16,0,3ro,0,2,32,0,0,29,6,0,48,0,0,0
71399,35322,2021-06-24T13:18:45.571133Z,2021,56,21,50,31,0,4to,0,6,25,0,0,35,6,0,56,0,0,0
71399,35323,2021-06-24T13:18:45.571133Z,2021,51,15,44,25,0,5to,2,2,26,0,0,36,7,0,49,0,0,0
71399,35324,2021-06-24T13:18:45.571133Z,2021,32,5,31,15,0,K,0,0,17,0,0,27,1,0,32,0,0,0
71399,5293,2020-11-18T16:21:14.4736826Z,2019,72,25,66,29,0,1ro,0,6,43,0,0,47,6,0,72,0,0,0
71399,5294,2020-11-18T16:21:14.4736826Z,2019,55,24,41,31,0,2do,0,1,24,0,0,31,14,0,55,0,0,0
71399,5295,2020-11-18T16:21:14.4736826Z,2019,55,21,49,24,0,3ro,3,4,31,0,0,34,6,0,52,0,0,0
71399,5296,2020-11-18T16:21:14.4746826Z,2019,48,18,40,23,0,4to,2,4,25,0,0,30,8,0,46,0,1,0
71399,5297,2020-11-18T16:21:14.4746826Z,2019,55,14,47,26,0,5to,1,0,29,0,0,41,8,0,54,0,0,0
71399,5298,2020-11-18T16:21:14.4746826Z,2019,47,16,43,22,0,K,1,0,25,0,0,31,4,0,46,0,0,0
58131,10024,2020-11-18T16:22:01.9413385Z,2020,38,19,34,19,0,1ro,1,0,19,0,0,19,4,0,36,0,0,1
58131,10025,2020-11-18T16:22:01.9413385Z,2020,40,17,32,22,0,2do,0,0,18,0,0,23,8,0,40,0,0,0
58131,10026,2020-11-18T16:22:01.9423394Z,2020,28,8,19,16,0,3ro,0,0,12,0,0,20,9,0,28,0,0,0
58131,10027,2020-11-18T16:22:01.9423394Z,2020,34,13,29,17,0,4to,1,0,17,0,0,21,5,0,33,0,1,0
58131,10028,2020-11-18T16:22:01.9423394Z,2020,28,14,25,16,0,5to,0,0,12,0,0,14,3,0,28,0,0,0
58131,10029,2020-11-18T16:22:01.9433393Z,2020,35,11,30,13,0,K,0,0,22,0,0,24,5,0,35,0,0,0
58131,10030,2020-11-18T16:22:01.9433393Z,2020,15,13,14,4,0,Sin Grado,0,0,11,0,0,2,1,0,15,0,0,0
58131,34031,2021-06-24T13:18:36.932939Z,2021,36,19,32,12,0,1ro,1,0,24,0,0,17,4,0,35,0,0,0
58131,34032,2021-06-24T13:18:36.932939Z,2021,39,19,35,22,0,2do,0,0,17,0,0,20,4,0,38,0,0,1
58131,34033,2021-06-24T13:18:36.9339403Z,2021,41,19,37,20,0,3ro,0,0,21,0,0,22,4,0,41,0,0,0
58131,34034,2021-06-24T13:18:36.9339403Z,2021,39,15,30,20,0,4to,0,0,19,0,0,24,9,0,39,0,0,0
58131,34035,2021-06-24T13:18:36.9339403Z,2021,34,11,26,19,0,5to,1,0,15,0,0,23,8,0,33,0,1,0
58131,34036,2021-06-24T13:18:36.9349413Z,2021,43,6,38,25,0,K,0,0,18,0,0,37,5,1,42,0,0,0
58131,34037,2021-06-24T13:18:36.9349413Z,2021,7,7,7,1,0,Sin Grado,0,0,6,0,0,0,0,0,7,0,0,0
58131,4007,2020-11-18T16:21:07.2878923Z,2019,54,25,44,25,0,1ro,0,0,29,0,0,29,10,0,54,0,0,0
58131,4008,2020-11-18T16:21:07.2878923Z,2019,29,11,19,14,0,2do,0,0,15,0,0,18,10,0,29,0,0,0
58131,4009,2020-11-18T16:21:07.2878923Z,2019,36,14,29,17,0,3ro,1,0,19,0,0,22,7,0,35,0,1,0
58131,4010,2020-11-18T16:21:07.2878923Z,2019,33,14,27,17,0,4to,1,0,16,0,0,19,6,0,32,0,0,0
58131,4011,2020-11-18T16:21:07.2878923Z,2019,40,11,32,21,0,5to,0,0,19,0,0,29,8,0,40,0,0,0
58131,4012,2020-11-18T16:21:07.2888928Z,2019,36,16,30,18,0,K,1,0,18,0,0,20,6,0,34,0,0,1
58131,4013,2020-11-18T16:21:07.2888928Z,2019,16,14,15,2,0,Sin Grado,0,0,14,0,0,2,1,0,16,0,0,0
24661,1406,2020-11-18T16:20:46.3309186Z,2019,22,6,21,14,0,1ro,0,0,8,0,0,16,1,0,22,0,0,0
24661,1407,2020-11-18T16:20:46.3309186Z,2019,22,9,19,12,0,2do,0,0,10,0,0,13,3,0,22,0,0,0
24661,1408,2020-11-18T16:20:46.3309186Z,2019,20,6,17,13,0,3ro,0,0,7,0,0,14,3,0,20,0,0,0
24661,1409,2020-11-18T16:20:46.3309186Z,2019,15,6,13,7,0,4to,0,0,8,0,0,9,2,0,15,0,1,0
24661,1410,2020-11-18T16:20:46.3319191Z,2019,19,5,16,7,0,5to,0,0,12,0,0,14,3,0,19,0,0,0
24661,1411,2020-11-18T16:20:46.3319191Z,2019,33,12,30,16,0,6to,0,0,17,0,0,21,3,0,33,0,0,0
24661,1412,2020-11-18T16:20:46.3319191Z,2019,27,6,23,14,0,7mo,0,0,13,0,0,21,4,0,27,0,0,0
24661,1413,2020-11-18T16:20:46.3319191Z,2019,44,11,34,23,0,8vo,0,0,21,0,0,33,10,0,44,0,1,0
24661,1414,2020-11-18T16:20:46.3329191Z,2019,25,5,22,14,0,K,0,0,11,0,0,20,3,0,25,0,0,0
24661,1415,2020-11-18T16:20:46.3329191Z,2019,21,21,20,2,0,Sin Grado,0,0,19,0,0,0,1,0,21,0,0,0
24661,31407,2021-06-24T13:18:14.9111427Z,2021,14,2,13,5,0,1ro,0,0,9,0,0,12,1,0,14,0,0,0
24661,31408,2021-06-24T13:18:14.9111427Z,2021,15,3,14,7,0,2do,0,0,8,0,0,12,1,0,15,0,0,0
24661,31409,2021-06-24T13:18:14.9111427Z,2021,25,7,25,12,0,3ro,0,0,13,0,0,18,0,0,25,0,0,0
24661,31410,2021-06-24T13:18:14.9111427Z,2021,20,6,17,12,0,4to,0,0,8,0,0,14,3,0,20,0,0,0
24661,31411,2021-06-24T13:18:14.9121432Z,2021,22,6,19,16,0,5to,0,0,6,0,0,16,3,0,22,0,0,0
24661,31412,2021-06-24T13:18:14.9121432Z,2021,29,10,27,9,0,6to,0,0,20,0,0,19,2,0,29,0,0,0
24661,31413,2021-06-24T13:18:14.9121432Z,2021,27,9,22,11,0,7mo,0,0,16,0,0,18,5,0,27,0,0,0
24661,31414,2021-06-24T13:18:14.9121432Z,2021,33,10,24,16,0,8vo,0,0,17,0,0,23,9,0,33,0,0,0
24661,31415,2021-06-24T13:18:14.9131433Z,2021,19,6,13,8,0,K,0,0,11,0,0,13,6,0,19,0,0,0
24661,31416,2021-06-24T13:18:14.9131433Z,2021,17,17,14,1,0,Sin Grado,0,1,16,0,0,0,3,0,17,0,1,0
24661,7410,2020-11-18T16:21:45.7545455Z,2020,21,6,20,11,0,1ro,0,0,10,0,0,15,1,0,21,0,0,0
24661,7411,2020-11-18T16:21:45.7545455Z,2020,31,12,29,16,0,2do,1,0,15,0,0,19,2,0,30,0,0,0
24661,7412,2020-11-18T16:21:45.7555455Z,2020,20,5,17,11,0,3ro,0,0,9,0,0,15,3,0,20,0,0,0
24661,7413,2020-11-18T16:21:45.7555455Z,2020,20,6,19,13,0,4to,0,0,7,0,0,14,1,0,19,0,0,1
24661,7414,2020-11-18T16:21:45.7555455Z,2020,20,5,18,7,0,5to,0,1,13,0,0,15,2,0,20,0,0,0
24661,7415,2020-11-18T16:21:45.7555455Z,2020,31,12,26,12,0,6to,0,0,19,0,0,19,5,2,29,0,0,0
24661,7416,2020-11-18T16:21:45.7565468Z,2020,34,12,30,15,0,7mo,0,0,19,0,0,22,4,0,34,0,0,0
24661,7417,2020-11-18T16:21:45.7565468Z,2020,20,4,15,10,0,8vo,0,0,10,0,0,16,5,0,20,0,0,0
24661,7418,2020-11-18T16:21:45.7565468Z,2020,13,2,13,6,0,K,0,0,7,0,0,11,0,0,13,0,0,0
24661,7419,2020-11-18T16:21:45.7565468Z,2020,31,31,29,1,0,Sin Grado,0,0,30,0,0,0,2,0,31,0,1,0
70680,11112,2020-11-18T16:22:08.3215892Z,2020,17,4,15,11,0,1ro,0,0,6,0,0,13,2,0,17,0,0,0
70680,11113,2020-11-18T16:22:08.3215892Z,2020,10,4,8,8,0,2do,0,0,2,0,0,6,2,0,10,0,0,0
70680,11114,2020-11-18T16:22:08.3215892Z,2020,12,3,7,3,0,3ro,0,1,9,0,0,9,5,0,12,0,0,0
70680,11115,2020-11-18T16:22:08.3225897Z,2020,12,4,7,7,0,4to,0,0,5,0,0,8,5,0,12,0,0,0
70680,11116,2020-11-18T16:22:08.3225897Z,2020,15,4,10,6,0,5to,0,0,9,0,0,11,5,0,15,0,0,0
70680,11117,2020-11-18T16:22:08.3225897Z,2020,17,4,10,5,0,6to,0,0,12,0,0,13,7,0,17,1,0,0
70680,11118,2020-11-18T16:22:08.3225897Z,2020,18,7,17,6,0,7mo,0,0,12,0,0,11,1,0,18,2,0,0
70680,11119,2020-11-18T16:22:08.3235906Z,2020,27,6,20,14,0,8vo,0,0,13,0,0,21,7,0,27,2,0,0
70680,11120,2020-11-18T16:22:08.3235906Z,2020,11,3,8,5,0,K,1,0,6,0,0,8,3,0,10,0,0,0
70680,11121,2020-11-18T16:22:08.3235906Z,2020,11,11,10,6,0,Sin Grado,0,2,5,0,0,0,1,0,11,0,0,0
70680,35133,2021-06-24T13:18:44.4943605Z,2021,10,4,7,5,0,1ro,1,0,5,0,0,6,3,0,9,0,0,0
70680,35134,2021-06-24T13:18:44.4943605Z,2021,13,2,11,9,0,2do,0,2,4,0,0,11,2,0,13,0,0,0
70680,35135,2021-06-24T13:18:44.495361Z,2021,7,3,5,4,0,3ro,0,0,3,0,0,4,2,0,7,0,0,0
70680,35136,2021-06-24T13:18:44.495361Z,2021,13,3,11,3,0,4to,0,0,10,0,0,10,2,0,13,0,0,0
70680,35137,2021-06-24T13:18:44.495361Z,2021,10,2,5,6,0,5to,0,0,4,0,0,8,5,0,10,0,0,0
70680,35138,2021-06-24T13:18:44.4963624Z,2021,16,6,13,7,0,6to,0,0,9,0,0,10,3,0,16,0,0,0
70680,35139,2021-06-24T13:18:44.4963624Z,2021,14,2,9,4,0,7mo,0,0,10,0,0,12,5,0,14,0,0,0
70680,35140,2021-06-24T13:18:44.4963624Z,2021,18,7,16,7,0,8vo,0,0,11,0,0,11,2,0,18,2,0,0
70680,35141,2021-06-24T13:18:44.4973629Z,2021,4,1,4,2,0,K,0,0,2,0,0,3,0,0,4,0,0,0
70680,35142,2021-06-24T13:18:44.4973629Z,2021,11,11,10,7,0,Sin Grado,0,0,4,0,0,0,1,0,11,0,0,0
70680,5106,2020-11-18T16:21:14.0183815Z,2019,9,6,4,5,0,1ro,0,0,4,0,0,3,5,0,9,0,0,0
70680,5107,2020-11-18T16:21:14.0183815Z,2019,14,5,11,4,0,2do,0,0,10,0,0,9,3,0,14,0,0,0
70680,5108,2020-11-18T16:21:14.0183815Z,2019,14,6,9,9,0,3ro,0,0,5,0,0,8,5,0,14,0,0,0
70680,5109,2020-11-18T16:21:14.0183815Z,2019,15,6,13,7,0,4to,0,0,8,0,0,9,2,0,15,0,0,0
70680,5110,2020-11-18T16:21:14.019381Z,2019,16,4,9,3,0,5to,0,0,13,0,0,12,7,0,16,1,0,0
70680,5111,2020-11-18T16:21:14.019381Z,2019,20,9,16,9,0,6to,0,0,11,0,0,11,4,0,20,2,0,0
70680,5112,2020-11-18T16:21:14.019381Z,2019,23,3,17,12,0,7mo,0,1,11,0,0,20,6,0,23,2,0,0
70680,5113,2020-11-18T16:21:14.0203819Z,2019,24,7,21,14,0,8vo,0,0,10,0,0,17,3,0,24,1,0,0
70680,5114,2020-11-18T16:21:14.0203819Z,2019,14,2,11,11,0,K,0,0,3,0,0,12,3,0,14,0,0,0
70680,5115,2020-11-18T16:21:14.0203819Z,2019,14,14,13,6,0,Sin Grado,0,0,8,0,0,0,1,0,14,0,0,0
20719,1051,2020-11-18T16:20:43.8092346Z,2019,17,2,12,8,0,1ro,0,1,9,0,0,15,5,0,17,0,0,0
20719,1052,2020-11-18T16:20:43.8092346Z,2019,28,5,17,15,0,2do,0,1,13,0,0,23,11,0,28,0,0,0
20719,1053,2020-11-18T16:20:43.8102355Z,2019,24,7,15,11,0,3ro,1,0,13,0,0,17,9,0,23,0,1,0
20719,1054,2020-11-18T16:20:43.8102355Z,2019,20,2,12,5,0,4to,0,0,15,0,0,18,8,0,20,0,1,0
20719,1055,2020-11-18T16:20:43.8102355Z,2019,28,8,16,9,0,5to,0,2,19,0,0,20,12,0,28,0,1,0
20719,1056,2020-11-18T16:20:43.811235Z,2019,23,7,11,12,0,6to,0,0,11,0,0,16,12,0,23,0,0,0
20719,1057,2020-11-18T16:20:43.811235Z,2019,21,4,15,16,0,7mo,0,0,5,0,0,17,6,0,21,0,1,0
20719,1058,2020-11-18T16:20:43.811235Z,2019,23,3,13,13,0,8vo,0,0,10,0,0,20,10,0,23,1,0,0
20719,1059,2020-11-18T16:20:43.811235Z,2019,24,1,19,11,0,K,0,1,13,0,0,23,5,0,24,0,0,0
20719,1060,2020-11-18T16:20:43.811235Z,2019,7,7,6,2,0,Sin Grado,0,0,5,0,0,0,1,0,7,0,0,0
20719,31051,2021-06-24T13:18:12.0751082Z,2021,22,4,14,9,0,1ro,0,2,13,0,0,18,8,0,22,0,0,0
20719,31052,2021-06-24T13:18:12.0751082Z,2021,25,1,20,9,0,2do,0,2,16,0,0,24,5,0,25,0,0,0
20719,31053,2021-06-24T13:18:12.0761087Z,2021,20,4,15,9,0,3ro,0,0,11,0,0,16,5,0,20,0,0,0
20719,31054,2021-06-24T13:18:12.0761087Z,2021,24,3,16,14,0,4to,0,2,10,0,0,21,8,0,24,0,1,0
20719,31055,2021-06-24T13:18:12.0761087Z,2021,21,5,14,12,0,5to,1,1,9,0,0,16,7,0,20,0,0,0
20719,31056,2021-06-24T13:18:12.0771097Z,2021,23,3,14,6,0,6to,0,1,17,0,0,20,9,0,23,0,1,0
20719,31057,2021-06-24T13:18:12.0771097Z,2021,21,8,13,6,0,7mo,0,1,15,0,0,13,8,0,21,0,1,0
20719,31058,2021-06-24T13:18:12.0771097Z,2021,22,6,13,12,0,8vo,0,0,10,0,0,16,9,0,22,0,0,0
20719,31059,2021-06-24T13:18:12.0781106Z,2021,20,1,12,12,0,K,0,1,8,0,0,19,8,0,20,0,0,0
20719,31060,2021-06-24T13:18:12.0781106Z,2021,6,6,5,2,0,Sin Grado,0,0,4,0,0,0,1,0,6,0,0,0
20719,7055,2020-11-18T16:21:43.6411334Z,2020,22,1,16,10,0,1ro,0,0,12,0,0,21,6,0,22,0,0,0
20719,7056,2020-11-18T16:21:43.6411334Z,2020,20,2,10,9,0,2do,0,0,11,0,0,18,10,0,20,0,0,0
20719,7057,2020-11-18T16:21:43.6421334Z,2020,25,3,13,14,0,3ro,0,4,11,0,0,22,12,0,25,0,0,0
20719,7058,2020-11-18T16:21:43.6421334Z,2020,25,7,13,13,0,4to,1,0,12,0,0,18,12,0,24,0,0,0
20719,7059,2020-11-18T16:21:43.6421334Z,2020,23,3,15,5,0,5to,0,0,18,0,0,20,8,0,23,0,1,0
20719,7060,2020-11-18T16:21:43.6431343Z,2020,26,8,16,9,0,6to,0,1,17,0,0,18,10,0,26,0,1,0
20719,7061,2020-11-18T16:21:43.6431343Z,2020,25,8,14,16,0,7mo,0,1,9,0,0,17,11,0,25,0,0,0
20719,7062,2020-11-18T16:21:43.6431343Z,2020,22,4,16,17,0,8vo,1,0,5,0,0,18,6,0,21,0,1,0
20719,7063,2020-11-18T16:21:43.6441352Z,2020,19,4,10,8,0,K,0,2,11,0,0,15,9,0,19,0,0,0
20719,7064,2020-11-18T16:21:43.6441352Z,2020,6,6,5,0,0,Sin Grado,0,0,6,0,0,0,1,0,6,0,0,0
71548,11353,2020-11-18T16:22:10.177829Z,2020,29,6,26,20,0,1ro,1,0,9,0,0,23,3,0,28,0,0,0
71548,11354,2020-11-18T16:22:10.1788317Z,2020,20,9,18,12,0,2do,2,0,8,0,0,11,2,0,18,0,0,0
71548,11355,2020-11-18T16:22:10.1788317Z,2020,22,7,20,14,0,3ro,0,0,8,0,0,15,2,0,22,0,0,0
71548,11356,2020-11-18T16:22:10.1788317Z,2020,25,10,23,10,0,4to,0,0,15,0,0,15,2,0,25,0,0,0
71548,11357,2020-11-18T16:22:10.1798294Z,2020,14,6,13,8,0,5to,1,0,6,0,0,8,1,0,13,0,1,0
71548,11358,2020-11-18T16:22:10.1798294Z,2020,22,5,17,12,0,K,0,0,10,0,0,17,5,0,22,0,0,0
71548,11359,2020-11-18T16:22:10.1798294Z,2020,17,3,15,9,0,PK,0,0,8,0,0,14,2,0,17,0,0,0
71548,11360,2020-11-18T16:22:10.1798294Z,2020,8,8,7,1,0,Sin Grado,0,0,7,0,0,0,1,0,8,0,0,0
71548,35374,2021-06-24T13:18:45.5961516Z,2021,20,5,19,11,0,1ro,0,0,9,0,0,15,1,0,20,0,0,0
71548,35375,2021-06-24T13:18:45.5971521Z,2021,23,5,23,16,0,2do,0,0,7,0,0,18,0,0,23,0,0,0
71548,35376,2021-06-24T13:18:45.5971521Z,2021,16,9,15,9,0,3ro,1,0,7,0,0,7,1,0,15,0,0,0
71548,35377,2021-06-24T13:18:45.5971521Z,2021,18,8,17,12,0,4to,0,0,6,0,0,10,1,0,18,0,0,0
71548,35378,2021-06-24T13:18:45.5971521Z,2021,21,7,19,10,0,5to,0,0,11,0,0,14,2,0,21,0,0,0
71548,35379,2021-06-24T13:18:45.5981526Z,2021,22,5,20,9,0,K,0,0,13,0,0,17,2,0,22,0,0,0
71548,35380,2021-06-24T13:18:45.5981526Z,2021,17,3,14,8,0,PK,1,0,9,0,0,14,3,0,16,0,0,0
71548,35381,2021-06-24T13:18:45.5981526Z,2021,9,9,9,1,0,Sin Grado,0,0,8,0,0,0,0,0,9,0,0,0
71548,5347,2020-11-18T16:21:15.0800857Z,2019,26,10,24,14,1,1ro,2,0,12,0,0,16,2,0,24,0,0,0
71548,5348,2020-11-18T16:21:15.0810857Z,2019,20,7,19,12,0,2do,0,0,8,0,0,13,1,0,20,0,0,0
71548,5349,2020-11-18T16:21:15.0810857Z,2019,31,13,28,10,1,3ro,0,0,21,0,0,18,3,0,31,0,0,0
71548,5350,2020-11-18T16:21:15.0810857Z,2019,18,10,16,9,0,4to,1,0,9,0,0,8,2,0,17,0,1,0
71548,5351,2020-11-18T16:21:15.0820875Z,2019,23,4,18,13,1,5to,0,0,10,0,0,19,5,0,23,0,0,0
71548,5352,2020-11-18T16:21:15.0820875Z,2019,28,5,4,20,0,K,1,0,8,0,0,23,24,0,27,0,0,0
71548,5353,2020-11-18T16:21:15.0820875Z,2019,5,4,4,1,1,Sin Grado,0,1,4,0,0,1,1,0,5,0,0,0
57000,33924,2021-06-24T13:18:36.6387284Z,2021,99,27,83,57,0,6to,0,0,42,0,0,72,16,0,99,2,0,0
57000,33925,2021-06-24T13:18:36.6387284Z,2021,81,25,64,36,0,7mo,0,2,45,0,0,56,17,0,81,0,1,0
57000,33926,2021-06-24T13:18:36.6397285Z,2021,133,50,106,62,0,8vo,0,2,71,0,0,83,27,0,133,5,1,0
57000,3901,2020-11-18T16:21:06.7705474Z,2019,155,53,120,70,0,6to,1,0,85,0,0,102,35,0,154,6,1,0
57000,3902,2020-11-18T16:21:06.7705474Z,2019,128,44,96,58,0,7mo,0,0,70,0,0,84,32,0,128,2,0,0
57000,3903,2020-11-18T16:21:06.7705474Z,2019,138,32,104,66,0,8vo,0,0,72,0,0,106,34,0,138,4,0,0
57000,9918,2020-11-18T16:22:01.5360679Z,2020,95,30,67,44,0,6to,0,0,51,0,0,65,28,0,95,1,1,0
57000,9919,2020-11-18T16:22:01.5370692Z,2020,153,52,120,70,0,7mo,0,1,83,0,0,101,33,0,153,6,1,0
57000,9920,2020-11-18T16:22:01.5370692Z,2020,128,49,94,58,0,8vo,0,1,70,0,0,79,34,0,128,3,0,0
71373,11289,2020-11-18T16:22:09.5874342Z,2020,63,21,55,34,0,6to,3,2,29,0,0,42,8,0,60,0,0,0
71373,11290,2020-11-18T16:22:09.5874342Z,2020,79,23,67,44,0,7mo,1,3,35,0,0,56,12,0,78,0,0,0
71373,11291,2020-11-18T16:22:09.5874342Z,2020,93,35,85,43,0,8vo,0,0,50,0,0,58,8,0,93,0,0,0
71373,11292,2020-11-18T16:22:09.5874342Z,2020,15,15,15,8,0,Sin Grado,0,0,7,0,0,0,0,0,15,0,0,0
71373,35310,2021-06-24T13:18:45.5631273Z,2021,61,24,59,35,0,6to,1,0,26,0,0,37,2,0,60,0,1,0
71373,35311,2021-06-24T13:18:45.5631273Z,2021,62,20,54,32,0,7mo,1,0,30,0,0,42,8,0,61,0,0,0
71373,35312,2021-06-24T13:18:45.5631273Z,2021,89,31,79,51,0,8vo,1,0,38,0,0,58,10,0,88,0,0,0
71373,35313,2021-06-24T13:18:45.5641287Z,2021,19,19,19,7,0,Sin Grado,0,0,12,0,0,0,0,0,19,0,0,0
71373,5284,2020-11-18T16:21:14.469679Z,2019,85,36,72,48,0,6to,1,2,37,0,0,49,13,0,84,0,0,0
71373,5285,2020-11-18T16:21:14.469679Z,2019,97,36,84,48,0,7mo,1,0,49,0,0,61,13,0,96,0,0,0
71373,5286,2020-11-18T16:21:14.469679Z,2019,97,40,81,40,0,8vo,1,0,57,0,0,57,16,0,96,0,0,0
71373,5287,2020-11-18T16:21:14.4706804Z,2019,12,11,11,5,0,Sin Grado,0,0,7,0,0,1,1,0,12,0,0,0
52894,33642,2021-06-24T13:18:33.6746025Z,2021,23,6,21,11,0,1ro,0,2,12,0,0,17,2,0,23,0,0,0
52894,33643,2021-06-24T13:18:33.675603Z,2021,23,5,22,9,0,2do,0,1,14,0,0,18,1,0,23,0,0,0
52894,33644,2021-06-24T13:18:33.675603Z,2021,24,8,21,12,0,3ro,1,1,12,0,0,16,3,0,23,0,0,0
52894,33645,2021-06-24T13:18:33.675603Z,2021,31,13,27,19,0,4to,0,0,12,0,0,18,4,0,31,0,0,0
52894,33646,2021-06-24T13:18:33.676604Z,2021,38,11,34,17,0,5to,0,4,21,0,0,27,4,0,38,0,0,0
52894,33647,2021-06-24T13:18:33.676604Z,2021,24,3,19,15,0,K,0,1,9,0,0,21,5,0,24,0,0,0
52894,3617,2020-11-18T16:21:04.3209139Z,2019,24,9,21,11,0,1ro,0,0,13,0,0,15,3,0,24,0,0,0
52894,3618,2020-11-18T16:21:04.3219143Z,2019,29,13,25,15,0,2do,0,1,14,0,0,16,4,0,29,0,1,0
52894,3619,2020-11-18T16:21:04.3219143Z,2019,36,10,31,14,0,3ro,0,0,22,0,0,26,5,0,36,0,0,0
52894,3620,2020-11-18T16:21:04.3219143Z,2019,41,14,39,22,0,4to,0,1,19,0,0,27,2,0,41,0,1,0
52894,3621,2020-11-18T16:21:04.3219143Z,2019,50,18,39,24,0,5to,0,1,26,0,0,32,11,0,50,0,0,0
52894,3622,2020-11-18T16:21:04.3219143Z,2019,22,4,20,9,0,K,0,0,13,0,0,18,2,0,22,0,0,0
52894,9636,2020-11-18T16:21:59.4897011Z,2020,23,5,19,9,0,1ro,0,0,14,0,0,18,4,0,23,0,0,0
52894,9637,2020-11-18T16:21:59.4897011Z,2020,21,7,18,12,0,2do,0,0,9,0,0,14,3,0,21,0,0,0
52894,9638,2020-11-18T16:21:59.4897011Z,2020,30,13,22,18,0,3ro,0,0,12,0,0,17,8,0,30,0,0,0
52894,9639,2020-11-18T16:21:59.490702Z,2020,40,11,32,17,0,4to,0,2,23,0,0,29,8,0,40,0,0,0
52894,9640,2020-11-18T16:21:59.490702Z,2020,40,11,35,23,0,5to,0,2,17,0,0,29,5,0,40,0,1,0
52894,9641,2020-11-18T16:21:59.490702Z,2020,24,6,18,10,0,K,0,1,14,0,0,18,6,0,24,0,0,0
18267,30848,2021-06-24T13:18:11.4626691Z,2021,42,4,36,22,0,1ro,0,1,20,0,0,38,6,0,42,0,0,0
18267,30849,2021-06-24T13:18:11.4626691Z,2021,50,20,47,29,0,2do,0,2,21,0,0,30,3,0,50,0,0,0
18267,30850,2021-06-24T13:18:11.4626691Z,2021,49,14,40,26,0,3ro,1,4,23,0,0,35,9,0,48,0,0,0
18267,30851,2021-06-24T13:18:11.46367Z,2021,50,17,44,26,0,4to,1,1,24,0,0,33,6,0,49,0,0,0
18267,30852,2021-06-24T13:18:11.46367Z,2021,53,17,46,30,0,5to,0,4,23,0,0,36,7,0,53,0,0,0
18267,30853,2021-06-24T13:18:11.46367Z,2021,83,38,74,40,0,6to,1,2,43,0,0,45,9,0,82,0,0,0
18267,30854,2021-06-24T13:18:11.46367Z,2021,74,30,62,43,0,7mo,0,0,31,0,0,44,12,0,74,0,0,0
18267,30855,2021-06-24T13:18:11.4646705Z,2021,76,20,59,39,0,8vo,0,1,37,0,0,56,17,0,76,0,0,0
18267,30856,2021-06-24T13:18:11.4646705Z,2021,42,7,35,21,0,K,0,0,21,0,0,35,7,1,41,0,0,0
18267,30857,2021-06-24T13:18:11.4646705Z,2021,8,8,7,2,0,Sin Grado,0,0,6,0,0,0,1,0,8,0,0,0
18267,6852,2020-11-18T16:21:42.0480688Z,2020,57,22,54,31,0,1ro,0,0,26,0,0,35,3,0,57,0,0,0
18267,6853,2020-11-18T16:21:42.0480688Z,2020,48,11,43,24,0,2do,2,0,24,0,0,37,5,0,46,0,0,0
18267,6854,2020-11-18T16:21:42.0480688Z,2020,51,16,46,25,0,3ro,2,0,26,0,0,35,5,0,49,0,0,0
18267,6855,2020-11-18T16:21:42.0490701Z,2020,51,18,49,27,0,4to,0,0,24,0,0,33,2,0,51,0,0,0
18267,6856,2020-11-18T16:21:42.0490701Z,2020,71,25,61,35,0,5to,2,0,36,0,0,46,10,0,69,0,0,0
18267,6857,2020-11-18T16:21:42.0490701Z,2020,78,30,67,44,0,6to,0,0,34,0,0,48,11,0,78,0,0,0
18267,6858,2020-11-18T16:21:42.0490701Z,2020,81,23,71,41,0,7mo,0,0,40,0,0,58,10,0,81,0,0,0
18267,6859,2020-11-18T16:21:42.0490701Z,2020,65,16,54,27,0,8vo,0,0,38,0,0,49,11,0,65,0,0,0
18267,6860,2020-11-18T16:21:42.0500705Z,2020,35,0,34,17,0,K,0,0,18,0,0,35,1,0,35,0,0,0
18267,6861,2020-11-18T16:21:42.0500705Z,2020,8,8,8,3,0,Sin Grado,0,0,5,0,0,0,0,0,8,0,0,0
18267,851,2020-11-18T16:20:42.6484599Z,2019,63,23,59,35,0,1ro,2,6,28,0,0,40,4,0,61,0,0,0
18267,852,2020-11-18T16:20:42.6484599Z,2019,52,17,46,24,0,2do,2,5,28,0,1,35,6,0,50,0,1,0
18267,853,2020-11-18T16:20:42.6494603Z,2019,53,18,48,30,0,3ro,0,4,23,0,0,35,5,0,53,0,0,0
18267,854,2020-11-18T16:20:42.6494603Z,2019,74,26,65,38,0,4to,2,7,36,0,0,48,9,0,72,0,0,0
18267,855,2020-11-18T16:20:42.6494603Z,2019,70,25,64,39,0,5to,0,8,31,0,0,45,6,0,70,0,0,0
18267,856,2020-11-18T16:20:42.6494603Z,2019,86,24,73,45,0,6to,0,5,41,0,0,62,13,0,86,0,0,0
18267,857,2020-11-18T16:20:42.6494603Z,2019,67,15,55,28,0,7mo,0,2,39,0,0,52,12,0,67,0,0,0
18267,858,2020-11-18T16:20:42.6504608Z,2019,68,14,59,34,0,8vo,2,1,34,0,0,54,9,0,66,0,0,0
18267,859,2020-11-18T16:20:42.6504608Z,2019,50,8,46,40,0,K,0,4,10,0,0,42,4,0,50,0,0,0
18267,860,2020-11-18T16:20:42.6504608Z,2019,6,6,6,2,0,Sin Grado,0,2,4,0,0,0,0,0,6,0,0,0
43018,2841,2020-11-18T16:20:59.1774814Z,2019,49,23,47,33,0,1ro,1,1,16,0,0,26,2,0,48,0,0,0
43018,2842,2020-11-18T16:20:59.1784823Z,2019,45,19,42,23,0,2do,0,3,22,0,0,26,3,2,43,0,0,0
43018,2843,2020-11-18T16:20:59.1784823Z,2019,26,16,23,13,0,3ro,0,2,13,0,0,10,3,0,26,0,0,0
43018,2844,2020-11-18T16:20:59.1784823Z,2019,39,14,36,20,0,4to,0,0,19,0,0,25,3,0,39,0,1,0
43018,2845,2020-11-18T16:20:59.1784823Z,2019,42,20,37,20,0,5to,0,0,22,0,0,22,5,0,42,0,0,0
43018,2846,2020-11-18T16:20:59.1784823Z,2019,42,11,40,23,0,K,0,0,19,0,0,31,2,0,42,0,0,0
43018,2847,2020-11-18T16:20:59.1794828Z,2019,35,29,31,9,0,Sin Grado,0,0,26,0,0,6,4,0,35,0,0,0
43018,32848,2021-06-24T13:18:28.2016784Z,2021,38,12,36,17,0,1ro,2,0,21,0,0,26,2,0,36,0,0,0
43018,32849,2021-06-24T13:18:28.2016784Z,2021,38,9,38,20,0,2do,0,0,18,0,0,29,0,0,38,0,0,0
43018,32850,2021-06-24T13:18:28.2016784Z,2021,25,11,23,17,0,3ro,1,0,8,0,0,14,2,0,24,0,0,0
43018,32851,2021-06-24T13:18:28.2026784Z,2021,31,11,29,20,0,4to,0,0,11,0,0,20,2,0,31,0,0,0
43018,32852,2021-06-24T13:18:28.2026784Z,2021,21,12,19,9,0,5to,0,0,12,0,0,9,2,0,21,0,0,0
43018,32853,2021-06-24T13:18:28.2026784Z,2021,48,10,44,25,0,K,5,0,23,0,0,38,4,0,43,0,0,0
43018,32854,2021-06-24T13:18:28.2026784Z,2021,13,2,12,5,0,PK,1,0,8,0,0,11,1,0,12,0,0,0
43018,32855,2021-06-24T13:18:28.2036794Z,2021,20,20,17,4,0,Sin Grado,1,0,16,0,0,0,3,0,19,0,0,0
43018,8852,2020-11-18T16:21:54.2261913Z,2020,43,13,39,23,0,1ro,0,0,20,0,0,30,4,0,43,0,0,0
43018,8853,2020-11-18T16:21:54.2271922Z,2020,35,15,32,23,0,2do,1,0,12,0,0,20,3,0,34,0,0,0
43018,8854,2020-11-18T16:21:54.2271922Z,2020,43,15,38,25,0,3ro,1,3,18,0,0,28,5,1,41,0,0,0
43018,8855,2020-11-18T16:21:54.2271922Z,2020,28,14,26,15,0,4to,0,1,13,0,0,14,2,0,28,0,0,0
43018,8856,2020-11-18T16:21:54.2281931Z,2020,38,16,34,20,0,5to,1,0,18,0,0,22,4,0,37,0,0,0
43018,8857,2020-11-18T16:21:54.2281931Z,2020,36,8,36,17,0,K,2,0,19,0,0,28,0,0,34,0,0,0
43018,8858,2020-11-18T16:21:54.2281931Z,2020,16,3,14,8,0,PK,0,0,8,0,0,13,2,0,16,0,0,0
43018,8859,2020-11-18T16:21:54.2281931Z,2020,39,38,35,7,0,Sin Grado,0,0,32,0,0,1,4,0,39,0,0,0
50500,3272,2020-11-18T16:21:01.4630086Z,2019,69,34,53,32,0,1ro,1,3,37,0,0,35,16,0,68,1,0,0
50500,3273,2020-11-18T16:21:01.4630086Z,2019,63,25,55,33,0,2do,2,3,30,0,0,38,8,0,61,0,0,0
50500,3274,2020-11-18T16:21:01.4640077Z,2019,76,32,61,32,0,3ro,1,5,44,0,0,44,15,0,75,1,0,0
50500,3275,2020-11-18T16:21:01.4640077Z,2019,79,29,63,41,0,4to,1,2,38,0,0,50,16,0,78,0,0,0
50500,3276,2020-11-18T16:21:01.4640077Z,2019,73,22,56,37,0,5to,1,2,36,0,0,51,17,0,72,1,1,0
50500,3277,2020-11-18T16:21:01.4640077Z,2019,48,14,39,19,0,K,0,2,29,0,0,34,9,0,48,0,0,0
50500,3278,2020-11-18T16:21:01.4640077Z,2019,3,3,2,2,0,Sin Grado,0,0,1,0,0,0,1,0,3,0,0,0
50500,33298,2021-06-24T13:18:30.9036154Z,2021,42,20,36,20,0,1ro,0,0,22,0,0,22,6,0,42,0,0,0
50500,33299,2021-06-24T13:18:30.9036154Z,2021,46,19,41,18,0,2do,1,0,28,0,0,27,5,0,45,0,0,0
50500,33300,2021-06-24T13:18:31.5360689Z,2021,53,27,43,27,0,3ro,1,0,26,0,0,26,10,0,52,1,0,0
50500,33301,2021-06-24T13:18:31.5360689Z,2021,55,19,49,28,0,4to,2,0,27,0,0,36,6,0,53,1,0,0
50500,33302,2021-06-24T13:18:31.5370694Z,2021,60,29,51,26,0,5to,1,0,34,0,0,31,9,0,59,1,0,0
50500,33303,2021-06-24T13:18:31.5370694Z,2021,41,9,35,21,0,K,4,0,20,0,0,32,6,0,37,0,0,0
50500,33304,2021-06-24T13:18:31.5370694Z,2021,3,3,2,2,0,Sin Grado,0,0,1,0,0,0,1,0,3,0,0,0
50500,9292,2020-11-18T16:21:57.3482726Z,2020,48,17,38,19,0,1ro,1,0,29,0,0,31,10,0,47,0,0,0
50500,9293,2020-11-18T16:21:57.3482726Z,2020,61,28,53,28,0,2do,1,0,33,0,0,33,8,0,60,1,0,0
50500,9294,2020-11-18T16:21:57.3492735Z,2020,60,23,53,29,0,3ro,2,0,31,0,0,37,7,0,58,1,0,0
50500,9295,2020-11-18T16:21:57.3492735Z,2020,63,29,49,29,0,4to,1,0,34,0,0,34,14,0,62,1,0,0
50500,9296,2020-11-18T16:21:57.3492735Z,2020,72,25,58,37,0,5to,0,0,35,0,0,47,14,0,72,0,0,0
50500,9297,2020-11-18T16:21:57.3492735Z,2020,48,22,39,23,0,K,0,0,25,0,0,26,9,0,48,0,0,0
50500,9298,2020-11-18T16:21:57.3502748Z,2020,3,3,2,2,0,Sin Grado,0,0,1,0,0,0,1,0,3,0,0,0
71522,11335,2020-11-18T16:22:10.1718241Z,2020,36,13,34,14,0,1ro,1,0,22,0,0,23,2,0,35,0,0,0
71522,11336,2020-11-18T16:22:10.1718241Z,2020,28,12,26,18,0,2do,0,0,10,0,0,16,2,0,28,0,0,0
71522,11337,2020-11-18T16:22:10.1728254Z,2020,18,6,17,10,0,3ro,1,0,8,0,0,12,1,0,17,0,0,0
71522,11338,2020-11-18T16:22:10.1728254Z,2020,25,8,20,13,0,4to,2,0,12,0,0,17,5,0,23,0,0,0
71522,11339,2020-11-18T16:22:10.1728254Z,2020,21,7,19,10,0,5to,0,0,11,0,0,14,2,0,21,0,0,0
71522,11340,2020-11-18T16:22:10.1738263Z,2020,25,8,23,10,0,K,1,0,15,0,0,17,2,0,24,0,0,0
71522,11341,2020-11-18T16:22:10.1738263Z,2020,23,7,19,9,0,PK,0,0,14,0,0,16,4,0,23,0,0,0
71522,11342,2020-11-18T16:22:10.1738263Z,2020,12,12,9,0,0,Sin Grado,0,0,12,0,0,0,3,0,12,0,0,0
71522,35356,2021-06-24T13:18:45.5911474Z,2021,30,6,28,11,0,1ro,1,0,19,0,0,24,2,0,29,0,0,0
71522,35357,2021-06-24T13:18:45.5911474Z,2021,45,12,42,16,0,2do,0,0,29,0,0,33,3,0,45,0,0,0
71522,35358,2021-06-24T13:18:45.5911474Z,2021,25,11,24,15,0,3ro,0,0,10,0,0,14,1,0,25,0,0,0
71522,35359,2021-06-24T13:18:45.5911474Z,2021,19,7,18,10,0,4to,1,0,9,0,0,12,1,0,18,0,0,0
71522,35360,2021-06-24T13:18:45.5921474Z,2021,21,7,19,11,0,5to,1,0,10,0,0,14,2,0,20,0,0,0
71522,35361,2021-06-24T13:18:45.5921474Z,2021,44,12,40,19,0,K,0,0,25,0,0,32,4,0,44,0,0,0
71522,35362,2021-06-24T13:18:45.5921474Z,2021,11,1,10,5,0,PK,0,0,6,0,0,10,1,0,11,0,0,0
71522,35363,2021-06-24T13:18:45.5931488Z,2021,6,6,4,0,0,Sin Grado,0,0,6,0,0,0,2,0,6,0,0,0
71522,5330,2020-11-18T16:21:15.0770844Z,2019,31,12,30,15,0,1ro,1,1,16,0,0,19,1,0,30,0,0,0
71522,5331,2020-11-18T16:21:15.0770844Z,2019,27,12,23,17,0,2do,1,1,10,0,0,15,4,0,26,0,0,0
71522,5332,2020-11-18T16:21:15.0780848Z,2019,23,10,17,13,0,3ro,2,1,10,0,0,13,6,0,21,0,0,0
71522,5333,2020-11-18T16:21:15.0780848Z,2019,21,7,19,11,0,4to,0,0,10,0,0,14,2,0,21,0,0,0
71522,5334,2020-11-18T16:21:15.0780848Z,2019,18,8,17,7,0,5to,0,0,11,0,0,10,1,0,18,0,0,0
71522,5335,2020-11-18T16:21:15.0790861Z,2019,23,7,21,10,0,K,0,0,13,0,0,16,2,0,23,0,0,0
71522,5336,2020-11-18T16:21:15.0790861Z,2019,14,13,12,0,0,Sin Grado,0,1,14,0,0,1,2,0,14,0,0,0
50757,3307,2020-11-18T16:21:02.1334565Z,2019,36,13,30,14,0,1ro,0,0,22,0,0,23,6,0,36,1,0,0
50757,3308,2020-11-18T16:21:02.1344569Z,2019,43,16,34,19,0,2do,0,0,24,0,0,27,9,0,43,0,0,0
50757,3309,2020-11-18T16:21:02.1344569Z,2019,41,16,32,24,0,3ro,0,0,17,0,0,25,9,0,41,0,0,0
50757,3310,2020-11-18T16:21:02.1344569Z,2019,51,20,38,23,0,4to,1,0,28,0,0,31,13,0,50,0,1,0
50757,3311,2020-11-18T16:21:02.1344569Z,2019,43,7,32,23,0,5to,0,0,20,0,0,36,11,0,43,0,0,0
50757,3312,2020-11-18T16:21:02.1354574Z,2019,55,16,44,30,0,6to,0,0,25,0,1,39,11,0,55,0,1,0
50757,3313,2020-11-18T16:21:02.1354574Z,2019,73,21,53,21,0,7mo,0,0,52,0,0,52,20,0,73,0,4,0
50757,3314,2020-11-18T16:21:02.1364578Z,2019,59,16,38,26,0,8vo,0,0,33,0,0,43,21,0,59,0,2,0
50757,3315,2020-11-18T16:21:02.1364578Z,2019,39,7,30,23,0,K,0,0,16,0,0,32,9,0,39,0,0,0
50757,3316,2020-11-18T16:21:02.1364578Z,2019,10,10,9,3,0,Sin Grado,0,0,7,0,0,0,1,0,10,0,0,0
50757,33333,2021-06-24T13:18:31.5620871Z,2021,26,6,22,11,0,1ro,0,5,15,0,0,20,4,0,26,0,0,0
50757,33334,2021-06-24T13:18:31.5630876Z,2021,25,7,21,15,0,2do,0,1,10,0,0,18,4,0,25,0,0,0
50757,33335,2021-06-24T13:18:31.5630876Z,2021,23,9,18,12,0,3ro,1,2,11,0,0,14,5,0,22,1,0,0
50757,33336,2021-06-24T13:18:31.5630876Z,2021,27,11,20,13,0,4to,0,0,14,0,0,16,7,0,27,0,0,0
50757,33337,2021-06-24T13:18:31.5630876Z,2021,27,14,20,16,0,5to,0,3,11,0,0,13,7,0,27,0,0,0
50757,33338,2021-06-24T13:18:31.5630876Z,2021,34,12,26,16,0,6to,0,2,18,0,0,22,8,0,34,0,0,0
50757,33339,2021-06-24T13:18:31.5640894Z,2021,36,6,28,14,0,7mo,0,0,22,0,0,30,8,0,36,0,0,0
50757,33340,2021-06-24T13:18:31.5640894Z,2021,36,9,27,17,0,8vo,0,1,19,0,0,27,9,0,36,0,1,0
50757,33341,2021-06-24T13:18:31.5640894Z,2021,13,5,8,2,0,K,0,1,11,0,0,8,5,0,13,0,0,0
50757,33342,2021-06-24T13:18:31.5640894Z,2021,6,6,4,2,0,Sin Grado,0,0,4,0,0,0,2,0,6,0,0,0
50757,9327,2020-11-18T16:21:57.9997069Z,2020,43,12,36,27,0,1ro,0,11,16,0,0,31,7,0,43,0,0,0
50757,9328,2020-11-18T16:21:57.9997069Z,2020,32,10,20,13,0,2do,2,5,19,0,0,22,12,0,30,1,0,0
50757,9329,2020-11-18T16:21:57.9997069Z,2020,42,15,30,20,0,3ro,0,4,22,0,0,27,12,0,42,0,0,0
50757,9330,2020-11-18T16:21:58.0007069Z,2020,40,18,32,24,0,4to,0,6,16,0,0,22,8,0,40,0,0,0
50757,9331,2020-11-18T16:21:58.0007069Z,2020,48,19,33,23,0,5to,1,7,25,0,0,29,15,0,47,0,1,0
50757,9332,2020-11-18T16:21:58.0007069Z,2020,46,10,30,18,0,6to,0,4,28,0,0,36,16,0,46,0,0,0
50757,9333,2020-11-18T16:21:58.0007069Z,2020,54,14,46,31,0,7mo,0,2,23,0,0,40,8,0,54,0,2,0
50757,9334,2020-11-18T16:21:58.0017078Z,2020,78,22,57,26,0,8vo,0,9,52,0,0,56,21,0,78,0,1,0
50757,9335,2020-11-18T16:21:58.0017078Z,2020,42,9,37,18,0,K,0,7,24,0,0,33,5,0,42,0,0,0
50757,9336,2020-11-18T16:21:58.0017078Z,2020,12,12,8,4,0,Sin Grado,0,1,8,0,0,0,4,0,12,0,0,0
14357,30561,2021-06-24T13:18:10.3899003Z,2021,128,25,98,56,0,10mo,1,0,72,0,0,103,30,0,127,3,0,0
14357,30562,2021-06-24T13:18:10.3899003Z,2021,137,29,113,67,0,11mo,1,0,70,0,0,108,24,0,136,2,0,0
14357,30563,2021-06-24T13:18:10.3899003Z,2021,98,17,71,45,0,12mo,1,0,53,0,0,81,27,0,97,4,0,0
14357,30564,2021-06-24T13:18:10.3909003Z,2021,133,23,103,63,0,9no,0,0,70,0,0,110,30,0,133,4,0,0
14357,30565,2021-06-24T13:18:10.3909003Z,2021,11,9,10,2,0,Sin Grado,1,0,9,0,0,2,1,0,10,0,0,0
14357,564,2020-11-18T16:20:40.776215Z,2019,116,20,73,56,0,10mo,0,0,60,0,0,96,43,0,116,6,0,0
14357,565,2020-11-18T16:20:40.776215Z,2019,91,12,60,58,0,11mo,2,0,33,0,1,79,31,0,89,4,0,0
14357,566,2020-11-18T16:20:40.776215Z,2019,118,0,75,63,0,12mo,1,0,55,0,0,118,43,0,117,0,0,0
14357,567,2020-11-18T16:20:40.777215Z,2019,124,25,93,58,0,9no,0,0,66,0,0,99,31,0,124,2,0,0
14357,6563,2020-11-18T16:21:40.3579458Z,2020,137,27,96,64,0,10mo,1,0,73,0,0,110,41,0,136,2,0,0
14357,6564,2020-11-18T16:21:40.3589462Z,2020,110,20,75,54,0,11mo,1,0,56,0,0,90,35,0,109,6,0,0
14357,6565,2020-11-18T16:21:40.3589462Z,2020,91,12,63,61,0,12mo,2,0,30,0,0,79,28,0,89,4,0,0
14357,6566,2020-11-18T16:21:40.3589462Z,2020,131,23,97,57,0,9no,1,0,74,0,0,108,34,0,130,3,0,0
14357,6567,2020-11-18T16:21:40.3589462Z,2020,3,3,3,0,0,Sin Grado,1,0,3,0,0,0,0,0,2,0,0,0
71092,11229,2020-11-18T16:22:09.5664212Z,2020,209,61,176,113,0,10mo,2,6,96,0,0,148,33,0,204,0,0,3
71092,11230,2020-11-18T16:22:09.5664212Z,2020,173,45,141,76,0,11mo,1,1,97,0,0,128,32,0,171,0,0,1
71092,11231,2020-11-18T16:22:09.5674212Z,2020,180,48,136,88,0,12mo,1,3,92,0,0,132,44,0,179,0,0,0
71092,11232,2020-11-18T16:22:09.5674212Z,2020,238,76,192,132,0,9no,2,10,106,0,0,162,46,0,235,0,0,1
71092,11233,2020-11-18T16:22:09.5674212Z,2020,10,10,9,4,0,Sin Grado,0,0,6,0,0,0,1,0,10,1,0,0
71092,35250,2021-06-24T13:18:44.8145901Z,2021,236,66,170,131,0,10mo,2,10,105,0,0,170,66,0,234,0,0,0
71092,35251,2021-06-24T13:18:44.8155915Z,2021,177,48,135,108,0,11mo,2,9,69,0,0,129,42,1,173,0,1,1
71092,35252,2021-06-24T13:18:44.8155915Z,2021,151,42,111,67,0,12mo,1,1,84,0,0,109,40,0,150,0,0,0
71092,35253,2021-06-24T13:18:44.8155915Z,2021,170,53,138,87,0,9no,2,6,83,0,0,117,32,0,167,0,1,1
71092,35254,2021-06-24T13:18:44.8155915Z,2021,15,15,13,4,0,Sin Grado,0,2,11,0,0,0,2,0,15,0,0,0
71092,5224,2020-11-18T16:21:14.4406605Z,2019,189,48,150,80,0,10mo,1,10,109,0,0,141,39,0,188,0,0,0
71092,5225,2020-11-18T16:21:14.4416627Z,2019,182,44,139,88,0,11mo,1,8,94,0,0,138,43,0,181,0,0,0
71092,5226,2020-11-18T16:21:14.4416627Z,2019,224,1,171,119,0,12mo,2,5,105,0,0,223,53,0,221,0,0,1
71092,5227,2020-11-18T16:21:14.4416627Z,2019,243,70,201,131,0,9no,4,12,112,0,0,173,42,0,236,0,1,3
71092,5228,2020-11-18T16:21:14.4416627Z,2019,8,6,5,2,0,Sin Grado,0,0,6,0,0,2,3,0,8,0,0,0
34207,2210,2020-11-18T16:20:54.9966949Z,2019,61,15,59,35,0,6to,2,0,26,0,0,46,2,0,59,0,0,0
34207,2211,2020-11-18T16:20:54.9966949Z,2019,73,23,64,45,0,7mo,3,0,28,0,0,50,9,0,70,0,0,0
34207,2212,2020-11-18T16:20:54.9976949Z,2019,77,16,71,30,0,8vo,2,0,47,0,0,61,6,0,75,0,0,0
34207,2213,2020-11-18T16:20:54.9976949Z,2019,34,30,34,17,0,Sin Grado,0,0,17,0,0,4,0,0,34,0,0,0
34207,32217,2021-06-24T13:18:21.7440419Z,2021,44,8,39,25,0,6to,0,0,19,0,0,36,5,0,44,0,1,0
34207,32218,2021-06-24T13:18:21.7450419Z,2021,54,10,43,25,0,7mo,2,0,29,0,0,44,11,1,51,0,0,0
34207,32219,2021-06-24T13:18:21.7450419Z,2021,53,10,50,34,0,8vo,2,0,19,0,0,43,3,0,51,0,0,0
34207,32220,2021-06-24T13:18:21.7450419Z,2021,28,28,27,8,0,Sin Grado,0,0,20,0,0,0,1,0,28,0,0,0
34207,8222,2020-11-18T16:21:50.674825Z,2020,60,13,55,29,0,6to,1,0,31,0,0,47,5,1,58,0,0,0
34207,8223,2020-11-18T16:21:50.674825Z,2020,61,13,59,39,0,7mo,2,0,22,0,0,48,2,0,58,0,0,1
34207,8224,2020-11-18T16:21:50.674825Z,2020,60,19,53,32,0,8vo,4,0,28,0,0,41,7,0,56,0,0,0
34207,8225,2020-11-18T16:21:50.674825Z,2020,29,29,28,11,0,Sin Grado,0,0,18,0,0,0,1,0,29,0,0,0
60343,10153,2020-11-18T16:22:02.7098457Z,2020,49,7,44,23,0,1ro,1,0,26,0,0,42,5,0,48,0,0,0
60343,10154,2020-11-18T16:22:02.7098457Z,2020,53,13,49,28,0,2do,1,0,25,0,0,40,4,0,52,0,0,0
60343,10155,2020-11-18T16:22:02.7098457Z,2020,72,24,62,35,0,3ro,2,0,37,0,0,48,10,0,70,0,1,0
60343,10156,2020-11-18T16:22:02.710847Z,2020,67,21,56,32,0,4to,1,1,35,0,0,46,11,0,66,1,1,0
60343,10157,2020-11-18T16:22:02.710847Z,2020,59,19,51,29,0,5to,2,0,30,0,0,40,8,0,57,0,1,0
60343,10158,2020-11-18T16:22:02.710847Z,2020,73,30,65,44,0,6to,1,0,29,0,0,43,8,0,72,0,0,0
60343,10159,2020-11-18T16:22:02.710847Z,2020,74,25,64,41,0,7mo,6,0,33,0,0,49,10,0,68,0,1,0
60343,10160,2020-11-18T16:22:02.710847Z,2020,72,30,59,39,0,8vo,5,0,33,0,0,42,13,0,67,0,1,0
60343,10161,2020-11-18T16:22:02.7118475Z,2020,42,3,40,11,0,K,0,0,31,0,0,39,2,0,42,0,0,0
60343,10162,2020-11-18T16:22:02.7118475Z,2020,97,91,84,23,0,Sin Grado,3,1,74,0,0,6,13,0,94,0,0,0
60343,34170,2021-06-24T13:18:37.4803308Z,2021,46,5,41,12,0,1ro,2,0,34,0,0,41,5,0,44,0,0,0
60343,34171,2021-06-24T13:18:37.4813317Z,2021,53,11,47,26,0,2do,1,0,27,0,0,42,6,1,51,0,0,0
60343,34172,2021-06-24T13:18:37.4813317Z,2021,57,15,51,30,0,3ro,2,0,27,0,0,42,6,0,54,0,0,1
60343,34173,2021-06-24T13:18:37.4813317Z,2021,66,21,57,33,0,4to,2,0,33,0,0,45,9,0,63,0,1,1
60343,34174,2021-06-24T13:18:37.4813317Z,2021,69,18,60,37,0,5to,2,0,32,0,0,51,9,0,66,1,1,1
60343,34175,2021-06-24T13:18:37.4823327Z,2021,79,27,77,38,0,6to,4,0,41,0,0,52,2,0,74,0,1,1
60343,34176,2021-06-24T13:18:37.4823327Z,2021,74,26,69,44,0,7mo,2,0,30,0,0,48,5,0,72,0,0,0
60343,34177,2021-06-24T13:18:37.4823327Z,2021,74,26,70,41,0,8vo,6,0,33,0,0,48,4,0,68,0,1,0
60343,34178,2021-06-24T13:18:37.4823327Z,2021,52,5,45,31,0,K,0,0,21,0,0,47,7,1,51,0,0,0
60343,34179,2021-06-24T13:18:37.4833336Z,2021,78,76,66,15,0,Sin Grado,3,0,63,0,0,2,12,0,75,0,0,0
60343,4133,2020-11-18T16:21:07.9983696Z,2019,53,14,50,31,0,1ro,1,1,22,0,0,39,3,0,51,0,0,1
60343,4134,2020-11-18T16:21:07.9983696Z,2019,63,19,52,29,0,2do,0,1,34,0,0,44,11,1,62,0,0,0
60343,4135,2020-11-18T16:21:07.9993687Z,2019,59,21,52,29,0,3ro,1,1,30,0,1,38,7,0,58,0,1,0
60343,4136,2020-11-18T16:21:07.9993687Z,2019,69,25,60,29,0,4to,2,0,40,0,0,44,9,0,67,0,0,0
60343,4137,2020-11-18T16:21:07.9993687Z,2019,56,26,51,34,0,5to,1,1,22,0,0,30,5,0,54,0,0,1
60343,4138,2020-11-18T16:21:07.9993687Z,2019,79,28,69,47,0,6to,3,0,32,0,0,51,10,0,76,0,1,0
60343,4139,2020-11-18T16:21:08.0003691Z,2019,65,27,55,33,0,7mo,5,0,32,0,1,38,10,0,60,0,1,0
60343,4140,2020-11-18T16:21:08.0003691Z,2019,60,16,47,33,0,8vo,1,0,27,0,0,44,13,0,59,0,0,0
60343,4141,2020-11-18T16:21:08.0003691Z,2019,53,10,48,19,0,K,1,0,34,0,0,43,5,0,52,0,0,0
60343,4142,2020-11-18T16:21:08.00137Z,2019,90,86,75,23,0,Sin Grado,3,1,67,0,0,4,15,0,87,0,0,0
13318,30477,2021-06-24T13:18:09.5132704Z,2021,23,5,18,12,0,10mo,0,0,11,0,0,18,5,0,23,0,0,0
13318,30478,2021-06-24T13:18:09.5132704Z,2021,22,6,18,12,0,11mo,1,0,10,0,0,16,4,0,21,0,0,0
13318,30479,2021-06-24T13:18:09.5132704Z,2021,18,4,13,6,0,12mo,0,0,12,0,0,14,5,0,18,0,0,0
13318,30480,2021-06-24T13:18:09.5132704Z,2021,25,5,21,14,0,6to,0,0,11,0,0,20,4,0,25,0,0,0
13318,30481,2021-06-24T13:18:09.5132704Z,2021,28,11,23,12,0,7mo,0,0,16,0,0,17,5,0,28,0,0,0
13318,30482,2021-06-24T13:18:09.5142717Z,2021,19,9,15,10,0,8vo,1,0,9,0,0,10,4,0,18,0,0,0
13318,30483,2021-06-24T13:18:09.5142717Z,2021,23,7,21,10,0,9no,0,0,13,0,0,16,2,0,23,0,0,0
13318,479,2020-11-18T16:20:40.0727448Z,2019,18,3,14,5,0,10mo,0,0,13,0,0,15,4,0,18,0,0,0
13318,480,2020-11-18T16:20:40.0727448Z,2019,20,4,15,11,0,11mo,0,0,9,0,0,16,5,0,20,0,0,0
13318,481,2020-11-18T16:20:40.0727448Z,2019,9,0,8,4,0,12mo,0,0,5,0,0,9,1,0,9,0,0,0
13318,482,2020-11-18T16:20:40.0727448Z,2019,21,8,17,12,0,6to,0,0,9,0,0,13,4,0,21,0,0,0
13318,483,2020-11-18T16:20:40.0737444Z,2019,21,6,15,8,0,7mo,0,0,13,0,0,15,6,0,21,0,1,0
13318,484,2020-11-18T16:20:40.0737444Z,2019,30,7,23,19,0,8vo,0,0,11,0,0,23,7,0,30,0,0,0
13318,485,2020-11-18T16:20:40.0737444Z,2019,25,7,18,11,0,9no,0,0,14,0,0,18,7,0,25,0,0,0
13318,486,2020-11-18T16:20:40.0747448Z,2019,2,0,2,0,0,Sin Grado,0,0,2,0,0,2,0,0,2,0,0,0
13318,6479,2020-11-18T16:21:39.6804934Z,2020,22,7,16,10,0,10mo,0,0,12,0,0,15,6,0,22,0,0,0
13318,6480,2020-11-18T16:21:39.6804934Z,2020,19,4,15,6,0,11mo,0,0,13,0,0,15,4,0,19,0,0,0
13318,6481,2020-11-18T16:21:39.6814939Z,2020,16,1,9,9,0,12mo,0,0,7,0,0,15,7,0,16,0,0,0
13318,6482,2020-11-18T16:21:39.6814939Z,2020,26,11,21,12,0,6to,0,0,14,0,0,15,5,0,26,0,1,0
13318,6483,2020-11-18T16:21:39.6814939Z,2020,20,10,16,11,0,7mo,0,0,9,0,0,10,4,0,20,0,0,0
13318,6484,2020-11-18T16:21:39.6814939Z,2020,19,6,14,8,0,8vo,0,0,11,0,0,13,5,0,19,0,1,0
13318,6485,2020-11-18T16:21:39.6824948Z,2020,29,8,23,17,0,9no,0,0,12,0,0,21,6,0,29,0,0,0
18242,30833,2021-06-24T13:18:11.4526615Z,2021,106,19,84,52,0,10mo,0,0,54,0,0,87,22,0,106,4,0,0
18242,30834,2021-06-24T13:18:11.4526615Z,2021,96,18,77,57,0,11mo,0,2,39,0,0,78,19,0,96,0,0,0
18242,30835,2021-06-24T13:18:11.4536624Z,2021,81,15,51,43,0,12mo,0,0,38,0,0,66,30,0,81,4,0,0
18242,30836,2021-06-24T13:18:11.4536624Z,2021,105,28,80,55,0,9no,0,1,50,0,0,77,25,0,105,0,0,0
18242,30837,2021-06-24T13:18:11.4536624Z,2021,8,8,8,1,0,Sin Grado,0,0,7,0,0,0,0,0,8,0,0,0
18242,6837,2020-11-18T16:21:42.039063Z,2020,101,17,79,62,0,10mo,1,0,39,0,0,84,22,0,100,0,0,0
18242,6838,2020-11-18T16:21:42.039063Z,2020,100,20,69,51,0,11mo,0,0,49,0,0,80,31,0,100,4,0,0
18242,6839,2020-11-18T16:21:42.0400634Z,2020,110,16,78,65,0,12mo,0,0,45,0,0,94,32,0,110,2,0,0
18242,6840,2020-11-18T16:21:42.0400634Z,2020,123,21,94,59,0,9no,0,0,64,0,0,102,29,0,123,3,0,0
18242,6841,2020-11-18T16:21:42.0400634Z,2020,7,6,7,3,0,Sin Grado,0,0,4,0,0,1,0,0,7,0,0,0
18242,836,2020-11-18T16:20:42.6404532Z,2019,107,23,75,52,0,10mo,0,2,55,0,0,84,32,0,107,4,0,0
18242,837,2020-11-18T16:20:42.6404532Z,2019,121,24,87,70,0,11mo,0,3,51,0,0,97,34,0,121,2,0,0
18242,838,2020-11-18T16:20:42.6404532Z,2019,98,0,65,51,0,12mo,0,1,47,0,0,98,33,0,98,0,1,0
18242,839,2020-11-18T16:20:42.6414541Z,2019,99,20,72,60,0,9no,0,1,39,0,0,79,27,0,99,0,0,0
18242,840,2020-11-18T16:20:42.6414541Z,2019,9,9,9,4,0,Sin Grado,0,0,5,0,0,0,0,0,9,0,0,0
57919,10000,2020-11-18T16:22:01.563087Z,2020,186,44,148,100,0,12mo,1,5,86,0,0,142,38,0,184,0,0,1
57919,10001,2020-11-18T16:22:01.9293301Z,2020,230,71,188,107,0,9no,1,5,123,0,0,159,42,0,229,0,0,0
57919,34005,2021-06-24T13:18:36.915927Z,2021,216,62,179,104,0,10mo,1,0,112,0,0,154,37,0,215,0,0,0
57919,34006,2021-06-24T13:18:36.915927Z,2021,159,33,144,83,0,11mo,1,0,76,0,0,126,15,0,158,0,1,0
57919,34007,2021-06-24T13:18:36.915927Z,2021,154,37,127,71,0,12mo,2,0,83,0,0,117,27,0,152,0,1,0
57919,34008,2021-06-24T13:18:36.9169279Z,2021,202,54,166,118,0,9no,3,0,84,0,0,148,36,0,199,1,0,0
57919,3981,2020-11-18T16:21:06.8906272Z,2019,170,42,134,78,0,10mo,2,1,92,0,0,128,36,0,168,0,1,0
57919,3982,2020-11-18T16:21:06.8906272Z,2019,207,46,152,107,0,11mo,1,0,100,0,0,161,55,0,205,0,0,1
57919,3983,2020-11-18T16:21:06.8916276Z,2019,183,0,139,92,0,12mo,0,0,91,0,0,183,44,0,183,0,0,0
57919,3984,2020-11-18T16:21:06.8916276Z,2019,183,45,158,99,0,9no,1,0,84,0,0,138,25,0,182,0,1,0
57919,9998,2020-11-18T16:22:01.563087Z,2020,162,38,132,86,0,10mo,1,6,76,0,0,124,30,0,161,0,1,0
57919,9999,2020-11-18T16:22:01.563087Z,2020,162,41,127,76,0,11mo,2,3,86,0,0,121,35,0,160,0,1,0
75812,11610,2020-11-18T16:22:11.7398718Z,2020,90,37,78,39,0,10mo,0,0,51,0,0,53,12,0,90,0,0,0
75812,11611,2020-11-18T16:22:11.7398718Z,2020,89,20,78,45,0,11mo,4,0,44,0,0,69,11,0,85,0,0,0
75812,11612,2020-11-18T16:22:11.7398718Z,2020,96,23,76,51,0,12mo,2,0,45,0,0,73,20,0,94,0,0,0
75812,11613,2020-11-18T16:22:11.7398718Z,2020,74,21,63,40,0,9no,1,0,34,0,0,53,11,0,73,0,0,0
75812,35633,2021-06-24T13:18:47.3734252Z,2021,94,26,82,55,0,10mo,2,0,39,0,0,68,12,0,92,0,0,0
75812,35634,2021-06-24T13:18:47.3734252Z,2021,85,33,76,39,0,11mo,0,0,46,0,0,52,9,0,85,0,0,0
75812,35635,2021-06-24T13:18:47.3744261Z,2021,83,19,72,46,0,12mo,4,0,37,0,0,64,11,0,79,0,0,0
75812,35636,2021-06-24T13:18:47.3744261Z,2021,112,46,103,66,0,9no,0,0,46,0,0,66,9,0,111,0,0,1
75812,5603,2020-11-18T16:21:16.6021026Z,2019,95,22,83,50,0,10mo,3,0,45,0,0,73,12,0,92,0,0,0
75812,5604,2020-11-18T16:21:16.6021026Z,2019,100,23,77,54,0,11mo,2,0,46,0,0,77,23,0,98,0,0,0
75812,5605,2020-11-18T16:21:16.6021026Z,2019,72,0,53,34,0,12mo,2,0,38,0,0,72,19,0,70,0,0,0
75812,5606,2020-11-18T16:21:16.6021026Z,2019,98,42,87,38,0,9no,1,1,60,0,0,56,11,0,97,0,0,0
54502,33793,2021-06-24T13:18:35.280754Z,2021,36,8,29,24,0,1ro,0,0,12,0,0,28,7,0,36,0,0,0
54502,33794,2021-06-24T13:18:35.280754Z,2021,46,12,38,27,0,2do,0,0,19,0,0,34,8,0,46,0,0,0
54502,33795,2021-06-24T13:18:35.281755Z,2021,52,23,45,33,0,3ro,0,0,19,0,0,29,7,0,52,0,0,0
54502,33796,2021-06-24T13:18:35.281755Z,2021,44,19,35,21,0,4to,0,0,23,0,0,25,9,0,44,0,0,0
54502,33797,2021-06-24T13:18:35.281755Z,2021,46,16,39,31,0,5to,0,0,15,0,0,30,7,0,46,0,0,0
54502,33798,2021-06-24T13:18:35.282755Z,2021,50,7,39,23,0,K,0,0,27,0,0,43,11,0,50,0,0,0
54502,3770,2020-11-18T16:21:05.1234471Z,2019,54,24,47,28,0,1ro,0,0,26,0,0,30,7,0,54,0,0,0
54502,3771,2020-11-18T16:21:05.1244476Z,2019,53,27,43,26,0,2do,0,0,27,0,0,26,10,0,53,0,0,0
54502,3772,2020-11-18T16:21:05.1244476Z,2019,37,15,32,24,0,3ro,0,0,13,0,0,22,5,0,37,0,0,0
54502,3773,2020-11-18T16:21:05.1244476Z,2019,43,14,36,23,0,4to,0,0,20,0,0,29,7,0,43,1,0,0
54502,3774,2020-11-18T16:21:05.1244476Z,2019,35,9,27,19,0,5to,0,0,16,0,0,26,8,0,35,0,0,0
54502,3775,2020-11-18T16:21:05.1244476Z,2019,42,7,34,21,0,K,0,0,21,0,0,35,8,0,42,0,0,0
54502,9787,2020-11-18T16:22:00.1321311Z,2020,47,13,37,26,0,1ro,0,5,21,0,0,34,10,0,47,0,0,0
54502,9788,2020-11-18T16:22:00.1321311Z,2020,55,25,43,34,0,2do,0,6,21,0,0,30,12,0,55,0,0,0
54502,9789,2020-11-18T16:22:00.1331325Z,2020,47,21,38,22,0,3ro,0,3,25,0,0,26,9,0,47,0,0,0
54502,9790,2020-11-18T16:22:00.1331325Z,2020,44,17,35,27,0,4to,0,3,17,0,0,27,9,0,44,0,0,0
54502,9791,2020-11-18T16:22:00.1331325Z,2020,39,10,33,22,0,5to,0,1,17,0,0,29,6,0,39,1,0,0
54502,9792,2020-11-18T16:22:00.1341316Z,2020,48,10,41,27,0,K,0,1,21,0,0,38,7,0,48,0,0,0
34348,2237,2020-11-18T16:20:55.0037007Z,2019,115,35,94,53,0,6to,4,0,62,0,0,80,21,0,110,0,1,1
34348,2238,2020-11-18T16:20:55.0037007Z,2019,93,21,78,56,0,7mo,0,3,37,0,0,72,15,0,93,0,0,0
34348,2239,2020-11-18T16:20:55.0046998Z,2019,116,26,86,62,0,8vo,2,1,54,0,0,90,30,0,113,0,0,1
34348,2240,2020-11-18T16:20:55.0046998Z,2019,20,18,15,4,0,Sin Grado,0,1,16,0,0,2,5,0,20,0,0,0
34348,32244,2021-06-24T13:18:21.7520471Z,2021,112,25,99,61,0,6to,2,0,51,0,0,87,13,0,110,0,0,0
34348,32245,2021-06-24T13:18:21.7520471Z,2021,105,23,94,48,0,7mo,1,0,57,0,0,82,11,0,104,0,0,0
34348,32246,2021-06-24T13:18:21.7530481Z,2021,105,29,84,43,0,8vo,3,0,62,0,0,76,21,0,102,0,0,0
34348,32247,2021-06-24T13:18:21.7530481Z,2021,22,21,21,7,0,Sin Grado,0,0,15,0,0,1,1,0,22,0,0,0
34348,8249,2020-11-18T16:21:50.6838308Z,2020,114,20,100,57,0,6to,2,0,57,0,0,94,14,0,112,0,0,0
34348,8250,2020-11-18T16:21:50.6838308Z,2020,119,32,84,49,0,7mo,5,1,70,0,0,87,35,0,114,0,0,0
34348,8251,2020-11-18T16:21:50.6838308Z,2020,112,25,92,65,0,8vo,2,1,47,0,0,87,20,0,110,0,0,0
34348,8252,2020-11-18T16:21:50.6838308Z,2020,23,23,20,7,0,Sin Grado,0,1,16,0,0,0,3,0,23,0,0,0
54619,33803,2021-06-24T13:18:35.7170669Z,2021,185,44,145,97,0,10mo,0,0,88,0,0,141,40,0,184,3,1,1
54619,33804,2021-06-24T13:18:35.7170669Z,2021,157,27,122,83,0,11mo,2,2,74,0,0,130,35,1,154,5,1,0
54619,33805,2021-06-24T13:18:35.7180678Z,2021,185,27,144,97,0,12mo,4,0,88,0,0,158,41,1,180,7,0,0
54619,33806,2021-06-24T13:18:35.7180678Z,2021,186,51,146,97,0,9no,2,0,89,0,0,135,40,4,180,0,1,0
54619,33807,2021-06-24T13:18:35.7180678Z,2021,18,17,18,6,0,Sin Grado,0,0,12,0,0,1,0,0,18,0,0,0
54619,3780,2020-11-18T16:21:05.1274493Z,2019,183,33,137,96,0,10mo,2,0,87,0,0,150,46,1,180,7,0,0
54619,3781,2020-11-18T16:21:05.1274493Z,2019,180,31,113,95,0,11mo,0,0,85,0,0,149,67,6,174,4,0,0
54619,3782,2020-11-18T16:21:05.1284502Z,2019,170,1,120,84,0,12mo,0,0,86,0,0,169,50,0,170,0,0,0
54619,3783,2020-11-18T16:21:05.1284502Z,2019,166,31,121,86,0,9no,3,0,80,0,0,135,45,1,161,5,1,1
54619,3784,2020-11-18T16:21:05.1284502Z,2019,13,10,12,2,0,Sin Grado,0,0,11,0,0,3,1,0,13,0,0,0
54619,9797,2020-11-18T16:22:00.1321311Z,2020,162,29,119,83,0,10mo,3,0,79,0,0,133,43,1,158,5,1,0
54619,9798,2020-11-18T16:22:00.1321311Z,2020,178,29,131,94,0,11mo,2,0,84,0,0,149,47,1,175,7,0,0
54619,9799,2020-11-18T16:22:00.1321311Z,2020,173,33,117,95,0,12mo,0,0,78,0,0,140,56,4,169,4,0,0
54619,9800,2020-11-18T16:22:00.1321311Z,2020,185,48,137,97,0,9no,1,0,88,0,0,137,48,0,183,3,1,1
54619,9801,2020-11-18T16:22:00.4933713Z,2020,13,13,13,3,0,Sin Grado,0,0,10,0,0,0,0,0,13,0,0,0
11940,256,2020-11-18T16:20:38.795891Z,2019,23,10,18,11,0,10mo,0,0,12,0,0,13,5,0,23,0,0,0
11940,257,2020-11-18T16:20:38.795891Z,2019,20,9,18,9,0,11mo,0,0,11,0,0,11,2,0,20,0,1,0
11940,258,2020-11-18T16:20:38.795891Z,2019,18,4,16,8,0,1ro,0,0,10,0,0,14,2,0,17,0,0,1
11940,259,2020-11-18T16:20:38.795891Z,2019,17,6,13,8,0,2do,0,0,9,0,0,11,4,0,17,0,0,0
11940,260,2020-11-18T16:20:38.795891Z,2019,21,6,15,13,0,3ro,1,0,8,0,0,15,6,0,20,0,0,0
11940,261,2020-11-18T16:20:38.7968914Z,2019,16,4,15,9,0,4to,1,0,7,0,0,12,1,0,15,0,0,0
11940,262,2020-11-18T16:20:38.7968914Z,2019,22,5,19,11,0,5to,0,0,11,0,0,17,3,0,22,0,0,0
11940,263,2020-11-18T16:20:38.7968914Z,2019,19,8,15,7,0,6to,0,0,12,0,0,11,4,0,19,0,0,0
11940,264,2020-11-18T16:20:38.7978923Z,2019,18,5,13,11,0,7mo,2,0,7,0,0,13,5,0,16,0,0,0
11940,265,2020-11-18T16:20:38.7978923Z,2019,19,4,14,8,0,8vo,0,0,11,0,0,15,5,0,19,0,0,0
11940,266,2020-11-18T16:20:38.7978923Z,2019,33,12,29,13,0,9no,1,0,20,0,0,21,4,0,32,0,0,0
11940,267,2020-11-18T16:20:38.7978923Z,2019,9,2,6,7,0,K,0,0,2,0,0,7,3,0,9,0,0,0
11940,268,2020-11-18T16:20:38.7988928Z,2019,24,23,20,4,0,Sin Grado,1,0,20,0,0,1,4,0,23,0,0,0
11940,30256,2021-06-24T13:18:07.129562Z,2021,23,9,20,10,0,10mo,0,0,13,0,0,14,3,0,23,0,1,0
11940,30257,2021-06-24T13:18:07.129562Z,2021,31,11,30,9,0,11mo,1,0,22,0,0,20,1,0,30,0,0,0
11940,30258,2021-06-24T13:18:07.1305625Z,2021,12,7,12,6,0,12mo,0,0,6,0,0,5,0,0,12,0,0,0
11940,30259,2021-06-24T13:18:07.1305625Z,2021,14,4,14,7,0,3ro,0,0,7,0,0,10,0,0,13,0,0,1
11940,30260,2021-06-24T13:18:07.1305625Z,2021,12,4,12,6,0,4to,0,0,6,0,0,8,0,0,12,0,0,0
11940,30261,2021-06-24T13:18:07.131563Z,2021,21,7,19,14,0,5to,1,0,7,0,0,14,2,0,20,0,0,0
11940,30262,2021-06-24T13:18:07.131563Z,2021,17,7,17,7,0,6to,1,0,10,0,0,10,0,0,16,0,0,0
11940,30263,2021-06-24T13:18:07.131563Z,2021,22,5,21,11,0,7mo,0,0,11,0,0,17,1,0,22,0,0,0
11940,30264,2021-06-24T13:18:07.1325635Z,2021,18,9,16,7,0,8vo,0,0,11,0,0,9,2,0,18,0,0,0
11940,30265,2021-06-24T13:18:07.1325635Z,2021,19,6,15,12,0,9no,0,0,7,0,0,13,4,0,19,0,0,0
11940,30266,2021-06-24T13:18:07.1335649Z,2021,26,26,22,7,0,Sin Grado,1,0,19,0,0,0,4,0,25,0,0,0
11940,6258,2020-11-18T16:21:38.6418009Z,2020,34,11,32,10,0,10mo,1,0,24,0,0,23,2,0,33,0,0,0
11940,6259,2020-11-18T16:21:38.6418009Z,2020,13,8,12,7,0,11mo,0,0,6,0,0,5,1,0,13,0,0,0
11940,6260,2020-11-18T16:21:38.6418009Z,2020,16,9,15,8,0,12mo,0,0,8,0,0,7,1,0,16,0,1,0
11940,6261,2020-11-18T16:21:38.6428005Z,2020,13,4,11,7,0,2do,0,0,6,0,0,9,2,0,12,0,0,1
11940,6262,2020-11-18T16:21:38.6428005Z,2020,15,4,13,7,0,3ro,0,0,8,0,0,11,2,0,15,0,0,0
11940,6263,2020-11-18T16:21:38.6428005Z,2020,19,6,16,14,0,4to,1,0,5,0,0,13,3,0,18,0,0,0
11940,6264,2020-11-18T16:21:38.6428005Z,2020,16,3,16,8,0,5to,1,0,8,0,0,13,0,0,15,0,0,0
11940,6265,2020-11-18T16:21:38.6438023Z,2020,24,5,23,12,0,6to,0,0,12,0,0,19,1,0,24,0,0,0
11940,6266,2020-11-18T16:21:38.6438023Z,2020,20,8,13,8,0,7mo,0,0,12,0,0,12,7,0,20,0,0,0
11940,6267,2020-11-18T16:21:38.6438023Z,2020,20,4,16,13,0,8vo,2,0,7,0,0,16,4,0,18,0,0,0
11940,6268,2020-11-18T16:21:38.6438023Z,2020,28,10,23,13,0,9no,0,0,15,0,0,18,5,0,28,0,1,0
11940,6269,2020-11-18T16:21:38.6438023Z,2020,28,28,23,5,0,Sin Grado,1,0,23,0,0,0,5,0,27,0,0,0
25031,1486,2020-11-18T16:20:46.3439266Z,2019,85,24,67,40,0,6to,0,1,45,0,0,61,18,0,85,0,2,0
25031,1487,2020-11-18T16:20:46.3449271Z,2019,93,31,71,42,0,7mo,0,2,51,0,0,62,22,0,93,0,0,0
25031,1488,2020-11-18T16:20:46.3449271Z,2019,105,28,84,45,0,8vo,0,0,60,0,0,77,21,0,105,0,1,0
25031,1489,2020-11-18T16:20:46.3449271Z,2019,12,12,11,4,0,Sin Grado,0,0,8,0,0,0,1,0,12,0,0,0
25031,31487,2021-06-24T13:18:14.9321571Z,2021,42,16,37,23,0,6to,0,0,19,0,0,26,5,0,42,0,0,0
25031,31488,2021-06-24T13:18:14.9331576Z,2021,64,20,54,31,0,7mo,0,0,33,0,0,44,10,0,64,0,1,0
25031,31489,2021-06-24T13:18:14.9331576Z,2021,94,26,77,40,0,8vo,0,0,54,0,0,68,17,0,94,0,1,0
25031,31490,2021-06-24T13:18:14.9331576Z,2021,23,23,23,12,0,Sin Grado,0,1,11,0,0,0,0,0,23,0,0,0
25031,7490,2020-11-18T16:21:45.77856Z,2020,58,21,47,31,0,6to,2,0,27,0,0,37,11,0,56,0,1,0
25031,7491,2020-11-18T16:21:45.77856Z,2020,97,28,76,42,0,7mo,0,1,55,0,0,69,21,0,97,0,1,0
25031,7492,2020-11-18T16:21:45.77856Z,2020,90,28,70,42,0,8vo,0,0,48,0,0,62,20,0,90,0,0,0
25031,7493,2020-11-18T16:21:45.7795613Z,2020,12,12,11,4,0,Sin Grado,0,1,8,0,0,0,1,0,12,0,0,0
70532,11041,2020-11-18T16:22:07.6261248Z,2020,29,7,25,16,0,1ro,0,0,13,0,0,22,4,0,29,0,0,0
70532,11042,2020-11-18T16:22:07.6261248Z,2020,33,14,28,13,0,2do,0,0,20,0,0,19,5,0,33,0,0,0
70532,11043,2020-11-18T16:22:07.6261248Z,2020,43,23,33,18,0,3ro,0,0,25,0,0,20,10,0,43,0,0,0
70532,11044,2020-11-18T16:22:07.6271256Z,2020,48,20,37,24,0,4to,1,1,24,0,0,28,11,0,47,0,0,0
70532,11045,2020-11-18T16:22:07.6271256Z,2020,43,24,31,21,0,5to,0,0,22,0,0,19,12,0,43,0,0,0
70532,11046,2020-11-18T16:22:07.6271256Z,2020,25,9,18,12,0,K,1,0,13,0,0,16,7,0,24,0,0,0
70532,11047,2020-11-18T16:22:07.6281265Z,2020,11,9,8,5,0,Sin Grado,0,0,6,0,0,2,3,0,11,0,0,0
70532,35062,2021-06-24T13:18:43.7148022Z,2021,18,3,17,9,0,1ro,0,0,9,0,0,15,1,0,18,0,0,0
70532,35063,2021-06-24T13:18:43.7148022Z,2021,25,8,21,13,0,2do,0,0,12,0,0,17,4,0,25,0,0,0
70532,35064,2021-06-24T13:18:43.7148022Z,2021,33,14,28,14,0,3ro,0,0,19,0,0,19,5,0,33,0,0,0
70532,35065,2021-06-24T13:18:43.7158027Z,2021,45,19,36,18,0,4to,0,1,27,0,0,26,9,0,45,0,0,0
70532,35066,2021-06-24T13:18:43.7158027Z,2021,47,19,37,22,0,5to,1,0,25,0,0,28,10,0,46,0,0,0
70532,35067,2021-06-24T13:18:43.7158027Z,2021,39,18,25,15,0,K,0,0,24,0,0,21,14,0,39,0,0,0
70532,35068,2021-06-24T13:18:43.7158027Z,2021,6,3,4,3,0,Sin Grado,0,0,3,0,0,3,2,0,6,0,0,0
70532,5033,2020-11-18T16:21:13.4229846Z,2019,32,17,27,12,0,1ro,0,1,20,0,0,15,5,0,32,0,0,0
70532,5034,2020-11-18T16:21:13.423985Z,2019,40,20,30,18,0,2do,0,1,22,0,0,20,10,0,40,0,0,0
70532,5035,2020-11-18T16:21:13.423985Z,2019,44,24,36,18,0,3ro,3,3,26,0,0,20,8,0,41,0,0,0
70532,5036,2020-11-18T16:21:13.423985Z,2019,46,27,34,21,0,4to,0,1,25,0,0,19,12,0,46,0,0,0
70532,5037,2020-11-18T16:21:13.423985Z,2019,48,19,40,22,0,5to,0,1,26,0,0,29,8,0,48,0,0,0
70532,5038,2020-11-18T16:21:13.423985Z,2019,27,8,23,17,0,K,0,0,10,0,0,19,4,0,27,0,0,0
70532,5039,2020-11-18T16:21:13.4249863Z,2019,14,9,12,6,0,Sin Grado,1,0,8,0,0,5,2,0,13,0,0,0
14779,30573,2021-06-24T13:18:10.3959037Z,2021,39,13,37,20,0,1ro,3,2,19,0,0,26,2,0,36,0,1,0
14779,30574,2021-06-24T13:18:10.3959037Z,2021,47,23,47,21,0,2do,1,1,26,0,0,24,0,0,46,0,2,0
14779,30575,2021-06-24T13:18:10.3959037Z,2021,41,21,41,23,0,3ro,1,1,18,0,0,20,0,0,40,0,0,0
14779,30576,2021-06-24T13:18:10.3959037Z,2021,37,16,36,15,0,4to,0,0,22,0,0,21,1,0,37,0,0,0
14779,30577,2021-06-24T13:18:10.3969051Z,2021,32,14,31,12,0,5to,2,1,20,0,0,18,1,0,30,0,1,0
14779,30578,2021-06-24T13:18:10.3969051Z,2021,18,5,17,8,0,K,0,0,10,0,0,13,1,0,18,0,0,0
14779,30579,2021-06-24T13:18:10.3969051Z,2021,4,3,4,0,0,Sin Grado,1,0,4,0,0,1,0,0,3,0,0,0
14779,575,2020-11-18T16:20:40.7822176Z,2019,52,21,50,27,0,1ro,1,0,25,0,0,31,2,0,51,0,0,0
14779,576,2020-11-18T16:20:40.7822176Z,2019,36,17,33,17,0,2do,0,0,19,0,0,19,3,0,36,0,0,0
14779,577,2020-11-18T16:20:40.7832181Z,2019,29,14,25,12,0,3ro,0,0,17,0,0,15,4,0,29,0,0,0
14779,578,2020-11-18T16:20:40.7832181Z,2019,46,21,42,23,0,4to,2,0,23,0,0,25,4,0,44,0,0,0
14779,579,2020-11-18T16:20:40.7832181Z,2019,40,11,36,22,0,5to,2,1,18,0,0,29,4,0,38,0,0,0
14779,580,2020-11-18T16:20:40.7832181Z,2019,42,15,41,19,0,K,1,0,23,0,0,27,1,0,41,0,0,0
14779,581,2020-11-18T16:20:40.7832181Z,2019,11,11,10,3,0,Sin Grado,0,0,8,0,0,0,1,0,11,0,0,0
14779,6575,2020-11-18T16:21:40.3619484Z,2020,50,20,46,23,0,1ro,1,0,27,0,0,30,4,0,49,0,0,0
14779,6576,2020-11-18T16:21:40.3619484Z,2020,40,18,39,24,0,2do,1,0,16,0,0,22,1,0,39,0,0,0
14779,6577,2020-11-18T16:21:40.3619484Z,2020,38,16,36,18,0,3ro,0,0,20,0,0,22,2,0,38,0,0,0
14779,6578,2020-11-18T16:21:40.3629493Z,2020,37,16,34,17,0,4to,0,0,20,0,0,21,3,0,37,0,0,0
14779,6579,2020-11-18T16:21:40.3629493Z,2020,37,18,30,19,0,5to,2,0,18,0,0,19,7,0,35,0,0,0
14779,6580,2020-11-18T16:21:40.3629493Z,2020,43,14,25,24,0,K,1,0,19,0,0,29,18,0,42,0,0,0
14779,6581,2020-11-18T16:21:40.3629493Z,2020,11,11,10,4,0,Sin Grado,0,0,7,0,0,0,1,0,11,0,0,0
17319,30677,2021-06-24T13:18:10.6691003Z,2021,146,49,125,76,0,10mo,4,0,70,0,0,97,21,0,142,0,3,0
17319,30678,2021-06-24T13:18:10.6691003Z,2021,151,35,128,76,0,11mo,1,0,75,0,0,116,23,0,150,2,0,0
17319,30679,2021-06-24T13:18:10.6701008Z,2021,111,27,93,54,0,12mo,0,0,57,0,0,84,18,0,111,2,0,0
17319,30680,2021-06-24T13:18:10.6701008Z,2021,125,39,102,60,0,9no,1,0,65,0,0,86,23,0,124,0,0,0
17319,30681,2021-06-24T13:18:10.6701008Z,2021,10,10,9,4,0,Sin Grado,0,0,6,0,0,0,1,0,10,0,0,0
17319,6679,2020-11-18T16:21:40.7652187Z,2020,165,38,135,84,0,10mo,1,0,81,0,0,127,30,0,164,3,0,0
17319,6680,2020-11-18T16:21:40.7652187Z,2020,118,27,90,58,0,11mo,0,0,60,0,0,91,28,0,118,2,0,0
17319,6681,2020-11-18T16:21:40.7652187Z,2020,120,25,92,63,0,12mo,1,0,57,0,0,95,28,0,119,1,0,0
17319,6682,2020-11-18T16:21:40.7652187Z,2020,152,48,126,79,0,9no,4,0,73,0,0,104,26,0,148,0,4,0
17319,6683,2020-11-18T16:21:40.7662201Z,2020,7,7,7,5,0,Sin Grado,0,0,2,0,0,0,0,0,7,0,0,0
17319,679,2020-11-18T16:20:41.1954948Z,2019,126,31,105,61,0,10mo,0,0,65,0,0,95,21,0,126,2,0,0
17319,680,2020-11-18T16:20:41.1954948Z,2019,123,26,96,62,0,11mo,1,0,61,0,0,97,27,0,122,1,0,0
17319,681,2020-11-18T16:20:41.1964962Z,2019,136,3,104,66,0,12mo,1,0,70,0,0,133,32,0,135,0,1,0
17319,682,2020-11-18T16:20:41.1964962Z,2019,186,49,151,92,0,9no,1,1,94,0,0,137,35,0,185,3,0,0
17319,683,2020-11-18T16:20:41.1964962Z,2019,8,7,7,5,0,Sin Grado,0,0,3,0,0,1,1,0,8,0,0,0
30734,1829,2020-11-18T16:20:52.4770175Z,2019,33,7,22,15,0,1ro,0,0,18,0,0,26,11,0,33,0,0,0
30734,1830,2020-11-18T16:20:52.4770175Z,2019,36,11,27,22,0,2do,0,0,14,0,0,25,9,0,36,0,0,0
30734,1831,2020-11-18T16:20:52.4770175Z,2019,30,12,21,10,0,3ro,0,0,20,0,0,18,9,0,30,0,0,0
30734,1832,2020-11-18T16:20:52.4770175Z,2019,31,13,27,11,0,4to,0,0,20,0,0,18,4,0,31,0,0,0
30734,1833,2020-11-18T16:20:52.4770175Z,2019,36,10,25,18,0,5to,0,0,18,0,0,26,11,0,36,0,0,0
30734,1834,2020-11-18T16:20:52.4780193Z,2019,37,7,25,16,0,6to,0,0,21,0,0,30,12,0,36,0,0,1
30734,1835,2020-11-18T16:20:52.4780193Z,2019,28,1,12,14,0,K,0,0,14,0,0,27,16,0,28,0,0,0
30734,1836,2020-11-18T16:20:52.4780193Z,2019,26,1,21,19,0,PK,0,0,7,0,0,25,5,0,26,0,0,0
30734,1837,2020-11-18T16:20:52.4780193Z,2019,5,4,3,2,0,Sin Grado,0,0,3,0,0,1,2,0,5,0,0,0
30734,31832,2021-06-24T13:18:17.760185Z,2021,31,5,21,12,0,1ro,0,0,19,0,0,26,10,0,31,0,0,0
30734,31833,2021-06-24T13:18:17.760185Z,2021,34,2,21,19,0,2do,0,0,15,0,0,32,13,0,34,0,0,0
30734,31834,2021-06-24T13:18:17.760185Z,2021,36,11,22,17,0,3ro,0,0,19,0,0,25,14,0,36,0,0,0
30734,31835,2021-06-24T13:18:17.7611855Z,2021,38,11,29,17,0,4to,0,0,21,0,0,27,9,0,38,0,0,0
30734,31836,2021-06-24T13:18:17.7611855Z,2021,29,10,17,10,0,5to,0,0,19,0,0,19,12,0,29,0,0,0
30734,31837,2021-06-24T13:18:17.7611855Z,2021,30,13,23,11,0,6to,0,0,19,0,0,17,7,0,30,0,0,0
30734,31838,2021-06-24T13:18:17.7621864Z,2021,33,11,24,14,0,7mo,0,0,19,0,0,22,9,0,33,0,0,0
30734,31839,2021-06-24T13:18:17.7621864Z,2021,25,5,13,10,0,8vo,1,0,15,0,0,20,12,0,23,0,0,1
30734,31840,2021-06-24T13:18:17.7631865Z,2021,34,4,18,13,0,K,1,0,21,0,0,30,16,0,32,0,0,1
30734,31841,2021-06-24T13:18:17.7631865Z,2021,22,0,11,10,0,PK,1,0,12,0,0,22,11,0,21,0,0,0
30734,31842,2021-06-24T13:18:17.7631865Z,2021,5,5,3,2,0,Sin Grado,0,0,3,0,0,0,2,0,5,0,0,0
30734,7835,2020-11-18T16:21:48.4733548Z,2020,36,4,18,19,0,1ro,0,0,17,0,0,32,18,0,36,0,0,0
30734,7836,2020-11-18T16:21:48.4733548Z,2020,35,9,20,14,0,2do,0,0,21,0,0,26,15,0,35,0,0,0
30734,7837,2020-11-18T16:21:48.4733548Z,2020,36,11,26,19,0,3ro,0,0,17,0,0,25,10,0,36,0,0,0
30734,7838,2020-11-18T16:21:48.4733548Z,2020,28,10,20,9,0,4to,0,0,19,0,0,18,8,0,28,0,0,0
30734,7839,2020-11-18T16:21:48.4743557Z,2020,32,14,26,11,0,5to,0,0,21,0,0,18,6,0,32,0,0,0
30734,7840,2020-11-18T16:21:48.4743557Z,2020,32,10,24,15,0,6to,0,0,17,0,0,22,8,0,32,0,0,0
30734,7841,2020-11-18T16:21:48.4743557Z,2020,27,7,20,12,0,7mo,1,0,15,0,0,20,7,0,25,0,0,1
30734,7842,2020-11-18T16:21:48.4743557Z,2020,6,2,5,2,0,8vo,0,0,4,0,0,4,1,0,6,0,0,0
30734,7843,2020-11-18T16:21:48.4743557Z,2020,21,1,7,10,0,K,0,0,11,0,0,20,14,0,21,0,0,0
30734,7844,2020-11-18T16:21:48.4753562Z,2020,34,2,13,18,0,PK,1,0,16,0,0,32,21,0,33,0,0,0
30734,7845,2020-11-18T16:21:48.4753562Z,2020,2,2,1,0,0,Sin Grado,0,0,2,0,0,0,1,0,2,0,0,0
12930,30469,2021-06-24T13:18:09.5052655Z,2021,92,33,77,41,0,10mo,0,0,51,0,0,59,15,0,92,1,0,0
12930,30470,2021-06-24T13:18:09.5052655Z,2021,101,39,72,52,0,11mo,0,0,49,0,0,62,29,0,101,3,0,0
12930,30471,2021-06-24T13:18:09.5052655Z,2021,61,26,51,28,0,12mo,0,0,33,0,0,35,10,0,61,1,0,0
12930,30472,2021-06-24T13:18:09.5052655Z,2021,113,57,94,63,0,9no,1,0,50,0,0,56,19,0,112,1,1,0
12930,471,2020-11-18T16:20:40.0677404Z,2019,90,39,78,38,0,10mo,0,0,52,0,0,51,12,0,90,2,0,0
12930,472,2020-11-18T16:20:40.0677404Z,2019,82,26,63,47,0,11mo,0,0,35,0,0,56,19,0,82,3,0,0
12930,473,2020-11-18T16:20:40.0687408Z,2019,60,0,47,27,0,12mo,0,0,33,0,0,60,13,0,60,0,0,0
12930,474,2020-11-18T16:20:40.0687408Z,2019,131,48,96,60,0,9no,1,0,71,0,0,83,35,0,130,2,0,0
12930,6472,2020-11-18T16:21:39.6684859Z,2020,97,37,71,50,0,10mo,0,0,47,0,0,60,26,0,97,2,0,0
12930,6473,2020-11-18T16:21:39.6684859Z,2020,71,29,62,31,0,11mo,0,0,40,0,0,42,9,0,71,1,0,0
12930,6474,2020-11-18T16:21:39.6684859Z,2020,60,19,48,35,0,12mo,1,0,25,0,0,41,12,0,59,2,0,0
12930,6475,2020-11-18T16:21:39.6684859Z,2020,77,29,65,28,0,9no,1,0,49,0,0,48,12,0,76,2,0,0
62893,10505,2020-11-18T16:22:04.9193219Z,2020,18,7,11,11,0,10mo,0,0,7,0,0,11,7,0,18,0,0,0
62893,10506,2020-11-18T16:22:04.9193219Z,2020,13,3,11,8,0,11mo,1,0,5,0,0,10,2,0,12,0,0,0
62893,10507,2020-11-18T16:22:04.9203223Z,2020,7,0,7,4,0,12mo,0,0,3,0,0,7,0,0,7,0,0,0
62893,10508,2020-11-18T16:22:04.9203223Z,2020,14,3,12,10,0,1ro,0,0,4,0,0,11,2,0,14,0,0,0
62893,10509,2020-11-18T16:22:04.9203223Z,2020,23,4,19,13,0,2do,3,0,10,0,0,19,4,0,20,0,0,0
62893,10510,2020-11-18T16:22:04.9213245Z,2020,27,8,23,14,0,3ro,1,0,13,0,0,19,4,0,26,0,0,0
62893,10511,2020-11-18T16:22:04.9213245Z,2020,20,2,15,16,0,4to,1,0,4,0,0,18,5,0,19,0,0,0
62893,10512,2020-11-18T16:22:04.9213245Z,2020,15,3,10,7,0,5to,0,0,8,0,0,12,5,0,15,0,0,0
62893,10513,2020-11-18T16:22:04.9213245Z,2020,47,6,40,32,0,6to,0,0,15,0,0,41,7,0,47,0,0,0
62893,10514,2020-11-18T16:22:04.9223245Z,2020,58,15,39,29,0,7mo,1,0,29,0,0,43,19,0,57,0,0,0
62893,10515,2020-11-18T16:22:04.9223245Z,2020,48,13,29,25,0,8vo,0,0,23,0,0,35,19,0,48,0,0,0
62893,10516,2020-11-18T16:22:04.9223245Z,2020,30,7,22,15,0,9no,3,0,15,0,0,23,8,0,27,0,0,0
62893,10517,2020-11-18T16:22:04.9223245Z,2020,13,4,10,8,0,K,0,0,5,0,0,9,3,0,13,0,0,0
62893,10518,2020-11-18T16:22:04.9223245Z,2020,17,16,15,7,0,Sin Grado,0,0,10,0,0,1,2,0,17,0,0,0
62893,34518,2021-06-24T13:18:40.2122902Z,2021,26,7,19,14,0,10mo,1,0,12,0,0,19,7,0,25,0,0,0
62893,34519,2021-06-24T13:18:40.2122902Z,2021,18,6,12,10,0,11mo,0,0,8,0,0,12,6,0,18,0,0,0
62893,34520,2021-06-24T13:18:40.2122902Z,2021,11,1,8,6,0,12mo,2,0,5,0,0,10,3,0,9,0,0,0
62893,34521,2021-06-24T13:18:40.2132907Z,2021,20,5,13,11,0,1ro,0,0,9,0,0,15,7,0,20,0,0,0
62893,34522,2021-06-24T13:18:40.2132907Z,2021,19,5,11,13,0,2do,0,0,6,0,0,14,8,0,19,0,0,0
62893,34523,2021-06-24T13:18:40.2132907Z,2021,25,6,21,15,0,3ro,3,0,10,0,0,19,4,0,22,0,0,0
62893,34524,2021-06-24T13:18:40.2132907Z,2021,30,9,21,17,0,4to,1,0,13,0,0,21,9,0,29,0,0,0
62893,34525,2021-06-24T13:18:40.2132907Z,2021,26,6,21,17,0,5to,0,0,9,0,0,20,5,0,26,0,0,0
62893,34526,2021-06-24T13:18:40.2142912Z,2021,47,11,30,25,0,6to,1,0,22,0,0,36,17,0,46,0,0,0
62893,34527,2021-06-24T13:18:40.2142912Z,2021,54,12,44,33,0,7mo,1,0,21,0,0,42,10,0,53,0,0,0
62893,34528,2021-06-24T13:18:40.2142912Z,2021,43,10,32,24,0,8vo,1,0,19,0,0,33,11,0,42,0,0,0
62893,34529,2021-06-24T13:18:40.2142912Z,2021,55,15,40,30,0,9no,0,0,25,0,0,40,15,0,55,0,0,0
62893,34530,2021-06-24T13:18:40.2142912Z,2021,22,1,18,11,0,K,0,0,11,0,0,21,4,0,22,0,0,0
62893,34531,2021-06-24T13:18:40.2152935Z,2021,18,18,15,10,0,Sin Grado,0,1,8,0,0,0,3,0,18,0,0,0
62893,4495,2020-11-18T16:21:10.1507996Z,2019,12,3,9,7,0,10mo,1,0,5,0,0,9,3,0,11,0,0,0
62893,4496,2020-11-18T16:21:10.1507996Z,2019,9,0,9,5,0,11mo,0,0,4,0,0,9,0,0,9,0,0,0
62893,4497,2020-11-18T16:21:10.1507996Z,2019,24,6,17,13,0,1ro,5,0,11,0,0,18,7,0,19,0,0,0
62893,4498,2020-11-18T16:21:10.1518018Z,2019,17,3,16,6,0,2do,1,0,11,0,0,14,1,0,16,0,0,0
62893,4499,2020-11-18T16:21:10.1518018Z,2019,26,7,21,18,0,3ro,1,0,8,0,0,19,5,0,25,0,0,0
62893,4500,2020-11-18T16:21:10.1518018Z,2019,16,5,14,8,0,4to,0,0,8,0,0,11,2,0,16,0,0,0
62893,4501,2020-11-18T16:21:10.8212475Z,2019,26,5,19,16,0,5to,0,0,10,0,0,21,7,0,26,0,0,0
62893,4502,2020-11-18T16:21:10.8222475Z,2019,45,14,30,24,0,6to,1,0,21,0,0,31,15,0,44,0,0,0
62893,4503,2020-11-18T16:21:10.8222475Z,2019,65,16,47,29,0,7mo,0,0,36,0,0,49,18,0,65,0,0,0
62893,4504,2020-11-18T16:21:10.8222475Z,2019,49,9,36,24,0,8vo,4,0,25,0,0,40,13,0,45,0,0,0
62893,4505,2020-11-18T16:21:10.8232493Z,2019,23,9,16,13,0,9no,0,0,10,0,0,14,7,0,23,0,0,0
62893,4506,2020-11-18T16:21:10.8232493Z,2019,11,3,0,8,0,K,0,0,3,0,0,8,11,0,11,0,0,0
62893,4507,2020-11-18T16:21:10.8232493Z,2019,20,17,17,4,0,Sin Grado,0,0,16,0,0,3,3,0,20,0,0,0
61408,10217,2020-11-18T16:22:03.12012Z,2020,33,8,32,22,0,1ro,0,1,11,0,0,25,1,0,33,0,0,0
61408,10218,2020-11-18T16:22:03.12012Z,2020,24,6,24,16,0,2do,1,0,8,0,0,18,0,0,23,0,0,0
61408,10219,2020-11-18T16:22:03.12012Z,2020,20,4,16,11,0,3ro,0,0,9,0,0,16,4,0,20,0,0,0
61408,10220,2020-11-18T16:22:03.12012Z,2020,27,8,23,15,0,4to,0,1,12,0,0,19,4,0,27,0,0,0
61408,10221,2020-11-18T16:22:03.1211213Z,2020,39,11,37,19,0,5to,0,0,20,0,0,28,2,0,39,0,0,0
61408,10222,2020-11-18T16:22:03.1211213Z,2020,43,11,43,24,0,6to,1,0,19,0,0,32,0,0,42,0,0,0
61408,10223,2020-11-18T16:22:03.1211213Z,2020,49,15,44,19,0,7mo,0,0,30,0,0,34,5,0,49,0,0,0
61408,10224,2020-11-18T16:22:03.1211213Z,2020,53,22,48,31,0,8vo,0,0,22,0,0,31,5,0,53,0,0,0
61408,10225,2020-11-18T16:22:03.1221213Z,2020,21,5,19,7,0,K,0,0,14,0,0,16,2,0,21,0,0,0
61408,34233,2021-06-24T13:18:38.0697546Z,2021,22,3,22,7,0,1ro,1,0,15,0,0,19,0,0,21,0,0,0
61408,34234,2021-06-24T13:18:38.0697546Z,2021,31,8,31,19,0,2do,0,0,12,0,0,23,0,0,31,0,0,0
61408,34235,2021-06-24T13:18:38.0697546Z,2021,25,5,25,16,0,3ro,2,0,9,0,0,20,0,0,23,0,0,0
61408,34236,2021-06-24T13:18:38.0707546Z,2021,21,6,20,12,0,4to,0,0,9,0,0,15,1,0,21,0,0,0
61408,34237,2021-06-24T13:18:38.0707546Z,2021,27,7,25,14,0,5to,0,0,13,0,0,20,2,0,27,0,0,0
61408,34238,2021-06-24T13:18:38.0707546Z,2021,50,16,47,22,0,6to,0,0,28,0,0,34,3,0,50,0,0,0
61408,34239,2021-06-24T13:18:38.0717564Z,2021,45,10,44,26,0,7mo,1,0,19,0,0,35,1,0,44,0,0,0
61408,34240,2021-06-24T13:18:38.0717564Z,2021,53,15,48,22,0,8vo,1,0,31,0,0,38,5,0,52,0,0,0
61408,34241,2021-06-24T13:18:38.0717564Z,2021,13,3,13,6,0,K,0,0,7,0,0,10,0,0,13,0,0,0
61408,4202,2020-11-18T16:21:09.0110415Z,2019,31,7,31,20,0,1ro,1,0,11,0,0,24,0,0,30,0,0,0
61408,4203,2020-11-18T16:21:09.0110415Z,2019,28,5,26,16,0,2do,0,0,12,0,0,23,2,0,28,0,0,0
61408,4204,2020-11-18T16:21:09.0110415Z,2019,27,6,25,17,0,3ro,0,0,10,0,0,21,2,0,27,0,0,0
61408,4205,2020-11-18T16:21:09.0120419Z,2019,38,11,36,17,0,4to,0,0,21,0,0,27,2,0,38,0,0,0
61408,4206,2020-11-18T16:21:09.0120419Z,2019,37,8,36,22,0,5to,0,0,15,0,0,29,1,0,37,0,0,0
61408,4207,2020-11-18T16:21:09.0120419Z,2019,52,17,47,20,0,6to,0,0,32,0,0,35,5,0,52,0,0,0
61408,4208,2020-11-18T16:21:09.0130428Z,2019,62,26,57,34,0,7mo,0,0,28,0,0,36,5,0,62,0,0,0
61408,4209,2020-11-18T16:21:09.0130428Z,2019,40,8,40,17,0,8vo,5,0,23,0,0,32,0,0,35,0,0,0
61408,4210,2020-11-18T16:21:09.0130428Z,2019,24,7,22,16,0,K,0,0,8,0,0,17,2,0,24,0,0,0
52258,33558,2021-06-24T13:18:33.4014069Z,2021,61,18,56,31,0,1ro,0,0,30,0,0,43,5,0,61,0,0,0
52258,33559,2021-06-24T13:18:33.4014069Z,2021,69,23,64,31,0,2do,0,0,38,0,0,46,5,0,69,0,0,0
52258,33560,2021-06-24T13:18:33.4014069Z,2021,51,12,42,28,0,3ro,0,0,23,0,0,39,9,1,50,0,0,0
52258,33561,2021-06-24T13:18:33.4014069Z,2021,65,16,59,31,0,4to,0,0,34,0,0,49,6,0,65,0,0,0
52258,33562,2021-06-24T13:18:33.4024069Z,2021,55,14,49,25,0,5to,0,0,30,0,0,41,6,0,55,0,0,0
52258,33563,2021-06-24T13:18:33.4024069Z,2021,76,14,48,39,0,K,0,0,37,0,0,62,28,0,74,0,0,2
52258,3534,2020-11-18T16:21:03.2672132Z,2019,53,19,45,26,0,1ro,1,1,27,0,0,34,8,1,51,0,0,0
52258,3535,2020-11-18T16:21:03.2672132Z,2019,63,20,56,32,0,2do,0,0,31,0,0,43,7,0,63,0,0,0
52258,3536,2020-11-18T16:21:03.2672132Z,2019,60,20,49,27,0,3ro,0,0,33,0,0,40,11,0,60,0,0,0
52258,3537,2020-11-18T16:21:03.2682141Z,2019,59,22,51,23,0,4to,1,1,36,0,0,37,8,0,58,0,0,0
52258,3538,2020-11-18T16:21:03.2682141Z,2019,64,18,56,35,0,5to,0,1,29,0,0,46,8,0,64,0,0,0
52258,3539,2020-11-18T16:21:03.2682141Z,2019,61,16,50,28,0,K,0,0,33,0,0,45,11,0,61,0,0,0
52258,9553,2020-11-18T16:21:59.085431Z,2020,65,20,58,29,0,1ro,0,2,36,0,0,45,7,0,65,0,0,0
52258,9554,2020-11-18T16:21:59.085431Z,2020,47,16,40,24,0,2do,1,0,23,0,0,31,7,1,45,0,0,0
52258,9555,2020-11-18T16:21:59.0864319Z,2020,68,19,61,32,0,3ro,0,2,36,0,0,49,7,0,68,0,0,0
52258,9556,2020-11-18T16:21:59.0864319Z,2020,57,15,45,26,0,4to,0,0,31,0,0,42,12,0,56,0,0,1
52258,9557,2020-11-18T16:21:59.0864319Z,2020,57,21,48,24,0,5to,0,1,33,0,0,36,9,0,57,0,0,0
52258,9558,2020-11-18T16:21:59.0864319Z,2020,68,16,62,35,0,K,0,1,33,0,0,52,6,0,68,0,0,0
42804,2800,2020-11-18T16:20:58.7602025Z,2019,39,14,36,17,1,1ro,0,1,22,0,0,25,3,0,39,0,0,0
42804,2801,2020-11-18T16:20:59.1674743Z,2019,33,12,30,14,0,2do,0,0,19,0,0,21,3,0,33,0,0,0
42804,2802,2020-11-18T16:20:59.1674743Z,2019,41,17,33,24,0,3ro,0,0,17,0,0,24,8,0,41,0,1,0
42804,2803,2020-11-18T16:20:59.1674743Z,2019,46,10,35,27,0,4to,2,0,19,0,0,36,11,0,44,0,0,0
42804,2804,2020-11-18T16:20:59.1674743Z,2019,67,23,50,34,0,5to,0,0,33,0,0,44,17,0,65,1,0,2
42804,2805,2020-11-18T16:20:59.1684752Z,2019,24,5,21,16,0,K,1,0,8,0,0,19,3,0,23,0,0,0
42804,2806,2020-11-18T16:20:59.1684752Z,2019,7,7,6,6,0,Sin Grado,0,0,1,0,0,0,1,0,7,0,0,0
42804,32806,2021-06-24T13:18:28.1856664Z,2021,26,8,20,10,0,1ro,0,0,16,0,0,18,6,0,26,0,0,0
42804,32807,2021-06-24T13:18:28.1856664Z,2021,34,12,30,19,0,2do,1,0,15,0,0,22,4,0,33,0,0,0
42804,32808,2021-06-24T13:18:28.1856664Z,2021,28,11,21,13,0,3ro,1,1,15,0,0,17,7,0,27,0,0,0
42804,32809,2021-06-24T13:18:28.1866665Z,2021,30,7,22,7,0,4to,1,1,23,0,0,23,8,0,29,0,0,0
42804,32810,2021-06-24T13:18:28.1866665Z,2021,53,20,46,29,0,5to,0,0,24,0,0,33,7,0,53,0,1,0
42804,32811,2021-06-24T13:18:28.1866665Z,2021,17,5,10,3,0,K,0,0,14,0,0,12,7,0,17,0,0,0
42804,32812,2021-06-24T13:18:28.1866665Z,2021,6,6,5,6,0,Sin Grado,0,0,0,0,0,0,1,0,6,0,0,0
42804,8810,2020-11-18T16:21:54.2101802Z,2020,35,12,32,21,0,1ro,1,0,14,0,0,23,3,0,34,0,0,0
42804,8811,2020-11-18T16:21:54.2101802Z,2020,32,11,28,16,0,2do,0,1,16,0,0,21,4,0,32,0,0,0
42804,8812,2020-11-18T16:21:54.2111815Z,2020,30,9,23,10,0,3ro,0,0,20,0,0,21,7,0,30,0,0,0
42804,8813,2020-11-18T16:21:54.2111815Z,2020,47,16,35,29,0,4to,0,0,18,0,0,31,12,0,47,0,1,0
42804,8814,2020-11-18T16:21:54.2111815Z,2020,52,16,39,27,0,5to,1,1,25,0,0,36,13,0,51,0,0,0
42804,8815,2020-11-18T16:21:54.2111815Z,2020,25,4,21,12,0,K,0,0,13,0,0,21,4,0,25,0,0,0
42804,8816,2020-11-18T16:21:54.2111815Z,2020,6,6,4,5,0,Sin Grado,0,0,1,0,0,0,2,0,6,0,0,0
75804,11606,2020-11-18T16:22:11.7128531Z,2020,91,41,74,39,0,6to,0,0,52,0,0,50,17,0,91,0,0,0
75804,11607,2020-11-18T16:22:11.7128531Z,2020,124,40,102,64,0,7mo,2,0,60,0,0,84,22,0,122,1,0,0
75804,11608,2020-11-18T16:22:11.7128531Z,2020,137,49,118,77,0,8vo,2,0,60,0,0,88,19,0,134,0,0,1
75804,11609,2020-11-18T16:22:11.7128531Z,2020,53,53,50,17,0,Sin Grado,0,0,36,0,0,0,3,0,53,2,0,0
75804,35629,2021-06-24T13:18:47.3714237Z,2021,116,47,100,57,0,6to,3,0,59,0,0,69,16,0,112,1,0,1
75804,35630,2021-06-24T13:18:47.3724256Z,2021,94,38,85,45,0,7mo,2,0,49,0,0,56,9,0,92,0,0,0
75804,35631,2021-06-24T13:18:47.3724256Z,2021,135,47,112,64,0,8vo,3,0,71,0,0,88,23,0,132,1,0,0
75804,35632,2021-06-24T13:18:47.3724256Z,2021,32,32,31,8,0,Sin Grado,1,0,24,0,0,0,1,0,31,2,0,0
75804,5599,2020-11-18T16:21:16.2048366Z,2019,109,27,89,64,0,6to,4,0,45,0,0,82,20,0,104,1,2,1
75804,5600,2020-11-18T16:21:16.2048366Z,2019,139,50,124,74,0,7mo,2,0,65,0,0,89,15,0,136,0,0,1
75804,5601,2020-11-18T16:21:16.5950982Z,2019,138,42,118,75,0,8vo,1,0,63,0,0,96,20,0,137,1,0,0
75804,5602,2020-11-18T16:21:16.5950982Z,2019,47,44,44,14,0,Sin Grado,1,0,33,0,0,3,3,0,46,3,0,0
35881,2387,2020-11-18T16:20:55.7451953Z,2019,107,12,89,48,0,10mo,3,0,59,0,0,95,18,0,104,0,0,0
35881,2388,2020-11-18T16:20:55.7451953Z,2019,102,9,87,55,0,11mo,3,0,47,0,0,93,15,0,99,0,0,0
35881,2389,2020-11-18T16:20:55.7451953Z,2019,116,0,91,68,0,12mo,5,0,48,0,0,116,25,0,111,0,0,0
35881,2390,2020-11-18T16:20:55.7461958Z,2019,98,15,90,52,0,9no,1,0,46,0,0,83,8,0,97,0,0,0
35881,32394,2021-06-24T13:18:23.363202Z,2021,91,16,81,38,0,10mo,0,0,53,0,0,75,10,0,91,0,0,0
35881,32395,2021-06-24T13:18:23.363202Z,2021,82,12,76,47,0,11mo,1,0,35,0,0,70,6,0,81,0,0,0
35881,32396,2021-06-24T13:18:23.363202Z,2021,86,14,79,41,0,12mo,3,0,45,0,0,72,7,0,83,0,0,0
35881,32397,2021-06-24T13:18:23.363202Z,2021,75,22,69,35,0,9no,0,0,40,0,0,53,6,0,75,0,0,0
35881,32398,2021-06-24T13:18:23.363202Z,2021,7,7,7,4,0,Sin Grado,0,0,3,0,0,0,0,0,7,0,0,0
35881,8399,2020-11-18T16:21:51.4163181Z,2020,87,12,81,51,0,10mo,1,0,36,0,0,75,6,0,86,0,0,0
35881,8400,2020-11-18T16:21:51.4163181Z,2020,92,16,80,45,0,11mo,4,0,47,0,0,76,12,0,88,0,0,0
35881,8401,2020-11-18T16:21:51.7865616Z,2020,79,7,65,45,0,12mo,3,0,34,0,0,72,14,0,76,0,0,0
35881,8402,2020-11-18T16:21:51.7865616Z,2020,87,10,71,39,0,9no,0,0,48,0,0,77,16,0,87,0,0,0
35881,8403,2020-11-18T16:21:51.7875621Z,2020,2,2,2,1,0,Sin Grado,0,0,1,0,0,0,0,0,2,0,0,0
61390,10213,2020-11-18T16:22:03.114116Z,2020,57,8,26,34,0,10mo,1,0,23,0,0,49,31,0,56,0,0,0
61390,10214,2020-11-18T16:22:03.1151169Z,2020,48,5,18,25,0,11mo,1,0,23,0,0,43,30,0,47,0,0,0
61390,10215,2020-11-18T16:22:03.1151169Z,2020,52,8,28,29,0,12mo,1,0,23,0,0,44,24,0,51,0,0,0
61390,10216,2020-11-18T16:22:03.1151169Z,2020,46,7,13,21,0,9no,1,0,25,0,0,39,33,1,44,0,1,0
61390,34229,2021-06-24T13:18:38.0467374Z,2021,43,7,20,22,0,10mo,1,0,21,0,0,36,23,1,41,0,0,0
61390,34230,2021-06-24T13:18:38.0467374Z,2021,56,7,35,34,0,11mo,1,0,22,0,0,49,21,0,55,0,0,0
61390,34231,2021-06-24T13:18:38.0467374Z,2021,46,5,23,24,0,12mo,1,0,22,0,0,41,23,0,45,0,0,0
61390,34232,2021-06-24T13:18:38.0467374Z,2021,47,9,26,28,0,9no,3,0,19,0,0,38,21,1,43,0,0,0
61390,4198,2020-11-18T16:21:08.0213821Z,2019,50,6,20,25,0,10mo,2,0,25,0,0,44,30,0,48,0,0,0
61390,4199,2020-11-18T16:21:08.0223843Z,2019,53,8,29,29,0,11mo,2,0,24,0,0,45,24,0,51,0,0,0
61390,4200,2020-11-18T16:21:08.0223843Z,2019,47,0,18,28,0,12mo,1,0,19,0,0,47,29,0,46,0,0,0
61390,4201,2020-11-18T16:21:08.9990336Z,2019,51,9,20,28,0,9no,0,0,23,0,0,42,31,0,51,0,0,0
40204,2532,2020-11-18T16:20:57.6324556Z,2019,79,20,56,40,0,1ro,0,0,39,0,2,59,23,0,79,2,0,0
40204,2533,2020-11-18T16:20:57.6324556Z,2019,91,20,69,39,0,2do,0,0,52,0,0,71,22,0,91,0,0,0
40204,2534,2020-11-18T16:20:57.6334574Z,2019,68,10,48,37,0,3ro,0,1,31,0,0,58,20,0,68,2,0,0
40204,2535,2020-11-18T16:20:57.6334574Z,2019,82,18,59,41,0,4to,2,1,41,0,0,64,23,0,80,1,2,0
40204,2536,2020-11-18T16:20:57.6334574Z,2019,73,17,49,32,0,5to,0,0,41,0,0,56,24,0,73,1,0,0
40204,2537,2020-11-18T16:20:57.6344574Z,2019,73,12,44,37,0,6to,0,0,36,0,0,61,29,0,73,0,0,0
40204,2538,2020-11-18T16:20:57.6344574Z,2019,70,17,54,40,0,K,0,2,30,0,0,53,16,0,70,0,0,0
40204,2539,2020-11-18T16:20:57.6344574Z,2019,21,4,17,12,0,PK,0,0,9,0,0,17,4,0,21,0,0,0
40204,2540,2020-11-18T16:20:57.6354569Z,2019,5,5,5,0,0,Sin Grado,0,0,5,0,0,0,0,0,5,0,0,0
40204,32540,2021-06-24T13:18:25.2295467Z,2021,64,6,52,32,0,1ro,0,0,32,0,0,58,12,0,64,0,0,0
40204,32541,2021-06-24T13:18:25.2295467Z,2021,69,6,53,35,0,2do,0,0,34,0,0,63,16,0,69,0,0,0
40204,32542,2021-06-24T13:18:25.2305472Z,2021,67,16,54,33,0,3ro,0,0,34,0,0,51,13,0,67,2,1,0
40204,32543,2021-06-24T13:18:25.2305472Z,2021,74,11,55,33,0,4to,0,0,41,0,0,63,19,0,74,0,0,0
40204,32544,2021-06-24T13:18:25.2305472Z,2021,66,8,50,36,0,5to,0,0,30,0,0,58,16,0,66,3,0,0
40204,32545,2021-06-24T13:18:25.2315482Z,2021,62,11,43,29,0,6to,3,0,33,0,0,51,19,0,59,0,2,0
40204,32546,2021-06-24T13:18:25.2315482Z,2021,53,10,36,19,0,7mo,0,0,34,0,0,43,17,0,53,0,0,0
40204,32547,2021-06-24T13:18:25.2315482Z,2021,66,13,48,35,0,K,0,0,31,0,0,53,18,0,66,0,0,0
40204,32548,2021-06-24T13:18:25.2325487Z,2021,25,4,20,14,0,PK,0,0,11,0,0,21,5,0,25,0,0,0
40204,8545,2020-11-18T16:21:52.6331267Z,2020,75,12,58,44,0,1ro,0,1,31,0,0,63,17,0,75,0,0,0
40204,8546,2020-11-18T16:21:52.6341285Z,2020,83,24,61,40,0,2do,1,0,43,0,0,59,22,0,82,2,1,0
40204,8547,2020-11-18T16:21:52.6341285Z,2020,78,13,56,35,0,3ro,0,1,43,0,0,65,22,0,78,0,0,0
40204,8548,2020-11-18T16:21:52.6341285Z,2020,76,10,49,39,0,4to,2,0,37,0,0,66,27,0,74,3,0,0
40204,8549,2020-11-18T16:21:52.6341285Z,2020,70,13,48,35,0,5to,2,0,35,0,0,57,22,0,68,0,2,0
40204,8550,2020-11-18T16:21:52.6341285Z,2020,63,13,46,26,0,6to,0,0,37,0,0,50,17,0,63,0,0,0
40204,8551,2020-11-18T16:21:52.6351285Z,2020,68,12,55,37,0,K,2,0,31,0,0,56,13,0,66,0,0,0
40204,8552,2020-11-18T16:21:52.6351285Z,2020,21,0,15,13,0,PK,0,0,8,0,0,21,6,0,21,0,0,0
40204,8553,2020-11-18T16:21:52.6351285Z,2020,7,7,7,1,0,Sin Grado,0,0,6,0,0,0,0,0,7,0,0,0
70177,10917,2020-11-18T16:22:07.201844Z,2020,59,14,52,26,0,1ro,1,0,33,0,0,45,7,0,58,0,0,0
70177,10918,2020-11-18T16:22:07.201844Z,2020,43,21,33,20,0,2do,1,0,23,0,0,22,10,0,42,0,0,0
70177,10919,2020-11-18T16:22:07.201844Z,2020,55,21,47,33,0,3ro,0,0,22,0,0,34,8,0,55,0,0,0
70177,10920,2020-11-18T16:22:07.2028444Z,2020,55,20,45,32,0,4to,0,0,23,0,0,35,10,0,55,0,0,0
70177,10921,2020-11-18T16:22:07.2028444Z,2020,67,24,52,32,0,5to,2,0,35,0,0,43,15,3,62,0,3,0
70177,10922,2020-11-18T16:22:07.2028444Z,2020,54,22,48,23,0,K,0,0,31,0,0,32,6,0,54,0,0,0
70177,10923,2020-11-18T16:22:07.2028444Z,2020,13,12,9,4,0,Sin Grado,0,0,9,0,0,1,4,0,13,0,0,0
70177,34938,2021-06-24T13:18:43.3375319Z,2021,41,14,39,18,0,1ro,0,0,23,0,0,27,2,0,41,0,0,0
70177,34939,2021-06-24T13:18:43.3375319Z,2021,50,11,46,26,0,2do,1,0,24,0,0,39,4,0,49,0,0,0
70177,34940,2021-06-24T13:18:43.3375319Z,2021,40,17,33,17,0,3ro,0,0,23,0,0,23,7,0,40,0,0,0
70177,34941,2021-06-24T13:18:43.3375319Z,2021,55,18,46,31,0,4to,0,0,24,0,0,37,9,0,55,0,0,0
70177,34942,2021-06-24T13:18:43.3375319Z,2021,53,21,49,29,0,5to,0,0,24,0,0,32,4,0,53,0,0,0
70177,34943,2021-06-24T13:18:43.3385324Z,2021,50,16,35,25,0,K,1,0,25,0,0,34,15,0,49,0,0,0
70177,34944,2021-06-24T13:18:43.3385324Z,2021,16,15,13,5,0,Sin Grado,1,0,11,0,0,1,3,0,15,0,0,0
70177,4909,2020-11-18T16:21:12.9906958Z,2019,50,27,21,22,0,1ro,1,0,28,0,0,23,29,0,49,0,0,0
70177,4910,2020-11-18T16:21:12.9916971Z,2019,59,21,48,35,0,2do,1,0,24,0,0,38,11,0,58,0,0,0
70177,4911,2020-11-18T16:21:12.9916971Z,2019,61,27,51,36,0,3ro,0,0,25,0,0,34,10,0,61,0,0,0
70177,4912,2020-11-18T16:21:12.9916971Z,2019,66,28,53,28,0,4to,2,0,38,0,0,38,13,3,61,0,3,0
70177,4913,2020-11-18T16:21:12.9916971Z,2019,70,18,58,37,0,5to,5,0,33,0,0,52,12,0,65,0,0,0
70177,4914,2020-11-18T16:21:12.9926971Z,2019,63,17,2,46,0,K,0,0,17,0,0,46,61,0,63,0,0,0
70177,4915,2020-11-18T16:21:12.9926971Z,2019,21,19,15,6,0,Sin Grado,0,0,15,0,0,2,6,0,21,0,0,0
33704,2189,2020-11-18T16:20:54.6084351Z,2019,33,6,19,21,0,10mo,1,0,12,0,0,27,14,0,32,0,0,0
33704,2190,2020-11-18T16:20:54.6084351Z,2019,73,5,41,35,0,6to,1,0,38,0,0,68,32,0,71,2,0,1
33704,2191,2020-11-18T16:20:54.6084351Z,2019,95,5,39,49,0,7mo,4,0,46,0,0,90,56,0,91,2,0,0
33704,2192,2020-11-18T16:20:54.6084351Z,2019,120,9,64,61,0,8vo,4,0,59,0,0,111,56,0,116,3,0,0
33704,2193,2020-11-18T16:20:54.6094355Z,2019,46,5,24,33,0,9no,0,0,13,0,0,41,22,0,45,1,0,1
33704,32194,2021-06-24T13:18:20.9905009Z,2021,76,5,38,39,0,10mo,1,0,37,0,0,71,38,0,75,4,0,0
33704,32195,2021-06-24T13:18:20.9915009Z,2021,34,5,20,23,0,11mo,0,0,11,0,0,29,14,0,33,1,0,1
33704,32196,2021-06-24T13:18:20.9915009Z,2021,22,3,12,16,0,12mo,1,0,6,0,0,19,10,0,21,1,0,0
33704,32197,2021-06-24T13:18:20.9915009Z,2021,25,1,14,14,0,6to,1,0,11,0,0,24,11,0,24,0,0,0
33704,32198,2021-06-24T13:18:20.9915009Z,2021,52,4,32,26,0,7mo,0,0,26,0,0,48,20,0,52,1,0,0
33704,32199,2021-06-24T13:18:20.9915009Z,2021,73,5,42,35,0,8vo,1,0,38,0,0,68,31,0,72,3,0,0
33704,32200,2021-06-24T13:18:21.7200242Z,2021,67,4,32,30,0,9no,3,0,37,0,0,63,35,0,64,3,0,0
33704,8200,2020-11-18T16:21:50.2425362Z,2020,40,5,20,29,0,10mo,0,0,11,0,0,35,20,0,39,1,0,1
33704,8201,2020-11-18T16:21:50.6738241Z,2020,23,3,13,16,0,11mo,1,0,7,0,0,20,10,0,22,1,0,0
33704,8202,2020-11-18T16:21:50.6738241Z,2020,49,3,26,24,0,6to,0,0,25,0,0,46,23,0,49,1,0,0
33704,8203,2020-11-18T16:21:50.6738241Z,2020,76,5,41,37,0,7mo,1,0,39,0,0,71,35,1,74,3,0,0
33704,8204,2020-11-18T16:21:50.6738241Z,2020,88,5,35,45,0,8vo,3,0,43,0,0,83,53,0,85,5,0,0
33704,8205,2020-11-18T16:21:50.6738241Z,2020,83,5,41,43,0,9no,2,0,40,0,0,78,42,0,81,4,0,0
62547,10436,2020-11-18T16:22:04.1327965Z,2020,91,25,83,51,0,10mo,2,0,40,0,0,66,8,0,89,0,0,0
62547,10437,2020-11-18T16:22:04.1337978Z,2020,81,26,66,39,0,11mo,11,0,42,0,0,55,15,0,70,0,0,0
62547,10438,2020-11-18T16:22:04.1337978Z,2020,62,13,57,40,0,12mo,10,0,22,0,0,49,5,0,52,0,0,0
62547,10439,2020-11-18T16:22:04.1347987Z,2020,95,29,88,49,0,9no,12,0,46,0,0,66,7,0,82,0,0,1
62547,10440,2020-11-18T16:22:04.1347987Z,2020,36,35,27,4,0,Sin Grado,1,2,32,0,0,1,9,1,34,0,1,0
62547,34450,2021-06-24T13:18:39.4507448Z,2021,86,25,72,45,0,10mo,10,0,41,0,0,61,14,0,75,0,0,1
62547,34451,2021-06-24T13:18:39.4517449Z,2021,87,25,72,48,0,11mo,4,1,39,0,0,62,15,0,83,0,0,0
62547,34452,2021-06-24T13:18:39.4517449Z,2021,76,26,66,37,0,12mo,11,0,39,0,0,50,10,0,65,0,0,0
62547,34453,2021-06-24T13:18:39.4517449Z,2021,49,16,45,23,0,9no,2,2,26,0,0,33,4,0,47,0,0,0
62547,34454,2021-06-24T13:18:39.4517449Z,2021,36,36,23,3,0,Sin Grado,1,2,33,0,0,0,13,1,34,0,1,0
62547,4424,2020-11-18T16:21:10.128784Z,2019,93,30,80,44,0,10mo,6,2,49,0,0,63,13,0,87,0,0,0
62547,4425,2020-11-18T16:21:10.128784Z,2019,76,14,72,43,0,11mo,8,1,33,0,0,62,4,0,68,0,0,0
62547,4426,2020-11-18T16:21:10.1297849Z,2019,89,0,80,42,0,12mo,9,0,47,0,0,89,9,0,80,0,0,0
62547,4427,2020-11-18T16:21:10.1297849Z,2019,101,26,88,58,0,9no,2,0,43,0,0,75,13,1,98,0,0,0
62547,4428,2020-11-18T16:21:10.1297849Z,2019,40,33,28,2,0,Sin Grado,0,0,38,0,0,7,12,1,39,0,0,0
75879,11626,2020-11-18T16:22:11.73587Z,2020,15,6,12,8,0,10mo,2,0,7,0,0,9,3,0,13,0,0,0
75879,11627,2020-11-18T16:22:11.73587Z,2020,11,4,6,5,0,11mo,1,0,6,0,0,7,5,0,10,1,0,0
75879,11628,2020-11-18T16:22:11.73587Z,2020,4,2,3,2,0,12mo,1,0,2,0,0,2,1,0,3,0,0,0
75879,11629,2020-11-18T16:22:11.7368709Z,2020,27,8,12,11,0,1ro,1,0,16,0,0,19,15,0,26,0,0,0
75879,11630,2020-11-18T16:22:11.7368709Z,2020,33,13,15,25,0,2do,4,0,8,0,0,20,18,1,28,0,1,0
75879,11631,2020-11-18T16:22:11.7368709Z,2020,29,11,16,15,0,3ro,2,0,14,0,0,18,13,1,26,0,0,0
75879,11632,2020-11-18T16:22:11.7368709Z,2020,19,8,11,10,0,4to,2,0,9,0,0,11,8,0,17,0,0,0
75879,11633,2020-11-18T16:22:11.7378709Z,2020,37,17,21,19,0,5to,5,0,18,0,0,20,16,0,32,0,0,0
75879,11634,2020-11-18T16:22:11.7378709Z,2020,31,12,23,20,0,6to,1,0,11,0,0,19,8,0,30,0,0,0
75879,11635,2020-11-18T16:22:11.7378709Z,2020,27,14,16,14,0,7mo,0,0,13,0,0,13,11,0,27,0,0,0
75879,11636,2020-11-18T16:22:11.7378709Z,2020,25,13,19,12,0,8vo,0,0,13,0,0,12,6,0,25,0,0,0
75879,11637,2020-11-18T16:22:11.7388709Z,2020,21,11,14,9,0,9no,2,0,12,0,0,10,7,0,19,0,0,0
75879,11638,2020-11-18T16:22:11.7388709Z,2020,34,5,18,17,0,K,2,0,17,0,0,29,16,0,32,0,0,0
75879,11639,2020-11-18T16:22:11.7388709Z,2020,55,5,23,23,0,PK,2,0,32,0,0,50,32,0,53,0,0,0
75879,35649,2021-06-24T13:18:47.3974428Z,2021,19,10,15,7,0,10mo,2,0,12,0,0,9,4,0,17,0,0,0
75879,35650,2021-06-24T13:18:47.3974428Z,2021,14,5,11,7,0,11mo,1,0,7,0,0,9,3,0,13,0,0,0
75879,35651,2021-06-24T13:18:47.3974428Z,2021,10,3,6,5,0,12mo,1,0,5,0,0,7,4,0,9,1,0,0
75879,35652,2021-06-24T13:18:47.3974428Z,2021,30,5,20,15,0,1ro,0,0,15,0,0,25,10,0,30,0,0,0
75879,35653,2021-06-24T13:18:47.3974428Z,2021,26,9,18,12,0,2do,1,0,14,0,0,17,8,0,25,0,0,0
75879,35654,2021-06-24T13:18:47.3984433Z,2021,32,14,19,23,0,3ro,5,0,9,0,0,18,13,1,26,0,1,0
75879,35655,2021-06-24T13:18:47.3984433Z,2021,29,11,21,17,0,4to,2,0,12,0,0,18,8,1,26,0,0,0
75879,35656,2021-06-24T13:18:47.3984433Z,2021,21,9,15,13,0,5to,2,0,8,0,0,12,6,0,19,0,0,0
75879,35657,2021-06-24T13:18:47.3984433Z,2021,35,15,24,20,0,6to,5,0,15,0,0,20,11,0,30,0,0,0
75879,35658,2021-06-24T13:18:47.3984433Z,2021,32,16,25,16,0,7mo,2,0,16,0,0,16,7,0,30,1,0,0
75879,35659,2021-06-24T13:18:47.3994447Z,2021,27,14,18,13,0,8vo,0,0,14,0,0,13,9,0,27,0,0,0
75879,35660,2021-06-24T13:18:47.3994447Z,2021,24,12,17,11,0,9no,0,0,13,0,0,12,7,0,24,0,0,0
75879,35661,2021-06-24T13:18:47.3994447Z,2021,30,6,20,15,0,K,2,0,15,0,0,24,10,0,28,0,0,0
75879,35662,2021-06-24T13:18:47.3994447Z,2021,55,4,30,21,0,PK,3,0,34,0,0,51,25,0,51,0,0,1
75879,5619,2020-11-18T16:21:16.6171124Z,2019,16,4,11,9,0,10mo,2,0,7,0,0,12,5,0,14,1,0,0
75879,5620,2020-11-18T16:21:16.6171124Z,2019,12,6,9,6,0,11mo,2,0,6,0,0,6,3,0,10,0,0,0
75879,5621,2020-11-18T16:21:16.6181138Z,2019,7,0,5,3,0,12mo,0,0,4,0,0,7,2,0,7,0,0,0
75879,5622,2020-11-18T16:21:16.6181138Z,2019,32,14,16,22,0,1ro,4,0,10,0,0,18,16,1,27,0,1,0
75879,5623,2020-11-18T16:21:16.6181138Z,2019,32,12,18,20,0,2do,2,0,12,0,0,20,14,1,29,0,0,0
75879,5624,2020-11-18T16:21:16.6181138Z,2019,21,10,13,11,0,3ro,2,0,10,0,0,11,8,0,19,0,0,0
75879,5625,2020-11-18T16:21:16.6191147Z,2019,37,17,18,20,0,4to,3,0,17,0,0,20,19,0,34,0,0,0
75879,5626,2020-11-18T16:21:16.6191147Z,2019,32,13,24,20,0,5to,1,0,12,0,0,19,8,0,31,0,0,0
75879,5627,2020-11-18T16:21:16.6191147Z,2019,26,9,12,15,0,6to,0,0,11,0,0,17,14,0,26,0,0,0
75879,5628,2020-11-18T16:21:16.6191147Z,2019,29,16,19,12,0,7mo,1,0,17,0,0,13,10,0,28,0,0,0
75879,5629,2020-11-18T16:21:16.6201156Z,2019,26,10,16,13,0,8vo,2,0,13,0,0,16,10,0,24,0,0,0
75879,5630,2020-11-18T16:21:16.6201156Z,2019,24,8,18,12,0,9no,3,0,12,0,0,16,6,0,21,0,0,0
75879,5631,2020-11-18T16:21:16.6201156Z,2019,29,9,15,13,0,K,1,0,16,0,0,20,14,0,28,0,0,0
75879,5632,2020-11-18T16:21:16.6211142Z,2019,72,7,36,33,0,PK,2,1,39,0,0,65,36,0,70,0,0,0
10827,100,2020-11-18T16:20:36.7215116Z,2019,20,17,17,4,0,Sin Grado,0,0,16,0,0,3,3,0,19,0,1,1
10827,30096,2021-06-24T13:18:05.8956779Z,2021,128,40,104,71,0,10mo,3,0,57,0,0,88,24,0,125,0,3,0
10827,30097,2021-06-24T13:18:05.8956779Z,2021,132,37,109,64,0,11mo,2,0,68,0,0,95,23,0,129,0,1,1
10827,30098,2021-06-24T13:18:05.8956779Z,2021,117,39,89,61,0,12mo,6,0,56,0,0,78,28,0,111,0,0,0
10827,30099,2021-06-24T13:18:05.8956779Z,2021,150,62,128,74,0,9no,2,0,76,0,0,88,22,0,148,0,1,0
10827,30100,2021-06-24T13:18:06.2789512Z,2021,18,18,17,3,0,Sin Grado,0,0,15,0,0,0,1,0,18,0,0,0
10827,6097,2020-11-18T16:21:37.7011717Z,2020,130,37,108,66,0,10mo,3,0,64,0,0,93,22,0,127,0,0,0
10827,6098,2020-11-18T16:21:37.7021721Z,2020,124,36,89,68,0,11mo,6,0,56,0,0,88,35,0,118,0,0,0
10827,6099,2020-11-18T16:21:37.7021721Z,2020,137,46,111,70,0,12mo,0,0,67,0,0,91,26,0,137,0,0,0
10827,6100,2020-11-18T16:21:37.7021721Z,2020,137,39,115,76,0,9no,2,0,61,0,0,98,22,0,135,0,2,0
10827,6101,2020-11-18T16:21:38.2235206Z,2020,20,20,18,4,0,Sin Grado,0,0,16,0,0,0,2,0,19,0,0,1
10827,96,2020-11-18T16:20:36.7215116Z,2019,133,41,92,70,0,10mo,6,0,63,0,0,92,41,0,127,0,0,0
10827,97,2020-11-18T16:20:36.7215116Z,2019,150,50,117,72,0,11mo,0,0,78,0,0,100,33,0,150,0,0,0
10827,98,2020-11-18T16:20:36.7215116Z,2019,141,0,108,71,0,12mo,4,0,70,0,0,141,33,0,137,0,0,0
10827,99,2020-11-18T16:20:36.7215116Z,2019,133,40,116,68,0,9no,3,0,65,0,0,93,17,0,130,0,0,0
75267,11552,2020-11-18T16:22:11.3155883Z,2020,157,37,124,86,0,10mo,0,0,71,0,0,120,33,0,157,0,0,0
75267,11553,2020-11-18T16:22:11.3155883Z,2020,109,23,86,59,0,11mo,1,0,50,0,0,86,23,0,108,0,0,0
75267,11554,2020-11-18T16:22:11.3155883Z,2020,146,24,99,78,0,12mo,1,0,68,0,0,122,47,0,145,0,0,0
75267,11555,2020-11-18T16:22:11.3155883Z,2020,160,45,133,74,0,9no,6,0,86,0,0,115,27,0,154,0,0,0
75267,35575,2021-06-24T13:18:46.5938668Z,2021,153,45,131,73,0,10mo,6,0,80,0,0,108,22,0,147,0,0,0
75267,35576,2021-06-24T13:18:46.5938668Z,2021,141,28,109,79,0,11mo,0,0,62,0,0,113,32,0,141,0,0,0
75267,35577,2021-06-24T13:18:46.5938668Z,2021,105,20,86,57,0,12mo,1,0,48,0,0,85,19,0,104,0,0,0
75267,35578,2021-06-24T13:18:46.5948669Z,2021,100,30,92,47,0,9no,0,1,53,0,0,70,8,0,100,0,0,0
75267,5543,2020-11-18T16:21:16.1828228Z,2019,156,35,122,82,0,10mo,1,0,74,0,0,121,34,0,155,0,0,0
75267,5544,2020-11-18T16:21:16.1828228Z,2019,148,26,97,78,0,11mo,1,0,70,0,0,122,51,0,147,0,0,0
75267,5545,2020-11-18T16:21:16.1828228Z,2019,150,0,109,83,0,12mo,2,0,67,0,0,150,41,0,148,0,0,0
75267,5546,2020-11-18T16:21:16.1838232Z,2019,198,54,157,96,0,9no,1,1,102,0,0,144,41,0,197,0,0,0
62554,10441,2020-11-18T16:22:04.1347987Z,2020,97,34,93,48,0,6to,1,0,49,0,0,63,4,0,96,1,0,0
62554,10442,2020-11-18T16:22:04.1347987Z,2020,97,38,88,51,0,7mo,2,0,46,0,0,59,9,0,95,0,0,0
62554,10443,2020-11-18T16:22:04.1357991Z,2020,86,27,80,45,0,8vo,1,0,41,0,0,59,6,0,85,0,0,0
62554,34455,2021-06-24T13:18:39.4537463Z,2021,90,34,90,44,0,6to,1,0,46,0,0,56,0,0,89,1,0,0
62554,34456,2021-06-24T13:18:39.4537463Z,2021,82,31,80,41,0,7mo,2,0,41,0,0,51,2,0,80,0,0,0
62554,34457,2021-06-24T13:18:39.4547477Z,2021,91,35,84,48,0,8vo,2,0,43,0,0,56,7,0,89,0,0,0
62554,4429,2020-11-18T16:21:10.1277849Z,2019,113,42,105,62,0,6to,2,0,51,0,0,71,8,0,111,0,0,0
62554,4430,2020-11-18T16:21:10.128784Z,2019,113,36,108,56,0,7mo,1,0,57,0,0,77,5,0,112,0,0,0
62554,4431,2020-11-18T16:21:10.128784Z,2019,81,25,74,45,0,8vo,2,0,36,0,0,56,7,0,79,0,0,0
70060,10889,2020-11-18T16:22:06.559419Z,2020,101,39,92,54,0,6to,3,0,47,0,0,62,9,0,98,0,0,0
70060,10890,2020-11-18T16:22:06.559419Z,2020,103,47,87,43,0,7mo,4,1,60,0,0,56,16,0,99,0,0,0
70060,10891,2020-11-18T16:22:06.559419Z,2020,80,36,71,41,0,8vo,1,0,39,0,0,44,9,0,79,0,0,0
70060,10892,2020-11-18T16:22:06.5604181Z,2020,41,41,36,12,0,Sin Grado,0,2,29,0,0,0,5,0,40,0,1,1
70060,34911,2021-06-24T13:18:43.3155161Z,2021,89,37,78,40,0,6to,2,1,49,0,0,52,11,0,87,0,0,0
70060,34912,2021-06-24T13:18:43.3165161Z,2021,104,41,95,58,0,7mo,2,0,46,0,0,63,9,0,102,0,0,0
70060,34913,2021-06-24T13:18:43.3165161Z,2021,97,45,83,41,0,8vo,3,0,56,0,0,52,14,0,94,1,0,0
70060,34914,2021-06-24T13:18:43.3165161Z,2021,46,46,42,16,0,Sin Grado,1,1,30,0,0,0,4,0,44,0,1,1
70060,4881,2020-11-18T16:21:12.4423295Z,2019,91,43,74,35,0,6to,2,0,56,0,0,48,17,0,88,0,0,1
70060,4882,2020-11-18T16:21:12.4423295Z,2019,73,27,64,38,0,7mo,0,0,35,0,0,46,9,0,73,0,0,0
70060,4883,2020-11-18T16:21:12.4423295Z,2019,109,40,96,59,0,8vo,3,0,50,0,0,69,13,0,106,0,0,0
70060,4884,2020-11-18T16:21:12.4433304Z,2019,41,39,38,13,0,Sin Grado,1,3,28,0,0,2,3,0,40,0,0,0
55731,33854,2021-06-24T13:18:35.757096Z,2021,24,7,19,11,0,1ro,0,0,13,0,0,17,5,0,24,0,0,0
55731,33855,2021-06-24T13:18:35.757096Z,2021,30,9,26,17,0,2do,2,0,13,0,0,21,4,0,28,0,0,0
55731,33856,2021-06-24T13:18:35.7580965Z,2021,40,7,36,22,0,3ro,1,0,18,0,0,33,4,0,39,1,0,0
55731,33857,2021-06-24T13:18:35.7580965Z,2021,42,14,38,21,0,4to,1,0,21,0,0,28,4,0,41,1,0,0
55731,33858,2021-06-24T13:18:35.7580965Z,2021,36,11,29,19,0,5to,1,0,17,0,0,25,7,0,35,0,0,0
55731,33859,2021-06-24T13:18:35.7580965Z,2021,22,1,18,12,0,K,0,0,10,0,0,21,4,0,22,0,0,0
55731,3831,2020-11-18T16:21:05.5717461Z,2019,41,10,34,21,0,1ro,0,1,20,0,0,31,7,0,41,1,0,0
55731,3832,2020-11-18T16:21:05.5717461Z,2019,46,15,43,24,0,2do,1,2,22,0,0,31,3,0,45,1,0,0
55731,3833,2020-11-18T16:21:05.5717461Z,2019,40,14,35,18,0,3ro,2,2,22,0,0,26,5,0,38,0,0,0
55731,3834,2020-11-18T16:21:05.5717461Z,2019,33,15,30,16,0,4to,1,0,17,0,0,18,3,0,32,0,0,0
55731,3835,2020-11-18T16:21:05.5717461Z,2019,31,8,26,15,0,5to,0,5,16,0,0,23,5,0,31,0,0,0
55731,3836,2020-11-18T16:21:05.5727466Z,2019,30,6,26,20,0,K,0,0,10,0,0,24,4,0,30,0,0,0
55731,9848,2020-11-18T16:22:00.5243927Z,2020,27,9,22,14,0,1ro,1,1,13,0,0,18,5,0,26,0,0,0
55731,9849,2020-11-18T16:22:00.5243927Z,2020,39,9,32,21,0,2do,1,0,18,0,0,30,7,0,38,1,0,0
55731,9850,2020-11-18T16:22:00.5243927Z,2020,45,13,39,23,0,3ro,1,0,22,0,0,32,6,0,44,1,0,0
55731,9851,2020-11-18T16:22:00.5243927Z,2020,38,13,33,18,0,4to,2,0,20,0,0,25,5,0,36,0,0,0
55731,9852,2020-11-18T16:22:00.5243927Z,2020,38,17,34,20,0,5to,1,0,18,0,0,21,4,0,37,0,0,0
55731,9853,2020-11-18T16:22:00.5243927Z,2020,31,7,25,12,0,K,0,1,19,0,0,24,6,0,31,0,0,0
57562,33976,2021-06-24T13:18:36.657741Z,2021,79,28,67,38,0,6to,2,0,41,0,0,51,12,0,77,0,0,0
57562,33977,2021-06-24T13:18:36.6587419Z,2021,95,31,72,46,0,7mo,1,0,49,0,0,64,23,0,94,2,0,0
57562,33978,2021-06-24T13:18:36.6587419Z,2021,90,25,74,44,0,8vo,3,0,46,0,0,65,16,0,86,1,0,1
57562,3952,2020-11-18T16:21:06.87962Z,2019,119,40,97,50,0,6to,6,0,69,0,0,79,22,0,112,2,0,1
57562,3953,2020-11-18T16:21:06.8806209Z,2019,108,36,90,51,0,7mo,2,1,57,0,0,72,18,1,105,0,0,0
57562,3954,2020-11-18T16:21:06.8806209Z,2019,127,34,100,69,0,8vo,0,1,58,0,0,93,27,1,126,1,1,0
57562,9969,2020-11-18T16:22:01.5530794Z,2020,115,40,85,51,0,6to,1,0,64,0,0,75,30,0,114,3,0,0
57562,9970,2020-11-18T16:22:01.5530794Z,2020,115,36,96,49,0,7mo,3,0,66,0,0,79,19,0,111,2,0,1
57562,9971,2020-11-18T16:22:01.5530794Z,2020,116,40,98,54,0,8vo,2,2,62,0,0,76,18,0,114,0,0,0
52274,33564,2021-06-24T13:18:33.4014069Z,2021,114,33,83,65,0,10mo,0,0,49,0,0,81,31,0,114,1,0,0
52274,33565,2021-06-24T13:18:33.4014069Z,2021,105,28,81,48,0,11mo,1,1,57,0,0,77,24,0,104,0,0,0
52274,33566,2021-06-24T13:18:33.4024069Z,2021,95,24,68,45,0,12mo,2,0,50,0,0,71,27,0,93,0,1,0
52274,33567,2021-06-24T13:18:33.4024069Z,2021,116,47,92,51,0,9no,1,0,65,0,0,69,24,0,115,0,0,0
52274,3540,2020-11-18T16:21:03.2622105Z,2019,108,29,79,47,0,10mo,4,0,61,0,0,79,29,0,104,0,1,0
52274,3541,2020-11-18T16:21:03.2632114Z,2019,111,28,80,47,0,11mo,1,0,64,0,0,83,31,0,110,3,0,0
52274,3542,2020-11-18T16:21:03.2632114Z,2019,102,0,84,57,0,12mo,1,0,45,0,0,102,18,0,101,4,0,0
52274,3543,2020-11-18T16:21:03.2632114Z,2019,120,34,88,61,0,9no,2,0,59,0,0,86,32,0,118,0,0,0
52274,9559,2020-11-18T16:21:59.0864319Z,2020,117,35,91,56,0,10mo,1,0,61,0,0,82,26,0,116,0,0,0
52274,9560,2020-11-18T16:21:59.0874324Z,2020,109,27,80,49,0,11mo,2,0,60,0,0,82,29,0,107,0,1,0
52274,9561,2020-11-18T16:21:59.0874324Z,2020,103,26,75,48,0,12mo,1,0,55,0,0,77,28,0,102,3,0,0
52274,9562,2020-11-18T16:21:59.0874324Z,2020,124,36,94,70,0,9no,0,1,54,0,0,88,30,0,124,1,0,0
47647,3156,2020-11-18T16:21:01.0257163Z,2019,147,26,102,81,0,10mo,3,0,66,0,0,121,45,0,144,5,1,0
47647,3157,2020-11-18T16:21:01.0257163Z,2019,176,34,133,98,0,11mo,4,0,78,0,0,142,43,0,172,7,0,0
47647,3158,2020-11-18T16:21:01.0257163Z,2019,147,0,100,77,0,12mo,0,0,70,0,0,147,47,0,147,4,1,0
47647,3159,2020-11-18T16:21:01.0267167Z,2019,146,37,120,70,0,9no,1,0,76,0,0,109,26,0,144,3,0,1
47647,33172,2021-06-24T13:18:30.341213Z,2021,145,35,105,73,0,10mo,1,0,72,0,0,110,40,0,144,2,1,0
47647,33173,2021-06-24T13:18:30.341213Z,2021,138,28,100,77,0,11mo,4,0,61,0,0,110,38,0,134,2,0,0
47647,33174,2021-06-24T13:18:30.341213Z,2021,139,21,91,77,0,12mo,6,0,62,0,0,118,48,0,133,5,2,0
47647,33175,2021-06-24T13:18:30.341213Z,2021,150,38,96,67,0,9no,1,0,83,0,0,112,54,0,149,1,1,0
47647,33176,2021-06-24T13:18:30.3422139Z,2021,6,6,4,1,0,Sin Grado,0,0,5,0,0,0,2,0,6,0,0,0
47647,9170,2020-11-18T16:21:56.1454734Z,2020,144,37,110,76,0,10mo,1,0,68,0,0,107,34,0,143,3,0,0
47647,9171,2020-11-18T16:21:56.1454734Z,2020,147,22,96,81,0,11mo,5,0,66,0,0,125,51,0,142,5,1,0
47647,9172,2020-11-18T16:21:56.1464738Z,2020,152,31,109,88,0,12mo,5,1,64,0,0,121,43,0,147,7,0,0
47647,9173,2020-11-18T16:21:56.1464738Z,2020,134,35,109,67,0,9no,2,0,67,0,0,99,25,0,132,1,2,0
68510,10812,2020-11-18T16:22:06.5283967Z,2020,53,14,45,30,0,1ro,0,3,23,0,0,39,8,0,53,0,0,0
68510,10813,2020-11-18T16:22:06.5283967Z,2020,55,18,51,22,0,2do,1,5,33,0,0,37,4,0,54,0,0,0
68510,10814,2020-11-18T16:22:06.5293976Z,2020,54,15,46,31,0,3ro,0,4,23,0,0,39,8,0,54,0,0,0
68510,10815,2020-11-18T16:22:06.5293976Z,2020,63,27,51,29,0,4to,0,3,34,0,0,36,12,0,62,0,0,1
68510,10816,2020-11-18T16:22:06.5293976Z,2020,61,21,42,31,0,5to,0,7,30,0,0,40,19,0,61,0,0,0
68510,10817,2020-11-18T16:22:06.5293976Z,2020,51,13,41,23,0,K,1,3,28,0,0,38,10,0,50,0,0,0
68510,10818,2020-11-18T16:22:06.5293976Z,2020,35,35,27,19,0,Sin Grado,0,1,16,0,0,0,8,0,35,0,0,0
68510,34833,2021-06-24T13:18:42.2967856Z,2021,50,16,42,27,0,1ro,1,0,23,0,0,34,8,0,49,0,0,0
68510,34834,2021-06-24T13:18:42.2967856Z,2021,50,13,45,26,0,2do,1,0,24,0,0,37,5,0,49,0,0,0
68510,34835,2021-06-24T13:18:42.2967856Z,2021,56,19,49,23,0,3ro,1,0,33,0,0,37,7,0,55,0,0,0
68510,34836,2021-06-24T13:18:42.2977856Z,2021,55,16,46,31,0,4to,0,0,24,0,0,39,9,0,55,0,0,0
68510,34837,2021-06-24T13:18:42.2977856Z,2021,60,23,54,26,0,5to,1,0,34,0,0,37,6,0,59,0,0,0
68510,34838,2021-06-24T13:18:42.2977856Z,2021,49,12,43,18,0,K,0,0,31,0,0,37,6,0,49,0,0,0
68510,34839,2021-06-24T13:18:42.2977856Z,2021,33,33,25,16,0,Sin Grado,0,0,17,0,0,0,8,0,33,0,0,0
68510,4805,2020-11-18T16:21:12.3772862Z,2019,59,18,55,24,0,1ro,1,2,35,0,0,41,4,0,58,0,0,0
68510,4806,2020-11-18T16:21:12.3772862Z,2019,63,21,55,34,0,2do,0,8,29,0,0,42,8,1,62,0,1,0
68510,4807,2020-11-18T16:21:12.3782867Z,2019,68,28,56,33,0,3ro,0,2,35,0,0,40,12,0,68,0,0,0
68510,4808,2020-11-18T16:21:12.3782867Z,2019,67,24,52,37,0,4to,0,4,30,0,0,43,15,0,67,0,0,0
68510,4809,2020-11-18T16:21:12.3782867Z,2019,61,12,44,27,0,5to,0,4,34,0,0,49,17,0,61,0,0,0
68510,4810,2020-11-18T16:21:12.3792871Z,2019,48,12,40,31,0,K,0,1,17,0,0,36,8,0,48,0,0,0
68510,4811,2020-11-18T16:21:12.3792871Z,2019,27,26,19,8,0,Sin Grado,0,1,19,0,0,1,8,0,27,0,0,0
21758,1249,2020-11-18T16:20:45.087088Z,2019,95,18,72,45,0,10mo,0,0,50,0,0,77,23,0,95,0,0,0
21758,1250,2020-11-18T16:20:45.0880884Z,2019,79,21,58,42,0,11mo,0,0,37,0,0,58,21,0,79,0,0,0
21758,1251,2020-11-18T16:20:45.0880884Z,2019,122,0,95,59,0,12mo,0,0,63,0,0,122,27,0,122,0,0,0
21758,1252,2020-11-18T16:20:45.0880884Z,2019,66,20,55,37,0,9no,0,0,29,0,0,46,11,0,66,0,0,0
21758,1253,2020-11-18T16:20:45.0880884Z,2019,35,31,32,6,0,Sin Grado,0,1,29,0,0,4,3,0,35,0,1,0
21758,31250,2021-06-24T13:18:14.0175008Z,2021,91,26,74,43,0,10mo,1,0,48,0,0,65,17,0,90,0,0,0
21758,31251,2021-06-24T13:18:14.0185013Z,2021,77,25,62,42,0,11mo,0,0,35,0,0,52,15,0,77,0,0,0
21758,31252,2021-06-24T13:18:14.0185013Z,2021,86,15,68,44,0,12mo,0,0,42,0,0,71,18,0,86,0,0,0
21758,31253,2021-06-24T13:18:14.0185013Z,2021,96,26,82,50,0,9no,0,0,46,0,0,70,14,0,96,0,1,0
21758,31254,2021-06-24T13:18:14.0195031Z,2021,31,30,27,6,0,Sin Grado,0,2,25,0,0,1,4,0,31,0,1,0
21758,7254,2020-11-18T16:21:44.5957706Z,2020,75,24,56,43,0,10mo,0,0,32,0,0,51,19,0,75,0,0,0
21758,7255,2020-11-18T16:21:44.5957706Z,2020,92,19,66,44,0,11mo,0,0,48,0,0,73,26,0,92,0,0,0
21758,7256,2020-11-18T16:21:44.5957706Z,2020,69,15,49,39,0,12mo,0,0,30,0,0,54,20,0,69,0,0,0
21758,7257,2020-11-18T16:21:44.5967711Z,2020,98,30,77,48,0,9no,1,0,50,0,0,68,21,0,97,0,0,0
21758,7258,2020-11-18T16:21:44.5967711Z,2020,36,35,32,8,0,Sin Grado,0,2,28,0,0,1,4,0,36,0,1,0
12278,30327,2021-06-24T13:18:08.8327829Z,2021,42,15,39,20,0,1ro,1,1,22,0,0,27,3,0,41,0,0,0
12278,30328,2021-06-24T13:18:08.8327829Z,2021,32,9,29,16,0,2do,2,0,16,0,0,23,3,0,30,0,0,0
12278,30329,2021-06-24T13:18:08.8327829Z,2021,48,17,38,23,0,3ro,0,2,25,0,0,31,10,1,47,0,0,0
12278,30330,2021-06-24T13:18:08.8327829Z,2021,54,18,43,27,0,4to,0,0,27,0,0,36,11,0,54,0,0,0
12278,30331,2021-06-24T13:18:08.8337838Z,2021,50,10,44,28,0,5to,0,2,22,0,0,40,6,1,49,0,0,0
12278,30332,2021-06-24T13:18:08.8337838Z,2021,38,8,35,13,0,K,0,0,25,0,0,30,3,0,38,0,0,0
12278,329,2020-11-18T16:20:39.6324494Z,2019,56,20,37,25,0,1ro,0,2,31,0,0,36,19,0,56,0,0,0
12278,330,2020-11-18T16:20:39.6334507Z,2019,61,23,41,28,0,2do,0,0,33,0,1,38,20,0,61,0,0,0
12278,331,2020-11-18T16:20:39.6334507Z,2019,52,14,38,26,0,3ro,0,1,26,0,0,38,14,0,52,0,0,0
12278,332,2020-11-18T16:20:39.6334507Z,2019,60,12,44,27,0,4to,1,5,33,0,0,48,16,0,59,0,0,0
12278,333,2020-11-18T16:20:39.6334507Z,2019,52,19,35,21,0,5to,0,5,31,0,1,33,17,0,52,0,0,0
12278,334,2020-11-18T16:20:39.634452Z,2019,37,10,34,16,0,K,0,0,21,0,0,27,3,0,37,0,0,0
12278,6330,2020-11-18T16:21:39.2371975Z,2020,34,9,28,16,0,1ro,1,0,18,0,0,25,6,0,33,0,0,0
12278,6331,2020-11-18T16:21:39.2371975Z,2020,56,18,39,25,0,2do,0,2,31,0,0,38,17,1,55,0,0,0
12278,6332,2020-11-18T16:21:39.238198Z,2020,56,17,41,27,0,3ro,0,1,29,0,0,39,15,0,56,0,0,0
12278,6333,2020-11-18T16:21:39.238198Z,2020,50,13,35,29,0,4to,0,2,21,0,0,37,15,1,49,0,0,0
12278,6334,2020-11-18T16:21:39.238198Z,2020,61,12,46,24,0,5to,1,0,37,0,0,49,15,0,60,0,0,0
12278,6335,2020-11-18T16:21:39.2391984Z,2020,49,18,40,25,0,K,1,1,24,0,0,31,9,0,48,0,0,0
33563,2168,2020-11-18T16:20:54.6064346Z,2019,54,21,49,31,0,1ro,0,0,23,0,0,33,5,0,54,0,0,0
33563,2169,2020-11-18T16:20:54.6064346Z,2019,49,21,43,26,0,2do,1,0,23,0,0,28,6,3,45,0,2,0
33563,2170,2020-11-18T16:20:54.6074342Z,2019,47,18,32,22,0,3ro,0,0,25,0,0,29,15,1,45,0,1,1
33563,2171,2020-11-18T16:20:54.6074342Z,2019,50,16,39,23,0,4to,0,0,27,0,0,34,11,0,50,0,0,0
33563,2172,2020-11-18T16:20:54.6074342Z,2019,42,11,30,21,0,5to,0,0,21,0,0,31,12,1,41,0,0,0
33563,2173,2020-11-18T16:20:54.6074342Z,2019,1,0,1,1,0,6to,0,0,0,0,0,1,0,0,1,0,0,0
33563,2174,2020-11-18T16:20:54.6074342Z,2019,45,10,37,18,0,K,0,0,27,0,0,35,8,0,45,0,0,0
33563,2175,2020-11-18T16:20:54.6084351Z,2019,60,8,26,33,0,PK,0,0,27,0,0,52,34,0,60,0,0,0
33563,32174,2021-06-24T13:18:20.9194497Z,2021,54,10,39,25,0,1ro,0,0,29,0,0,44,15,0,54,0,0,0
33563,32175,2021-06-24T13:18:20.9204506Z,2021,59,13,52,32,0,2do,0,0,27,0,0,46,7,1,58,0,0,0
33563,32176,2021-06-24T13:18:20.9204506Z,2021,46,14,37,24,0,3ro,0,0,22,0,0,32,9,0,46,0,0,0
33563,32177,2021-06-24T13:18:20.9204506Z,2021,45,18,37,21,0,4to,1,0,24,0,0,27,8,1,43,0,0,0
33563,32178,2021-06-24T13:18:20.9204506Z,2021,51,16,33,26,0,5to,3,0,25,0,0,35,18,0,47,0,0,1
33563,32179,2021-06-24T13:18:20.921452Z,2021,11,1,8,7,0,6to,0,0,4,0,0,10,3,0,11,0,0,0
33563,32180,2021-06-24T13:18:20.921452Z,2021,69,7,54,41,0,K,0,0,28,0,0,62,15,0,68,0,0,1
33563,32181,2021-06-24T13:18:20.921452Z,2021,13,2,6,10,0,PK,0,0,3,0,0,11,7,0,13,0,0,0
33563,8180,2020-11-18T16:21:50.2365322Z,2020,59,11,41,30,0,1ro,0,0,29,0,0,48,18,0,59,0,0,0
33563,8181,2020-11-18T16:21:50.2365322Z,2020,50,15,37,25,0,2do,0,0,25,0,0,35,13,0,50,0,0,0
33563,8182,2020-11-18T16:21:50.2375327Z,2020,53,21,41,29,0,3ro,4,0,24,0,0,32,12,3,46,0,2,0
33563,8183,2020-11-18T16:21:50.2375327Z,2020,47,18,31,22,0,4to,2,0,25,0,0,29,16,0,44,0,0,1
33563,8184,2020-11-18T16:21:50.2375327Z,2020,46,14,37,22,0,5to,0,0,24,0,0,32,9,0,46,0,0,0
33563,8185,2020-11-18T16:21:50.2375327Z,2020,7,0,4,5,0,6to,0,0,2,0,0,7,3,0,7,0,0,0
33563,8186,2020-11-18T16:21:50.2375327Z,2020,51,9,37,22,0,K,0,0,29,0,0,42,14,0,51,0,0,0
33563,8187,2020-11-18T16:21:50.2385335Z,2020,35,2,21,21,0,PK,0,0,14,0,0,33,14,0,35,0,0,0
62539,10429,2020-11-18T16:22:04.1337978Z,2020,46,21,38,20,0,1ro,3,0,26,0,0,25,8,0,43,0,0,0
62539,10430,2020-11-18T16:22:04.1337978Z,2020,27,18,24,13,0,2do,2,0,14,0,0,9,3,0,25,0,0,0
62539,10431,2020-11-18T16:22:04.1337978Z,2020,40,19,34,18,0,3ro,0,0,22,0,0,21,6,0,40,0,0,0
62539,10432,2020-11-18T16:22:04.1347987Z,2020,32,8,26,18,0,4to,1,0,14,0,0,24,6,0,31,0,0,0
62539,10433,2020-11-18T16:22:04.1357991Z,2020,27,12,26,7,0,5to,1,0,20,0,0,15,1,0,26,0,0,0
62539,10434,2020-11-18T16:22:04.1357991Z,2020,28,11,25,12,0,K,1,0,16,0,0,17,3,0,27,0,0,0
62539,10435,2020-11-18T16:22:04.1367991Z,2020,20,19,18,4,0,Sin Grado,0,0,16,0,0,1,2,0,20,0,0,0
62539,34443,2021-06-24T13:18:39.4447401Z,2021,25,10,25,8,0,1ro,2,0,17,0,0,15,0,0,23,0,0,0
62539,34444,2021-06-24T13:18:39.4447401Z,2021,46,21,43,21,0,2do,3,0,25,0,0,25,3,0,43,0,0,0
62539,34445,2021-06-24T13:18:39.4447401Z,2021,28,19,24,11,0,3ro,3,0,17,0,0,9,4,0,25,0,0,0
62539,34446,2021-06-24T13:18:39.4457397Z,2021,37,19,37,18,0,4to,0,0,19,0,0,18,0,0,37,0,0,0
62539,34447,2021-06-24T13:18:39.4457397Z,2021,31,8,25,17,0,5to,2,0,14,0,0,23,6,0,29,0,0,0
62539,34448,2021-06-24T13:18:39.4457397Z,2021,21,8,19,10,0,K,0,0,11,0,0,13,2,0,21,0,0,0
62539,34449,2021-06-24T13:18:39.4457397Z,2021,20,20,18,4,0,Sin Grado,0,0,16,0,0,0,2,0,20,0,0,0
62539,4417,2020-11-18T16:21:10.1317862Z,2019,52,34,46,24,0,1ro,3,0,28,0,0,18,6,0,49,0,0,0
62539,4418,2020-11-18T16:21:10.1317862Z,2019,36,17,33,16,0,2do,0,0,20,0,0,19,3,0,36,0,0,0
62539,4419,2020-11-18T16:21:10.1327871Z,2019,32,7,25,17,0,3ro,1,1,15,0,0,25,7,0,31,0,0,0
62539,4420,2020-11-18T16:21:10.1327871Z,2019,29,11,29,8,0,4to,1,1,21,0,0,18,0,0,28,0,0,0
62539,4421,2020-11-18T16:21:10.1327871Z,2019,41,14,32,20,0,5to,4,0,21,0,0,27,9,0,37,0,0,0
62539,4422,2020-11-18T16:21:10.1327871Z,2019,32,15,28,14,0,K,1,0,18,0,0,17,4,0,31,0,0,0
62539,4423,2020-11-18T16:21:10.1337871Z,2019,25,25,20,5,0,Sin Grado,0,0,20,0,0,0,5,0,25,0,0,0
10710,30082,2021-06-24T13:18:05.8886722Z,2021,49,17,44,30,0,1ro,0,0,19,0,0,32,5,0,49,0,0,0
10710,30083,2021-06-24T13:18:05.8896727Z,2021,60,20,56,23,0,2do,0,0,37,0,0,40,4,0,60,0,0,0
10710,30084,2021-06-24T13:18:05.8896727Z,2021,48,21,40,22,0,3ro,0,0,26,0,0,27,8,0,48,0,0,0
10710,30085,2021-06-24T13:18:05.8896727Z,2021,53,19,43,22,0,4to,0,0,31,0,0,34,10,0,53,0,0,0
10710,30086,2021-06-24T13:18:05.8896727Z,2021,50,19,44,15,0,5to,0,0,35,0,0,31,6,0,50,0,0,0
10710,30087,2021-06-24T13:18:05.8896727Z,2021,43,15,38,21,0,K,1,0,22,0,0,28,5,0,42,0,0,0
10710,30088,2021-06-24T13:18:05.8906741Z,2021,19,19,12,3,0,Sin Grado,0,0,16,0,0,0,7,0,19,0,0,0
10710,6083,2020-11-18T16:21:37.6961686Z,2020,59,21,48,26,0,1ro,0,0,33,0,0,38,11,0,59,0,0,0
10710,6084,2020-11-18T16:21:37.6961686Z,2020,54,26,45,25,0,2do,0,0,29,0,0,28,9,0,54,0,0,0
10710,6085,2020-11-18T16:21:37.6971686Z,2020,54,19,39,24,0,3ro,0,0,30,0,0,35,15,0,54,0,0,0
10710,6086,2020-11-18T16:21:37.6971686Z,2020,49,19,40,13,0,4to,1,0,36,0,0,30,9,0,48,0,0,0
10710,6087,2020-11-18T16:21:37.6971686Z,2020,53,10,41,30,0,5to,3,0,23,0,0,43,12,0,50,0,0,0
10710,6088,2020-11-18T16:21:37.6971686Z,2020,52,17,45,28,0,K,0,0,24,0,0,35,7,0,52,0,0,0
10710,6089,2020-11-18T16:21:37.6971686Z,2020,13,13,10,4,0,Sin Grado,0,0,9,0,0,0,3,0,13,0,0,0
10710,82,2020-11-18T16:20:36.8425915Z,2019,59,31,50,30,0,1ro,0,0,29,0,0,28,9,0,59,0,0,0
10710,83,2020-11-18T16:20:36.8435923Z,2019,64,24,50,30,0,2do,0,0,34,0,0,40,14,0,64,0,0,0
10710,84,2020-11-18T16:20:36.8435923Z,2019,45,15,32,16,0,3ro,1,0,29,0,0,30,13,0,44,0,0,0
10710,85,2020-11-18T16:20:36.8435923Z,2019,72,23,59,34,0,4to,3,0,38,0,0,49,13,0,69,0,0,0
10710,86,2020-11-18T16:20:36.8435923Z,2019,62,18,53,38,0,5to,1,0,24,0,0,44,9,0,61,0,0,0
10710,87,2020-11-18T16:20:36.8445928Z,2019,63,19,50,26,0,K,0,0,37,0,0,44,13,0,63,0,0,0
10710,88,2020-11-18T16:20:36.8445928Z,2019,15,14,8,4,0,Sin Grado,0,0,11,0,0,1,7,0,15,0,0,0
16220,30656,2021-06-24T13:18:10.6540888Z,2021,37,10,32,21,0,1ro,0,0,16,0,0,27,5,0,36,0,0,1
16220,30657,2021-06-24T13:18:10.6540888Z,2021,41,11,35,16,0,2do,0,0,25,0,0,30,6,0,40,1,0,1
16220,30658,2021-06-24T13:18:10.6550902Z,2021,52,12,44,30,0,3ro,0,0,22,0,0,40,8,0,52,0,0,0
16220,30659,2021-06-24T13:18:10.6550902Z,2021,47,13,37,25,0,4to,1,0,22,0,0,34,10,0,46,0,0,0
16220,30660,2021-06-24T13:18:10.6550902Z,2021,44,10,35,21,0,5to,0,0,23,0,0,34,9,0,44,0,0,0
16220,30661,2021-06-24T13:18:10.6550902Z,2021,34,1,26,17,0,K,0,0,17,0,0,33,8,0,34,0,0,0
16220,30662,2021-06-24T13:18:10.6560903Z,2021,2,2,1,1,0,Sin Grado,0,0,1,0,0,0,1,0,2,0,0,0
16220,658,2020-11-18T16:20:41.1884895Z,2019,56,15,48,35,0,1ro,0,0,21,0,0,41,8,0,56,0,0,0
16220,659,2020-11-18T16:20:41.1884895Z,2019,52,17,38,25,0,2do,0,1,27,0,0,35,14,0,52,0,0,0
16220,660,2020-11-18T16:20:41.1884895Z,2019,47,11,37,22,0,3ro,0,2,25,0,0,36,10,0,47,0,0,0
16220,661,2020-11-18T16:20:41.1894895Z,2019,60,11,47,31,0,4to,1,0,29,0,0,49,13,0,59,0,0,0
16220,662,2020-11-18T16:20:41.1894895Z,2019,75,14,55,40,0,5to,0,2,35,0,0,61,20,0,75,0,1,0
16220,663,2020-11-18T16:20:41.1894895Z,2019,42,9,38,18,0,K,0,1,24,0,0,33,4,0,42,1,0,0
16220,664,2020-11-18T16:20:41.1894895Z,2019,2,2,1,1,0,Sin Grado,0,0,1,0,0,0,1,0,2,0,0,0
16220,6658,2020-11-18T16:21:40.7582143Z,2020,47,12,41,19,0,1ro,0,0,28,0,0,35,6,0,47,1,0,0
16220,6659,2020-11-18T16:21:40.7582143Z,2020,62,14,48,33,0,2do,0,1,29,0,0,48,14,0,62,0,0,0
16220,6660,2020-11-18T16:21:40.7582143Z,2020,56,19,42,29,0,3ro,0,1,27,0,0,37,14,0,56,0,0,0
16220,6661,2020-11-18T16:21:40.7582143Z,2020,48,11,41,22,0,4to,0,3,26,0,0,37,7,0,48,0,0,0
16220,6662,2020-11-18T16:21:40.7592148Z,2020,59,10,42,29,0,5to,1,2,30,0,0,49,17,0,58,0,0,0
16220,6663,2020-11-18T16:21:40.7592148Z,2020,44,10,35,24,0,K,0,0,20,0,0,34,9,0,43,0,0,1
16220,6664,2020-11-18T16:21:40.7592148Z,2020,2,2,1,1,0,Sin Grado,0,0,1,0,0,0,1,0,2,0,0,0
60038,10113,2020-11-18T16:22:02.694836Z,2020,13,2,6,13,0,10mo,1,0,0,0,0,11,7,0,12,0,0,0
60038,10114,2020-11-18T16:22:02.694836Z,2020,11,0,8,8,0,11mo,1,0,3,0,0,11,3,0,10,0,0,0
60038,10115,2020-11-18T16:22:02.694836Z,2020,9,1,6,8,0,12mo,1,0,1,0,0,8,3,0,8,0,0,0
60038,10116,2020-11-18T16:22:02.6958387Z,2020,13,1,6,13,0,5to,0,0,0,0,0,12,7,0,13,0,0,0
60038,10117,2020-11-18T16:22:02.6958387Z,2020,15,2,4,15,0,6to,0,0,0,0,0,13,11,1,14,0,0,0
60038,10118,2020-11-18T16:22:02.6958387Z,2020,19,1,7,19,0,7mo,0,0,0,0,0,18,12,0,19,0,0,0
60038,10119,2020-11-18T16:22:02.6958387Z,2020,13,1,6,13,0,8vo,0,0,0,0,0,12,7,0,13,0,0,0
60038,10120,2020-11-18T16:22:02.6968373Z,2020,13,3,7,10,0,9no,1,0,3,0,0,10,6,0,12,0,0,0
60038,34130,2021-06-24T13:18:37.4332977Z,2021,10,2,5,7,0,10mo,0,0,3,0,0,8,5,0,10,0,0,0
60038,34131,2021-06-24T13:18:37.4332977Z,2021,12,2,5,12,0,11mo,1,0,0,0,0,10,7,0,11,0,0,0
60038,34132,2021-06-24T13:18:37.4332977Z,2021,10,0,7,8,0,12mo,1,0,2,0,0,10,3,0,9,0,0,0
60038,34133,2021-06-24T13:18:37.4342987Z,2021,7,0,2,7,0,5to,0,0,0,0,0,7,5,0,7,0,0,0
60038,34134,2021-06-24T13:18:37.4342987Z,2021,12,1,7,12,0,6to,0,0,0,0,0,11,5,0,12,0,0,0
60038,34135,2021-06-24T13:18:37.4342987Z,2021,13,3,5,13,0,7mo,0,0,0,0,0,10,8,1,12,0,0,0
60038,34136,2021-06-24T13:18:37.4342987Z,2021,17,1,9,17,0,8vo,0,0,0,0,0,16,8,0,17,0,0,0
60038,34137,2021-06-24T13:18:37.4352996Z,2021,13,1,5,13,0,9no,0,0,0,0,0,12,8,0,13,0,0,0
60038,4095,2020-11-18T16:21:07.3139097Z,2019,9,0,4,8,0,10mo,0,0,1,0,0,9,5,0,9,0,0,0
60038,4096,2020-11-18T16:21:07.3139097Z,2019,11,1,5,10,0,11mo,1,0,1,0,0,10,6,0,10,0,0,0
60038,4097,2020-11-18T16:21:07.3139097Z,2019,14,0,5,11,0,12mo,0,0,3,0,0,14,9,0,14,0,0,0
60038,4098,2020-11-18T16:21:07.3139097Z,2019,11,1,3,11,0,5to,0,1,0,0,0,10,8,1,10,0,0,0
60038,4099,2020-11-18T16:21:07.3149101Z,2019,17,2,8,16,0,6to,0,0,1,0,0,15,9,0,17,0,0,0
60038,4100,2020-11-18T16:21:07.3149101Z,2019,16,3,5,15,0,7mo,0,0,1,0,0,13,11,1,15,0,0,0
60038,4101,2020-11-18T16:21:07.9843589Z,2019,15,4,8,12,0,8vo,1,0,3,0,0,11,7,0,14,0,0,0
60038,4102,2020-11-18T16:21:07.9843589Z,2019,13,3,4,13,0,9no,1,0,0,0,0,10,9,0,12,0,0,0
55475,33841,2021-06-24T13:18:35.7470898Z,2021,36,12,33,17,0,1ro,0,0,19,0,0,24,3,0,36,0,0,0
55475,33842,2021-06-24T13:18:35.7480898Z,2021,30,13,29,13,0,2do,0,0,17,0,0,17,1,0,30,0,0,0
55475,33843,2021-06-24T13:18:35.7480898Z,2021,38,9,35,16,0,3ro,0,1,22,0,0,29,3,0,37,0,0,1
55475,33844,2021-06-24T13:18:35.7480898Z,2021,41,12,35,16,0,4to,0,1,25,0,0,29,6,0,41,2,0,0
55475,33845,2021-06-24T13:18:35.7480898Z,2021,45,19,43,22,0,5to,0,2,23,0,0,26,2,0,45,0,0,0
55475,33846,2021-06-24T13:18:35.7480898Z,2021,25,9,15,12,0,K,1,1,13,0,0,16,10,1,23,0,0,0
55475,3818,2020-11-18T16:21:05.5647417Z,2019,64,22,59,36,0,1ro,1,1,28,0,0,42,5,0,62,0,0,1
55475,3819,2020-11-18T16:21:05.5647417Z,2019,51,16,44,21,0,2do,1,0,30,0,0,35,7,0,50,2,0,0
55475,3820,2020-11-18T16:21:05.5647417Z,2019,55,23,48,25,0,3ro,0,3,30,0,0,32,7,0,55,0,0,0
55475,3821,2020-11-18T16:21:05.5657417Z,2019,59,18,49,26,0,4to,3,2,33,0,0,41,10,0,56,0,1,0
55475,3822,2020-11-18T16:21:05.5657417Z,2019,59,19,57,26,0,5to,0,5,33,0,0,40,2,0,59,0,0,0
55475,3823,2020-11-18T16:21:05.5657417Z,2019,61,23,51,35,0,K,0,1,26,0,0,38,10,0,60,0,0,1
55475,9835,2020-11-18T16:22:00.5183883Z,2020,38,18,32,14,0,1ro,0,1,24,0,0,20,6,0,37,0,0,1
55475,9836,2020-11-18T16:22:00.5193887Z,2020,51,18,44,24,0,2do,0,9,27,0,0,33,7,0,50,0,0,1
55475,9837,2020-11-18T16:22:00.5193887Z,2020,51,17,43,20,0,3ro,1,5,31,0,0,34,8,0,50,2,0,0
55475,9838,2020-11-18T16:22:00.5193887Z,2020,50,22,43,23,0,4to,0,5,27,0,0,28,7,0,50,0,0,0
55475,9839,2020-11-18T16:22:00.5193887Z,2020,55,17,48,23,0,5to,3,3,32,0,0,38,7,0,52,0,1,0
55475,9840,2020-11-18T16:22:00.5193887Z,2020,50,18,43,24,0,K,0,5,26,0,0,32,7,0,50,0,0,0
52704,33616,2021-06-24T13:18:33.6615934Z,2021,26,9,22,10,0,1ro,0,1,16,0,0,17,4,0,26,0,0,0
52704,33617,2021-06-24T13:18:33.6615934Z,2021,25,8,22,11,0,2do,0,1,14,0,0,17,3,0,25,0,0,0
52704,33618,2021-06-24T13:18:33.6615934Z,2021,26,9,23,14,0,3ro,0,7,12,0,0,17,3,0,26,0,0,0
52704,33619,2021-06-24T13:18:33.6625939Z,2021,27,12,25,15,0,4to,0,4,12,0,0,15,2,0,27,0,0,0
52704,33620,2021-06-24T13:18:33.6625939Z,2021,38,11,34,16,0,5to,0,4,22,0,0,27,4,0,38,0,0,0
52704,33621,2021-06-24T13:18:33.6635944Z,2021,18,3,16,13,0,K,0,1,5,0,0,15,2,0,18,0,0,0
52704,3591,2020-11-18T16:21:03.2872301Z,2019,25,8,22,14,0,1ro,0,6,11,0,0,17,3,0,25,0,0,0
52704,3592,2020-11-18T16:21:03.2872301Z,2019,29,11,26,19,0,2do,0,3,10,0,0,18,3,0,29,0,0,0
52704,3593,2020-11-18T16:21:03.2872301Z,2019,43,13,38,19,0,3ro,0,7,24,0,0,30,5,0,43,0,0,0
52704,3594,2020-11-18T16:21:03.2882292Z,2019,34,16,28,14,0,4to,1,4,20,0,0,18,6,0,33,0,0,0
52704,3595,2020-11-18T16:21:03.2882292Z,2019,34,12,28,15,0,5to,0,6,19,0,0,22,6,0,34,0,0,0
52704,3596,2020-11-18T16:21:03.2882292Z,2019,33,8,32,15,0,K,0,3,18,0,0,25,1,0,33,0,0,0
52704,9610,2020-11-18T16:21:59.4856989Z,2020,32,10,28,14,0,1ro,0,4,18,0,0,22,4,0,32,0,0,0
52704,9611,2020-11-18T16:21:59.4856989Z,2020,27,7,22,14,0,2do,0,7,13,0,0,20,5,0,27,0,0,0
52704,9612,2020-11-18T16:21:59.4856989Z,2020,27,12,25,15,0,3ro,0,6,12,0,0,15,2,0,27,0,0,0
52704,9613,2020-11-18T16:21:59.4866993Z,2020,40,13,35,16,0,4to,0,12,24,0,0,27,5,0,40,0,0,0
52704,9614,2020-11-18T16:21:59.4866993Z,2020,38,15,31,16,0,5to,1,7,22,0,0,23,7,0,37,0,0,0
52704,9615,2020-11-18T16:21:59.4866993Z,2020,36,8,30,15,0,K,0,2,21,0,0,28,6,0,36,0,0,0
11908,236,2020-11-18T16:20:38.7728754Z,2019,28,4,22,9,0,1ro,0,0,19,0,0,24,6,0,28,0,0,0
11908,237,2020-11-18T16:20:38.7728754Z,2019,26,10,23,10,0,2do,1,0,16,0,0,16,3,0,25,0,1,0
11908,238,2020-11-18T16:20:38.7728754Z,2019,17,3,16,7,0,3ro,1,0,10,0,0,14,1,0,16,0,0,0
11908,239,2020-11-18T16:20:38.7738763Z,2019,27,9,24,11,0,4to,0,0,16,0,0,18,3,0,27,0,0,0
11908,240,2020-11-18T16:20:38.7738763Z,2019,38,8,31,16,0,5to,0,0,22,0,0,30,7,0,38,0,0,0
11908,241,2020-11-18T16:20:38.7738763Z,2019,23,4,21,11,0,6to,0,0,12,0,0,19,2,0,23,0,0,0
11908,242,2020-11-18T16:20:38.7738763Z,2019,25,1,23,15,0,K,2,0,10,0,0,24,2,0,23,0,0,0
11908,243,2020-11-18T16:20:38.7738763Z,2019,13,2,9,9,0,PK,0,0,4,0,0,11,4,0,13,0,0,0
11908,244,2020-11-18T16:20:38.7748767Z,2019,3,3,3,3,0,Sin Grado,0,0,0,0,0,0,0,0,3,0,0,0
11908,30236,2021-06-24T13:18:07.1035433Z,2021,26,2,24,18,0,1ro,0,0,8,0,0,24,2,0,26,0,0,0
11908,30237,2021-06-24T13:18:07.1035433Z,2021,35,2,33,23,0,2do,2,0,12,0,0,33,2,0,33,0,0,0
11908,30238,2021-06-24T13:18:07.1035433Z,2021,30,6,28,9,0,3ro,0,0,21,0,0,24,2,0,30,0,0,0
11908,30239,2021-06-24T13:18:07.1035433Z,2021,33,12,32,14,0,4to,1,0,19,0,0,21,1,0,32,0,1,0
11908,30240,2021-06-24T13:18:07.1045438Z,2021,24,4,21,9,0,5to,1,0,15,0,0,20,3,0,23,0,0,0
11908,30241,2021-06-24T13:18:07.1045438Z,2021,32,9,30,14,0,6to,0,0,18,0,0,23,2,0,32,0,0,0
11908,30242,2021-06-24T13:18:07.1045438Z,2021,23,1,18,10,0,K,0,0,13,0,0,22,5,0,23,0,0,0
11908,30243,2021-06-24T13:18:07.1045438Z,2021,13,2,13,5,0,PK,0,0,8,0,0,11,0,0,13,0,0,0
11908,30244,2021-06-24T13:18:07.1055452Z,2021,4,4,4,3,0,Sin Grado,0,0,1,0,0,0,0,0,4,0,0,0
11908,6238,2020-11-18T16:21:38.6327951Z,2020,28,2,25,19,0,1ro,2,0,9,0,0,26,3,0,26,0,0,0
11908,6239,2020-11-18T16:21:38.6327951Z,2020,26,4,23,6,0,2do,0,0,20,0,0,22,3,0,26,0,0,0
11908,6240,2020-11-18T16:21:38.6337956Z,2020,25,9,23,10,0,3ro,1,0,15,0,0,16,2,0,24,0,1,0
11908,6241,2020-11-18T16:21:38.6337956Z,2020,19,3,19,8,0,4to,1,0,11,0,0,16,0,0,18,0,0,0
11908,6242,2020-11-18T16:21:38.6337956Z,2020,29,9,26,11,0,5to,0,0,18,0,0,20,3,0,29,0,0,0
11908,6243,2020-11-18T16:21:38.6337956Z,2020,34,8,31,14,0,6to,0,0,20,0,0,26,3,0,34,0,0,0
11908,6244,2020-11-18T16:21:38.6337956Z,2020,18,2,15,12,0,K,0,0,6,0,0,16,3,0,18,0,0,0
11908,6245,2020-11-18T16:21:38.6347951Z,2020,15,0,10,7,0,PK,0,0,8,0,0,15,5,0,15,0,0,0
11908,6246,2020-11-18T16:21:38.6347951Z,2020,3,3,3,3,0,Sin Grado,0,0,0,0,0,0,0,0,3,0,0,0
70292,10959,2020-11-18T16:22:07.2178541Z,2020,41,13,41,29,0,1ro,2,1,12,0,0,28,0,0,39,0,0,0
70292,10960,2020-11-18T16:22:07.2178541Z,2020,41,11,38,20,0,2do,2,1,21,0,0,30,3,0,38,0,0,1
70292,10961,2020-11-18T16:22:07.218855Z,2020,45,20,38,15,0,3ro,1,0,30,0,0,25,7,0,44,0,0,0
70292,10962,2020-11-18T16:22:07.218855Z,2020,65,25,57,31,0,4to,0,0,34,0,0,40,8,0,65,0,0,0
70292,10963,2020-11-18T16:22:07.218855Z,2020,38,18,37,22,0,5to,0,2,16,0,0,20,1,0,38,0,0,0
70292,10964,2020-11-18T16:22:07.218855Z,2020,33,9,30,15,0,K,0,0,18,0,0,24,3,0,33,0,0,0
70292,34980,2021-06-24T13:18:43.3435353Z,2021,49,13,45,26,0,1ro,0,0,23,0,0,36,4,0,49,0,0,0
70292,34981,2021-06-24T13:18:43.3445362Z,2021,42,14,41,25,0,2do,2,0,17,0,0,28,1,0,40,0,0,0
70292,34982,2021-06-24T13:18:43.3445362Z,2021,52,14,43,25,0,3ro,2,0,27,0,0,38,9,0,49,0,0,1
70292,34983,2021-06-24T13:18:43.3445362Z,2021,48,20,39,18,0,4to,1,0,30,0,0,28,9,0,47,0,0,0
70292,34984,2021-06-24T13:18:43.3445362Z,2021,70,24,56,36,0,5to,0,0,34,0,0,46,14,0,70,0,0,0
70292,34985,2021-06-24T13:18:43.3455372Z,2021,51,18,47,25,0,K,1,0,26,0,0,33,4,0,50,0,0,0
70292,4951,2020-11-18T16:21:13.0177141Z,2019,51,18,47,25,0,1ro,3,1,26,0,0,33,4,0,47,0,0,1
70292,4952,2020-11-18T16:21:13.0177141Z,2019,38,14,33,11,0,2do,0,0,27,0,0,24,5,0,38,0,0,0
70292,4953,2020-11-18T16:21:13.0177141Z,2019,64,28,55,28,0,3ro,0,2,36,0,0,36,9,0,64,0,0,0
70292,4954,2020-11-18T16:21:13.0177141Z,2019,42,18,41,25,0,4to,0,1,17,0,0,24,1,0,42,0,0,0
70292,4955,2020-11-18T16:21:13.0187149Z,2019,54,19,45,29,0,5to,0,2,25,0,0,35,9,0,54,1,0,0
70292,4956,2020-11-18T16:21:13.0187149Z,2019,48,15,48,30,0,K,1,0,18,0,0,33,0,0,47,0,0,0
10314,11,2020-11-18T16:20:36.6854877Z,2019,20,9,18,10,0,1ro,0,0,10,0,0,11,2,0,20,0,0,0
10314,12,2020-11-18T16:20:36.6854877Z,2019,41,22,33,19,0,2do,0,0,22,0,0,19,8,0,41,0,0,0
10314,13,2020-11-18T16:20:36.6854877Z,2019,23,13,19,10,0,3ro,0,0,13,0,0,10,4,0,23,0,0,0
10314,14,2020-11-18T16:20:36.6864895Z,2019,35,18,25,18,0,4to,1,0,17,0,0,17,10,0,34,0,0,0
10314,15,2020-11-18T16:20:36.6864895Z,2019,32,12,24,16,0,5to,0,0,16,0,0,20,8,0,32,0,0,0
10314,16,2020-11-18T16:20:36.6864895Z,2019,23,8,18,12,0,K,0,0,11,0,0,15,5,0,23,0,0,0
10314,17,2020-11-18T16:20:36.6864895Z,2019,18,5,15,10,0,PK,0,0,8,0,0,13,3,0,18,0,0,0
10314,30011,2021-06-24T13:18:05.8956779Z,2021,36,7,32,20,0,1ro,1,0,16,0,0,29,4,0,35,0,0,0
10314,30012,2021-06-24T13:18:05.8966779Z,2021,22,13,20,13,0,2do,0,0,9,0,0,9,2,0,22,0,0,0
10314,30013,2021-06-24T13:18:05.8966779Z,2021,17,7,14,6,0,3ro,1,0,11,0,0,10,3,0,16,0,0,0
10314,30014,2021-06-24T13:18:05.8966779Z,2021,35,15,29,16,0,4to,0,0,19,0,0,20,6,0,35,0,0,0
10314,30015,2021-06-24T13:18:05.8966779Z,2021,24,12,21,13,0,5to,0,0,11,0,0,12,3,0,24,0,0,0
10314,30016,2021-06-24T13:18:05.8976798Z,2021,26,6,18,11,0,K,0,0,15,0,0,20,8,0,26,0,0,0
10314,30017,2021-06-24T13:18:05.8976798Z,2021,15,2,9,5,0,PK,0,0,10,0,0,13,6,0,15,0,0,0
10314,6012,2020-11-18T16:21:37.6761548Z,2020,23,8,21,12,0,1ro,0,0,11,0,0,15,2,0,23,0,0,0
10314,6013,2020-11-18T16:21:37.6761548Z,2020,26,11,22,10,0,2do,2,0,16,0,0,15,4,0,24,0,0,0
10314,6014,2020-11-18T16:21:37.6771548Z,2020,37,17,32,16,0,3ro,0,0,21,0,0,20,5,0,37,0,0,0
10314,6015,2020-11-18T16:21:37.6771548Z,2020,24,13,19,13,0,4to,0,0,11,0,0,11,5,0,24,0,0,0
10314,6016,2020-11-18T16:21:37.6771548Z,2020,34,18,23,18,0,5to,1,0,16,0,0,16,11,0,33,0,0,0
10314,6017,2020-11-18T16:21:37.6771548Z,2020,36,6,31,15,0,K,3,0,21,0,0,30,5,0,33,0,0,0
10314,6018,2020-11-18T16:21:37.6771548Z,2020,14,3,12,5,0,PK,0,0,9,0,0,11,2,0,14,0,0,0
61416,10226,2020-11-18T16:22:03.12012Z,2020,111,28,58,53,0,1ro,0,0,58,0,0,83,53,0,111,0,0,0
61416,10227,2020-11-18T16:22:03.12012Z,2020,114,28,62,52,0,2do,3,0,62,0,0,86,52,1,108,0,0,2
61416,10228,2020-11-18T16:22:03.12012Z,2020,114,35,65,48,0,3ro,4,1,66,0,0,79,49,1,108,0,0,1
61416,10229,2020-11-18T16:22:03.12012Z,2020,113,37,57,52,0,4to,5,0,61,0,0,76,56,0,108,0,0,0
61416,10230,2020-11-18T16:22:03.12012Z,2020,117,26,56,55,0,5to,6,0,62,0,0,91,61,0,111,0,1,0
61416,10231,2020-11-18T16:22:03.1211213Z,2020,98,24,55,41,0,K,1,0,57,0,0,74,43,0,97,0,0,0
61416,10232,2020-11-18T16:22:03.1211213Z,2020,2,2,2,0,0,Sin Grado,0,0,2,0,0,0,0,0,2,0,0,0
61416,34242,2021-06-24T13:18:38.0637503Z,2021,94,23,61,39,0,1ro,0,0,55,0,0,71,33,0,94,0,0,0
61416,34243,2021-06-24T13:18:38.0647503Z,2021,107,27,72,49,0,2do,1,0,58,0,0,80,35,0,106,0,0,0
61416,34244,2021-06-24T13:18:38.0647503Z,2021,123,35,78,59,0,3ro,1,0,64,0,0,88,45,1,120,0,0,1
61416,34245,2021-06-24T13:18:38.0657517Z,2021,109,35,64,48,0,4to,3,0,61,0,0,74,45,1,105,0,0,0
61416,34246,2021-06-24T13:18:38.0657517Z,2021,116,40,75,55,0,5to,5,0,61,0,0,76,41,0,111,0,0,0
61416,34247,2021-06-24T13:18:38.0657517Z,2021,88,24,60,33,0,K,2,0,55,0,0,64,28,0,86,0,0,0
61416,34248,2021-06-24T13:18:38.0667522Z,2021,5,5,2,0,0,Sin Grado,0,0,5,0,0,0,3,0,5,0,0,0
61416,4211,2020-11-18T16:21:09.0070393Z,2019,86,21,45,38,0,1ro,1,0,48,0,0,65,41,0,85,0,0,0
61416,4212,2020-11-18T16:21:09.0080402Z,2019,111,37,67,47,0,2do,3,0,64,0,0,74,44,1,106,0,0,1
61416,4213,2020-11-18T16:21:09.0080402Z,2019,104,30,58,47,0,3ro,4,0,57,0,0,74,46,0,100,0,0,0
61416,4214,2020-11-18T16:21:09.0080402Z,2019,123,35,62,52,0,4to,5,0,71,0,0,88,61,0,118,0,1,0
61416,4215,2020-11-18T16:21:09.0090415Z,2019,121,24,65,58,0,5to,4,0,63,0,0,97,56,0,117,2,0,0
61416,4216,2020-11-18T16:21:09.0090415Z,2019,83,19,49,39,0,K,0,0,44,0,0,64,34,0,83,0,0,0
61416,4217,2020-11-18T16:21:09.0090415Z,2019,5,5,3,0,0,Sin Grado,0,0,5,0,0,0,2,0,5,0,0,0
43224,2848,2020-11-18T16:20:59.1914912Z,2019,22,7,19,9,0,1ro,0,0,13,0,0,15,3,0,22,0,0,0
43224,2849,2020-11-18T16:20:59.1924935Z,2019,31,16,28,12,0,2do,2,0,19,0,0,15,3,0,29,0,0,0
43224,2850,2020-11-18T16:20:59.1924935Z,2019,24,8,20,14,0,3ro,1,0,10,0,0,16,4,0,23,0,0,0
43224,2851,2020-11-18T16:20:59.1924935Z,2019,49,25,44,17,0,4to,3,0,32,0,0,24,5,0,46,0,0,0
43224,2852,2020-11-18T16:20:59.1924935Z,2019,55,25,48,21,0,5to,2,0,34,0,0,30,7,0,53,0,0,0
43224,2853,2020-11-18T16:20:59.1934917Z,2019,137,44,110,63,0,6to,3,0,74,0,0,93,27,0,134,0,0,0
43224,2854,2020-11-18T16:20:59.1934917Z,2019,132,50,108,60,0,7mo,4,0,72,0,0,82,24,0,128,0,2,0
43224,2855,2020-11-18T16:20:59.1934917Z,2019,133,36,101,66,0,8vo,2,0,67,0,0,97,32,0,131,0,1,0
43224,2856,2020-11-18T16:20:59.1934917Z,2019,27,13,22,17,0,K,0,0,10,0,0,14,5,0,27,0,0,0
43224,2857,2020-11-18T16:20:59.1934917Z,2019,43,40,40,17,0,Sin Grado,1,0,26,0,0,3,3,0,42,0,2,0
43224,32856,2021-06-24T13:18:28.1986755Z,2021,21,8,18,8,0,1ro,0,0,13,0,0,13,3,0,21,0,0,0
43224,32857,2021-06-24T13:18:28.1986755Z,2021,23,8,20,14,0,2do,0,0,9,0,0,15,3,0,23,0,0,0
43224,32858,2021-06-24T13:18:28.1986755Z,2021,17,6,15,6,0,3ro,0,0,11,0,0,11,2,0,17,0,0,0
43224,32859,2021-06-24T13:18:28.1986755Z,2021,17,8,13,5,0,4to,0,0,12,0,0,9,4,0,17,0,0,0
43224,32860,2021-06-24T13:18:28.1996769Z,2021,20,9,14,11,0,5to,2,0,9,0,0,11,6,0,18,0,0,0
43224,32861,2021-06-24T13:18:28.1996769Z,2021,80,38,70,35,0,6to,2,0,45,0,0,42,10,0,78,0,0,0
43224,32862,2021-06-24T13:18:28.1996769Z,2021,99,37,79,42,0,7mo,1,0,57,0,0,62,20,0,97,1,0,1
43224,32863,2021-06-24T13:18:28.1996769Z,2021,113,38,92,54,0,8vo,3,0,59,0,0,75,21,0,110,0,1,0
43224,32864,2021-06-24T13:18:28.1996769Z,2021,26,11,16,9,0,K,0,0,17,0,0,15,10,0,26,0,0,0
43224,32865,2021-06-24T13:18:28.200677Z,2021,23,23,15,9,0,Sin Grado,2,0,14,0,0,0,8,0,21,0,1,0
43224,8860,2020-11-18T16:21:54.2321953Z,2020,22,9,19,14,0,1ro,0,0,8,0,0,13,3,0,22,0,0,0
43224,8861,2020-11-18T16:21:54.2321953Z,2020,16,5,10,4,0,2do,0,0,12,0,0,11,6,0,16,0,0,0
43224,8862,2020-11-18T16:21:54.2321953Z,2020,26,12,22,10,0,3ro,2,0,16,0,0,14,4,0,24,0,0,0
43224,8863,2020-11-18T16:21:54.2331958Z,2020,22,10,19,11,0,4to,2,0,11,0,0,12,3,0,20,0,0,0
43224,8864,2020-11-18T16:21:54.2331958Z,2020,52,26,50,19,0,5to,2,0,33,0,0,26,2,0,50,0,0,0
43224,8865,2020-11-18T16:21:54.2331958Z,2020,89,32,77,37,0,6to,1,0,52,0,0,57,12,0,87,1,0,1
43224,8866,2020-11-18T16:21:54.2331958Z,2020,130,44,108,60,0,7mo,5,0,70,0,0,86,22,0,125,0,2,0
43224,8867,2020-11-18T16:21:54.2331958Z,2020,81,28,64,36,0,8vo,1,0,45,0,0,53,17,0,80,0,0,0
43224,8868,2020-11-18T16:21:54.2341966Z,2020,28,14,23,12,0,K,0,0,16,0,0,14,5,0,28,0,0,0
43224,8869,2020-11-18T16:21:54.2341966Z,2020,45,45,44,19,0,Sin Grado,1,0,26,0,0,0,1,0,44,0,2,0
23515,1373,2020-11-18T16:20:45.8986303Z,2019,25,9,22,13,0,1ro,0,0,12,0,0,16,3,0,25,0,0,0
23515,1374,2020-11-18T16:20:45.8986303Z,2019,26,11,22,10,0,2do,1,0,16,0,0,15,4,0,25,0,0,0
23515,1375,2020-11-18T16:20:45.8986303Z,2019,31,9,30,16,0,3ro,0,0,15,0,0,22,1,0,31,0,0,0
23515,1376,2020-11-18T16:20:45.8996303Z,2019,33,15,26,13,0,4to,0,0,20,0,0,18,7,0,33,0,0,0
23515,1377,2020-11-18T16:20:45.8996303Z,2019,29,8,26,17,0,5to,0,0,12,0,0,21,3,0,29,0,0,0
23515,1378,2020-11-18T16:20:45.8996303Z,2019,25,12,19,9,0,K,0,0,16,0,0,13,6,0,25,0,0,0
23515,1379,2020-11-18T16:20:45.8996303Z,2019,35,34,28,9,0,Sin Grado,0,0,26,0,0,1,7,0,35,0,0,0
23515,31374,2021-06-24T13:18:14.6319423Z,2021,22,10,18,8,0,1ro,0,0,14,0,0,12,4,0,22,0,0,0
23515,31375,2021-06-24T13:18:14.6329423Z,2021,21,11,18,5,0,2do,0,0,16,0,0,10,3,0,21,0,0,0
23515,31376,2021-06-24T13:18:14.6329423Z,2021,25,12,23,12,0,3ro,0,0,13,0,0,13,2,0,25,0,0,0
23515,31377,2021-06-24T13:18:14.6329423Z,2021,23,9,20,8,0,4to,1,0,15,0,0,14,3,0,22,0,0,0
23515,31378,2021-06-24T13:18:14.6329423Z,2021,36,11,34,20,0,5to,0,0,16,0,0,25,2,0,36,0,0,0
23515,31379,2021-06-24T13:18:14.6339437Z,2021,24,7,15,8,0,K,0,0,16,0,0,17,9,0,24,0,0,0
23515,31380,2021-06-24T13:18:14.6339437Z,2021,26,26,22,3,0,Sin Grado,0,0,23,0,0,0,4,0,26,0,0,0
23515,7377,2020-11-18T16:21:45.3462733Z,2020,25,11,20,9,0,1ro,0,0,16,0,0,14,5,0,25,0,0,0
23515,7378,2020-11-18T16:21:45.3472733Z,2020,27,11,23,12,0,2do,0,0,15,0,0,16,4,0,27,0,0,0
23515,7379,2020-11-18T16:21:45.3472733Z,2020,23,8,18,7,0,3ro,1,0,16,0,0,15,5,0,22,0,0,0
23515,7380,2020-11-18T16:21:45.3472733Z,2020,38,11,34,22,0,4to,1,0,16,0,0,27,4,0,37,0,0,0
23515,7381,2020-11-18T16:21:45.3482742Z,2020,37,16,32,16,0,5to,0,0,21,0,0,21,5,0,37,0,0,0
23515,7382,2020-11-18T16:21:45.3482742Z,2020,25,9,22,13,0,K,0,0,12,0,0,16,3,0,25,0,0,0
23515,7383,2020-11-18T16:21:45.3482742Z,2020,29,29,22,5,0,Sin Grado,1,3,24,0,0,0,7,0,28,0,0,0
45641,3018,2020-11-18T16:21:00.3252479Z,2019,16,6,14,9,0,1ro,0,0,7,0,0,10,2,0,16,0,0,0
45641,3019,2020-11-18T16:21:00.3252479Z,2019,20,7,16,9,0,2do,0,0,11,0,0,13,4,0,20,0,0,0
45641,3020,2020-11-18T16:21:00.3262488Z,2019,14,6,12,4,0,3ro,0,0,10,0,0,8,2,0,14,0,0,0
45641,3021,2020-11-18T16:21:00.3262488Z,2019,16,7,15,7,0,4to,0,0,9,0,0,9,1,0,16,0,0,0
45641,3022,2020-11-18T16:21:00.3262488Z,2019,16,4,12,9,0,5to,0,0,7,0,0,12,4,0,16,0,0,0
45641,3023,2020-11-18T16:21:00.3262488Z,2019,10,2,10,4,0,K,0,0,6,0,0,8,0,0,10,0,0,0
45641,33027,2021-06-24T13:18:29.8108318Z,2021,14,5,13,10,0,1ro,0,0,4,0,0,9,1,0,14,0,0,0
45641,33028,2021-06-24T13:18:29.8108318Z,2021,12,2,10,4,0,2do,0,0,8,0,0,10,2,0,12,0,0,0
45641,33029,2021-06-24T13:18:29.8108318Z,2021,13,4,11,7,0,3ro,0,0,6,0,0,9,2,0,13,0,0,0
45641,33030,2021-06-24T13:18:29.8118332Z,2021,15,4,13,9,0,4to,0,0,6,0,0,11,2,0,15,0,0,0
45641,33031,2021-06-24T13:18:29.8118332Z,2021,13,5,11,5,0,5to,0,0,8,0,0,8,2,0,13,0,0,0
45641,33032,2021-06-24T13:18:29.8118332Z,2021,9,2,6,5,0,K,0,0,4,0,0,7,3,0,9,0,0,0
45641,9032,2020-11-18T16:21:55.4239925Z,2020,12,3,12,4,0,1ro,0,0,8,0,0,9,0,0,12,0,0,0
45641,9033,2020-11-18T16:21:55.4249925Z,2020,14,5,11,9,0,2do,0,0,5,0,0,9,3,0,14,0,0,0
45641,9034,2020-11-18T16:21:55.4249925Z,2020,19,7,12,11,0,3ro,0,0,8,0,0,12,7,0,19,0,0,0
45641,9035,2020-11-18T16:21:55.4249925Z,2020,11,5,9,4,0,4to,0,0,7,0,0,6,2,0,11,0,0,0
45641,9036,2020-11-18T16:21:55.4259934Z,2020,16,7,13,8,0,5to,1,0,8,0,0,9,3,0,15,0,0,0
45641,9037,2020-11-18T16:21:55.4259934Z,2020,19,5,16,11,0,K,0,0,8,0,0,14,3,0,19,0,0,0
61424,10233,2020-11-18T16:22:03.1171178Z,2020,185,183,125,77,0,Sin Grado,7,20,108,0,0,2,60,0,178,0,0,0
61424,34249,2021-06-24T13:18:38.0627489Z,2021,169,169,116,70,0,Sin Grado,6,18,99,0,0,0,53,0,163,0,0,0
61424,4218,2020-11-18T16:21:09.0060389Z,2019,196,182,124,84,0,Sin Grado,7,15,112,0,0,14,72,0,189,0,0,0
30916,1879,2020-11-18T16:20:52.4870242Z,2019,40,12,31,21,0,1ro,0,1,19,0,0,28,9,0,40,0,0,0
30916,1880,2020-11-18T16:20:52.4870242Z,2019,46,16,38,25,0,2do,0,1,21,0,0,30,8,0,46,1,0,0
30916,1881,2020-11-18T16:20:52.4870242Z,2019,48,17,34,28,0,3ro,0,0,20,0,0,31,14,0,48,1,0,0
30916,1882,2020-11-18T16:20:52.4870242Z,2019,53,15,41,30,0,4to,0,2,23,0,0,38,12,0,53,0,0,0
30916,1883,2020-11-18T16:20:52.4870242Z,2019,46,13,37,26,0,5to,0,2,20,0,0,33,9,0,46,0,0,0
30916,1884,2020-11-18T16:20:52.4880242Z,2019,37,8,27,18,0,K,0,0,19,0,0,29,10,0,37,0,0,0
30916,1885,2020-11-18T16:20:52.4880242Z,2019,4,4,1,1,1,Sin Grado,0,1,3,0,0,0,3,0,4,0,0,0
30916,31884,2021-06-24T13:18:17.778197Z,2021,40,6,34,26,0,1ro,2,0,14,0,0,34,6,0,38,0,0,0
30916,31885,2021-06-24T13:18:17.778197Z,2021,52,16,41,24,0,2do,0,1,28,0,0,36,11,0,52,0,0,0
30916,31886,2021-06-24T13:18:17.7791979Z,2021,49,12,39,26,0,3ro,0,1,23,0,0,37,10,0,49,0,0,0
30916,31887,2021-06-24T13:18:17.7791979Z,2021,52,19,47,26,0,4to,0,0,26,0,0,33,5,0,52,1,0,0
30916,31888,2021-06-24T13:18:17.7791979Z,2021,49,16,36,29,0,5to,0,0,20,0,0,33,13,0,49,1,0,0
30916,31889,2021-06-24T13:18:17.7791979Z,2021,39,12,34,21,0,K,0,0,18,0,0,27,5,1,38,0,0,0
30916,31890,2021-06-24T13:18:17.7791979Z,2021,5,5,5,2,0,Sin Grado,0,0,3,0,0,0,0,0,5,0,0,0
30916,7887,2020-11-18T16:21:48.4853629Z,2020,49,12,37,22,0,1ro,0,0,27,0,0,37,12,0,49,0,0,0
30916,7888,2020-11-18T16:21:48.4853629Z,2020,39,8,31,19,0,2do,1,0,20,0,0,31,8,0,38,0,0,0
30916,7889,2020-11-18T16:21:48.4853629Z,2020,48,19,38,25,0,3ro,0,0,23,0,0,29,10,0,48,1,0,0
30916,7890,2020-11-18T16:21:48.4863633Z,2020,49,18,34,28,0,4to,0,0,21,0,0,31,15,0,49,1,0,0
30916,7891,2020-11-18T16:21:48.4863633Z,2020,56,12,41,32,0,5to,0,0,24,0,0,44,15,0,56,0,0,0
30916,7892,2020-11-18T16:21:48.4863633Z,2020,40,7,30,24,0,K,0,0,16,0,0,33,10,0,40,0,0,0
30916,7893,2020-11-18T16:21:48.4863633Z,2020,5,5,1,4,0,Sin Grado,0,0,1,0,0,0,4,0,5,0,0,0
71779,11439,2020-11-18T16:22:10.5680892Z,2020,190,40,155,102,0,10mo,0,1,88,0,0,150,35,0,190,0,0,0
71779,11440,2020-11-18T16:22:10.5680892Z,2020,142,35,105,69,0,11mo,0,0,73,0,0,107,37,0,142,1,0,0
71779,11441,2020-11-18T16:22:10.5680892Z,2020,115,15,75,58,0,12mo,0,0,57,0,0,100,40,0,115,2,0,0
71779,11442,2020-11-18T16:22:10.5690897Z,2020,168,38,139,84,0,9no,1,0,84,0,0,130,29,0,167,0,0,0
71779,35461,2021-06-24T13:18:46.2356095Z,2021,104,20,91,59,0,10mo,2,0,45,0,0,84,13,0,101,0,0,1
71779,35462,2021-06-24T13:18:46.2356095Z,2021,102,13,87,78,0,11mo,0,0,24,0,0,89,15,0,102,0,0,0
71779,35463,2021-06-24T13:18:46.23661Z,2021,170,38,132,91,0,12mo,0,0,79,0,0,132,38,0,170,1,0,0
71779,5430,2020-11-18T16:21:15.4743482Z,2019,157,37,119,76,0,10mo,0,1,81,0,0,120,38,0,157,1,0,0
71779,5431,2020-11-18T16:21:15.4743482Z,2019,114,19,76,57,0,11mo,0,0,57,0,1,95,38,0,114,2,0,0
71779,5432,2020-11-18T16:21:15.4753491Z,2019,129,0,93,70,0,12mo,1,0,59,0,0,129,36,0,128,0,0,0
71779,5433,2020-11-18T16:21:15.4753491Z,2019,220,44,176,120,0,9no,0,0,100,0,0,176,44,0,220,0,0,0
61432,10234,2020-11-18T16:22:03.1241231Z,2020,19,5,15,13,0,1ro,6,0,6,0,0,14,4,0,13,0,0,0
61432,10235,2020-11-18T16:22:03.1241231Z,2020,15,8,15,9,0,2do,3,0,6,0,0,7,0,0,12,1,0,0
61432,10236,2020-11-18T16:22:03.1241231Z,2020,16,4,15,9,0,3ro,2,0,7,0,0,12,1,0,14,0,0,0
61432,10237,2020-11-18T16:22:03.1241231Z,2020,21,10,20,9,0,4to,2,0,12,0,0,11,1,0,19,0,0,0
61432,10238,2020-11-18T16:22:03.1241231Z,2020,32,10,30,15,0,5to,9,0,17,0,0,22,2,0,22,1,0,1
61432,10239,2020-11-18T16:22:03.1251236Z,2020,52,19,48,25,0,6to,4,0,27,0,0,33,4,0,48,1,0,0
61432,10240,2020-11-18T16:22:03.1251236Z,2020,71,18,66,36,0,7mo,12,0,35,0,0,53,5,0,58,1,1,1
61432,10241,2020-11-18T16:22:03.1251236Z,2020,51,18,45,27,0,8vo,6,0,24,0,0,33,6,0,45,1,0,0
61432,10242,2020-11-18T16:22:03.1251236Z,2020,12,1,11,7,0,K,2,0,5,0,0,11,1,0,10,0,0,0
61432,34250,2021-06-24T13:18:38.0737579Z,2021,13,2,11,5,0,1ro,3,0,8,0,0,11,2,0,10,0,0,0
61432,34251,2021-06-24T13:18:38.0747584Z,2021,20,7,20,12,0,2do,5,0,8,0,0,13,0,0,15,0,0,0
61432,34252,2021-06-24T13:18:38.0747584Z,2021,14,8,13,9,0,3ro,1,0,5,0,0,6,1,0,13,1,0,0
61432,34253,2021-06-24T13:18:38.0747584Z,2021,12,4,12,5,0,4to,1,0,7,0,0,8,0,0,11,0,0,0
61432,34254,2021-06-24T13:18:38.0757593Z,2021,17,9,15,10,0,5to,3,0,7,0,0,8,2,0,14,0,0,0
61432,34255,2021-06-24T13:18:38.0757593Z,2021,44,15,42,21,0,6to,7,0,23,0,0,29,2,0,36,1,0,1
61432,34256,2021-06-24T13:18:38.0757593Z,2021,45,17,39,21,0,7mo,3,0,24,0,0,28,6,0,42,1,0,0
61432,34257,2021-06-24T13:18:38.0767594Z,2021,63,17,59,30,0,8vo,12,0,33,0,0,46,4,0,50,1,1,1
61432,34258,2021-06-24T13:18:38.0767594Z,2021,5,1,4,1,0,K,0,0,4,0,0,4,1,0,5,0,0,0
61432,4219,2020-11-18T16:21:09.0120419Z,2019,21,8,20,12,0,1ro,5,0,9,0,0,13,1,0,16,1,0,0
61432,4220,2020-11-18T16:21:09.0120419Z,2019,18,6,16,10,0,2do,1,0,8,0,0,12,2,0,17,0,0,0
61432,4221,2020-11-18T16:21:09.0120419Z,2019,26,10,25,13,0,3ro,5,0,13,0,0,16,1,0,21,1,0,0
61432,4222,2020-11-18T16:21:09.0130428Z,2019,31,11,28,15,0,4to,7,0,16,0,0,20,3,0,23,1,0,1
61432,4223,2020-11-18T16:21:09.0130428Z,2019,26,10,24,15,0,5to,3,0,11,0,0,16,2,0,23,1,0,0
61432,4224,2020-11-18T16:21:09.0130428Z,2019,58,16,52,34,0,6to,13,0,24,0,0,42,6,0,44,2,1,1
61432,4225,2020-11-18T16:21:09.0130428Z,2019,45,16,37,23,0,7mo,7,0,22,0,0,29,8,0,38,1,0,0
61432,4226,2020-11-18T16:21:09.0140446Z,2019,59,16,50,30,0,8vo,15,0,29,0,0,43,9,0,44,0,0,0
61432,4227,2020-11-18T16:21:09.0140446Z,2019,22,5,20,16,0,K,2,0,6,0,0,17,2,0,20,0,0,0
52761,33622,2021-06-24T13:18:33.6655959Z,2021,15,3,13,8,0,1ro,0,0,7,0,0,12,2,0,15,0,0,0
52761,33623,2021-06-24T13:18:33.6655959Z,2021,14,3,9,8,0,2do,0,0,6,0,0,11,5,0,14,0,0,0
52761,33624,2021-06-24T13:18:33.6655959Z,2021,20,2,14,14,0,3ro,0,0,6,0,0,18,6,0,20,0,0,0
52761,33625,2021-06-24T13:18:33.6665964Z,2021,13,5,8,8,0,4to,0,0,5,0,0,8,5,0,13,0,0,0
52761,33626,2021-06-24T13:18:33.6665964Z,2021,21,5,16,4,0,5to,0,0,17,0,0,16,5,0,19,0,1,2
52761,33627,2021-06-24T13:18:33.6675977Z,2021,22,5,17,12,0,K,0,0,10,0,0,17,5,0,22,0,0,0
52761,3597,2020-11-18T16:21:03.2882292Z,2019,24,3,17,13,0,1ro,0,0,11,0,0,21,7,0,24,0,0,0
52761,3598,2020-11-18T16:21:03.2882292Z,2019,20,6,14,8,0,2do,0,1,12,0,0,14,6,0,20,0,0,0
52761,3599,2020-11-18T16:21:03.2882292Z,2019,20,4,16,5,0,3ro,0,0,15,0,0,16,4,0,19,0,2,1
52761,3600,2020-11-18T16:21:03.2892274Z,2019,16,3,12,7,0,4to,0,0,9,0,0,13,4,0,16,0,1,0
52761,3601,2020-11-18T16:21:04.3099073Z,2019,23,3,21,16,0,5to,0,1,7,0,0,20,2,0,23,0,1,0
52761,3602,2020-11-18T16:21:04.3099073Z,2019,20,4,16,11,0,K,0,0,9,0,0,16,4,0,20,0,0,0
52761,9616,2020-11-18T16:21:59.4877002Z,2020,14,3,9,5,0,1ro,0,2,9,0,0,11,5,0,14,1,0,0
52761,9617,2020-11-18T16:21:59.4877002Z,2020,24,3,15,15,0,2do,0,0,9,0,0,21,9,0,24,0,0,0
52761,9618,2020-11-18T16:21:59.4877002Z,2020,14,3,11,8,0,3ro,0,2,6,0,0,11,3,0,14,0,0,0
52761,9619,2020-11-18T16:21:59.4887007Z,2020,22,5,18,5,0,4to,0,1,17,0,0,17,4,0,21,1,1,1
52761,9620,2020-11-18T16:21:59.4887007Z,2020,11,4,8,4,0,5to,0,0,7,0,0,7,3,0,11,0,0,0
52761,9621,2020-11-18T16:21:59.4887007Z,2020,20,2,16,10,0,K,0,0,10,0,0,18,4,0,20,0,0,0
43406,2911,2020-11-18T16:20:59.9039672Z,2019,45,15,34,20,0,10mo,0,0,25,0,0,30,11,0,45,0,0,0
43406,2912,2020-11-18T16:20:59.9039672Z,2019,31,8,26,17,0,11mo,0,0,14,0,0,23,5,0,31,0,0,0
43406,2913,2020-11-18T16:20:59.9039672Z,2019,39,0,31,18,0,12mo,0,0,21,0,0,39,8,0,39,0,0,0
43406,2914,2020-11-18T16:20:59.9049676Z,2019,50,12,38,14,0,6to,0,0,36,0,0,38,12,0,50,0,0,0
43406,2915,2020-11-18T16:20:59.9049676Z,2019,42,17,35,21,0,7mo,0,0,21,0,0,25,7,0,42,0,0,0
43406,2916,2020-11-18T16:20:59.9049676Z,2019,55,16,44,25,0,8vo,0,0,30,0,0,39,11,0,55,0,0,0
43406,2917,2020-11-18T16:20:59.9059685Z,2019,56,19,48,21,0,9no,0,0,35,0,0,37,8,0,56,0,0,0
43406,2918,2020-11-18T16:20:59.9059685Z,2019,2,2,2,0,0,Sin Grado,0,0,2,0,0,0,0,0,2,0,0,0
43406,32920,2021-06-24T13:18:28.8661548Z,2021,33,11,28,14,0,10mo,0,0,19,0,0,22,5,0,33,0,0,0
43406,32921,2021-06-24T13:18:28.8671553Z,2021,43,16,32,16,0,11mo,0,0,27,0,0,27,11,0,43,0,0,0
43406,32922,2021-06-24T13:18:28.8671553Z,2021,31,6,24,16,0,12mo,0,0,15,0,0,25,7,0,30,0,0,1
43406,32923,2021-06-24T13:18:28.8671553Z,2021,32,10,29,13,0,6to,2,0,19,0,0,22,3,0,30,0,1,0
43406,32924,2021-06-24T13:18:28.8671553Z,2021,31,9,25,16,0,7mo,0,0,15,0,0,22,6,0,31,1,1,0
43406,32925,2021-06-24T13:18:28.8671553Z,2021,49,12,40,18,0,8vo,0,0,31,0,0,37,9,0,49,0,0,0
43406,32926,2021-06-24T13:18:28.8681558Z,2021,35,17,28,12,0,9no,0,0,23,0,0,18,7,0,35,0,0,0
43406,32927,2021-06-24T13:18:28.8681558Z,2021,10,10,8,2,0,Sin Grado,0,0,8,0,0,0,2,0,10,0,0,0
43406,8924,2020-11-18T16:21:54.9877002Z,2020,51,18,44,21,0,10mo,0,0,30,0,0,33,7,0,51,0,0,0
43406,8925,2020-11-18T16:21:54.9877002Z,2020,37,8,27,18,0,11mo,0,0,19,0,0,29,10,0,37,0,0,0
43406,8926,2020-11-18T16:21:54.9887007Z,2020,26,6,21,16,0,12mo,0,0,10,0,0,20,5,0,26,0,0,0
43406,8927,2020-11-18T16:21:54.9887007Z,2020,45,11,39,23,0,6to,1,0,22,0,0,34,6,0,44,1,1,0
43406,8928,2020-11-18T16:21:54.9887007Z,2020,53,10,41,18,0,7mo,0,0,35,0,0,43,12,0,53,0,0,0
43406,8929,2020-11-18T16:21:54.9887007Z,2020,46,18,38,22,0,8vo,0,0,24,0,0,28,8,0,46,0,0,0
43406,8930,2020-11-18T16:21:54.9887007Z,2020,45,12,38,20,0,9no,0,0,25,0,0,33,7,0,45,0,0,0
43406,8931,2020-11-18T16:21:54.9897011Z,2020,8,8,8,2,0,Sin Grado,0,0,6,0,0,0,0,0,8,0,0,0
64998,10684,2020-11-18T16:22:05.3686249Z,2020,8,5,5,5,0,10mo,0,0,3,0,0,3,3,0,8,0,0,0
64998,10685,2020-11-18T16:22:05.3686249Z,2020,8,6,4,2,0,11mo,0,0,6,0,0,2,4,0,7,0,0,1
64998,10686,2020-11-18T16:22:05.3686249Z,2020,5,5,2,1,0,12mo,0,0,4,0,0,0,3,0,5,0,0,0
64998,10687,2020-11-18T16:22:05.3696236Z,2020,8,8,5,3,0,1ro,0,0,5,0,0,0,3,0,8,0,0,0
64998,10688,2020-11-18T16:22:05.3696236Z,2020,13,11,9,3,0,2do,0,0,10,0,0,2,4,0,13,0,0,0
64998,10689,2020-11-18T16:22:05.3696236Z,2020,7,7,3,1,0,3ro,1,0,6,0,0,0,4,0,6,0,0,0
64998,10690,2020-11-18T16:22:05.3696236Z,2020,6,6,3,3,0,4to,0,0,3,0,0,0,3,0,5,0,0,1
64998,10691,2020-11-18T16:22:05.3696236Z,2020,14,10,8,7,0,5to,0,0,7,0,0,4,6,0,14,0,0,0
64998,10692,2020-11-18T16:22:05.3706244Z,2020,7,7,2,3,0,6to,0,0,4,0,0,0,5,0,7,0,0,0
64998,10693,2020-11-18T16:22:05.3706244Z,2020,11,9,5,5,0,7mo,0,0,6,0,0,2,6,0,11,0,0,0
64998,10694,2020-11-18T16:22:05.3706244Z,2020,12,9,7,3,0,8vo,0,0,9,0,0,3,5,0,12,0,0,0
64998,10695,2020-11-18T16:22:05.3706244Z,2020,8,7,6,5,0,9no,0,1,3,0,0,1,2,0,8,0,0,0
64998,10696,2020-11-18T16:22:05.3706244Z,2020,10,10,4,4,0,K,0,0,6,0,0,0,6,0,10,0,0,0
64998,10697,2020-11-18T16:22:05.3716244Z,2020,2,1,0,1,0,PK,0,0,1,0,0,1,2,0,2,0,0,0
64998,10698,2020-11-18T16:22:05.3716244Z,2020,12,12,2,5,0,Sin Grado,0,0,7,0,0,0,10,0,11,0,0,1
64998,34701,2021-06-24T13:18:41.45218Z,2021,6,6,3,3,0,10mo,0,0,3,0,0,0,3,0,6,0,0,0
64998,34702,2021-06-24T13:18:41.45218Z,2021,5,3,2,4,0,11mo,0,0,1,0,0,2,3,0,5,0,0,0
64998,34703,2021-06-24T13:18:41.45218Z,2021,9,7,5,2,0,12mo,0,0,7,0,0,2,4,0,8,0,0,1
64998,34704,2021-06-24T13:18:41.4531805Z,2021,6,5,4,1,0,1ro,0,0,5,0,0,1,2,0,6,0,0,0
64998,34705,2021-06-24T13:18:41.4531805Z,2021,8,7,4,3,0,2do,0,0,5,0,0,1,4,0,8,0,0,0
64998,34706,2021-06-24T13:18:41.4531805Z,2021,10,8,6,3,0,3ro,0,0,7,0,0,2,4,0,10,0,0,0
64998,34707,2021-06-24T13:18:41.4531805Z,2021,9,9,5,1,0,4to,1,0,8,0,0,0,4,0,7,0,0,1
64998,34708,2021-06-24T13:18:41.4531805Z,2021,9,7,5,5,0,5to,0,0,4,0,0,2,4,0,8,0,0,1
64998,34709,2021-06-24T13:18:41.4541805Z,2021,13,9,8,7,0,6to,0,0,6,0,0,4,5,0,13,0,0,0
64998,34710,2021-06-24T13:18:41.4541805Z,2021,9,8,2,3,0,7mo,0,0,6,0,0,1,7,0,9,0,0,0
64998,34711,2021-06-24T13:18:41.4541805Z,2021,11,9,7,5,0,8vo,0,0,6,0,0,2,4,0,11,0,0,0
64998,34712,2021-06-24T13:18:41.4541805Z,2021,11,8,7,2,0,9no,0,0,9,0,0,3,4,0,11,0,0,0
64998,34713,2021-06-24T13:18:41.4551823Z,2021,6,5,3,3,0,K,0,0,3,0,0,1,3,0,6,0,0,0
64998,34714,2021-06-24T13:18:41.4551823Z,2021,6,5,2,2,0,PK,0,0,4,0,0,1,4,0,6,0,0,0
64998,34715,2021-06-24T13:18:41.4551823Z,2021,12,12,2,6,0,Sin Grado,0,0,6,0,0,0,10,0,11,0,0,1
64998,4672,2020-11-18T16:21:11.2735496Z,2019,8,6,4,2,0,10mo,0,0,6,0,0,2,4,0,7,0,0,1
64998,4673,2020-11-18T16:21:11.2735496Z,2019,6,6,2,1,0,11mo,0,0,5,0,0,0,4,0,6,0,0,0
64998,4674,2020-11-18T16:21:11.2735496Z,2019,7,0,5,2,0,12mo,0,0,5,0,0,7,2,0,7,0,0,0
64998,4675,2020-11-18T16:21:11.2745496Z,2019,12,11,7,3,0,1ro,0,0,9,0,0,1,5,0,12,0,0,0
64998,4676,2020-11-18T16:21:11.2745496Z,2019,8,7,3,2,0,2do,1,0,6,0,0,1,5,0,7,0,0,0
64998,4677,2020-11-18T16:21:11.2745496Z,2019,5,5,3,2,0,3ro,0,0,3,0,0,0,2,0,4,0,0,1
64998,4678,2020-11-18T16:21:11.2745496Z,2019,9,8,4,5,0,4to,0,0,4,0,0,1,5,0,9,0,0,0
64998,4679,2020-11-18T16:21:11.2745496Z,2019,6,6,2,3,0,5to,0,0,3,0,0,0,4,0,6,0,0,0
64998,4680,2020-11-18T16:21:11.2755501Z,2019,9,8,3,4,0,6to,0,0,5,0,0,1,6,0,9,0,0,0
64998,4681,2020-11-18T16:21:11.2755501Z,2019,11,9,7,3,0,7mo,0,0,8,0,0,2,4,0,11,0,0,0
64998,4682,2020-11-18T16:21:11.2755501Z,2019,6,6,4,4,3,8vo,0,1,2,0,0,0,2,0,6,0,0,0
64998,4683,2020-11-18T16:21:11.2755501Z,2019,11,7,7,7,0,9no,0,0,4,0,0,4,4,0,11,0,0,0
64998,4684,2020-11-18T16:21:11.2755501Z,2019,8,8,3,3,0,K,0,0,5,0,0,0,5,0,8,0,0,0
64998,4685,2020-11-18T16:21:11.2765505Z,2019,4,4,2,0,0,PK,0,0,4,0,0,0,2,0,4,0,0,0
64998,4686,2020-11-18T16:21:11.2765505Z,2019,16,16,3,8,0,Sin Grado,0,0,8,0,0,0,13,0,15,0,0,1
53660,33727,2021-06-24T13:18:35.2527344Z,2021,16,2,16,5,0,1ro,0,2,11,0,0,14,0,0,16,0,0,0
53660,33728,2021-06-24T13:18:35.2537349Z,2021,19,2,14,5,0,2do,4,3,14,0,0,17,5,0,15,0,0,0
53660,33729,2021-06-24T13:18:35.2537349Z,2021,11,1,9,7,0,3ro,0,0,4,0,0,10,2,0,11,0,0,0
53660,33730,2021-06-24T13:18:35.2537349Z,2021,9,5,9,4,0,4to,0,0,5,0,0,4,0,0,9,0,0,0
53660,33731,2021-06-24T13:18:35.2547358Z,2021,12,6,11,7,0,5to,0,2,5,0,0,6,1,0,12,0,0,0
53660,33732,2021-06-24T13:18:35.2547358Z,2021,14,2,14,10,0,6to,0,2,4,0,0,12,0,0,14,0,0,0
53660,33733,2021-06-24T13:18:35.2547358Z,2021,16,4,13,8,0,7mo,1,0,8,0,0,12,3,0,15,0,0,0
53660,33734,2021-06-24T13:18:35.2557363Z,2021,20,7,17,9,0,8vo,0,2,11,0,0,13,3,0,20,0,0,0
53660,33735,2021-06-24T13:18:35.2567372Z,2021,13,0,10,10,0,K,0,2,3,0,0,13,3,0,13,0,0,0
53660,3703,2020-11-18T16:21:05.1034337Z,2019,6,1,5,4,0,1ro,0,0,2,0,0,5,1,0,6,0,0,0
53660,3704,2020-11-18T16:21:05.1044342Z,2019,13,5,13,5,0,2do,0,0,8,0,0,8,0,0,13,0,0,0
53660,3705,2020-11-18T16:21:05.1044342Z,2019,13,7,12,6,0,3ro,0,2,7,0,0,6,1,0,13,0,0,0
53660,3706,2020-11-18T16:21:05.1044342Z,2019,12,3,12,7,0,4to,0,1,5,0,0,9,0,0,12,0,0,0
53660,3707,2020-11-18T16:21:05.1044342Z,2019,10,3,10,5,0,5to,0,0,5,0,0,7,0,0,10,0,0,0
53660,3708,2020-11-18T16:21:05.1044342Z,2019,19,3,18,7,0,6to,0,4,12,0,0,16,1,0,19,0,0,0
53660,3709,2020-11-18T16:21:05.1054346Z,2019,15,5,15,7,0,7mo,0,3,8,0,0,10,0,0,15,0,0,0
53660,3710,2020-11-18T16:21:05.1054346Z,2019,9,3,9,5,0,8vo,0,3,4,0,0,6,0,0,9,0,0,0
53660,3711,2020-11-18T16:21:05.1054346Z,2019,15,1,14,4,0,K,1,2,11,0,0,14,1,0,14,0,0,0
53660,9721,2020-11-18T16:22:00.1131178Z,2020,15,2,14,5,0,1ro,1,2,10,0,0,13,1,0,14,0,0,0
53660,9722,2020-11-18T16:22:00.1131178Z,2020,10,3,9,6,0,2do,0,0,4,0,0,7,1,0,10,0,0,0
53660,9723,2020-11-18T16:22:00.1131178Z,2020,8,4,7,4,0,3ro,0,0,4,0,0,4,1,0,8,0,0,0
53660,9724,2020-11-18T16:22:00.1141187Z,2020,12,7,11,6,0,4to,0,3,6,0,0,5,1,0,12,0,0,0
53660,9725,2020-11-18T16:22:00.1141187Z,2020,13,2,13,8,0,5to,0,2,5,0,0,11,0,0,13,0,0,0
53660,9726,2020-11-18T16:22:00.1141187Z,2020,13,4,13,6,0,6to,0,0,7,0,0,9,0,0,13,0,0,0
53660,9727,2020-11-18T16:22:00.1151195Z,2020,18,6,17,7,0,7mo,0,2,11,0,0,12,1,0,18,0,0,0
53660,9728,2020-11-18T16:22:00.1151195Z,2020,15,6,14,7,0,8vo,0,4,8,0,0,9,1,0,15,0,0,0
53660,9729,2020-11-18T16:22:00.1151195Z,2020,16,2,16,4,0,K,0,1,12,0,0,14,0,0,16,0,0,0
17764,30763,2021-06-24T13:18:11.1934758Z,2021,94,31,85,50,0,6to,3,0,44,0,0,63,9,0,91,1,0,0
17764,30764,2021-06-24T13:18:11.1934758Z,2021,92,33,78,50,0,7mo,2,0,42,0,0,59,14,0,90,0,0,0
17764,30765,2021-06-24T13:18:11.1944768Z,2021,114,53,97,51,0,8vo,3,0,63,0,0,61,17,0,111,0,1,0
17764,6766,2020-11-18T16:21:41.4416686Z,2020,103,34,87,53,0,6to,3,0,50,0,0,69,16,0,100,0,0,0
17764,6767,2020-11-18T16:21:41.4416686Z,2020,123,50,101,54,0,7mo,3,0,69,0,0,73,22,0,120,0,0,0
17764,6768,2020-11-18T16:21:41.4416686Z,2020,119,48,98,55,0,8vo,2,0,64,0,0,71,21,0,117,0,0,0
17764,765,2020-11-18T16:20:42.1131045Z,2019,123,49,103,52,0,6to,4,0,71,0,0,74,20,0,119,0,0,0
17764,766,2020-11-18T16:20:42.1131045Z,2019,119,52,99,60,0,7mo,1,0,59,0,0,67,20,0,118,0,1,0
17764,767,2020-11-18T16:20:42.1141054Z,2019,111,31,92,60,0,8vo,1,0,51,0,0,80,19,0,110,0,1,0
35493,2331,2020-11-18T16:20:55.7271829Z,2019,104,27,84,51,0,6to,0,0,53,0,0,77,20,0,104,2,0,0
35493,2332,2020-11-18T16:20:55.7281842Z,2019,81,19,70,37,0,7mo,1,1,44,0,0,62,11,0,80,2,0,0
35493,2333,2020-11-18T16:20:55.7281842Z,2019,81,29,72,35,0,8vo,1,0,46,0,0,52,9,0,80,1,0,0
35493,2334,2020-11-18T16:20:55.7281842Z,2019,12,10,10,3,0,Sin Grado,0,0,9,0,0,2,2,0,12,0,0,0
35493,32338,2021-06-24T13:18:23.3001566Z,2021,98,21,86,47,0,6to,1,0,51,0,0,77,12,0,97,0,1,0
35493,32339,2021-06-24T13:18:23.3001566Z,2021,148,40,124,66,0,7mo,0,1,82,0,0,108,24,0,147,0,0,1
35493,32340,2021-06-24T13:18:23.3011579Z,2021,122,40,92,60,0,8vo,1,1,62,0,0,82,30,0,121,3,1,0
35493,32341,2021-06-24T13:18:23.3011579Z,2021,21,21,16,3,0,Sin Grado,1,0,18,0,0,0,5,0,20,0,0,0
35493,8343,2020-11-18T16:21:51.3973053Z,2020,133,44,110,62,0,6to,0,0,71,0,0,89,23,0,132,1,0,1
35493,8344,2020-11-18T16:21:51.3973053Z,2020,116,39,100,54,0,7mo,1,0,62,0,0,77,16,0,115,3,1,0
35493,8345,2020-11-18T16:21:51.3973053Z,2020,86,18,65,42,0,8vo,2,0,44,0,0,68,21,0,84,2,0,0
35493,8346,2020-11-18T16:21:51.3973053Z,2020,16,15,12,2,0,Sin Grado,1,0,14,0,0,1,4,0,15,0,0,0
45682,3024,2020-11-18T16:21:00.3232466Z,2019,189,67,149,88,0,10mo,3,0,101,0,0,122,40,0,186,0,0,0
45682,3025,2020-11-18T16:21:00.3242466Z,2019,176,56,138,99,0,11mo,3,0,77,0,0,120,38,0,173,3,2,0
45682,3026,2020-11-18T16:21:00.3242466Z,2019,209,0,146,97,0,12mo,2,0,112,0,3,209,63,0,207,0,2,0
45682,3027,2020-11-18T16:21:00.3242466Z,2019,196,71,158,104,0,9no,0,0,92,0,0,125,38,0,196,1,0,0
45682,33033,2021-06-24T13:18:29.8108318Z,2021,203,63,168,93,0,10mo,1,0,110,0,0,140,35,0,202,1,1,0
45682,33034,2021-06-24T13:18:29.8118332Z,2021,170,51,137,94,0,11mo,1,0,76,0,0,119,33,0,169,1,0,0
45682,33035,2021-06-24T13:18:29.8118332Z,2021,160,52,126,74,0,12mo,3,0,86,0,0,108,34,0,157,0,0,0
45682,33036,2021-06-24T13:18:29.8118332Z,2021,173,58,144,84,0,9no,1,0,89,0,0,115,29,0,172,2,0,0
45682,33037,2021-06-24T13:18:29.8118332Z,2021,7,7,7,4,0,Sin Grado,0,0,3,0,0,0,0,0,7,0,0,0
45682,9038,2020-11-18T16:21:55.4239925Z,2020,187,64,147,98,0,10mo,1,0,89,0,0,123,40,0,186,1,0,0
45682,9039,2020-11-18T16:21:55.4249925Z,2020,171,62,127,79,0,11mo,4,0,92,0,0,109,44,0,167,0,0,0
45682,9040,2020-11-18T16:21:55.4249925Z,2020,162,50,125,92,0,12mo,3,0,70,0,0,112,37,0,159,3,2,0
45682,9041,2020-11-18T16:21:55.4249925Z,2020,204,65,169,95,0,9no,1,0,109,0,0,139,35,0,203,1,1,0
32227,2001,2020-11-18T16:20:53.8839516Z,2019,126,31,108,62,0,6to,0,0,64,0,0,95,18,1,125,0,0,0
32227,2002,2020-11-18T16:20:53.8839516Z,2019,137,38,110,59,0,7mo,1,0,78,0,0,99,27,0,136,1,0,0
32227,2003,2020-11-18T16:20:53.884952Z,2019,152,32,124,83,0,8vo,1,0,69,0,0,120,28,1,150,1,0,0
32227,2004,2020-11-18T16:20:53.884952Z,2019,7,7,5,0,0,Sin Grado,0,0,7,0,0,0,2,0,7,0,0,0
32227,32008,2021-06-24T13:18:20.0678397Z,2021,141,34,118,70,0,6to,2,0,71,0,0,107,23,0,139,0,0,0
32227,32009,2021-06-24T13:18:20.0688406Z,2021,133,26,113,66,0,7mo,3,0,67,0,0,107,20,0,130,0,0,0
32227,32010,2021-06-24T13:18:20.0688406Z,2021,121,28,100,57,0,8vo,1,0,64,0,0,93,21,0,120,0,0,0
32227,32011,2021-06-24T13:18:20.0688406Z,2021,8,8,4,0,0,Sin Grado,1,0,8,0,0,0,4,0,7,0,0,0
32227,8012,2020-11-18T16:21:49.546071Z,2020,126,24,107,69,0,6to,2,0,57,0,0,102,19,0,124,0,0,0
32227,8013,2020-11-18T16:21:49.5470719Z,2020,115,29,96,56,0,7mo,0,0,59,0,0,86,19,1,114,0,0,0
32227,8014,2020-11-18T16:21:49.5470719Z,2020,146,37,118,62,0,8vo,3,0,84,0,0,109,28,0,143,1,0,0
32227,8015,2020-11-18T16:21:49.5470719Z,2020,10,10,7,0,0,Sin Grado,0,0,10,0,0,0,3,0,10,0,0,0
54247,33757,2021-06-24T13:18:35.2617402Z,2021,15,4,13,7,0,1ro,0,0,8,0,0,11,2,0,15,0,0,0
54247,33758,2021-06-24T13:18:35.2627416Z,2021,32,15,32,14,0,2do,2,0,18,0,0,17,0,0,30,0,0,0
54247,33759,2021-06-24T13:18:35.2627416Z,2021,34,15,33,18,0,3ro,0,0,16,0,0,19,1,0,34,0,0,0
54247,33760,2021-06-24T13:18:35.2627416Z,2021,39,15,37,21,0,4to,1,0,18,0,0,24,2,0,38,0,0,0
54247,33761,2021-06-24T13:18:35.263742Z,2021,32,14,29,13,0,5to,1,0,19,0,0,18,3,0,31,0,0,0
54247,33762,2021-06-24T13:18:35.263742Z,2021,18,5,17,11,0,K,0,0,7,0,0,13,1,0,18,0,0,0
54247,33763,2021-06-24T13:18:35.2647425Z,2021,3,3,2,1,0,PK,0,0,2,0,0,0,1,0,3,0,0,0
54247,3734,2020-11-18T16:21:05.1104386Z,2019,37,18,33,19,0,1ro,0,1,18,0,0,19,4,0,37,0,0,0
54247,3735,2020-11-18T16:21:05.1104386Z,2019,43,22,37,22,0,2do,1,1,21,0,0,21,6,0,42,0,0,0
54247,3736,2020-11-18T16:21:05.1104386Z,2019,45,20,38,23,0,3ro,1,3,22,0,0,25,7,0,44,0,0,0
54247,3737,2020-11-18T16:21:05.1104386Z,2019,43,16,39,21,0,4to,0,0,22,0,0,27,4,0,43,0,0,0
54247,3738,2020-11-18T16:21:05.1104386Z,2019,25,9,22,10,0,5to,0,0,15,0,0,16,3,0,25,0,0,0
54247,3739,2020-11-18T16:21:05.1114391Z,2019,25,13,22,11,0,K,0,0,14,0,0,12,3,0,25,0,0,0
54247,3740,2020-11-18T16:21:05.1114391Z,2019,6,6,6,1,0,PK,0,0,5,0,0,0,0,0,6,0,0,0
54247,9751,2020-11-18T16:22:00.1181209Z,2020,36,17,31,15,0,1ro,2,0,21,0,0,19,5,0,34,0,0,0
54247,9752,2020-11-18T16:22:00.1181209Z,2020,39,18,38,20,0,2do,0,2,19,0,0,21,1,0,39,0,0,0
54247,9753,2020-11-18T16:22:00.1181209Z,2020,45,19,39,25,0,3ro,1,1,20,0,0,26,6,0,44,0,0,0
54247,9754,2020-11-18T16:22:00.1191218Z,2020,41,18,35,19,0,4to,0,0,22,0,0,23,6,0,41,0,0,0
54247,9755,2020-11-18T16:22:00.1191218Z,2020,43,15,40,17,0,5to,1,2,26,0,0,28,3,0,42,0,0,0
54247,9756,2020-11-18T16:22:00.1191218Z,2020,33,8,29,17,0,K,0,1,16,0,0,25,4,0,33,0,0,0
54247,9757,2020-11-18T16:22:00.1191218Z,2020,5,5,4,2,0,PK,0,0,3,0,0,0,1,0,5,0,0,0
35360,2324,2020-11-18T16:20:55.7271829Z,2019,51,18,38,24,0,1ro,1,0,27,0,0,33,13,0,50,1,0,0
35360,2325,2020-11-18T16:20:55.7271829Z,2019,50,9,35,26,0,2do,0,0,24,0,0,41,15,0,50,0,0,0
35360,2326,2020-11-18T16:20:55.7271829Z,2019,66,22,46,30,0,3ro,1,0,36,0,0,44,20,0,65,0,0,0
35360,2327,2020-11-18T16:20:55.7281842Z,2019,62,16,49,30,0,4to,1,0,32,0,0,46,13,0,61,0,1,0
35360,2328,2020-11-18T16:20:55.7281842Z,2019,53,13,43,25,0,5to,2,0,28,0,0,40,10,0,51,0,0,0
35360,2329,2020-11-18T16:20:55.7281842Z,2019,56,14,41,26,0,K,0,0,30,0,0,42,15,0,56,0,0,0
35360,2330,2020-11-18T16:20:55.7291838Z,2019,2,2,2,1,0,Sin Grado,0,0,1,0,0,0,0,0,2,0,0,0
35360,32331,2021-06-24T13:18:23.2821436Z,2021,54,13,48,19,0,1ro,0,0,35,0,0,41,6,1,53,0,0,0
35360,32332,2021-06-24T13:18:23.2821436Z,2021,50,12,39,20,0,2do,0,0,30,0,0,38,11,0,50,0,0,0
35360,32333,2021-06-24T13:18:23.2821436Z,2021,52,14,45,23,0,3ro,0,0,29,0,0,38,7,0,52,1,0,0
35360,32334,2021-06-24T13:18:23.2821436Z,2021,48,8,40,26,0,4to,0,0,22,0,0,40,8,0,48,1,0,0
35360,32335,2021-06-24T13:18:23.2831446Z,2021,58,13,48,30,0,5to,1,0,28,0,0,45,10,0,57,0,0,0
35360,32336,2021-06-24T13:18:23.2831446Z,2021,54,14,49,35,0,K,0,0,19,0,0,40,5,0,54,0,0,0
35360,32337,2021-06-24T13:18:23.2831446Z,2021,4,3,3,1,0,Sin Grado,1,0,3,0,0,1,1,0,3,0,0,0
35360,8336,2020-11-18T16:21:51.4003066Z,2020,50,14,39,21,0,1ro,0,0,29,0,0,36,11,0,50,0,0,0
35360,8337,2020-11-18T16:21:51.4003066Z,2020,47,14,30,23,0,2do,0,0,24,0,0,33,17,0,47,1,0,0
35360,8338,2020-11-18T16:21:51.4003066Z,2020,47,10,34,25,0,3ro,0,0,22,0,0,37,13,0,47,1,0,0
35360,8339,2020-11-18T16:21:51.401307Z,2020,54,13,36,26,0,4to,1,0,28,0,0,41,18,0,53,0,0,0
35360,8340,2020-11-18T16:21:51.401307Z,2020,53,12,38,25,0,5to,0,0,28,0,0,41,15,0,53,0,1,0
35360,8341,2020-11-18T16:21:51.401307Z,2020,46,10,34,15,0,K,0,0,31,0,0,36,12,0,46,0,0,0
35360,8342,2020-11-18T16:21:51.402307Z,2020,6,6,6,3,0,Sin Grado,0,0,3,0,0,0,0,0,6,0,0,0
58511,10098,2020-11-18T16:22:01.9573482Z,2020,27,11,24,16,0,10mo,1,1,11,0,0,16,3,0,26,1,0,0
58511,10099,2020-11-18T16:22:01.9583486Z,2020,48,16,45,20,0,11mo,0,2,28,0,0,32,3,0,48,0,0,0
58511,10100,2020-11-18T16:22:01.9583486Z,2020,40,14,35,19,0,12mo,0,0,21,0,0,26,5,0,40,0,0,0
58511,10101,2020-11-18T16:22:02.6798267Z,2020,46,15,41,28,0,9no,1,3,18,0,0,31,5,0,45,0,1,0
58511,34106,2021-06-24T13:18:37.425292Z,2021,32,14,29,19,0,10mo,0,1,13,0,0,18,3,1,31,0,0,0
58511,34107,2021-06-24T13:18:37.425292Z,2021,25,11,22,14,0,11mo,1,0,11,0,0,14,3,0,24,1,0,0
58511,34108,2021-06-24T13:18:37.425292Z,2021,36,15,31,13,0,12mo,0,0,23,0,0,21,5,0,36,0,0,0
58511,34109,2021-06-24T13:18:37.4262929Z,2021,26,11,24,11,0,9no,1,0,15,0,0,15,2,0,25,0,0,0
58511,4080,2020-11-18T16:21:07.3069052Z,2019,61,20,56,26,0,10mo,1,1,35,0,0,41,5,0,60,0,0,0
58511,4081,2020-11-18T16:21:07.3069052Z,2019,47,15,45,22,0,11mo,0,0,25,0,0,32,2,0,47,0,0,0
58511,4082,2020-11-18T16:21:07.3069052Z,2019,56,0,47,33,0,12mo,0,0,23,0,0,56,9,0,56,0,1,0
58511,4083,2020-11-18T16:21:07.3079066Z,2019,43,16,35,27,0,9no,2,1,16,0,0,27,8,0,41,1,0,0
71894,11459,2020-11-18T16:22:10.5830995Z,2020,186,37,149,97,0,10mo,0,0,89,0,0,149,37,0,186,0,0,0
71894,11460,2020-11-18T16:22:10.5840999Z,2020,161,17,132,91,0,11mo,1,0,70,0,0,144,29,0,160,0,0,0
71894,11461,2020-11-18T16:22:10.5840999Z,2020,169,38,134,89,0,12mo,2,0,80,0,0,131,35,0,167,0,0,0
71894,11462,2020-11-18T16:22:10.5840999Z,2020,219,53,184,119,0,9no,3,0,100,0,0,166,35,0,216,0,0,0
71894,11463,2020-11-18T16:22:10.5840999Z,2020,4,4,4,1,0,Sin Grado,0,0,3,0,0,0,0,0,4,0,0,0
71894,35480,2021-06-24T13:18:46.2526224Z,2021,198,42,167,106,0,10mo,4,0,92,0,0,156,31,0,194,0,1,0
71894,35481,2021-06-24T13:18:46.2526224Z,2021,177,32,153,95,0,11mo,1,0,82,0,0,145,24,0,176,0,0,0
71894,35482,2021-06-24T13:18:46.2526224Z,2021,157,16,126,92,0,12mo,1,0,65,0,0,141,31,0,156,0,0,0
71894,35483,2021-06-24T13:18:46.2536233Z,2021,195,45,169,105,0,9no,5,0,90,0,0,150,26,0,190,0,1,0
71894,35484,2021-06-24T13:18:46.2536233Z,2021,5,5,5,1,0,Sin Grado,0,0,4,0,0,0,0,0,5,0,0,0
71894,5450,2020-11-18T16:21:15.482354Z,2019,165,21,140,89,0,10mo,3,0,76,0,1,144,25,0,162,0,0,0
71894,5451,2020-11-18T16:21:15.482354Z,2019,181,42,152,94,0,11mo,2,2,87,0,0,139,29,0,179,0,1,0
71894,5452,2020-11-18T16:21:15.482354Z,2019,189,0,135,88,0,12mo,5,0,101,0,0,189,54,0,184,0,0,0
71894,5453,2020-11-18T16:21:15.482354Z,2019,205,42,171,104,0,9no,2,1,101,0,0,163,34,0,202,0,0,1
56093,33885,2021-06-24T13:18:35.7691042Z,2021,48,12,38,24,0,1ro,0,0,24,0,0,36,10,1,47,0,0,0
56093,33886,2021-06-24T13:18:35.7701051Z,2021,63,27,54,27,0,2do,0,1,36,0,0,36,9,0,63,0,0,0
56093,33887,2021-06-24T13:18:35.7701051Z,2021,55,19,48,22,0,3ro,0,1,33,0,0,36,7,1,54,0,0,0
56093,33888,2021-06-24T13:18:35.7701051Z,2021,52,20,44,29,0,4to,0,0,23,0,0,32,8,0,52,0,0,0
56093,33889,2021-06-24T13:18:35.7701051Z,2021,59,21,50,32,0,5to,0,0,27,0,0,38,9,0,59,0,0,0
56093,33890,2021-06-24T13:18:35.7711056Z,2021,38,6,30,18,0,K,0,0,20,0,0,32,8,0,38,0,0,0
56093,33891,2021-06-24T13:18:35.7711056Z,2021,5,5,5,2,0,Sin Grado,0,0,3,0,0,0,0,0,5,0,0,0
56093,3862,2020-11-18T16:21:05.5817528Z,2019,94,43,75,39,0,1ro,0,7,55,0,0,51,19,0,94,0,2,0
56093,3863,2020-11-18T16:21:05.5817528Z,2019,70,21,50,35,0,2do,1,0,35,0,0,49,20,0,69,0,1,0
56093,3864,2020-11-18T16:21:05.5817528Z,2019,94,40,77,52,0,3ro,0,3,42,0,0,54,17,0,94,0,1,0
56093,3865,2020-11-18T16:21:05.5817528Z,2019,85,28,69,44,0,4to,0,4,41,0,0,57,16,0,85,0,0,0
56093,3866,2020-11-18T16:21:05.5817528Z,2019,99,34,74,49,0,5to,1,6,50,0,0,65,25,0,98,2,0,0
56093,3867,2020-11-18T16:21:05.5827537Z,2019,80,25,56,43,0,K,0,1,37,0,0,55,24,0,80,0,0,0
56093,3868,2020-11-18T16:21:05.5827537Z,2019,5,5,5,3,0,Sin Grado,0,1,2,0,0,0,0,0,5,0,0,0
56093,9879,2020-11-18T16:22:00.5323976Z,2020,83,40,72,40,0,1ro,0,2,43,0,0,43,11,0,83,0,0,0
56093,9880,2020-11-18T16:22:00.5323976Z,2020,71,29,58,26,0,2do,0,2,45,0,0,42,13,0,71,0,1,0
56093,9881,2020-11-18T16:22:00.5333985Z,2020,69,24,54,37,0,3ro,1,0,32,0,0,45,15,0,68,0,0,0
56093,9882,2020-11-18T16:22:00.5333985Z,2020,84,35,70,42,0,4to,0,1,42,0,0,49,14,0,84,0,1,0
56093,9883,2020-11-18T16:22:00.5333985Z,2020,75,26,62,33,0,5to,0,3,42,0,0,49,13,0,75,0,0,0
56093,9884,2020-11-18T16:22:00.5333985Z,2020,69,14,55,32,0,K,0,1,37,0,0,55,14,0,69,0,0,0
56093,9885,2020-11-18T16:22:00.5333985Z,2020,5,5,5,2,0,Sin Grado,0,0,3,0,0,0,0,0,5,0,0,0
58305,10082,2020-11-18T16:22:01.9543464Z,2020,85,28,74,30,0,10mo,0,1,55,0,0,57,11,0,85,1,0,0
58305,10083,2020-11-18T16:22:01.9553464Z,2020,78,21,64,33,0,11mo,3,0,45,0,0,57,14,0,75,1,0,0
58305,10084,2020-11-18T16:22:01.9553464Z,2020,86,25,75,29,0,12mo,1,2,57,0,0,61,11,0,85,3,0,0
58305,10085,2020-11-18T16:22:01.9553464Z,2020,135,42,114,64,0,9no,1,3,71,0,0,93,21,0,134,5,0,0
58305,10086,2020-11-18T16:22:01.9563473Z,2020,31,31,26,6,0,Sin Grado,0,1,25,0,0,0,5,0,31,0,0,0
58305,34090,2021-06-24T13:18:36.9929829Z,2021,110,28,90,48,0,10mo,0,2,62,0,0,82,20,0,110,3,1,0
58305,34091,2021-06-24T13:18:36.9929829Z,2021,64,23,54,23,0,11mo,0,1,41,0,0,41,10,0,64,1,0,0
58305,34092,2021-06-24T13:18:36.9929829Z,2021,70,21,60,29,0,12mo,3,3,41,0,0,49,10,0,67,1,0,0
58305,34093,2021-06-24T13:18:36.993983Z,2021,152,45,120,68,0,9no,0,1,84,0,0,107,32,0,152,1,0,0
58305,34094,2021-06-24T13:18:36.993983Z,2021,15,15,13,4,0,Sin Grado,0,0,11,0,0,0,2,0,15,0,0,0
58305,4064,2020-11-18T16:21:07.3049057Z,2019,93,30,77,36,0,10mo,2,1,57,0,0,63,16,0,91,1,0,0
58305,4065,2020-11-18T16:21:07.3049057Z,2019,93,27,81,30,0,11mo,0,1,63,0,0,66,12,0,93,3,0,0
58305,4066,2020-11-18T16:21:07.3049057Z,2019,62,0,51,27,0,12mo,1,0,35,0,0,62,11,0,61,0,0,0
58305,4067,2020-11-18T16:21:07.3049057Z,2019,107,40,93,38,0,9no,1,1,69,0,0,67,14,0,106,0,0,0
58305,4068,2020-11-18T16:21:07.3059043Z,2019,31,28,27,4,0,Sin Grado,0,1,27,0,0,3,4,0,31,0,0,0
43315,2890,2020-11-18T16:20:59.1984948Z,2019,175,41,126,105,0,10mo,1,0,70,0,0,134,49,0,174,0,0,0
43315,2891,2020-11-18T16:20:59.1984948Z,2019,157,36,102,64,0,11mo,1,0,93,0,0,121,55,0,156,0,1,0
43315,2892,2020-11-18T16:20:59.1994975Z,2019,135,1,95,78,0,12mo,1,0,57,0,0,134,40,0,134,0,0,0
43315,2893,2020-11-18T16:20:59.1994975Z,2019,188,51,127,101,0,9no,2,1,87,0,0,137,61,0,186,1,0,0
43315,32897,2021-06-24T13:18:28.2226937Z,2021,171,43,132,95,0,10mo,2,1,76,0,0,128,39,0,169,0,0,0
43315,32898,2021-06-24T13:18:28.2226937Z,2021,164,44,117,87,0,11mo,4,0,77,0,0,120,47,0,160,1,0,0
43315,32899,2021-06-24T13:18:28.2226937Z,2021,141,34,98,82,0,12mo,1,0,59,0,0,107,43,0,140,0,0,0
43315,32900,2021-06-24T13:18:28.8231233Z,2021,100,36,82,44,0,9no,2,0,56,0,0,64,18,0,98,0,0,0
43315,32901,2021-06-24T13:18:28.8231233Z,2021,19,18,14,8,0,Sin Grado,0,0,11,0,0,1,5,0,19,0,1,0
43315,8902,2020-11-18T16:21:54.9776935Z,2020,172,49,120,94,0,10mo,4,0,78,0,0,123,52,0,168,1,0,0
43315,8903,2020-11-18T16:21:54.9776935Z,2020,149,38,106,87,0,11mo,1,0,62,0,0,111,43,0,148,0,0,0
43315,8904,2020-11-18T16:21:54.9776935Z,2020,137,31,92,62,0,12mo,1,0,75,0,0,106,45,0,136,0,1,0
43315,8905,2020-11-18T16:21:54.9786935Z,2020,172,44,130,93,0,9no,2,0,79,0,0,128,42,0,170,0,0,0
11528,207,2020-11-18T16:20:38.7658709Z,2019,57,15,49,29,0,10mo,0,0,28,0,0,42,8,0,57,0,0,0
11528,208,2020-11-18T16:20:38.7658709Z,2019,53,12,45,19,0,11mo,0,0,34,0,0,41,8,0,53,0,0,0
11528,209,2020-11-18T16:20:38.7658709Z,2019,52,0,36,30,0,12mo,0,0,22,0,0,52,16,0,52,0,0,0
11528,210,2020-11-18T16:20:38.7668714Z,2019,58,19,56,29,0,6to,1,1,29,0,0,39,2,0,57,0,0,0
11528,211,2020-11-18T16:20:38.7668714Z,2019,54,27,50,31,0,7mo,0,0,23,0,0,27,4,0,54,0,0,0
11528,212,2020-11-18T16:20:38.7668714Z,2019,71,19,62,40,0,8vo,0,0,31,0,0,52,9,0,71,0,0,0
11528,213,2020-11-18T16:20:38.7668714Z,2019,62,21,54,28,0,9no,0,0,34,0,0,41,8,0,62,0,0,0
11528,214,2020-11-18T16:20:38.7678723Z,2019,10,9,8,1,0,Sin Grado,0,0,9,0,0,1,2,0,10,0,0,0
11528,30207,2021-06-24T13:18:07.0745228Z,2021,48,12,41,24,0,10mo,0,0,24,0,0,36,7,0,48,0,0,0
11528,30208,2021-06-24T13:18:07.0745228Z,2021,45,19,41,23,0,11mo,1,0,22,0,0,26,4,0,44,0,0,0
11528,30209,2021-06-24T13:18:07.0755237Z,2021,43,11,38,26,0,12mo,0,0,17,0,0,32,5,0,43,0,0,0
11528,30210,2021-06-24T13:18:07.0755237Z,2021,57,19,56,24,0,6to,0,0,33,0,0,38,1,0,57,0,0,0
11528,30211,2021-06-24T13:18:07.0765242Z,2021,64,24,59,28,0,7mo,0,0,36,0,0,40,5,0,64,0,0,0
11528,30212,2021-06-24T13:18:07.0765242Z,2021,62,22,59,35,0,8vo,1,0,27,0,0,40,3,0,61,0,0,0
11528,30213,2021-06-24T13:18:07.0765242Z,2021,63,28,59,32,0,9no,0,0,31,0,0,35,4,0,63,0,0,0
11528,30214,2021-06-24T13:18:07.0775247Z,2021,10,10,8,1,0,Sin Grado,0,0,9,0,0,0,2,0,10,0,0,0
11528,6209,2020-11-18T16:21:38.6227876Z,2020,55,24,46,29,0,10mo,0,0,26,0,0,31,9,0,55,0,0,0
11528,6210,2020-11-18T16:21:38.6237889Z,2020,46,12,39,25,0,11mo,0,0,21,0,0,34,7,0,46,0,0,0
11528,6211,2020-11-18T16:21:38.6237889Z,2020,35,8,31,15,0,12mo,0,0,20,0,0,27,4,0,35,0,0,0
11528,6212,2020-11-18T16:21:38.6237889Z,2020,65,23,58,29,0,6to,0,0,36,0,0,42,7,0,65,0,0,0
11528,6213,2020-11-18T16:21:38.6237889Z,2020,61,22,58,33,0,7mo,1,0,28,0,0,39,3,0,60,0,0,0
11528,6214,2020-11-18T16:21:38.6237889Z,2020,61,26,56,36,0,8vo,0,0,25,0,0,35,5,0,61,0,0,0
11528,6215,2020-11-18T16:21:38.6247889Z,2020,53,13,44,27,0,9no,0,0,26,0,0,40,9,0,53,0,0,0
11528,6216,2020-11-18T16:21:38.6247889Z,2020,11,10,9,2,0,Sin Grado,0,0,9,0,0,1,2,0,11,0,0,0
60905,10184,2020-11-18T16:22:02.7118475Z,2020,169,47,132,98,0,10mo,1,0,71,0,0,122,37,0,168,0,0,0
60905,10185,2020-11-18T16:22:02.7118475Z,2020,151,45,117,79,0,11mo,2,0,72,0,0,106,34,1,148,0,0,0
60905,10186,2020-11-18T16:22:02.7128479Z,2020,131,30,100,60,0,12mo,8,0,71,0,0,101,31,1,122,0,0,0
60905,10187,2020-11-18T16:22:02.7128479Z,2020,133,45,109,64,0,9no,3,0,69,0,0,88,24,0,130,0,0,0
60905,34201,2021-06-24T13:18:38.0357297Z,2021,60,18,55,27,0,10mo,4,0,33,0,0,42,5,0,56,0,0,0
60905,34202,2021-06-24T13:18:38.0357297Z,2021,37,9,32,21,0,11mo,0,0,16,0,0,28,5,0,37,0,0,0
60905,34203,2021-06-24T13:18:38.0357297Z,2021,141,43,109,74,0,12mo,2,0,67,0,0,98,32,1,138,0,0,0
60905,34204,2021-06-24T13:18:38.0357297Z,2021,117,42,100,66,0,9no,7,0,51,0,0,75,17,0,110,0,0,0
60905,4166,2020-11-18T16:21:08.0103749Z,2019,161,47,122,85,0,10mo,4,0,76,0,0,114,39,1,155,0,0,1
60905,4167,2020-11-18T16:21:08.0113758Z,2019,150,34,116,72,0,11mo,7,0,78,0,0,116,34,1,142,0,0,0
60905,4168,2020-11-18T16:21:08.0123776Z,2019,160,2,126,82,0,12mo,5,2,78,0,0,158,34,1,154,0,0,0
60905,4169,2020-11-18T16:21:08.013378Z,2019,178,50,135,102,0,9no,3,1,76,0,0,128,43,0,175,0,0,0
52365,33575,2021-06-24T13:18:33.4174184Z,2021,36,6,33,21,0,1ro,0,0,15,0,0,30,3,0,36,0,0,0
52365,33576,2021-06-24T13:18:33.4174184Z,2021,29,9,29,14,0,2do,0,0,15,0,0,20,0,0,29,0,0,0
52365,33577,2021-06-24T13:18:33.4174184Z,2021,36,12,33,15,0,3ro,0,0,21,0,0,24,3,0,36,0,0,0
52365,33578,2021-06-24T13:18:33.4174184Z,2021,32,11,29,16,0,4to,0,0,16,0,0,21,3,0,32,1,0,0
52365,33579,2021-06-24T13:18:33.4184184Z,2021,37,18,31,13,0,5to,1,0,24,0,0,19,6,0,36,0,0,0
52365,33580,2021-06-24T13:18:33.4184184Z,2021,16,2,16,7,0,K,0,0,9,0,0,14,0,0,16,0,0,0
52365,33581,2021-06-24T13:18:33.4184184Z,2021,6,0,4,3,0,PK,0,0,3,0,0,6,2,0,6,0,0,0
52365,33582,2021-06-24T13:18:33.4194198Z,2021,39,39,36,6,0,Sin Grado,1,0,33,0,0,0,3,0,36,0,0,2
52365,3551,2020-11-18T16:21:03.269215Z,2019,50,16,45,20,0,1ro,1,0,30,0,0,34,5,0,49,0,0,0
52365,3552,2020-11-18T16:21:03.2702149Z,2019,27,7,26,12,0,2do,1,0,15,0,0,20,1,0,26,1,0,0
52365,3553,2020-11-18T16:21:03.2702149Z,2019,56,19,54,22,0,3ro,3,0,34,0,0,37,2,0,53,0,0,0
52365,3554,2020-11-18T16:21:03.2702149Z,2019,45,18,43,19,0,4to,0,0,26,0,0,27,2,0,45,0,0,0
52365,3555,2020-11-18T16:21:03.2702149Z,2019,30,12,27,17,0,5to,1,0,13,0,0,18,3,0,29,0,1,0
52365,3556,2020-11-18T16:21:03.2712163Z,2019,38,8,33,24,0,K,0,0,14,0,0,30,5,0,38,0,0,0
52365,3557,2020-11-18T16:21:03.2712163Z,2019,28,28,25,7,0,Sin Grado,1,0,21,0,0,0,3,0,27,0,0,0
52365,9570,2020-11-18T16:21:59.0974391Z,2020,42,12,39,18,0,1ro,1,3,24,0,0,30,3,0,41,0,0,0
52365,9571,2020-11-18T16:21:59.0974391Z,2020,44,12,38,19,0,2do,1,3,25,0,0,32,6,0,43,0,0,0
52365,9572,2020-11-18T16:21:59.0974391Z,2020,36,15,36,16,0,3ro,0,3,20,0,0,21,0,0,36,1,0,0
52365,9573,2020-11-18T16:21:59.0974391Z,2020,52,23,50,18,0,4to,3,3,34,0,0,29,2,0,49,0,0,0
52365,9574,2020-11-18T16:21:59.0984395Z,2020,40,14,40,18,0,5to,0,0,22,0,0,26,0,0,40,0,0,0
52365,9575,2020-11-18T16:21:59.0984395Z,2020,48,8,42,23,0,K,0,1,25,0,0,40,6,0,48,0,0,0
52365,9576,2020-11-18T16:21:59.0984395Z,2020,44,42,39,10,0,Sin Grado,2,1,34,0,0,2,5,0,41,0,0,1
70094,10901,2020-11-18T16:22:07.1838316Z,2020,86,86,73,37,0,Sin Grado,1,3,49,0,0,0,13,2,82,0,0,1
70094,34923,2021-06-24T13:18:43.3155161Z,2021,92,92,75,37,0,Sin Grado,0,4,55,0,0,0,17,1,90,0,0,1
70094,4893,2020-11-18T16:21:12.4003023Z,2019,87,79,75,40,0,Sin Grado,1,6,47,0,0,8,12,1,84,0,0,1
53579,33717,2021-06-24T13:18:35.2297172Z,2021,18,4,16,6,0,1ro,0,0,12,0,0,14,2,0,18,0,0,0
53579,33718,2021-06-24T13:18:35.2297172Z,2021,15,2,13,9,0,2do,1,0,6,0,0,13,2,0,14,0,0,0
53579,33719,2021-06-24T13:18:35.2307181Z,2021,18,6,17,6,0,3ro,0,0,12,0,0,12,1,0,18,0,0,0
53579,33720,2021-06-24T13:18:35.2307181Z,2021,18,8,15,9,0,4to,0,0,9,0,0,10,3,0,18,0,0,0
53579,33721,2021-06-24T13:18:35.2307181Z,2021,18,4,17,12,0,5to,1,0,6,0,0,14,1,0,17,0,0,0
53579,33722,2021-06-24T13:18:35.2317191Z,2021,17,3,10,8,0,K,1,0,9,0,0,14,7,0,16,0,0,0
53579,33723,2021-06-24T13:18:35.2317191Z,2021,4,4,4,0,0,Sin Grado,0,0,4,0,0,0,0,0,4,0,0,0
53579,3693,2020-11-18T16:21:04.3379249Z,2019,22,5,20,11,0,1ro,0,0,11,0,0,17,2,0,22,0,0,0
53579,3694,2020-11-18T16:21:04.3389254Z,2019,20,13,19,8,0,2do,0,0,12,0,0,7,1,0,20,0,0,0
53579,3695,2020-11-18T16:21:04.3389254Z,2019,24,7,22,12,0,3ro,2,0,12,0,0,17,2,0,22,0,0,0
53579,3696,2020-11-18T16:21:04.3389254Z,2019,23,4,18,13,0,4to,1,0,10,0,0,19,5,0,22,0,0,0
53579,3697,2020-11-18T16:21:04.3389254Z,2019,20,5,19,10,0,5to,2,0,10,0,0,15,1,0,18,0,0,0
53579,3698,2020-11-18T16:21:04.3399258Z,2019,16,3,12,8,0,K,0,0,8,0,0,13,4,0,16,0,0,0
53579,3699,2020-11-18T16:21:04.3399258Z,2019,21,18,17,3,0,Sin Grado,0,0,18,0,0,3,4,0,21,0,0,0
53579,9711,2020-11-18T16:22:00.1111173Z,2020,21,3,17,11,0,1ro,1,1,10,0,0,18,4,0,20,0,0,0
53579,9712,2020-11-18T16:22:00.1111173Z,2020,21,6,19,8,0,2do,0,0,13,0,0,15,2,0,21,0,0,0
53579,9713,2020-11-18T16:22:00.1111173Z,2020,26,13,25,12,0,3ro,0,0,14,0,0,13,1,0,26,0,0,0
53579,9714,2020-11-18T16:22:00.1121173Z,2020,18,5,18,10,0,4to,1,0,8,0,0,13,0,0,17,0,0,0
53579,9715,2020-11-18T16:22:00.1121173Z,2020,23,4,21,12,0,5to,2,0,11,0,0,19,2,0,21,0,0,0
53579,9716,2020-11-18T16:22:00.1121173Z,2020,22,5,18,10,0,K,0,0,12,0,0,17,4,0,22,0,0,0
53579,9717,2020-11-18T16:22:00.1131178Z,2020,15,15,14,4,0,Sin Grado,0,0,11,0,0,0,1,0,15,0,0,0
17384,30696,2021-06-24T13:18:10.9332893Z,2021,183,48,140,87,0,10mo,3,0,96,0,0,135,43,0,180,0,0,0
17384,30697,2021-06-24T13:18:10.9332893Z,2021,173,42,117,92,0,11mo,4,0,81,0,0,131,56,0,169,0,0,0
17384,30698,2021-06-24T13:18:10.9332893Z,2021,164,30,115,74,0,12mo,3,0,90,0,0,134,49,0,161,0,0,0
17384,30699,2021-06-24T13:18:10.9342906Z,2021,176,47,139,94,0,9no,6,0,82,0,0,129,37,0,170,1,0,0
17384,30700,2021-06-24T13:18:11.1564495Z,2021,3,3,3,1,0,Sin Grado,0,0,2,0,0,0,0,0,3,0,0,0
17384,6698,2020-11-18T16:21:40.7722227Z,2020,187,48,121,96,0,10mo,5,0,91,0,0,139,66,0,182,0,0,0
17384,6699,2020-11-18T16:21:40.7722227Z,2020,178,33,117,81,0,11mo,4,0,97,0,0,145,61,0,174,0,0,0
17384,6700,2020-11-18T16:21:40.7722227Z,2020,184,38,138,93,0,12mo,0,0,91,0,0,146,46,0,184,0,0,0
17384,6701,2020-11-18T16:21:41.4246544Z,2020,194,55,148,91,0,9no,2,0,103,0,0,139,46,0,192,0,0,0
17384,6702,2020-11-18T16:21:41.4256553Z,2020,3,3,1,1,0,Sin Grado,0,0,2,0,0,0,2,0,3,0,0,0
17384,697,2020-11-18T16:20:41.5767488Z,2019,181,34,124,80,0,10mo,5,0,101,0,0,147,57,0,176,0,0,0
17384,698,2020-11-18T16:20:41.5767488Z,2019,202,36,152,97,0,11mo,0,0,105,0,0,166,50,0,202,0,1,0
17384,699,2020-11-18T16:20:41.5777497Z,2019,155,0,104,71,0,12mo,1,0,84,0,0,155,51,0,154,0,0,0
17384,700,2020-11-18T16:20:41.5777497Z,2019,206,53,137,100,0,9no,4,0,106,0,0,153,69,0,202,0,1,0
17384,701,2020-11-18T16:20:42.0940917Z,2019,3,3,1,1,0,Sin Grado,0,0,2,0,0,0,2,0,3,0,0,0
11756,226,2020-11-18T16:20:38.7728754Z,2019,56,28,45,29,0,1ro,1,1,27,0,0,28,11,0,55,0,0,0
11756,227,2020-11-18T16:20:38.7728754Z,2019,45,16,39,25,0,2do,0,0,20,0,0,29,6,0,45,0,0,0
11756,228,2020-11-18T16:20:38.7728754Z,2019,61,17,51,32,0,3ro,0,0,29,0,0,44,10,0,61,0,0,0
11756,229,2020-11-18T16:20:38.7738763Z,2019,69,22,54,44,0,4to,1,0,25,0,1,47,15,0,68,0,0,0
11756,230,2020-11-18T16:20:38.7738763Z,2019,54,18,45,26,0,5to,0,0,28,0,0,36,9,0,54,1,0,0
11756,231,2020-11-18T16:20:38.7738763Z,2019,79,25,62,43,0,6to,1,0,36,0,0,54,17,0,78,0,1,0
11756,232,2020-11-18T16:20:38.7738763Z,2019,78,24,53,48,0,7mo,5,0,30,0,0,54,25,0,73,0,1,0
11756,233,2020-11-18T16:20:38.7748767Z,2019,74,17,54,33,0,8vo,1,0,41,0,1,57,20,0,73,1,0,0
11756,234,2020-11-18T16:20:38.7748767Z,2019,50,16,48,26,0,K,0,1,24,0,0,34,2,0,50,0,0,0
11756,235,2020-11-18T16:20:38.7748767Z,2019,14,13,12,3,0,Sin Grado,1,0,11,0,0,1,2,0,13,0,0,0
11756,30226,2021-06-24T13:18:07.0955376Z,2021,37,12,34,15,0,1ro,0,0,22,0,0,25,3,0,37,0,0,0
11756,30227,2021-06-24T13:18:07.0965385Z,2021,44,17,41,21,0,2do,0,0,23,0,0,27,3,0,44,0,0,0
11756,30228,2021-06-24T13:18:07.0965385Z,2021,53,24,42,28,0,3ro,0,0,25,0,0,29,11,0,53,0,0,0
11756,30229,2021-06-24T13:18:07.0965385Z,2021,59,18,49,31,0,4to,0,0,28,0,0,41,10,0,59,0,0,0
11756,30230,2021-06-24T13:18:07.0975395Z,2021,62,16,57,35,0,5to,1,1,27,0,0,46,5,0,61,0,0,0
11756,30231,2021-06-24T13:18:07.0975395Z,2021,88,27,70,54,0,6to,2,1,34,0,0,61,18,0,86,0,0,0
11756,30232,2021-06-24T13:18:07.0985404Z,2021,74,27,60,35,0,7mo,2,0,39,0,0,47,14,0,72,0,0,0
11756,30233,2021-06-24T13:18:07.0985404Z,2021,82,25,65,43,0,8vo,1,0,39,0,0,57,17,0,81,0,0,0
11756,30234,2021-06-24T13:18:07.0985404Z,2021,32,9,22,15,0,K,2,0,17,0,0,23,10,0,29,0,0,1
11756,30235,2021-06-24T13:18:07.0985404Z,2021,12,12,9,3,0,Sin Grado,0,0,9,0,0,0,3,0,12,0,0,0
11756,6228,2020-11-18T16:21:38.6347951Z,2020,49,20,47,24,0,1ro,0,0,25,0,0,29,2,0,49,0,0,0
11756,6229,2020-11-18T16:21:38.6347951Z,2020,53,26,43,28,0,2do,1,0,25,0,0,27,10,0,52,0,0,0
11756,6230,2020-11-18T16:21:38.6357969Z,2020,58,22,51,30,0,3ro,0,1,28,0,0,36,7,0,58,0,0,0
11756,6231,2020-11-18T16:21:38.6357969Z,2020,67,19,58,35,0,4to,1,0,32,0,0,48,9,0,66,0,0,0
11756,6232,2020-11-18T16:21:38.6357969Z,2020,71,21,56,45,0,5to,3,1,26,0,0,50,15,0,68,0,0,0
11756,6233,2020-11-18T16:21:38.6367969Z,2020,79,29,62,39,0,6to,0,0,40,0,0,50,17,0,79,0,0,0
11756,6234,2020-11-18T16:21:38.6367969Z,2020,86,27,71,50,0,7mo,1,0,36,0,0,59,15,0,85,0,0,0
11756,6235,2020-11-18T16:21:38.6367969Z,2020,79,23,60,45,0,8vo,6,0,34,0,0,56,19,0,73,0,1,0
11756,6236,2020-11-18T16:21:38.6377974Z,2020,45,16,44,19,0,K,0,2,26,0,0,29,1,0,45,0,0,0
11756,6237,2020-11-18T16:21:38.6377974Z,2020,14,14,11,3,0,Sin Grado,0,0,11,0,0,0,3,0,14,0,0,0
33340,2164,2020-11-18T16:20:54.6024324Z,2019,92,14,71,44,0,10mo,3,1,48,0,0,78,21,0,89,0,0,0
33340,2165,2020-11-18T16:20:54.6024324Z,2019,115,18,93,69,0,11mo,3,1,46,0,0,97,22,0,112,0,0,0
33340,2166,2020-11-18T16:20:54.603432Z,2019,86,0,61,52,0,12mo,6,3,34,0,0,86,25,0,80,0,0,0
33340,2167,2020-11-18T16:20:54.603432Z,2019,91,11,69,50,0,9no,1,1,41,0,0,80,22,1,89,0,0,0
33340,32170,2021-06-24T13:18:20.9154482Z,2021,114,18,101,63,0,10mo,3,0,51,0,0,96,13,0,111,0,0,0
33340,32171,2021-06-24T13:18:20.9154482Z,2021,66,8,54,38,0,11mo,1,0,28,0,0,58,12,1,64,0,0,0
33340,32172,2021-06-24T13:18:20.9154482Z,2021,78,12,56,41,0,12mo,3,0,37,0,0,66,22,0,75,0,0,0
33340,32173,2021-06-24T13:18:20.9164478Z,2021,97,14,87,57,0,9no,2,0,40,0,0,83,10,0,95,0,0,0
33340,8176,2020-11-18T16:21:50.2325295Z,2020,83,8,62,44,0,10mo,1,4,39,0,0,75,21,1,81,0,0,0
33340,8177,2020-11-18T16:21:50.2325295Z,2020,84,15,64,44,0,11mo,4,6,40,0,0,69,20,0,80,0,0,0
33340,8178,2020-11-18T16:21:50.2325295Z,2020,101,18,83,62,0,12mo,3,10,39,0,0,83,18,0,98,0,0,0
33340,8179,2020-11-18T16:21:50.2325295Z,2020,120,18,95,64,0,9no,3,6,56,0,0,102,25,0,117,0,0,0
51698,33457,2021-06-24T13:18:32.4817472Z,2021,132,36,99,64,0,10mo,0,0,68,0,0,96,33,0,131,0,0,1
51698,33458,2021-06-24T13:18:32.4817472Z,2021,105,27,81,68,0,11mo,0,0,37,0,0,78,24,0,105,0,0,0
51698,33459,2021-06-24T13:18:32.4817472Z,2021,113,34,95,62,0,12mo,0,0,51,0,0,79,18,0,113,0,0,0
51698,33460,2021-06-24T13:18:32.4827477Z,2021,95,30,76,42,0,9no,10,0,53,0,0,65,19,0,85,1,0,0
51698,3433,2020-11-18T16:21:02.5527363Z,2019,150,44,111,77,0,10mo,1,0,73,0,0,106,39,0,149,0,1,0
51698,3434,2020-11-18T16:21:02.5537372Z,2019,158,29,120,94,0,11mo,0,0,64,0,0,129,38,0,158,0,3,0
51698,3435,2020-11-18T16:21:02.5537372Z,2019,158,0,117,90,0,12mo,1,0,68,0,0,158,41,0,157,0,1,0
51698,3436,2020-11-18T16:21:02.5537372Z,2019,103,25,73,65,0,9no,0,1,38,0,0,78,30,0,103,0,0,0
51698,9453,2020-11-18T16:21:58.4199863Z,2020,102,28,73,64,0,10mo,0,0,38,0,0,74,29,0,102,0,0,0
51698,9454,2020-11-18T16:21:58.4199863Z,2020,127,40,101,67,0,11mo,1,0,60,0,0,87,26,0,126,0,1,0
51698,9455,2020-11-18T16:21:58.4209872Z,2020,137,28,102,85,0,12mo,0,0,52,0,0,109,35,0,137,0,3,0
51698,9456,2020-11-18T16:21:58.4209872Z,2020,131,41,90,70,0,9no,0,0,61,0,0,90,41,0,130,0,0,1
63081,10593,2020-11-18T16:22:04.9373339Z,2020,53,17,50,30,0,1ro,0,0,23,0,0,36,3,0,51,0,0,2
63081,10594,2020-11-18T16:22:04.9373339Z,2020,47,20,43,24,0,2do,1,0,23,0,0,27,4,0,46,0,0,0
63081,10595,2020-11-18T16:22:04.9373339Z,2020,45,16,44,24,0,3ro,0,0,21,0,0,29,1,0,45,0,0,0
63081,10596,2020-11-18T16:22:04.9383339Z,2020,36,12,35,15,0,4to,0,0,21,0,0,24,1,0,36,0,0,0
63081,10597,2020-11-18T16:22:04.9383339Z,2020,38,10,37,15,0,5to,2,0,23,0,0,28,1,0,36,0,0,0
63081,10598,2020-11-18T16:22:04.9383339Z,2020,25,8,25,18,0,6to,0,0,7,0,0,17,0,0,25,0,0,0
63081,10599,2020-11-18T16:22:04.9383339Z,2020,37,6,35,17,0,K,0,0,20,0,0,31,2,0,37,0,0,0
63081,10600,2020-11-18T16:22:04.9393352Z,2020,39,5,38,18,0,PK,0,0,21,0,0,34,1,0,38,0,0,1
63081,10601,2020-11-18T16:22:05.3215906Z,2020,15,15,15,5,0,Sin Grado,0,0,10,0,0,0,0,0,15,0,0,0
63081,34608,2021-06-24T13:18:41.0739083Z,2021,37,10,36,20,0,1ro,0,0,17,0,0,27,1,0,37,0,0,0
63081,34609,2021-06-24T13:18:41.0749088Z,2021,55,23,55,27,0,2do,0,0,28,0,0,32,0,0,54,0,0,1
63081,34610,2021-06-24T13:18:41.0749088Z,2021,43,22,39,24,0,3ro,1,0,19,0,0,21,4,0,42,0,0,0
63081,34611,2021-06-24T13:18:41.0759097Z,2021,47,18,47,24,0,4to,0,0,23,0,0,29,0,0,47,0,0,0
63081,34612,2021-06-24T13:18:41.0759097Z,2021,33,9,29,14,0,5to,0,0,19,0,0,24,4,0,33,0,0,0
63081,34613,2021-06-24T13:18:41.0759097Z,2021,43,11,41,20,0,6to,2,0,23,0,0,32,2,0,41,0,0,0
63081,34614,2021-06-24T13:18:41.0759097Z,2021,41,14,40,17,0,K,0,0,24,0,0,27,1,0,41,0,0,0
63081,34615,2021-06-24T13:18:41.0769106Z,2021,29,4,27,14,0,PK,0,0,15,0,0,25,2,0,28,0,0,1
63081,34616,2021-06-24T13:18:41.0769106Z,2021,18,18,16,3,0,Sin Grado,0,0,15,0,0,0,2,0,18,0,0,0
63081,4581,2020-11-18T16:21:10.8462631Z,2019,47,23,45,24,0,1ro,1,1,23,0,0,24,2,0,46,0,0,0
63081,4582,2020-11-18T16:21:10.8462631Z,2019,49,17,49,25,0,2do,0,0,24,0,1,32,0,0,49,0,0,0
63081,4583,2020-11-18T16:21:10.8462631Z,2019,37,13,36,14,0,3ro,0,0,23,0,0,24,1,0,37,0,0,0
63081,4584,2020-11-18T16:21:10.8472649Z,2019,44,14,42,19,0,4to,2,0,25,0,0,30,2,0,42,0,0,0
63081,4585,2020-11-18T16:21:10.8472649Z,2019,28,10,27,17,0,5to,0,0,11,0,1,18,1,0,28,0,0,0
63081,4586,2020-11-18T16:21:10.8472649Z,2019,39,14,38,19,0,6to,0,0,20,0,0,25,1,0,39,0,0,0
63081,4587,2020-11-18T16:21:10.8482648Z,2019,40,8,24,24,0,K,0,0,16,0,0,32,16,0,40,0,0,0
63081,4588,2020-11-18T16:21:10.8482648Z,2019,48,7,44,22,0,PK,0,0,26,0,0,41,4,0,47,0,0,1
63081,4589,2020-11-18T16:21:10.8482648Z,2019,17,16,17,4,0,Sin Grado,0,0,13,0,0,1,0,0,17,0,0,0
71498,11321,2020-11-18T16:22:10.1708241Z,2020,15,9,14,7,0,1ro,0,0,8,0,0,6,1,0,15,0,0,0
71498,11322,2020-11-18T16:22:10.1708241Z,2020,8,1,7,5,0,2do,0,0,3,0,0,7,1,0,8,0,0,0
71498,11323,2020-11-18T16:22:10.1708241Z,2020,18,5,17,8,0,3ro,1,0,10,0,0,13,1,0,17,0,0,0
71498,11324,2020-11-18T16:22:10.1718241Z,2020,11,5,11,4,0,4to,0,0,7,0,0,6,0,0,11,0,0,0
71498,11325,2020-11-18T16:22:10.1718241Z,2020,14,6,13,5,0,5to,0,0,9,0,0,8,1,0,13,0,0,1
71498,11326,2020-11-18T16:22:10.1718241Z,2020,33,14,31,14,0,6to,0,0,19,0,0,19,2,0,33,0,0,0
71498,11327,2020-11-18T16:22:10.1728254Z,2020,48,11,47,29,0,7mo,0,0,19,0,0,37,1,0,48,0,0,0
71498,11328,2020-11-18T16:22:10.1728254Z,2020,38,11,34,25,0,8vo,0,0,13,0,0,27,4,0,38,0,0,0
71498,11329,2020-11-18T16:22:10.1728254Z,2020,17,4,16,11,0,K,0,0,6,0,0,13,1,0,17,0,0,0
71498,11330,2020-11-18T16:22:10.1738263Z,2020,60,58,56,14,0,Sin Grado,0,0,46,0,0,2,4,0,60,0,0,0
71498,35342,2021-06-24T13:18:45.5881459Z,2021,19,4,17,12,0,1ro,0,0,7,0,0,15,2,0,19,0,0,0
71498,35343,2021-06-24T13:18:45.5881459Z,2021,16,10,15,7,0,2do,0,0,9,0,0,6,1,0,16,0,0,0
71498,35344,2021-06-24T13:18:45.5891464Z,2021,9,2,8,5,0,3ro,0,0,4,0,0,7,1,0,9,0,1,0
71498,35345,2021-06-24T13:18:45.5891464Z,2021,19,6,18,8,0,4to,1,0,11,0,0,13,1,0,18,0,0,0
71498,35346,2021-06-24T13:18:45.5891464Z,2021,13,5,10,5,0,5to,0,0,8,0,0,8,3,0,13,0,0,0
71498,35347,2021-06-24T13:18:45.590146Z,2021,23,13,22,8,0,6to,0,0,15,0,0,10,1,0,22,0,0,1
71498,35348,2021-06-24T13:18:45.590146Z,2021,46,18,43,19,0,7mo,0,0,27,0,0,28,3,0,46,0,0,0
71498,35349,2021-06-24T13:18:45.590146Z,2021,50,12,48,31,0,8vo,0,0,19,0,0,38,2,0,50,0,0,0
71498,35350,2021-06-24T13:18:45.590146Z,2021,10,0,8,3,0,K,0,0,7,0,0,10,2,0,10,0,0,0
71498,35351,2021-06-24T13:18:45.5911474Z,2021,45,43,45,9,0,Sin Grado,0,0,36,0,0,2,0,0,45,0,0,0
71498,5316,2020-11-18T16:21:15.0770844Z,2019,21,9,18,8,0,1ro,2,0,13,0,0,12,3,0,19,0,0,0
71498,5317,2020-11-18T16:21:15.0770844Z,2019,14,4,13,9,0,2do,3,0,5,0,0,10,1,0,11,0,1,0
71498,5318,2020-11-18T16:21:15.0780848Z,2019,10,4,10,4,0,3ro,0,0,6,0,0,6,0,0,10,0,0,0
71498,5319,2020-11-18T16:21:15.0780848Z,2019,15,6,14,7,0,4to,0,0,8,0,0,9,1,0,14,0,0,1
71498,5320,2020-11-18T16:21:15.0780848Z,2019,16,8,14,5,0,5to,0,0,11,0,0,8,2,0,16,0,0,0
71498,5321,2020-11-18T16:21:15.0790861Z,2019,41,6,40,22,0,6to,0,0,19,0,0,35,1,0,41,0,0,0
71498,5322,2020-11-18T16:21:15.0790861Z,2019,38,10,32,22,0,7mo,0,0,16,0,0,28,6,0,38,0,0,0
71498,5323,2020-11-18T16:21:15.0790861Z,2019,44,10,40,25,0,8vo,1,0,19,0,0,34,4,0,43,0,0,0
71498,5324,2020-11-18T16:21:15.0800857Z,2019,15,5,14,11,0,K,0,0,4,0,0,10,1,0,15,0,0,0
71498,5325,2020-11-18T16:21:15.0800857Z,2019,72,55,68,16,0,Sin Grado,0,1,56,0,0,17,4,0,72,0,1,0
11387,164,2020-11-18T16:20:37.572074Z,2019,44,11,40,26,0,1ro,0,0,18,0,0,33,4,0,44,0,0,0
11387,165,2020-11-18T16:20:37.572074Z,2019,57,26,45,20,0,2do,2,0,37,0,0,31,12,0,55,0,0,0
11387,166,2020-11-18T16:20:37.572074Z,2019,56,17,45,29,0,3ro,0,0,27,0,0,39,11,0,56,0,0,0
11387,167,2020-11-18T16:20:37.572074Z,2019,62,25,47,32,0,4to,0,0,30,0,0,37,15,0,62,0,0,0
11387,168,2020-11-18T16:20:37.5730753Z,2019,60,26,49,25,0,5to,1,0,35,0,0,34,11,0,59,0,0,0
11387,169,2020-11-18T16:20:37.5730753Z,2019,75,23,55,29,0,6to,0,0,46,0,0,52,20,0,75,0,0,0
11387,170,2020-11-18T16:20:37.5730753Z,2019,74,27,52,40,0,7mo,0,1,34,0,0,47,22,0,74,0,0,0
11387,171,2020-11-18T16:20:37.5730753Z,2019,61,19,45,27,0,8vo,2,0,34,0,0,42,16,0,59,1,0,0
11387,172,2020-11-18T16:20:37.5730753Z,2019,59,14,50,28,0,K,4,0,31,0,0,45,9,0,54,0,1,1
11387,173,2020-11-18T16:20:37.5740766Z,2019,8,8,7,3,0,Sin Grado,0,0,5,0,0,0,1,0,7,0,0,1
11387,30163,2021-06-24T13:18:06.3219827Z,2021,37,12,35,12,0,1ro,0,0,25,0,0,25,2,0,37,0,0,0
11387,30164,2021-06-24T13:18:06.3229845Z,2021,44,9,37,21,0,2do,2,0,23,0,0,35,7,0,42,0,0,0
11387,30165,2021-06-24T13:18:06.3229845Z,2021,47,12,43,31,0,3ro,0,0,16,0,0,35,4,0,46,0,0,1
11387,30166,2021-06-24T13:18:06.3229845Z,2021,62,23,49,26,0,4to,2,0,36,0,0,39,13,0,60,0,0,0
11387,30167,2021-06-24T13:18:06.3229845Z,2021,59,19,48,30,0,5to,2,0,29,0,0,40,11,0,57,0,0,0
11387,30168,2021-06-24T13:18:06.3239841Z,2021,77,32,64,39,0,6to,1,0,38,0,0,45,13,0,76,0,0,0
11387,30169,2021-06-24T13:18:06.3239841Z,2021,63,18,49,27,0,7mo,1,0,36,0,0,45,14,0,62,0,0,0
11387,30170,2021-06-24T13:18:06.3239841Z,2021,83,29,58,34,0,8vo,1,1,49,0,0,54,25,0,82,0,0,0
11387,30171,2021-06-24T13:18:06.3239841Z,2021,28,10,23,14,0,K,0,0,14,0,0,18,5,0,28,0,0,0
11387,30172,2021-06-24T13:18:06.3249846Z,2021,17,17,15,7,0,Sin Grado,0,0,10,0,0,0,2,0,15,0,1,2
11387,6165,2020-11-18T16:21:38.2535407Z,2020,49,9,41,22,0,1ro,2,0,27,0,0,40,8,0,47,0,0,0
11387,6166,2020-11-18T16:21:38.2535407Z,2020,50,15,46,31,0,2do,0,0,19,0,0,35,4,0,50,0,0,0
11387,6167,2020-11-18T16:21:38.2535407Z,2020,62,24,47,25,0,3ro,2,0,37,0,0,38,15,0,60,0,0,0
11387,6168,2020-11-18T16:21:38.2535407Z,2020,61,16,44,32,0,4to,2,0,29,0,0,45,17,0,59,0,0,0
11387,6169,2020-11-18T16:21:38.2535407Z,2020,71,28,55,36,0,5to,0,0,35,0,0,43,16,0,71,0,0,0
11387,6170,2020-11-18T16:21:38.2545411Z,2020,64,21,45,30,0,6to,1,0,34,0,0,43,19,0,63,0,0,0
11387,6171,2020-11-18T16:21:38.2545411Z,2020,90,28,61,37,0,7mo,1,1,53,0,0,62,29,0,89,0,0,0
11387,6172,2020-11-18T16:21:38.2545411Z,2020,79,24,53,41,0,8vo,0,0,38,0,0,55,26,0,79,0,0,0
11387,6173,2020-11-18T16:21:38.2545411Z,2020,33,8,29,11,0,K,0,0,22,0,0,25,4,0,33,0,0,0
11387,6174,2020-11-18T16:21:38.2545411Z,2020,9,9,7,3,0,Sin Grado,0,0,6,0,0,0,2,0,7,0,1,2
61457,10248,2020-11-18T16:22:03.1281253Z,2020,17,3,16,12,0,1ro,0,0,5,0,0,14,1,0,17,0,0,0
61457,10249,2020-11-18T16:22:03.1281253Z,2020,36,14,33,16,0,2do,0,0,20,0,0,22,3,0,35,0,0,1
61457,10250,2020-11-18T16:22:03.1281253Z,2020,30,12,29,18,0,3ro,1,0,12,0,0,18,1,0,29,1,0,0
61457,10251,2020-11-18T16:22:03.1281253Z,2020,37,12,34,13,0,4to,2,0,24,0,0,25,3,0,35,0,0,0
61457,10252,2020-11-18T16:22:03.1291258Z,2020,30,14,26,13,0,5to,1,0,17,0,0,16,4,0,29,0,0,0
61457,10253,2020-11-18T16:22:03.1291258Z,2020,19,4,17,11,0,K,1,0,8,0,0,15,2,0,18,0,0,0
61457,10254,2020-11-18T16:22:03.1291258Z,2020,4,4,3,1,0,Sin Grado,0,0,3,0,0,0,1,0,4,0,0,0
61457,34263,2021-06-24T13:18:38.0837646Z,2021,16,5,16,8,0,1ro,1,0,8,0,0,11,0,0,15,0,0,0
61457,34264,2021-06-24T13:18:38.0837646Z,2021,19,5,18,11,0,2do,0,0,8,0,0,14,1,0,18,0,0,1
61457,34265,2021-06-24T13:18:38.0837646Z,2021,31,15,29,11,0,3ro,1,0,20,0,0,16,2,0,30,0,0,0
61457,34266,2021-06-24T13:18:38.0847651Z,2021,27,8,27,15,0,4to,1,0,12,0,0,19,0,0,26,1,0,0
61457,34267,2021-06-24T13:18:38.0847651Z,2021,30,12,28,11,0,5to,1,0,19,0,0,18,2,0,29,0,0,0
61457,34268,2021-06-24T13:18:38.0847651Z,2021,25,9,23,10,0,K,1,0,15,0,0,16,2,0,24,0,0,0
61457,34269,2021-06-24T13:18:38.0847651Z,2021,7,7,5,2,0,Sin Grado,0,0,5,0,0,0,2,0,7,0,0,0
61457,4233,2020-11-18T16:21:09.0140446Z,2019,48,16,43,17,0,1ro,1,0,31,0,0,32,5,0,46,0,0,1
61457,4234,2020-11-18T16:21:09.0140446Z,2019,28,13,27,16,0,2do,1,0,12,0,0,15,1,0,27,1,0,0
61457,4235,2020-11-18T16:21:09.0150446Z,2019,42,14,39,15,0,3ro,2,0,27,0,0,28,3,0,40,0,0,0
61457,4236,2020-11-18T16:21:09.0150446Z,2019,28,15,26,12,1,4to,0,0,16,0,0,13,2,0,28,0,0,0
61457,4237,2020-11-18T16:21:09.0150446Z,2019,31,14,31,10,0,5to,2,0,21,0,0,17,0,0,29,0,0,0
61457,4238,2020-11-18T16:21:09.0150446Z,2019,19,5,1,11,0,K,0,0,8,0,0,14,18,0,19,0,0,0
61457,4239,2020-11-18T16:21:09.0150446Z,2019,4,4,4,1,0,Sin Grado,1,1,3,0,0,0,0,0,3,0,0,0
17111,30663,2021-06-24T13:18:10.6620959Z,2021,21,8,21,14,0,1ro,0,0,7,0,0,13,0,0,20,0,0,1
17111,30664,2021-06-24T13:18:10.6620959Z,2021,23,8,18,14,0,2do,3,0,9,0,0,15,5,0,20,0,0,0
17111,30665,2021-06-24T13:18:10.6620959Z,2021,23,11,16,10,0,3ro,0,0,13,0,0,12,7,0,23,0,0,0
17111,30666,2021-06-24T13:18:10.663096Z,2021,28,11,19,13,0,4to,0,0,15,0,0,17,9,0,28,0,0,0
17111,30667,2021-06-24T13:18:10.663096Z,2021,32,15,27,18,0,5to,0,0,14,0,0,17,5,0,32,0,0,0
17111,30668,2021-06-24T13:18:10.663096Z,2021,45,19,38,25,0,6to,2,0,20,0,0,26,7,0,43,0,0,0
17111,30669,2021-06-24T13:18:10.6640969Z,2021,54,31,47,24,0,7mo,3,0,30,0,0,23,7,0,51,0,0,0
17111,30670,2021-06-24T13:18:10.6640969Z,2021,61,20,48,31,0,8vo,2,0,30,0,0,41,13,0,59,0,0,0
17111,30671,2021-06-24T13:18:10.6640969Z,2021,11,7,8,6,0,K,0,0,5,0,0,4,3,0,10,0,0,1
17111,30672,2021-06-24T13:18:10.6640969Z,2021,7,7,7,4,0,Sin Grado,0,0,3,0,0,0,0,0,7,0,0,0
17111,665,2020-11-18T16:20:41.1924921Z,2019,27,9,23,10,0,1ro,1,0,17,0,0,18,4,0,26,0,0,0
17111,666,2020-11-18T16:20:41.193493Z,2019,28,14,25,14,0,2do,0,0,14,0,0,14,3,0,28,0,0,0
17111,6665,2020-11-18T16:21:40.7612165Z,2020,23,8,23,13,0,1ro,3,0,10,0,0,15,0,0,20,0,0,0
17111,6666,2020-11-18T16:21:40.7612165Z,2020,25,12,21,11,0,2do,0,0,14,0,0,13,4,0,25,0,0,0
17111,6667,2020-11-18T16:21:40.7612165Z,2020,30,14,28,13,0,3ro,0,0,17,0,0,16,2,0,30,0,0,0
17111,6668,2020-11-18T16:21:40.7622165Z,2020,30,15,29,14,0,4to,0,0,16,0,0,15,1,0,30,0,0,0
17111,6669,2020-11-18T16:21:40.7622165Z,2020,29,13,28,15,0,5to,2,0,14,0,0,16,1,0,27,0,0,0
17111,667,2020-11-18T16:20:41.193493Z,2019,37,16,35,20,0,3ro,1,0,17,0,0,21,2,0,36,0,0,0
17111,6670,2020-11-18T16:21:40.7622165Z,2020,53,28,47,22,0,6to,3,0,31,0,0,25,6,0,50,0,0,0
17111,6671,2020-11-18T16:21:40.7622165Z,2020,67,23,54,33,0,7mo,2,0,34,0,0,44,13,0,65,0,0,0
17111,6672,2020-11-18T16:21:40.7622165Z,2020,59,32,46,27,0,8vo,1,0,32,0,0,27,13,0,58,0,1,0
17111,6673,2020-11-18T16:21:40.7632179Z,2020,25,12,25,15,0,K,0,0,10,0,0,13,0,0,24,0,0,1
17111,6674,2020-11-18T16:21:40.7632179Z,2020,14,14,11,4,0,Sin Grado,0,0,10,0,0,0,3,0,14,0,0,0
17111,668,2020-11-18T16:20:41.193493Z,2019,31,16,26,13,0,4to,3,0,18,0,0,15,5,0,28,0,0,0
17111,669,2020-11-18T16:20:41.194493Z,2019,33,23,30,15,0,5to,2,1,18,0,0,10,3,0,31,0,0,0
17111,670,2020-11-18T16:20:41.194493Z,2019,81,25,64,37,0,6to,2,0,44,0,0,56,17,0,79,0,2,0
17111,671,2020-11-18T16:20:41.194493Z,2019,88,42,70,41,0,7mo,2,1,47,0,0,46,18,0,86,0,1,0
17111,672,2020-11-18T16:20:41.1954948Z,2019,66,21,48,36,0,8vo,1,0,30,0,0,45,18,0,65,0,0,0
17111,673,2020-11-18T16:20:41.1954948Z,2019,23,9,23,11,0,K,3,0,12,0,0,14,0,0,20,0,0,0
17111,674,2020-11-18T16:20:41.1954948Z,2019,6,5,4,1,0,Sin Grado,0,0,5,0,0,1,2,0,6,0,0,0
25783,1537,2020-11-18T16:20:47.6437952Z,2019,50,20,42,24,0,1ro,0,4,26,0,0,30,8,0,50,0,0,0
25783,1538,2020-11-18T16:20:47.644797Z,2019,48,25,39,23,0,2do,0,4,25,0,0,23,9,0,48,0,0,0
25783,1539,2020-11-18T16:20:47.644797Z,2019,64,25,55,27,0,3ro,1,5,37,0,0,39,9,0,63,0,0,0
25783,1540,2020-11-18T16:20:47.644797Z,2019,48,18,43,22,0,4to,0,7,26,0,0,30,5,0,47,0,0,1
25783,1541,2020-11-18T16:20:47.6457974Z,2019,48,21,35,30,0,5to,0,2,18,0,0,27,13,0,48,0,0,0
25783,1542,2020-11-18T16:20:47.6457974Z,2019,42,13,33,30,0,K,0,0,12,0,0,29,9,0,42,0,0,0
25783,1543,2020-11-18T16:20:47.6457974Z,2019,16,5,11,9,0,PK,1,0,7,0,0,11,5,0,15,0,0,0
25783,1544,2020-11-18T16:20:47.6467974Z,2019,32,31,31,5,0,Sin Grado,1,8,27,0,0,1,1,0,31,0,0,0
25783,31539,2021-06-24T13:18:15.8267986Z,2021,35,11,31,18,0,1ro,1,0,17,0,0,24,4,0,34,0,0,0
25783,31540,2021-06-24T13:18:15.8277991Z,2021,39,14,32,21,0,2do,0,0,18,0,0,25,7,0,39,0,0,0
25783,31541,2021-06-24T13:18:15.8277991Z,2021,28,7,22,15,0,3ro,0,0,13,0,0,21,6,0,28,0,0,0
25783,31542,2021-06-24T13:18:15.8277991Z,2021,44,20,35,22,0,4to,0,0,22,0,0,24,9,0,44,0,0,0
25783,31543,2021-06-24T13:18:15.8288001Z,2021,43,19,37,23,0,5to,0,0,20,0,0,24,6,0,43,0,0,0
25783,31544,2021-06-24T13:18:15.8288001Z,2021,20,4,16,9,0,K,0,0,11,0,0,16,4,0,20,0,0,0
25783,31545,2021-06-24T13:18:15.8288001Z,2021,4,2,2,1,0,PK,0,0,3,0,0,2,2,0,4,0,0,0
25783,31546,2021-06-24T13:18:15.8298006Z,2021,26,26,23,8,0,Sin Grado,0,2,18,0,0,0,3,0,26,0,0,0
25783,7542,2020-11-18T16:21:46.3729534Z,2020,46,15,40,25,0,1ro,0,1,21,0,0,31,6,0,46,0,0,0
25783,7543,2020-11-18T16:21:46.3729534Z,2020,35,11,27,18,0,2do,0,2,17,0,0,24,8,0,35,0,0,0
25783,7544,2020-11-18T16:21:46.3729534Z,2020,46,25,36,20,0,3ro,0,3,26,0,0,21,10,0,46,0,0,0
25783,7545,2020-11-18T16:21:46.3739542Z,2020,52,20,44,22,0,4to,1,2,30,0,0,32,8,0,51,0,0,0
25783,7546,2020-11-18T16:21:46.3739542Z,2020,43,18,37,20,0,5to,0,2,23,0,0,25,6,0,43,0,0,0
25783,7547,2020-11-18T16:21:46.3739542Z,2020,34,7,31,17,0,K,1,0,17,0,0,27,3,0,33,0,0,0
25783,7548,2020-11-18T16:21:46.3739542Z,2020,11,2,8,5,0,PK,0,0,6,0,0,9,3,0,11,0,0,0
25783,7549,2020-11-18T16:21:46.3739542Z,2020,24,24,21,6,0,Sin Grado,0,1,18,0,0,0,3,0,24,0,0,0
26005,1552,2020-11-18T16:20:47.6477987Z,2019,82,28,67,42,0,6to,0,1,40,0,0,54,15,0,82,0,0,0
26005,1553,2020-11-18T16:20:47.6477987Z,2019,76,22,63,39,0,7mo,0,1,37,0,0,54,13,0,76,0,1,0
26005,1554,2020-11-18T16:20:47.6477987Z,2019,83,30,64,38,0,8vo,2,1,45,0,0,53,19,0,81,0,0,0
26005,31554,2021-06-24T13:18:15.8298006Z,2021,27,7,22,16,0,6to,0,0,11,0,0,20,5,0,27,1,0,0
26005,31555,2021-06-24T13:18:15.8308011Z,2021,59,20,47,28,0,7mo,4,0,31,0,0,39,12,0,55,0,0,0
26005,31556,2021-06-24T13:18:15.8308011Z,2021,109,36,93,58,0,8vo,0,0,51,0,0,73,16,0,109,0,0,0
26005,31557,2021-06-24T13:18:15.8308011Z,2021,7,7,7,0,0,Sin Grado,0,0,7,0,0,0,0,0,7,0,0,0
26005,7557,2020-11-18T16:21:46.3749547Z,2020,42,16,30,21,0,6to,2,0,21,0,0,26,12,0,40,0,0,0
26005,7558,2020-11-18T16:21:46.3749547Z,2020,108,39,89,55,0,7mo,0,0,53,0,0,69,19,0,108,0,1,0
26005,7559,2020-11-18T16:21:46.3759556Z,2020,77,21,61,40,0,8vo,0,1,37,0,0,56,16,0,77,0,0,0
26005,7560,2020-11-18T16:21:46.3759556Z,2020,3,3,3,0,0,Sin Grado,0,0,3,0,0,0,0,0,3,0,0,0
26021,1559,2020-11-18T16:20:47.652801Z,2019,139,20,94,68,0,10mo,2,0,71,0,0,119,45,0,137,0,1,0
26021,1560,2020-11-18T16:20:47.652801Z,2019,117,20,77,48,0,11mo,0,0,69,0,0,97,40,0,117,3,0,0
26021,1561,2020-11-18T16:20:47.652801Z,2019,117,0,69,62,0,12mo,0,0,55,0,0,117,48,0,117,0,1,0
26021,1562,2020-11-18T16:20:47.6538023Z,2019,141,35,93,66,1,9no,0,0,75,0,0,106,48,1,140,1,0,0
26021,31562,2021-06-24T13:18:15.8338039Z,2021,140,35,102,71,0,10mo,1,0,69,0,0,105,38,0,139,0,0,0
26021,31563,2021-06-24T13:18:15.8338039Z,2021,139,29,107,65,0,11mo,0,0,74,0,0,110,32,1,138,1,0,0
26021,31564,2021-06-24T13:18:15.8338039Z,2021,139,19,106,72,0,12mo,2,0,67,0,0,120,33,1,136,0,1,0
26021,31565,2021-06-24T13:18:15.8348039Z,2021,152,29,120,71,0,9no,0,0,81,0,0,123,32,0,152,6,0,0
26021,7565,2020-11-18T16:21:46.3769569Z,2020,140,34,92,69,0,10mo,0,0,71,0,0,106,48,1,139,2,0,0
26021,7566,2020-11-18T16:21:46.3769569Z,2020,132,19,93,69,0,11mo,2,0,63,0,0,113,39,0,130,0,1,0
26021,7567,2020-11-18T16:21:46.3769569Z,2020,122,21,82,55,0,12mo,0,1,67,0,0,101,40,0,122,4,0,0
26021,7568,2020-11-18T16:21:46.3769569Z,2020,146,37,107,75,0,9no,1,1,71,0,0,109,39,0,145,0,0,0
34264,2214,2020-11-18T16:20:55.0016985Z,2019,24,7,22,8,0,10mo,0,1,16,0,0,17,2,0,24,0,0,0
34264,2215,2020-11-18T16:20:55.0016985Z,2019,17,2,16,11,0,11mo,0,0,6,0,0,15,1,0,17,0,0,0
34264,2216,2020-11-18T16:20:55.0016985Z,2019,23,0,16,12,0,12mo,0,0,11,0,0,23,7,0,23,0,0,0
34264,2217,2020-11-18T16:20:55.0026985Z,2019,31,8,25,11,0,6to,0,0,20,0,0,23,6,0,31,0,0,0
34264,2218,2020-11-18T16:20:55.0026985Z,2019,34,10,28,14,0,7mo,0,0,20,0,0,24,6,0,34,0,0,0
34264,2219,2020-11-18T16:20:55.0026985Z,2019,29,11,24,14,0,8vo,0,0,15,0,0,18,5,0,29,0,0,0
34264,2220,2020-11-18T16:20:55.0026985Z,2019,24,4,17,10,0,9no,0,0,14,0,0,20,7,0,24,0,0,0
34264,32221,2021-06-24T13:18:21.7480438Z,2021,29,9,25,15,0,10mo,0,0,14,0,0,20,4,0,29,0,0,0
34264,32222,2021-06-24T13:18:21.7480438Z,2021,23,4,17,13,0,11mo,1,0,10,0,0,19,6,0,22,0,0,0
34264,32223,2021-06-24T13:18:21.7480438Z,2021,22,5,20,8,0,12mo,0,0,14,0,0,17,2,0,22,0,0,0
34264,32224,2021-06-24T13:18:21.7480438Z,2021,42,10,37,16,0,6to,2,0,26,0,0,32,5,0,40,0,0,0
34264,32225,2021-06-24T13:18:21.7490448Z,2021,45,13,34,20,0,7mo,0,0,25,0,0,32,11,0,45,0,0,0
34264,32226,2021-06-24T13:18:21.7490448Z,2021,49,13,42,18,0,8vo,0,0,31,0,0,36,7,1,48,0,0,0
34264,32227,2021-06-24T13:18:21.7490448Z,2021,44,15,39,19,0,9no,0,0,25,0,0,29,5,0,44,0,0,0
34264,8226,2020-11-18T16:21:50.6768263Z,2020,25,4,18,13,0,10mo,0,0,12,0,0,21,7,0,25,0,0,0
34264,8227,2020-11-18T16:21:50.6768263Z,2020,25,6,24,9,0,11mo,0,0,16,0,0,19,1,0,25,0,0,0
34264,8228,2020-11-18T16:21:50.6768263Z,2020,16,3,15,11,0,12mo,0,0,5,0,0,13,1,0,16,0,0,0
34264,8229,2020-11-18T16:21:50.6768263Z,2020,44,13,36,19,0,6to,0,0,25,0,0,31,8,0,44,0,0,0
34264,8230,2020-11-18T16:21:50.6768263Z,2020,48,12,41,17,0,7mo,0,0,31,0,0,36,7,1,47,0,0,0
34264,8231,2020-11-18T16:21:50.6778272Z,2020,38,11,32,17,0,8vo,0,1,21,0,0,27,6,0,38,0,0,0
34264,8232,2020-11-18T16:21:50.6778272Z,2020,27,9,23,15,0,9no,0,0,12,0,0,18,4,0,27,0,0,0
46995,3110,2020-11-18T16:21:01.0147083Z,2019,101,32,81,53,0,10mo,2,0,48,0,0,69,20,0,99,0,0,0
46995,3111,2020-11-18T16:21:01.0147083Z,2019,108,25,82,58,0,11mo,0,0,50,0,0,83,26,0,108,0,0,0
46995,3112,2020-11-18T16:21:01.0147083Z,2019,106,0,80,59,0,12mo,0,0,47,0,0,106,26,0,106,0,0,0
46995,3113,2020-11-18T16:21:01.0157087Z,2019,125,32,101,65,0,9no,1,0,60,0,0,93,24,0,124,0,0,0
46995,33124,2021-06-24T13:18:30.3131924Z,2021,106,29,91,52,0,10mo,3,1,54,0,0,77,15,0,103,1,0,0
46995,33125,2021-06-24T13:18:30.3131924Z,2021,115,28,90,65,0,11mo,2,0,50,0,0,87,25,0,113,1,0,0
46995,33126,2021-06-24T13:18:30.3131924Z,2021,84,25,61,49,0,12mo,2,0,35,0,0,59,23,0,82,1,0,0
46995,33127,2021-06-24T13:18:30.3131924Z,2021,102,37,85,43,0,9no,8,1,59,0,0,65,17,0,94,0,0,0
46995,33128,2021-06-24T13:18:30.3141929Z,2021,11,11,10,3,0,Sin Grado,0,0,8,0,0,0,1,0,11,0,0,0
46995,9124,2020-11-18T16:21:56.1284618Z,2020,125,33,101,69,0,10mo,2,6,56,0,0,92,24,0,123,1,0,0
46995,9125,2020-11-18T16:21:56.1284618Z,2020,86,25,69,49,0,11mo,2,1,37,0,0,61,17,0,84,1,0,0
46995,9126,2020-11-18T16:21:56.1284618Z,2020,103,23,80,56,0,12mo,0,5,47,0,0,80,23,0,103,1,0,0
46995,9127,2020-11-18T16:21:56.1294627Z,2020,115,33,94,58,0,9no,4,3,57,0,0,82,21,0,111,1,0,0
51763,33468,2021-06-24T13:18:32.4867506Z,2021,36,12,30,14,0,10mo,1,2,22,0,0,24,6,0,35,0,0,0
51763,33469,2021-06-24T13:18:32.4877515Z,2021,21,5,20,11,0,11mo,0,0,10,0,0,16,1,0,21,0,0,0
51763,33470,2021-06-24T13:18:32.4877515Z,2021,26,13,20,10,0,12mo,0,1,16,0,0,13,6,0,26,0,0,0
51763,33471,2021-06-24T13:18:32.4877515Z,2021,32,15,30,16,0,6to,1,0,16,0,0,17,2,0,31,0,0,0
51763,33472,2021-06-24T13:18:32.488752Z,2021,32,8,28,18,0,7mo,0,1,14,0,0,24,4,0,32,0,0,0
51763,33473,2021-06-24T13:18:32.488752Z,2021,32,9,29,17,0,8vo,3,8,15,0,0,23,3,0,29,0,0,0
51763,33474,2021-06-24T13:18:32.488752Z,2021,29,10,23,14,0,9no,0,0,15,0,0,19,6,0,29,0,0,0
51763,33475,2021-06-24T13:18:32.4897525Z,2021,6,6,4,2,0,Sin Grado,0,0,4,0,0,0,2,0,6,0,0,0
51763,3443,2020-11-18T16:21:02.5597403Z,2019,28,11,20,8,0,10mo,0,4,20,0,0,17,8,0,28,0,0,0
51763,3444,2020-11-18T16:21:02.5597403Z,2019,18,1,17,10,0,11mo,1,0,8,0,0,17,1,0,17,0,0,0
51763,3445,2020-11-18T16:21:02.5597403Z,2019,31,0,24,15,0,12mo,0,0,16,0,0,31,7,0,31,0,0,0
51763,3446,2020-11-18T16:21:02.5597403Z,2019,32,10,27,19,0,6to,4,14,13,0,0,22,5,0,28,0,0,0
51763,3447,2020-11-18T16:21:02.5607421Z,2019,38,11,29,19,0,7mo,0,9,19,0,0,27,9,0,38,0,0,0
51763,3448,2020-11-18T16:21:02.5607421Z,2019,47,12,37,19,0,8vo,2,5,28,0,0,35,10,0,45,0,0,0
51763,3449,2020-11-18T16:21:02.5607421Z,2019,27,9,24,13,0,9no,0,3,14,0,0,18,3,0,27,0,0,0
51763,3450,2020-11-18T16:21:02.5607421Z,2019,4,4,3,1,0,Sin Grado,0,0,3,0,0,0,1,0,4,0,0,0
51763,9464,2020-11-18T16:21:58.4389988Z,2020,23,7,21,11,0,10mo,0,0,12,0,0,16,2,0,23,0,0,0
51763,9465,2020-11-18T16:21:58.4389988Z,2020,27,12,21,10,0,11mo,0,0,17,0,0,15,6,0,27,0,0,0
51763,9466,2020-11-18T16:21:58.4389988Z,2020,17,1,16,9,0,12mo,1,0,8,0,0,16,1,0,16,0,0,0
51763,9467,2020-11-18T16:21:58.4399997Z,2020,34,9,26,17,0,6to,1,3,17,0,0,25,8,0,33,0,0,0
51763,9468,2020-11-18T16:21:58.4399997Z,2020,34,10,27,18,0,7mo,4,12,16,0,0,24,7,0,30,0,0,0
51763,9469,2020-11-18T16:21:58.4399997Z,2020,37,11,28,19,0,8vo,0,1,18,0,0,26,9,0,37,0,0,0
51763,9470,2020-11-18T16:21:58.4399997Z,2020,43,13,32,16,0,9no,2,0,27,0,0,30,11,0,41,0,0,0
51763,9471,2020-11-18T16:21:58.4399997Z,2020,8,8,6,2,0,Sin Grado,0,0,6,0,0,0,2,0,8,0,0,0
11395,174,2020-11-18T16:20:37.576078Z,2019,56,18,42,29,0,1ro,3,0,27,0,0,38,14,0,53,0,0,0
11395,175,2020-11-18T16:20:37.5770784Z,2019,68,27,55,34,0,2do,1,0,34,0,0,41,13,0,67,0,0,0
11395,176,2020-11-18T16:20:37.5770784Z,2019,51,10,43,24,0,3ro,1,0,27,0,0,41,8,0,50,0,0,0
11395,177,2020-11-18T16:20:37.5770784Z,2019,76,20,63,35,0,4to,4,0,41,0,0,56,13,0,72,0,0,0
11395,178,2020-11-18T16:20:37.5770784Z,2019,78,22,70,34,0,5to,2,0,44,0,0,56,8,0,76,0,1,0
11395,179,2020-11-18T16:20:37.5770784Z,2019,50,13,44,29,0,K,2,0,21,0,0,37,6,0,48,0,0,0
11395,30173,2021-06-24T13:18:06.3199813Z,2021,50,15,43,28,0,1ro,1,0,22,0,0,35,7,0,49,0,0,0
11395,30174,2021-06-24T13:18:06.3199813Z,2021,61,11,59,38,0,2do,3,0,23,0,0,50,2,0,58,0,0,0
11395,30175,2021-06-24T13:18:06.3209818Z,2021,54,20,46,29,0,3ro,3,0,25,0,0,34,8,0,51,0,0,0
11395,30176,2021-06-24T13:18:06.3209818Z,2021,68,31,58,33,0,4to,4,0,35,0,0,37,10,0,64,0,2,0
11395,30177,2021-06-24T13:18:06.3209818Z,2021,54,13,47,25,0,5to,0,0,29,0,0,41,7,0,54,0,0,0
11395,30178,2021-06-24T13:18:06.3209818Z,2021,48,8,41,22,0,K,2,0,26,0,0,40,7,0,46,0,0,0
11395,6175,2020-11-18T16:21:38.2545411Z,2020,50,11,44,32,0,1ro,2,0,18,0,0,39,6,0,48,0,0,0
11395,6176,2020-11-18T16:21:38.2545411Z,2020,49,16,39,29,0,2do,2,0,20,0,0,33,10,0,47,0,0,0
11395,6177,2020-11-18T16:21:38.2545411Z,2020,64,29,53,32,0,3ro,2,0,32,0,0,35,11,0,62,0,0,0
11395,6178,2020-11-18T16:21:38.2555416Z,2020,52,13,44,25,0,4to,0,0,27,0,0,39,8,0,52,0,0,0
11395,6179,2020-11-18T16:21:38.2555416Z,2020,73,20,64,32,0,5to,3,0,41,0,0,53,9,0,70,0,0,0
11395,6180,2020-11-18T16:21:38.2555416Z,2020,45,8,39,26,0,K,1,0,19,0,0,37,6,0,44,0,0,0
13425,30530,2021-06-24T13:18:10.3818937Z,2021,134,19,108,72,0,10mo,0,0,62,0,0,115,26,0,134,1,0,0
13425,30531,2021-06-24T13:18:10.382895Z,2021,110,12,94,55,0,11mo,0,0,55,0,0,98,16,0,110,1,0,0
13425,30532,2021-06-24T13:18:10.382895Z,2021,140,15,108,69,0,12mo,0,0,71,0,0,125,32,0,140,3,0,0
13425,30533,2021-06-24T13:18:10.382895Z,2021,101,10,75,57,0,9no,0,0,44,0,0,91,26,0,101,0,0,0
13425,30534,2021-06-24T13:18:10.3838955Z,2021,10,10,8,2,0,Sin Grado,1,0,8,0,0,0,2,0,9,0,0,0
13425,533,2020-11-18T16:20:40.7662074Z,2019,148,15,112,69,0,10mo,0,1,79,0,0,133,36,0,148,2,0,0
13425,534,2020-11-18T16:20:40.7662074Z,2019,187,23,144,94,0,11mo,1,2,93,0,0,164,43,0,186,4,1,0
13425,535,2020-11-18T16:20:40.7662074Z,2019,158,0,119,89,0,12mo,0,2,69,0,0,158,39,0,158,0,0,0
13425,536,2020-11-18T16:20:40.7662074Z,2019,136,24,114,67,0,9no,0,0,69,0,0,112,22,0,136,2,0,0
13425,537,2020-11-18T16:20:40.7662074Z,2019,17,13,11,4,0,Sin Grado,1,0,13,0,0,4,6,0,16,0,0,0
13425,6532,2020-11-18T16:21:40.3499404Z,2020,122,17,101,57,0,10mo,0,0,65,0,0,105,21,0,122,1,0,0
13425,6533,2020-11-18T16:21:40.3509413Z,2020,144,14,102,70,0,11mo,0,1,74,0,0,130,42,0,144,3,0,0
13425,6534,2020-11-18T16:21:40.3509413Z,2020,161,20,115,84,0,12mo,0,1,77,0,0,141,46,0,161,4,1,0
13425,6535,2020-11-18T16:21:40.3509413Z,2020,118,18,90,60,0,9no,0,2,58,0,0,100,28,0,117,1,0,1
13425,6536,2020-11-18T16:21:40.3509413Z,2020,16,15,12,4,0,Sin Grado,1,1,12,0,0,1,4,0,15,0,0,0
20834,1098,2020-11-18T16:20:43.822243Z,2019,44,18,42,27,0,1ro,1,0,17,0,0,26,2,0,43,1,0,0
20834,1099,2020-11-18T16:20:43.822243Z,2019,63,19,53,30,0,2do,1,0,33,0,0,44,10,0,62,0,1,0
20834,1100,2020-11-18T16:20:43.8232439Z,2019,58,25,54,26,0,3ro,3,0,32,0,0,33,4,0,55,1,0,0
20834,1101,2020-11-18T16:20:44.6197765Z,2019,69,23,58,25,0,4to,1,0,44,0,0,46,11,0,68,0,0,0
20834,1102,2020-11-18T16:20:44.6197765Z,2019,45,19,39,23,0,5to,2,0,22,0,0,26,6,0,43,0,0,0
20834,1103,2020-11-18T16:20:44.6197765Z,2019,49,12,44,24,0,K,3,0,25,0,0,37,5,0,46,0,0,0
20834,1104,2020-11-18T16:20:44.6197765Z,2019,22,19,21,9,0,Sin Grado,0,0,13,0,0,3,1,0,22,0,0,0
20834,31098,2021-06-24T13:18:12.1061307Z,2021,38,7,32,19,0,1ro,3,2,19,0,0,31,6,0,35,0,0,0
20834,31099,2021-06-24T13:18:12.1061307Z,2021,35,14,31,15,0,2do,1,0,20,0,0,21,4,0,34,0,0,0
20834,31100,2021-06-24T13:18:13.0267904Z,2021,36,11,32,21,0,3ro,1,0,15,0,0,25,4,0,35,1,0,0
20834,31101,2021-06-24T13:18:13.0267904Z,2021,51,14,42,28,0,4to,2,0,23,0,0,37,9,0,49,0,0,0
20834,31102,2021-06-24T13:18:13.0267904Z,2021,48,16,38,24,0,5to,4,0,24,0,0,32,10,0,44,1,0,0
20834,31103,2021-06-24T13:18:13.0267904Z,2021,26,11,15,11,0,K,0,1,15,0,0,15,11,0,26,0,0,0
20834,31104,2021-06-24T13:18:13.0277914Z,2021,15,15,11,5,0,Sin Grado,0,0,10,0,0,0,4,0,15,0,0,0
20834,7102,2020-11-18T16:21:44.1874979Z,2020,43,17,40,20,0,1ro,1,0,23,0,0,26,3,0,42,0,0,0
20834,7103,2020-11-18T16:21:44.1874979Z,2020,39,14,37,22,0,2do,1,2,17,0,0,25,2,0,38,1,0,0
20834,7104,2020-11-18T16:21:44.1874979Z,2020,59,17,49,32,0,3ro,1,1,27,0,0,42,10,0,58,0,0,0
20834,7105,2020-11-18T16:21:44.1884988Z,2020,49,15,47,26,0,4to,4,0,23,0,0,34,2,0,45,1,0,0
20834,7106,2020-11-18T16:21:44.1884988Z,2020,68,27,60,28,0,5to,1,0,40,0,0,41,8,0,67,0,0,0
20834,7107,2020-11-18T16:21:44.1884988Z,2020,42,8,38,19,0,K,3,0,23,0,0,34,4,0,39,0,0,0
20834,7108,2020-11-18T16:21:44.1884988Z,2020,20,20,20,6,0,Sin Grado,0,1,14,0,0,0,0,0,20,0,0,0
22327,1306,2020-11-18T16:20:45.8786174Z,2019,94,32,77,48,0,1ro,1,1,46,0,0,62,17,0,93,0,0,0
22327,1307,2020-11-18T16:20:45.8786174Z,2019,98,31,80,48,0,2do,0,0,50,0,0,67,18,0,98,0,0,0
22327,1308,2020-11-18T16:20:45.8786174Z,2019,100,22,83,55,0,3ro,1,0,45,0,0,78,17,0,99,0,0,0
22327,1309,2020-11-18T16:20:45.8796174Z,2019,102,27,76,56,0,4to,1,1,46,0,0,75,26,0,101,0,0,0
22327,1310,2020-11-18T16:20:45.8796174Z,2019,70,20,58,33,0,5to,1,0,37,0,0,50,12,0,69,0,0,0
22327,1311,2020-11-18T16:20:45.8796174Z,2019,71,9,60,37,0,K,0,0,34,0,0,62,11,0,71,0,0,0
22327,1312,2020-11-18T16:20:45.8806178Z,2019,28,27,25,9,0,Sin Grado,0,0,19,0,0,1,3,0,28,0,0,0
22327,31307,2021-06-24T13:18:14.5378744Z,2021,68,8,56,37,0,1ro,1,0,31,0,0,60,12,0,67,0,0,0
22327,31308,2021-06-24T13:18:14.5378744Z,2021,69,13,61,35,0,2do,0,0,34,0,0,56,8,0,69,0,0,0
22327,31309,2021-06-24T13:18:14.5388758Z,2021,86,22,71,43,0,3ro,1,0,43,0,0,64,15,0,85,0,0,0
22327,31310,2021-06-24T13:18:14.5388758Z,2021,86,26,75,49,0,4to,0,0,37,0,0,60,11,0,86,0,0,0
22327,31311,2021-06-24T13:18:14.5388758Z,2021,95,23,77,50,0,5to,1,0,45,0,0,72,18,0,94,0,0,0
22327,31312,2021-06-24T13:18:14.5388758Z,2021,74,11,63,40,0,K,0,0,34,0,0,63,11,1,73,0,0,0
22327,31313,2021-06-24T13:18:14.5398758Z,2021,21,21,15,9,0,Sin Grado,0,0,12,0,0,0,6,0,21,0,0,0
22327,7311,2020-11-18T16:21:45.3192546Z,2020,71,14,59,36,0,1ro,0,0,35,0,0,57,12,0,71,0,0,0
22327,7312,2020-11-18T16:21:45.3202555Z,2020,91,25,67,43,0,2do,1,0,48,0,0,66,24,0,90,0,0,0
22327,7313,2020-11-18T16:21:45.3202555Z,2020,90,26,72,51,0,3ro,0,0,39,0,0,64,18,0,90,0,0,0
22327,7314,2020-11-18T16:21:45.3202555Z,2020,101,23,84,54,0,4to,1,0,47,0,0,78,17,0,100,0,0,0
22327,7315,2020-11-18T16:21:45.3202555Z,2020,87,26,67,47,0,5to,0,0,40,0,0,61,20,0,87,0,0,0
22327,7316,2020-11-18T16:21:45.3212564Z,2020,71,11,59,34,0,K,1,0,37,0,0,60,12,0,70,0,0,0
22327,7317,2020-11-18T16:21:45.3212564Z,2020,28,27,20,9,0,Sin Grado,0,0,19,0,0,1,8,0,28,0,0,0
30924,1886,2020-11-18T16:20:52.4890256Z,2019,39,15,31,17,0,1ro,0,1,22,0,0,24,8,0,39,0,0,0
30924,1887,2020-11-18T16:20:52.4890256Z,2019,34,8,27,18,0,2do,0,0,16,0,0,26,7,0,34,0,0,0
30924,1888,2020-11-18T16:20:52.4890256Z,2019,32,8,26,20,0,3ro,0,0,12,0,0,24,6,0,32,0,0,0
30924,1889,2020-11-18T16:20:52.4890256Z,2019,41,4,33,21,0,4to,0,0,20,0,0,37,8,0,41,0,0,0
30924,1890,2020-11-18T16:20:52.490026Z,2019,34,10,25,14,0,5to,1,0,20,0,0,24,9,0,33,0,0,0
30924,1891,2020-11-18T16:20:52.490026Z,2019,30,5,11,17,0,K,0,0,13,0,0,25,19,0,30,0,0,0
30924,1892,2020-11-18T16:20:52.490026Z,2019,4,4,3,1,0,Sin Grado,0,0,3,0,0,0,1,0,4,0,0,0
30924,31891,2021-06-24T13:18:17.7852027Z,2021,32,10,27,18,0,1ro,0,1,14,0,0,22,5,0,32,0,0,0
30924,31892,2021-06-24T13:18:17.7862032Z,2021,44,14,36,23,0,2do,0,0,21,0,0,30,8,0,44,0,0,0
30924,31893,2021-06-24T13:18:17.7862032Z,2021,34,9,27,19,0,3ro,0,1,15,0,0,25,7,0,34,0,0,0
30924,31894,2021-06-24T13:18:17.7862032Z,2021,35,7,25,17,0,4to,0,0,18,0,0,28,10,0,35,0,0,0
30924,31895,2021-06-24T13:18:17.7862032Z,2021,36,9,29,22,0,5to,1,0,14,0,0,27,7,0,35,0,0,0
30924,31896,2021-06-24T13:18:17.7862032Z,2021,37,4,13,18,0,K,0,0,19,0,0,33,24,0,37,0,0,0
30924,31897,2021-06-24T13:18:17.7872041Z,2021,7,7,4,3,0,Sin Grado,0,0,4,0,0,0,3,0,7,0,0,0
30924,7894,2020-11-18T16:21:48.4893655Z,2020,37,9,30,20,0,1ro,0,0,17,0,0,28,7,0,37,0,0,0
30924,7895,2020-11-18T16:21:48.4903664Z,2020,33,10,27,15,0,2do,0,0,18,0,0,23,6,0,33,0,0,0
30924,7896,2020-11-18T16:21:48.4903664Z,2020,31,7,23,16,0,3ro,0,0,15,0,0,24,8,0,31,0,0,0
30924,7897,2020-11-18T16:21:48.4903664Z,2020,35,10,28,23,0,4to,0,0,12,0,0,25,7,0,35,0,0,0
30924,7898,2020-11-18T16:21:48.4903664Z,2020,38,4,31,17,0,5to,0,0,21,0,0,34,7,0,38,0,0,0
30924,7899,2020-11-18T16:21:48.4903664Z,2020,31,10,16,13,0,K,0,0,18,0,0,21,15,0,30,0,0,1
30924,7900,2020-11-18T16:21:48.4913673Z,2020,8,8,3,3,0,Sin Grado,1,0,5,0,0,0,5,0,6,0,0,1
40477,2579,2020-11-18T16:20:57.6444627Z,2019,52,20,46,29,0,1ro,1,1,23,0,0,32,6,0,51,0,0,0
40477,2580,2020-11-18T16:20:57.6454645Z,2019,45,13,42,19,0,2do,0,0,26,0,0,32,3,0,45,0,0,0
40477,2581,2020-11-18T16:20:57.6454645Z,2019,48,10,47,32,0,3ro,0,0,16,0,0,38,1,0,48,0,0,0
40477,2582,2020-11-18T16:20:57.6454645Z,2019,60,19,54,34,0,4to,0,0,26,0,0,41,6,0,60,0,0,0
40477,2583,2020-11-18T16:20:57.6454645Z,2019,54,17,45,27,0,5to,3,0,27,0,0,37,9,0,51,1,0,0
40477,2584,2020-11-18T16:20:57.646465Z,2019,45,13,41,26,0,K,0,1,19,0,0,32,4,1,44,0,0,0
40477,2585,2020-11-18T16:20:57.646465Z,2019,7,7,6,1,0,Sin Grado,0,0,6,0,0,0,1,0,7,0,0,0
40477,32587,2021-06-24T13:18:25.2415553Z,2021,37,11,30,22,0,1ro,2,0,15,0,0,26,7,0,35,0,0,0
40477,32588,2021-06-24T13:18:25.2415553Z,2021,42,19,37,17,0,2do,0,0,25,0,0,23,5,1,41,0,0,0
40477,32589,2021-06-24T13:18:25.2425563Z,2021,43,15,34,24,0,3ro,1,0,19,0,0,28,9,0,41,0,0,1
40477,32590,2021-06-24T13:18:25.2425563Z,2021,36,14,31,11,0,4to,0,0,25,0,0,22,5,0,36,0,0,0
40477,32591,2021-06-24T13:18:25.2425563Z,2021,57,14,49,32,0,5to,0,0,25,0,0,43,8,0,55,0,0,2
40477,32592,2021-06-24T13:18:25.2425563Z,2021,26,6,12,14,0,K,0,0,12,0,0,20,14,0,26,0,0,0
40477,32593,2021-06-24T13:18:25.2425563Z,2021,4,4,3,0,0,Sin Grado,0,0,4,0,0,0,1,0,4,0,0,0
40477,8591,2020-11-18T16:21:52.6531405Z,2020,45,18,44,18,0,1ro,0,0,27,0,0,27,1,1,44,0,0,0
40477,8592,2020-11-18T16:21:52.6531405Z,2020,47,14,43,25,0,2do,1,0,22,0,0,33,4,0,46,0,0,0
40477,8593,2020-11-18T16:21:52.6531405Z,2020,43,17,38,13,0,3ro,0,0,30,0,0,26,5,0,43,0,0,0
40477,8594,2020-11-18T16:21:52.6541414Z,2020,57,14,54,34,0,4to,0,0,23,0,0,43,3,0,57,0,0,0
40477,8595,2020-11-18T16:21:52.6541414Z,2020,56,16,48,34,0,5to,1,0,22,0,0,40,8,0,55,0,0,0
40477,8596,2020-11-18T16:21:52.6541414Z,2020,42,11,39,26,0,K,3,0,16,0,0,31,3,0,39,0,0,0
40477,8597,2020-11-18T16:21:52.6541414Z,2020,8,8,7,0,0,Sin Grado,0,0,8,0,0,0,1,0,8,0,0,0
41541,2662,2020-11-18T16:20:58.065743Z,2019,142,51,110,69,0,6to,0,0,73,0,0,91,32,0,141,0,1,1
41541,2663,2020-11-18T16:20:58.065743Z,2019,127,38,106,70,0,7mo,1,0,57,0,0,89,21,0,126,2,0,0
41541,2664,2020-11-18T16:20:58.065743Z,2019,149,45,124,73,0,8vo,1,0,76,0,0,104,25,0,148,1,1,0
41541,2665,2020-11-18T16:20:58.066743Z,2019,25,24,25,6,0,Sin Grado,0,0,19,0,0,1,0,0,25,0,0,0
41541,32669,2021-06-24T13:18:26.2782988Z,2021,93,41,78,51,0,6to,0,0,42,0,0,52,15,0,93,1,0,0
41541,32670,2021-06-24T13:18:26.2792997Z,2021,143,60,124,67,0,7mo,0,0,76,0,0,83,19,0,143,0,0,0
41541,32671,2021-06-24T13:18:26.2792997Z,2021,125,44,103,62,0,8vo,0,0,63,0,0,81,22,0,125,0,0,0
41541,32672,2021-06-24T13:18:26.2792997Z,2021,20,20,12,4,0,Sin Grado,0,0,16,0,0,0,8,0,20,0,0,0
41541,8673,2020-11-18T16:21:53.0614137Z,2020,147,62,116,69,0,6to,1,0,78,0,0,85,31,0,146,0,0,0
41541,8674,2020-11-18T16:21:53.0624146Z,2020,137,50,111,67,0,7mo,0,0,70,0,0,87,26,0,137,0,0,0
41541,8675,2020-11-18T16:21:53.0624146Z,2020,111,36,89,61,0,8vo,1,0,50,0,0,75,22,0,110,2,0,0
41541,8676,2020-11-18T16:21:53.0624146Z,2020,21,21,21,5,0,Sin Grado,0,0,16,0,0,0,0,0,21,0,0,0
42242,2743,2020-11-18T16:20:58.7491949Z,2019,54,18,44,29,0,1ro,0,0,25,0,0,36,10,0,54,0,0,0
42242,2744,2020-11-18T16:20:58.7491949Z,2019,46,16,42,23,0,2do,0,3,23,0,0,30,4,0,46,0,0,0
42242,2745,2020-11-18T16:20:58.7491949Z,2019,45,18,41,23,0,3ro,1,1,22,0,0,27,4,1,43,0,1,0
42242,2746,2020-11-18T16:20:58.7501962Z,2019,51,15,43,21,0,4to,0,1,30,0,0,36,8,1,50,0,0,0
42242,2747,2020-11-18T16:20:58.7501962Z,2019,46,17,43,24,1,5to,4,1,22,0,0,29,3,0,42,0,0,0
42242,2748,2020-11-18T16:20:58.7501962Z,2019,31,12,29,14,0,K,1,1,17,0,0,19,2,0,30,0,0,0
42242,32750,2021-06-24T13:18:27.1569292Z,2021,50,17,43,23,0,1ro,0,2,27,0,0,33,7,0,50,0,0,0
42242,32751,2021-06-24T13:18:27.1569292Z,2021,34,15,33,15,0,2do,1,0,19,0,0,19,1,0,33,0,0,0
42242,32752,2021-06-24T13:18:27.1569292Z,2021,56,18,45,30,0,3ro,0,0,26,0,0,38,11,0,56,0,0,0
42242,32753,2021-06-24T13:18:27.1569292Z,2021,38,9,31,22,0,4to,0,0,16,0,0,29,7,0,38,0,0,0
42242,32754,2021-06-24T13:18:27.1579297Z,2021,27,10,23,11,0,5to,0,0,16,0,0,17,4,0,27,0,0,0
42242,32755,2021-06-24T13:18:27.1579297Z,2021,41,5,39,26,0,K,0,0,15,0,0,36,2,0,40,0,0,1
42242,8754,2020-11-18T16:21:53.8079132Z,2020,39,16,35,13,0,1ro,1,3,26,0,0,23,4,0,38,0,0,0
42242,8755,2020-11-18T16:21:53.8079132Z,2020,54,17,43,33,0,2do,0,0,21,0,0,37,11,0,54,0,0,0
42242,8756,2020-11-18T16:21:53.8079132Z,2020,37,10,31,20,0,3ro,0,0,17,0,0,27,6,0,37,0,0,0
42242,8757,2020-11-18T16:21:53.8089123Z,2020,35,13,29,16,0,4to,0,0,19,0,0,22,6,0,35,0,0,0
42242,8758,2020-11-18T16:21:53.8089123Z,2020,47,16,39,19,0,5to,0,0,28,0,0,31,8,1,46,0,0,0
42242,8759,2020-11-18T16:21:53.8099141Z,2020,46,18,41,21,0,K,0,0,25,0,0,28,5,0,45,0,0,1
50773,3317,2020-11-18T16:21:02.1344569Z,2019,17,3,14,7,0,1ro,0,1,10,0,0,14,3,0,17,1,0,0
50773,3318,2020-11-18T16:21:02.1344569Z,2019,27,8,23,12,0,2do,0,1,15,0,0,19,4,0,27,0,0,0
50773,3319,2020-11-18T16:21:02.1354574Z,2019,30,9,27,17,0,3ro,3,0,13,0,0,21,3,0,27,1,0,0
50773,3320,2020-11-18T16:21:02.1354574Z,2019,27,10,22,15,0,4to,1,0,12,0,0,17,5,0,26,1,0,0
50773,3321,2020-11-18T16:21:02.1354574Z,2019,24,6,23,10,0,5to,1,0,14,0,0,18,1,0,23,1,0,0
50773,3322,2020-11-18T16:21:02.1364578Z,2019,26,10,21,13,0,K,2,0,13,0,0,16,5,0,24,1,0,0
50773,3323,2020-11-18T16:21:02.1364578Z,2019,15,4,8,7,0,PK,0,0,8,0,0,11,7,0,15,0,0,0
50773,33343,2021-06-24T13:18:31.5590852Z,2021,20,6,16,7,0,1ro,1,0,13,0,0,14,4,0,19,1,0,0
50773,33344,2021-06-24T13:18:31.5590852Z,2021,15,6,11,7,0,2do,0,0,8,0,0,9,4,0,15,0,0,0
50773,33345,2021-06-24T13:18:31.5590852Z,2021,11,1,9,6,0,3ro,0,0,5,0,0,10,2,0,11,0,0,0
50773,33346,2021-06-24T13:18:31.5600861Z,2021,13,3,12,6,0,4to,0,2,7,0,0,10,1,0,13,0,0,0
50773,33347,2021-06-24T13:18:31.5600861Z,2021,22,6,17,10,0,5to,1,0,12,0,0,16,5,0,21,1,0,0
50773,33348,2021-06-24T13:18:31.5600861Z,2021,16,4,12,3,0,K,1,0,13,0,0,12,4,0,15,0,0,0
50773,33349,2021-06-24T13:18:31.5600861Z,2021,5,0,4,2,0,PK,0,0,3,0,0,5,1,0,5,0,0,0
50773,9337,2020-11-18T16:21:57.9977056Z,2020,21,7,13,11,0,1ro,1,1,10,0,0,14,8,0,20,0,0,0
50773,9338,2020-11-18T16:21:57.9977056Z,2020,14,2,14,7,0,2do,0,0,7,0,0,12,0,0,14,1,0,0
50773,9339,2020-11-18T16:21:57.9977056Z,2020,18,7,15,7,0,3ro,0,2,11,0,0,11,3,0,18,0,0,0
50773,9340,2020-11-18T16:21:57.998706Z,2020,27,7,23,11,0,4to,3,3,16,0,0,20,4,0,24,1,0,0
50773,9341,2020-11-18T16:21:57.998706Z,2020,19,8,15,11,0,5to,0,2,8,0,0,11,4,0,19,1,0,0
50773,9342,2020-11-18T16:21:57.998706Z,2020,26,6,19,11,0,K,1,5,15,0,0,20,7,0,25,1,0,0
50773,9343,2020-11-18T16:21:57.9997069Z,2020,12,0,7,3,0,PK,1,0,9,0,0,12,5,0,11,0,0,0
53512,33710,2021-06-24T13:18:35.2297172Z,2021,18,3,16,10,0,1ro,1,0,8,0,0,15,2,0,17,0,0,0
53512,33711,2021-06-24T13:18:35.2297172Z,2021,24,4,20,13,0,2do,1,0,11,0,0,20,4,0,23,0,0,0
53512,33712,2021-06-24T13:18:35.2297172Z,2021,34,12,26,21,0,3ro,0,1,13,0,0,22,8,0,34,0,0,0
53512,33713,2021-06-24T13:18:35.2307181Z,2021,27,8,23,11,0,4to,0,0,16,0,0,19,4,0,27,0,0,0
53512,33714,2021-06-24T13:18:35.2307181Z,2021,40,12,32,19,0,5to,0,2,21,0,0,28,8,0,40,0,1,0
53512,33715,2021-06-24T13:18:35.2307181Z,2021,21,3,15,7,0,K,0,0,14,0,0,18,6,0,21,0,0,0
53512,33716,2021-06-24T13:18:35.2307181Z,2021,13,13,12,1,0,Sin Grado,0,1,12,0,0,0,1,0,13,0,0,0
53512,3686,2020-11-18T16:21:04.3369245Z,2019,37,15,32,23,0,1ro,0,0,14,0,0,22,5,0,37,0,0,0
53512,3687,2020-11-18T16:21:04.3379249Z,2019,32,7,26,15,0,2do,0,0,17,0,1,25,6,0,32,0,0,0
53512,3688,2020-11-18T16:21:04.3379249Z,2019,39,11,35,18,0,3ro,0,0,21,0,0,28,4,0,39,0,2,0
53512,3689,2020-11-18T16:21:04.3379249Z,2019,45,19,37,22,0,4to,0,0,23,0,0,26,8,0,45,2,0,0
53512,3690,2020-11-18T16:21:04.3379249Z,2019,39,10,30,22,0,5to,0,0,17,0,0,29,9,0,39,0,1,0
53512,3691,2020-11-18T16:21:04.3389254Z,2019,19,2,15,13,0,K,0,0,6,0,0,17,4,0,19,0,0,0
53512,3692,2020-11-18T16:21:04.3389254Z,2019,24,22,20,4,0,Sin Grado,0,0,20,0,0,2,4,0,24,0,0,0
53512,9704,2020-11-18T16:22:00.1071146Z,2020,24,5,18,13,0,1ro,0,0,11,0,0,19,6,0,24,0,0,0
53512,9705,2020-11-18T16:22:00.1071146Z,2020,41,17,32,25,0,2do,0,1,16,0,0,24,9,0,41,0,0,0
53512,9706,2020-11-18T16:22:00.1071146Z,2020,32,8,27,15,0,3ro,0,0,17,0,0,24,5,0,32,0,0,0
53512,9707,2020-11-18T16:22:00.1081155Z,2020,46,13,42,22,0,4to,0,2,24,0,0,33,4,0,46,0,2,0
53512,9708,2020-11-18T16:22:00.1081155Z,2020,49,21,41,22,0,5to,0,3,27,0,0,28,8,0,49,2,0,0
53512,9709,2020-11-18T16:22:00.1081155Z,2020,20,3,16,11,0,K,0,1,9,0,0,17,4,0,20,0,0,0
53512,9710,2020-11-18T16:22:00.1091146Z,2020,19,19,15,3,0,Sin Grado,0,2,16,0,0,0,4,0,19,0,0,0
61689,10350,2020-11-18T16:22:03.7545447Z,2020,55,9,50,26,0,1ro,1,0,29,0,0,46,5,0,53,0,0,1
61689,10351,2020-11-18T16:22:03.7545447Z,2020,51,17,42,27,0,2do,6,1,24,0,0,34,9,1,44,0,0,0
61689,10352,2020-11-18T16:22:03.7545447Z,2020,46,15,37,24,0,3ro,3,1,22,0,0,31,9,0,43,0,1,0
61689,10353,2020-11-18T16:22:03.7545447Z,2020,47,20,40,27,0,4to,2,0,20,0,0,27,7,0,44,0,0,1
61689,10354,2020-11-18T16:22:03.7555447Z,2020,60,18,51,35,0,5to,3,1,25,0,0,42,9,0,57,1,0,0
61689,10355,2020-11-18T16:22:03.7555447Z,2020,35,16,30,19,0,6to,4,0,16,0,0,19,5,0,31,1,0,0
61689,10356,2020-11-18T16:22:03.7555447Z,2020,50,14,49,21,0,K,1,2,29,0,0,36,1,0,49,0,0,0
61689,10357,2020-11-18T16:22:03.7555447Z,2020,16,4,14,6,0,PK,0,0,10,0,0,12,2,0,16,0,0,0
61689,34365,2021-06-24T13:18:38.629155Z,2021,48,18,45,24,0,1ro,0,1,24,0,0,30,3,0,48,0,0,0
61689,34366,2021-06-24T13:18:38.629155Z,2021,53,12,47,24,0,2do,1,0,29,0,0,41,6,0,51,0,0,1
61689,34367,2021-06-24T13:18:38.6301555Z,2021,53,21,48,32,0,3ro,5,0,21,0,0,32,5,1,47,0,0,0
61689,34368,2021-06-24T13:18:38.6301555Z,2021,48,21,42,27,0,4to,5,0,21,0,0,27,6,0,43,0,0,0
61689,34369,2021-06-24T13:18:38.6301555Z,2021,40,17,35,25,0,5to,2,1,15,0,0,23,5,0,37,0,0,1
61689,34370,2021-06-24T13:18:38.631156Z,2021,53,19,48,30,0,6to,3,0,23,0,0,34,5,0,50,1,0,0
61689,34371,2021-06-24T13:18:38.631156Z,2021,40,9,35,17,0,K,2,0,23,0,0,31,5,0,38,0,0,0
61689,34372,2021-06-24T13:18:38.631156Z,2021,15,3,13,9,0,PK,0,0,6,0,0,12,2,0,15,0,0,0
61689,4337,2020-11-18T16:21:09.6974967Z,2019,54,16,47,31,0,1ro,6,1,23,0,0,38,7,1,47,0,0,0
61689,4338,2020-11-18T16:21:09.6984967Z,2019,53,20,47,24,0,2do,2,1,29,0,0,33,6,0,51,0,1,0
61689,4339,2020-11-18T16:21:09.6984967Z,2019,51,19,42,28,0,3ro,3,1,23,0,0,32,9,0,47,0,0,1
61689,4340,2020-11-18T16:21:09.6984967Z,2019,58,19,53,31,0,4to,2,0,27,0,0,39,5,0,56,1,0,0
61689,4341,2020-11-18T16:21:09.6984967Z,2019,60,21,49,31,0,5to,7,0,29,0,0,39,11,0,53,1,0,0
61689,4342,2020-11-18T16:21:09.6994984Z,2019,32,15,28,14,0,6to,1,0,18,0,0,17,4,0,31,0,1,0
61689,4343,2020-11-18T16:21:09.6994984Z,2019,50,9,45,26,0,K,1,0,24,0,0,41,5,0,49,0,0,0
61689,4344,2020-11-18T16:21:09.6994984Z,2019,16,6,12,9,0,PK,0,3,7,0,0,10,4,0,16,0,0,0
62810,10493,2020-11-18T16:22:04.1558125Z,2020,38,13,37,19,0,1ro,4,0,19,0,0,25,1,0,34,0,0,0
62810,10494,2020-11-18T16:22:04.1558125Z,2020,34,11,32,20,0,2do,4,0,14,0,0,23,2,0,30,0,0,0
62810,10495,2020-11-18T16:22:04.1568125Z,2020,22,12,21,13,0,3ro,1,0,9,0,0,10,1,0,21,0,0,0
62810,10496,2020-11-18T16:22:04.1568125Z,2020,36,16,34,20,0,4to,6,0,16,0,0,20,2,0,30,0,0,0
62810,10497,2020-11-18T16:22:04.1578134Z,2020,35,14,27,15,0,5to,6,0,20,0,0,21,8,1,28,0,1,0
62810,10498,2020-11-18T16:22:04.1578134Z,2020,30,8,28,17,0,K,6,0,13,0,0,22,2,0,24,0,0,0
62810,10499,2020-11-18T16:22:04.1578134Z,2020,33,2,24,18,0,PK,0,0,15,0,0,31,9,0,33,0,0,0
62810,34506,2021-06-24T13:18:40.2002816Z,2021,31,8,29,15,0,1ro,4,0,16,0,0,23,2,0,27,0,0,0
62810,34507,2021-06-24T13:18:40.2002816Z,2021,29,13,27,12,0,2do,2,0,17,0,0,16,2,0,27,0,0,0
62810,34508,2021-06-24T13:18:40.2002816Z,2021,29,9,29,15,0,3ro,5,0,14,0,0,20,0,0,24,0,0,0
62810,34509,2021-06-24T13:18:40.2002816Z,2021,19,7,17,14,0,4to,2,0,5,0,0,12,2,0,17,0,0,0
62810,34510,2021-06-24T13:18:40.2012825Z,2021,32,16,30,17,0,5to,6,0,15,0,0,16,2,0,26,0,0,0
62810,34511,2021-06-24T13:18:40.2012825Z,2021,30,7,25,16,0,K,1,0,14,0,0,23,5,0,29,0,0,0
62810,34512,2021-06-24T13:18:40.2012825Z,2021,8,0,6,4,0,PK,0,0,4,0,0,8,2,0,8,0,0,0
62810,4483,2020-11-18T16:21:10.146796Z,2019,38,13,35,18,0,1ro,3,0,20,0,0,25,3,0,35,0,0,0
62810,4484,2020-11-18T16:21:10.146796Z,2019,25,11,24,16,0,2do,1,0,9,0,0,14,1,0,24,0,0,0
62810,4485,2020-11-18T16:21:10.146796Z,2019,40,19,37,21,0,3ro,5,0,19,0,0,21,3,0,35,0,0,0
62810,4486,2020-11-18T16:21:10.1477974Z,2019,35,12,28,14,0,4to,5,0,21,0,0,23,7,1,29,0,1,0
62810,4487,2020-11-18T16:21:10.1477974Z,2019,38,17,35,19,0,5to,3,0,19,0,0,21,3,2,33,0,0,0
62810,4488,2020-11-18T16:21:10.1477974Z,2019,24,8,22,17,0,K,1,0,7,0,0,16,2,0,23,0,0,0
62810,4489,2020-11-18T16:21:10.1477974Z,2019,27,4,20,14,0,PK,0,0,13,0,0,23,7,0,27,0,0,0
75820,11614,2020-11-18T16:22:11.722862Z,2020,40,13,36,24,0,1ro,0,0,16,0,0,27,4,0,40,0,0,0
75820,11615,2020-11-18T16:22:11.7238611Z,2020,44,13,43,17,0,2do,0,0,27,0,0,31,1,0,44,0,0,0
75820,11616,2020-11-18T16:22:11.7238611Z,2020,32,10,30,19,0,3ro,3,0,13,0,0,22,2,0,29,0,0,0
75820,11617,2020-11-18T16:22:11.7238611Z,2020,33,10,22,20,0,4to,0,0,13,0,0,23,11,0,33,1,0,0
75820,11618,2020-11-18T16:22:11.7238611Z,2020,41,12,35,17,0,5to,1,0,24,0,0,29,6,0,40,0,0,0
75820,11619,2020-11-18T16:22:11.7238611Z,2020,44,10,38,25,0,K,0,0,19,0,0,34,6,0,44,0,0,0
75820,11620,2020-11-18T16:22:11.724862Z,2020,24,3,11,17,0,PK,0,0,7,0,0,21,13,0,24,0,0,0
75820,11621,2020-11-18T16:22:11.724862Z,2020,4,4,4,2,0,Sin Grado,0,0,2,0,0,0,0,0,4,0,0,0
75820,35637,2021-06-24T13:18:47.3784299Z,2021,52,14,44,25,0,1ro,0,0,27,0,0,38,8,0,52,0,0,0
75820,35638,2021-06-24T13:18:47.3784299Z,2021,41,14,35,24,0,2do,0,0,17,0,0,27,6,0,41,0,0,0
75820,35639,2021-06-24T13:18:47.3794299Z,2021,48,20,40,16,0,3ro,1,0,32,0,0,28,8,0,47,0,0,0
75820,35640,2021-06-24T13:18:47.3794299Z,2021,30,9,28,20,0,4to,3,0,10,0,0,21,2,0,27,0,0,0
75820,35641,2021-06-24T13:18:47.3794299Z,2021,34,10,26,20,0,5to,0,0,14,0,0,24,8,0,34,1,0,0
75820,35642,2021-06-24T13:18:47.3794299Z,2021,37,9,29,20,0,K,0,0,17,0,0,28,8,0,37,0,0,0
75820,35643,2021-06-24T13:18:47.3804317Z,2021,11,2,9,6,0,PK,2,0,5,0,0,9,2,0,9,0,0,0
75820,35644,2021-06-24T13:18:47.3804317Z,2021,3,3,3,1,0,Sin Grado,0,0,2,0,0,0,0,0,3,0,0,0
75820,5607,2020-11-18T16:21:16.6071071Z,2019,51,22,49,20,0,1ro,2,2,31,0,0,29,2,0,49,0,0,0
75820,5608,2020-11-18T16:21:16.6071071Z,2019,38,11,36,23,0,2do,2,0,15,0,0,27,2,0,36,0,0,0
75820,5609,2020-11-18T16:21:16.6081071Z,2019,37,15,29,24,0,3ro,0,1,13,0,0,22,8,0,37,0,0,0
75820,5610,2020-11-18T16:21:16.6081071Z,2019,37,12,31,17,0,4to,1,0,20,0,0,25,6,0,36,0,0,0
75820,5611,2020-11-18T16:21:16.6081071Z,2019,33,16,31,14,0,5to,0,0,19,0,0,17,2,0,33,0,0,0
75820,5612,2020-11-18T16:21:16.6081071Z,2019,37,7,35,27,0,K,0,2,10,0,0,30,2,0,37,0,0,0
75820,5613,2020-11-18T16:21:16.6091066Z,2019,23,4,20,15,0,PK,0,1,8,0,0,19,3,0,23,0,0,0
75820,5614,2020-11-18T16:21:16.6091066Z,2019,3,3,3,2,0,Sin Grado,0,0,1,0,0,0,0,0,3,0,0,0
48264,3203,2020-11-18T16:21:01.435989Z,2019,174,69,122,89,0,10mo,2,0,85,0,0,105,52,0,171,0,0,1
48264,3204,2020-11-18T16:21:01.435989Z,2019,155,44,102,73,0,11mo,3,1,82,0,0,111,53,1,151,0,2,0
48264,3205,2020-11-18T16:21:01.4369903Z,2019,159,0,95,78,0,12mo,3,0,81,0,0,159,64,1,155,0,0,0
48264,3206,2020-11-18T16:21:01.4369903Z,2019,200,65,143,109,0,9no,2,0,91,0,0,135,57,1,197,0,0,0
48264,3207,2020-11-18T16:21:01.4369903Z,2019,2,1,1,1,0,Sin Grado,0,0,1,0,0,1,1,0,2,0,0,0
48264,33228,2021-06-24T13:18:30.8715924Z,2021,166,55,130,71,0,10mo,3,0,95,0,0,111,36,0,163,0,1,0
48264,33229,2021-06-24T13:18:30.8715924Z,2021,181,58,124,97,0,11mo,2,0,84,0,0,123,57,1,178,0,0,0
48264,33230,2021-06-24T13:18:30.8715924Z,2021,159,56,110,83,0,12mo,2,0,76,0,0,103,49,0,157,0,0,0
48264,33231,2021-06-24T13:18:30.8725929Z,2021,152,40,119,76,0,9no,3,0,76,0,0,112,33,0,149,0,1,0
48264,33232,2021-06-24T13:18:30.8725929Z,2021,25,25,20,8,0,Sin Grado,0,0,17,0,0,0,5,0,25,0,0,0
48264,9224,2020-11-18T16:21:57.3172532Z,2020,183,62,140,96,0,10mo,2,0,87,0,0,121,43,1,180,0,0,0
48264,9225,2020-11-18T16:21:57.3172532Z,2020,175,68,121,91,0,11mo,2,1,84,0,0,107,54,0,172,0,0,1
48264,9226,2020-11-18T16:21:57.3182554Z,2020,129,42,88,57,0,12mo,1,0,72,0,0,87,41,1,127,0,1,0
48264,9227,2020-11-18T16:21:57.3182554Z,2020,162,57,128,66,0,9no,1,0,96,0,0,105,34,0,161,0,1,0
70581,11067,2020-11-18T16:22:07.634131Z,2020,40,14,36,14,0,10mo,2,0,26,0,0,26,4,0,38,0,0,0
70581,11068,2020-11-18T16:22:07.6351309Z,2020,57,10,38,38,0,11mo,6,0,19,0,0,47,19,0,51,0,0,0
70581,11069,2020-11-18T16:22:07.6351309Z,2020,59,17,46,23,0,12mo,3,0,36,0,0,42,13,0,56,0,0,0
70581,11070,2020-11-18T16:22:07.6351309Z,2020,59,13,46,33,0,6to,3,0,26,0,0,46,13,0,56,0,0,0
70581,11071,2020-11-18T16:22:07.6351309Z,2020,61,23,52,28,0,7mo,0,0,33,0,0,38,9,0,61,0,0,0
70581,11072,2020-11-18T16:22:07.6361318Z,2020,57,22,44,23,0,8vo,2,0,34,0,0,35,13,0,55,0,0,0
70581,11073,2020-11-18T16:22:07.6361318Z,2020,64,26,46,32,0,9no,4,0,32,0,0,38,18,0,59,0,0,1
70581,35088,2021-06-24T13:18:43.7178036Z,2021,56,20,44,27,0,10mo,2,1,29,0,0,36,12,0,53,0,0,1
70581,35089,2021-06-24T13:18:43.7178036Z,2021,38,14,36,10,0,11mo,2,0,28,0,0,24,2,0,36,0,0,0
70581,35090,2021-06-24T13:18:43.7178036Z,2021,48,9,36,33,0,12mo,4,0,15,0,0,39,12,0,44,0,0,0
70581,35091,2021-06-24T13:18:43.7178036Z,2021,62,17,56,35,0,6to,6,0,27,0,0,45,6,0,56,0,1,0
70581,35092,2021-06-24T13:18:43.7188046Z,2021,57,16,49,29,0,7mo,3,0,28,0,0,41,8,0,54,0,0,0
70581,35093,2021-06-24T13:18:43.7188046Z,2021,59,21,50,26,0,8vo,0,0,33,0,0,38,9,0,59,0,0,0
70581,35094,2021-06-24T13:18:43.7188046Z,2021,85,28,76,38,0,9no,5,1,47,0,0,57,9,0,80,0,0,0
70581,5060,2020-11-18T16:21:13.4329912Z,2019,69,14,50,47,0,10mo,5,0,22,0,0,55,19,0,64,0,0,0
70581,5061,2020-11-18T16:21:13.4329912Z,2019,67,18,50,28,0,11mo,2,1,39,0,1,49,17,0,65,0,0,0
70581,5062,2020-11-18T16:21:13.4329912Z,2019,79,0,53,35,0,12mo,2,0,44,0,0,79,26,0,77,0,0,0
70581,5063,2020-11-18T16:21:13.4329912Z,2019,64,23,50,31,0,6to,1,0,33,0,0,41,14,0,63,0,0,0
70581,5064,2020-11-18T16:21:13.4339917Z,2019,46,21,33,17,0,7mo,0,0,29,0,0,25,13,0,46,0,0,0
70581,5065,2020-11-18T16:21:13.4339917Z,2019,60,19,47,28,0,8vo,1,1,32,0,0,41,13,0,58,0,0,1
70581,5066,2020-11-18T16:21:13.4339917Z,2019,49,18,41,18,0,9no,2,1,31,0,0,31,8,0,47,0,0,0
70581,5067,2020-11-18T16:21:13.4339917Z,2019,4,1,4,1,0,Sin Grado,0,1,3,0,0,3,0,0,4,0,0,0
20909,1105,2020-11-18T16:20:44.6197765Z,2019,110,43,92,54,0,6to,0,0,56,0,0,67,18,0,110,0,1,0
20909,1106,2020-11-18T16:20:44.6197765Z,2019,124,57,96,61,0,7mo,0,0,63,0,0,67,28,0,124,0,0,0
20909,1107,2020-11-18T16:20:44.6197765Z,2019,95,37,84,48,0,8vo,2,0,47,0,0,58,11,0,93,0,0,0
20909,31105,2021-06-24T13:18:13.0287919Z,2021,127,52,97,55,0,6to,4,0,72,0,0,75,30,0,123,1,0,0
20909,31106,2021-06-24T13:18:13.0287919Z,2021,113,48,96,50,0,7mo,2,0,63,0,0,65,17,0,111,0,0,0
20909,31107,2021-06-24T13:18:13.0287919Z,2021,124,42,94,56,0,8vo,1,0,68,0,0,82,30,0,123,0,1,0
20909,31108,2021-06-24T13:18:13.0287919Z,2021,13,13,10,6,0,Sin Grado,0,0,7,0,0,0,3,1,12,0,0,0
20909,7109,2020-11-18T16:21:44.1864975Z,2020,97,45,86,43,0,6to,2,2,54,0,0,52,11,0,95,0,0,0
20909,7110,2020-11-18T16:21:44.1874979Z,2020,125,44,106,59,0,7mo,1,0,66,0,0,81,19,0,123,0,1,1
20909,7111,2020-11-18T16:21:44.1874979Z,2020,117,52,91,59,0,8vo,0,1,58,0,0,65,26,0,116,0,1,1
20909,7112,2020-11-18T16:21:44.1874979Z,2020,8,8,6,4,0,Sin Grado,0,0,4,0,0,0,2,0,8,0,0,0
63099,10602,2020-11-18T16:22:05.3275955Z,2020,39,12,39,22,0,1ro,2,1,17,0,0,27,0,0,36,0,0,1
63099,10603,2020-11-18T16:22:05.3275955Z,2020,23,4,23,12,0,2do,0,0,11,0,0,19,0,0,22,0,0,1
63099,10604,2020-11-18T16:22:05.3275955Z,2020,25,7,24,13,0,3ro,0,0,12,0,0,18,1,0,25,0,0,0
63099,10605,2020-11-18T16:22:05.3285955Z,2020,15,8,15,8,0,4to,0,1,7,0,0,7,0,0,15,0,0,0
63099,10606,2020-11-18T16:22:05.3285955Z,2020,19,7,18,12,0,5to,0,0,7,0,0,12,1,0,19,0,0,0
63099,10607,2020-11-18T16:22:05.3285955Z,2020,29,6,29,13,0,K,0,1,16,0,0,23,0,0,29,0,0,0
63099,10608,2020-11-18T16:22:05.3285955Z,2020,30,30,30,10,0,Sin Grado,1,2,20,0,0,0,0,0,29,0,0,0
63099,34617,2021-06-24T13:18:41.0799121Z,2021,23,3,23,10,0,1ro,0,0,13,0,0,20,0,0,23,0,0,0
63099,34618,2021-06-24T13:18:41.0799121Z,2021,31,11,26,17,0,2do,0,0,14,0,0,20,5,0,31,0,0,0
63099,34619,2021-06-24T13:18:41.0799121Z,2021,19,7,15,8,0,3ro,0,0,11,0,0,12,4,0,18,0,0,1
63099,34620,2021-06-24T13:18:41.0809135Z,2021,22,6,20,15,0,4to,0,0,7,0,0,16,2,0,22,0,0,0
63099,34621,2021-06-24T13:18:41.0809135Z,2021,14,9,12,9,0,5to,0,0,5,0,0,5,2,0,14,0,0,0
63099,34622,2021-06-24T13:18:41.0809135Z,2021,17,5,8,13,0,K,0,0,4,0,0,12,9,0,17,0,0,0
63099,34623,2021-06-24T13:18:41.0809135Z,2021,15,14,13,2,0,Sin Grado,1,0,13,0,0,1,2,0,14,0,0,0
63099,4590,2020-11-18T16:21:10.8462631Z,2019,54,13,53,28,0,1ro,0,0,26,0,0,41,1,0,53,0,0,1
63099,4591,2020-11-18T16:21:10.8462631Z,2019,30,9,30,17,0,2do,0,2,13,0,0,21,0,0,30,0,0,0
63099,4592,2020-11-18T16:21:10.8472649Z,2019,23,11,23,13,0,3ro,0,0,10,0,0,12,0,0,22,0,0,1
63099,4593,2020-11-18T16:21:10.8472649Z,2019,27,8,25,16,0,4to,0,0,11,0,0,19,2,0,27,0,0,0
63099,4594,2020-11-18T16:21:10.8482648Z,2019,17,7,16,11,0,5to,0,2,6,0,0,10,1,0,17,0,0,0
63099,4595,2020-11-18T16:21:10.8482648Z,2019,1,0,1,0,0,6to,0,0,1,0,0,1,0,0,1,0,0,0
63099,4596,2020-11-18T16:21:10.8482648Z,2019,26,8,16,15,0,K,0,0,11,0,0,18,10,0,26,0,0,0
63099,4597,2020-11-18T16:21:10.8492657Z,2019,36,34,36,13,0,Sin Grado,0,1,23,0,0,2,0,0,36,0,0,0
71134,11234,2020-11-18T16:22:09.5854333Z,2020,47,20,28,25,0,1ro,0,0,22,0,0,27,19,0,47,0,0,0
71134,11235,2020-11-18T16:22:09.5854333Z,2020,33,17,23,19,0,2do,1,0,14,0,0,16,10,0,32,0,0,0
71134,11236,2020-11-18T16:22:09.5854333Z,2020,36,15,34,18,0,3ro,0,0,18,0,0,21,2,0,36,0,0,0
71134,11237,2020-11-18T16:22:09.5864333Z,2020,35,20,29,16,0,4to,0,0,19,0,0,15,6,0,35,0,0,0
71134,11238,2020-11-18T16:22:09.5864333Z,2020,29,8,25,16,0,5to,0,0,13,0,0,21,4,0,29,0,0,0
71134,11239,2020-11-18T16:22:09.5864333Z,2020,42,19,36,17,0,K,0,0,25,0,0,23,6,0,42,0,0,0
71134,11240,2020-11-18T16:22:09.5864333Z,2020,22,17,14,7,0,Sin Grado,0,0,15,0,0,5,8,0,22,0,0,0
71134,35255,2021-06-24T13:18:44.8255987Z,2021,42,17,36,18,0,1ro,0,0,24,0,0,25,6,0,42,0,0,0
71134,35256,2021-06-24T13:18:44.8255987Z,2021,44,19,38,27,0,2do,0,0,17,0,0,25,6,0,44,0,0,0
71134,35257,2021-06-24T13:18:44.8255987Z,2021,37,15,31,21,0,3ro,1,0,16,0,0,22,6,0,36,0,0,0
71134,35258,2021-06-24T13:18:44.8255987Z,2021,34,15,28,17,0,4to,0,0,17,0,0,19,6,0,34,0,0,0
71134,35259,2021-06-24T13:18:44.8266001Z,2021,36,19,33,17,0,5to,0,0,19,0,0,17,3,0,36,0,0,0
71134,35260,2021-06-24T13:18:44.8266001Z,2021,31,13,18,15,0,K,0,0,16,0,0,18,13,0,31,0,0,0
71134,35261,2021-06-24T13:18:44.8266001Z,2021,17,13,12,4,0,Sin Grado,0,0,13,0,0,4,5,0,17,0,0,0
71134,5229,2020-11-18T16:21:14.4446631Z,2019,44,20,41,30,0,1ro,1,0,14,0,0,24,3,0,43,0,0,0
71134,5230,2020-11-18T16:21:14.4446631Z,2019,38,11,36,18,0,2do,0,0,20,0,0,27,2,0,38,0,0,0
71134,5231,2020-11-18T16:21:14.4456631Z,2019,42,21,37,18,0,3ro,1,0,24,0,0,21,5,0,41,0,0,0
71134,5232,2020-11-18T16:21:14.4456631Z,2019,35,12,31,16,0,4to,0,0,19,0,0,23,4,0,35,0,0,0
71134,5233,2020-11-18T16:21:14.4456631Z,2019,28,9,21,16,0,5to,0,0,12,0,0,19,7,0,28,0,0,0
71134,5234,2020-11-18T16:21:14.4456631Z,2019,42,17,36,20,0,K,0,0,22,0,0,25,6,0,42,0,0,0
71134,5235,2020-11-18T16:21:14.4456631Z,2019,22,20,17,5,0,Sin Grado,0,1,17,0,0,2,5,0,22,0,0,0
31583,1977,2020-11-18T16:20:53.4116374Z,2019,23,5,21,10,0,1ro,0,0,13,0,0,18,2,0,23,0,0,0
31583,1978,2020-11-18T16:20:53.4116374Z,2019,25,5,20,10,0,2do,0,0,15,0,0,20,5,0,25,0,0,0
31583,1979,2020-11-18T16:20:53.4116374Z,2019,22,9,19,11,0,3ro,0,0,11,0,0,13,3,0,22,0,0,0
31583,1980,2020-11-18T16:20:53.4116374Z,2019,28,8,26,13,0,4to,0,0,15,0,0,20,2,0,28,0,0,0
31583,1981,2020-11-18T16:20:53.4126392Z,2019,29,9,27,12,0,5to,0,0,17,0,0,20,2,1,28,0,0,0
31583,1982,2020-11-18T16:20:53.4126392Z,2019,34,11,30,17,0,6to,0,0,17,0,0,23,4,0,34,0,0,0
31583,1983,2020-11-18T16:20:53.4126392Z,2019,30,10,25,14,0,7mo,1,0,16,0,0,20,5,0,29,0,0,0
31583,1984,2020-11-18T16:20:53.4136387Z,2019,16,4,13,5,0,8vo,0,0,11,0,0,12,3,0,16,0,0,0
31583,1985,2020-11-18T16:20:53.4136387Z,2019,15,4,12,8,0,K,0,0,7,0,0,11,3,0,15,0,0,0
31583,1986,2020-11-18T16:20:53.4136387Z,2019,20,2,16,10,0,PK,0,0,10,0,0,18,4,0,19,0,0,1
31583,31985,2021-06-24T13:18:18.6988576Z,2021,22,2,20,11,0,1ro,0,0,11,0,0,20,2,0,21,0,0,1
31583,31986,2021-06-24T13:18:18.6988576Z,2021,15,5,12,9,0,2do,0,0,6,0,0,10,3,0,14,0,0,1
31583,31987,2021-06-24T13:18:18.6988576Z,2021,23,3,22,9,0,3ro,0,0,14,0,0,20,1,0,23,0,0,0
31583,31988,2021-06-24T13:18:18.6988576Z,2021,23,9,19,10,0,4to,0,0,13,0,0,14,4,0,23,0,0,0
31583,31989,2021-06-24T13:18:18.6998617Z,2021,13,3,11,7,0,5to,0,0,6,0,0,10,2,0,13,0,0,0
31583,31990,2021-06-24T13:18:18.6998617Z,2021,33,8,30,15,0,6to,0,0,18,0,0,25,3,0,33,0,0,0
31583,31991,2021-06-24T13:18:18.6998617Z,2021,31,10,26,10,0,7mo,0,0,21,0,0,21,5,0,31,0,0,0
31583,31992,2021-06-24T13:18:18.700859Z,2021,30,10,27,14,0,8vo,0,0,16,0,0,20,3,0,30,0,0,0
31583,31993,2021-06-24T13:18:18.700859Z,2021,21,7,18,14,0,K,0,0,7,0,0,14,3,0,20,0,0,1
31583,31994,2021-06-24T13:18:18.700859Z,2021,15,0,15,3,0,PK,0,0,12,0,0,15,0,0,15,0,0,0
31583,7989,2020-11-18T16:21:49.1458058Z,2020,14,3,11,8,0,1ro,0,0,6,0,0,11,3,0,13,0,0,1
31583,7990,2020-11-18T16:21:49.1458058Z,2020,22,4,20,9,0,2do,0,0,13,0,0,18,2,0,21,0,0,1
31583,7991,2020-11-18T16:21:49.1458058Z,2020,21,7,15,10,0,3ro,0,0,11,0,0,14,6,0,21,0,0,0
31583,7992,2020-11-18T16:21:49.1458058Z,2020,14,4,10,8,0,4to,0,0,6,0,0,10,4,0,14,0,0,0
31583,7993,2020-11-18T16:21:49.1468049Z,2020,26,7,23,11,0,5to,0,0,15,0,0,19,3,0,26,0,0,0
31583,7994,2020-11-18T16:21:49.1468049Z,2020,31,11,23,11,0,6to,0,0,20,0,0,20,8,0,31,0,0,0
31583,7995,2020-11-18T16:21:49.1468049Z,2020,31,10,27,15,0,7mo,0,0,16,0,0,21,4,0,31,0,0,0
31583,7996,2020-11-18T16:21:49.1478058Z,2020,24,9,17,12,0,8vo,1,0,12,0,0,15,7,0,23,0,0,0
31583,7997,2020-11-18T16:21:49.1478058Z,2020,21,2,19,10,0,K,0,0,11,0,0,19,2,0,21,0,0,0
31583,7998,2020-11-18T16:21:49.1478058Z,2020,12,1,10,12,0,PK,0,0,0,0,0,11,2,0,11,0,0,1
35071,2313,2020-11-18T16:20:55.7872234Z,2019,67,22,56,33,0,1ro,1,1,34,0,0,45,11,0,66,0,0,0
35071,2314,2020-11-18T16:20:55.7872234Z,2019,56,16,41,27,0,2do,3,0,29,0,0,40,15,0,53,0,0,0
35071,2315,2020-11-18T16:20:55.7872234Z,2019,73,14,48,39,0,3ro,2,0,34,0,0,59,25,0,71,0,0,0
35071,2316,2020-11-18T16:20:55.7882234Z,2019,63,14,49,35,0,4to,5,0,28,0,0,49,14,0,58,0,0,0
35071,2317,2020-11-18T16:20:55.7882234Z,2019,64,15,37,31,0,5to,1,1,33,0,0,49,27,0,63,0,0,0
35071,2318,2020-11-18T16:20:55.7882234Z,2019,41,6,34,18,0,K,0,0,23,0,0,35,7,0,41,0,0,0
35071,2319,2020-11-18T16:20:55.7882234Z,2019,2,2,2,0,0,Sin Grado,0,0,2,0,0,0,0,0,2,0,0,0
35071,32320,2021-06-24T13:18:23.2781412Z,2021,52,13,41,25,0,1ro,0,0,27,0,0,39,11,0,52,0,0,0
35071,32321,2021-06-24T13:18:23.2781412Z,2021,48,10,44,20,0,2do,0,1,28,0,0,38,4,0,48,0,0,0
35071,32322,2021-06-24T13:18:23.2781412Z,2021,74,20,61,36,0,3ro,1,0,38,0,0,54,13,0,73,0,0,0
35071,32323,2021-06-24T13:18:23.2791417Z,2021,66,19,56,29,0,4to,3,0,37,0,0,47,10,0,63,0,0,0
35071,32324,2021-06-24T13:18:23.2791417Z,2021,82,15,67,39,0,5to,2,0,43,0,0,67,15,0,80,0,0,0
35071,32325,2021-06-24T13:18:23.2791417Z,2021,45,7,42,29,0,K,0,1,16,0,0,38,3,0,45,0,0,0
35071,32326,2021-06-24T13:18:23.2791417Z,2021,3,3,3,1,0,Sin Grado,0,0,2,0,0,0,0,0,3,0,0,0
35071,8325,2020-11-18T16:21:51.3963044Z,2020,53,12,42,21,0,1ro,0,0,32,0,0,41,11,0,53,0,0,0
35071,8326,2020-11-18T16:21:51.3963044Z,2020,67,16,52,32,0,2do,1,0,35,0,0,51,15,0,66,0,0,0
35071,8327,2020-11-18T16:21:51.3963044Z,2020,63,18,47,29,0,3ro,3,0,34,0,0,45,16,0,60,0,0,0
35071,8328,2020-11-18T16:21:51.3963044Z,2020,74,15,50,40,0,4to,2,0,34,0,0,59,24,0,72,0,0,0
35071,8329,2020-11-18T16:21:51.3973053Z,2020,61,15,46,31,0,5to,6,0,30,0,0,46,15,0,55,0,0,0
35071,8330,2020-11-18T16:21:51.3973053Z,2020,47,7,36,24,0,K,0,0,23,0,0,40,11,0,47,0,0,0
35071,8331,2020-11-18T16:21:51.3973053Z,2020,2,2,2,0,0,Sin Grado,0,0,2,0,0,0,0,0,2,0,0,0
66209,10767,2020-11-18T16:22:06.0280634Z,2020,99,14,69,64,0,10mo,2,0,35,0,0,85,30,0,97,0,0,0
66209,10768,2020-11-18T16:22:06.0280634Z,2020,129,31,99,70,0,11mo,5,2,59,0,0,98,30,0,124,0,0,0
66209,10769,2020-11-18T16:22:06.0280634Z,2020,122,32,83,55,0,12mo,3,1,67,0,0,90,39,1,118,0,0,0
66209,10770,2020-11-18T16:22:06.0290652Z,2020,147,35,121,69,0,9no,3,0,78,0,0,112,26,0,143,0,0,1
66209,10771,2020-11-18T16:22:06.0290652Z,2020,7,7,6,0,0,Sin Grado,0,0,7,0,0,0,1,0,7,0,0,0
66209,34784,2021-06-24T13:18:41.5012149Z,2021,125,26,106,63,0,10mo,3,0,62,0,0,99,19,0,122,0,0,0
66209,34785,2021-06-24T13:18:41.5022154Z,2021,93,11,73,60,0,11mo,2,0,33,0,0,82,20,1,90,0,0,0
66209,34786,2021-06-24T13:18:41.5022154Z,2021,115,29,93,63,0,12mo,5,2,52,0,0,86,22,0,110,0,0,0
66209,34787,2021-06-24T13:18:41.5032163Z,2021,86,25,78,50,0,9no,0,0,36,0,0,61,8,0,86,1,0,0
66209,34788,2021-06-24T13:18:41.5032163Z,2021,8,8,7,0,0,Sin Grado,0,0,8,0,0,0,1,0,8,0,0,0
66209,4759,2020-11-18T16:21:11.9149779Z,2019,127,27,95,66,0,10mo,3,1,61,0,0,100,32,0,124,0,0,0
66209,4760,2020-11-18T16:21:11.9149779Z,2019,130,36,99,56,0,11mo,5,0,74,0,0,94,31,0,125,0,0,0
66209,4761,2020-11-18T16:21:11.9149779Z,2019,127,0,96,66,0,12mo,3,0,61,0,0,127,31,0,124,0,0,0
66209,4762,2020-11-18T16:21:11.9149779Z,2019,122,29,94,67,0,9no,1,0,55,0,0,93,28,0,121,0,0,0
66209,4763,2020-11-18T16:21:11.9149779Z,2019,4,4,3,0,0,Sin Grado,0,0,4,0,0,0,1,0,4,0,0,0
66233,10779,2020-11-18T16:22:06.0320661Z,2020,64,10,58,32,0,1ro,0,0,32,0,0,54,6,0,64,0,0,0
66233,10780,2020-11-18T16:22:06.0320661Z,2020,59,18,51,30,0,2do,5,0,29,0,0,41,8,0,53,0,0,1
66233,10781,2020-11-18T16:22:06.0330665Z,2020,51,16,49,25,0,3ro,1,0,26,0,0,35,2,0,49,0,0,1
66233,10782,2020-11-18T16:22:06.0330665Z,2020,50,16,47,26,0,4to,0,0,24,0,0,34,3,0,50,0,0,0
66233,10783,2020-11-18T16:22:06.0330665Z,2020,43,18,39,27,0,5to,0,0,16,0,0,25,4,0,43,0,0,0
66233,10784,2020-11-18T16:22:06.0330665Z,2020,68,18,60,34,0,K,1,0,34,0,0,50,8,0,67,0,0,0
66233,10785,2020-11-18T16:22:06.034067Z,2020,10,10,9,3,0,Sin Grado,0,0,7,0,0,0,1,0,10,0,0,0
66233,34796,2021-06-24T13:18:41.5062178Z,2021,62,19,57,29,0,1ro,1,0,33,0,0,43,5,0,61,0,0,0
66233,34797,2021-06-24T13:18:41.5062178Z,2021,63,14,58,33,0,2do,0,0,30,0,0,49,5,0,63,0,0,0
66233,34798,2021-06-24T13:18:41.5062178Z,2021,56,19,51,29,0,3ro,5,0,27,0,0,37,5,0,50,0,0,1
66233,34799,2021-06-24T13:18:41.5072183Z,2021,49,15,46,22,0,4to,0,0,27,0,0,34,3,0,48,0,0,1
66233,34800,2021-06-24T13:18:42.2147259Z,2021,48,17,44,23,0,5to,0,0,25,0,0,31,4,0,48,0,0,0
66233,34801,2021-06-24T13:18:42.2147259Z,2021,62,12,58,35,0,K,0,0,27,0,0,50,4,0,62,0,0,0
66233,34802,2021-06-24T13:18:42.2147259Z,2021,11,11,10,3,0,Sin Grado,0,0,8,0,0,0,1,0,11,0,0,0
66233,4771,2020-11-18T16:21:11.920981Z,2019,68,24,60,33,0,1ro,6,0,35,0,0,44,8,0,62,0,0,0
66233,4772,2020-11-18T16:21:11.9219819Z,2019,45,16,43,20,0,2do,0,0,25,0,0,29,2,0,45,0,0,0
66233,4773,2020-11-18T16:21:11.9219819Z,2019,52,17,49,23,0,3ro,1,0,29,0,0,35,3,0,51,0,0,0
66233,4774,2020-11-18T16:21:11.9219819Z,2019,50,21,41,29,0,4to,0,0,21,0,0,29,9,0,50,0,0,0
66233,4775,2020-11-18T16:21:11.9219819Z,2019,41,12,32,17,0,5to,0,0,24,0,0,29,9,0,41,1,0,0
66233,4776,2020-11-18T16:21:11.9219819Z,2019,51,8,44,23,0,K,0,0,28,0,0,43,7,0,51,0,0,0
66233,4777,2020-11-18T16:21:11.9229832Z,2019,9,9,8,2,0,Sin Grado,0,0,7,0,0,0,1,0,9,0,0,0
46813,3095,2020-11-18T16:21:00.3502644Z,2019,45,19,44,21,0,1ro,1,0,24,0,0,26,1,0,44,0,0,0
46813,3096,2020-11-18T16:21:00.3502644Z,2019,34,10,32,11,0,2do,1,0,23,0,0,24,2,0,33,0,0,0
46813,3097,2020-11-18T16:21:00.3512657Z,2019,30,13,28,13,0,3ro,0,0,17,0,0,17,2,0,30,0,0,0
46813,3098,2020-11-18T16:21:00.3512657Z,2019,41,20,36,19,0,4to,2,0,22,0,0,21,5,0,39,0,1,0
46813,3099,2020-11-18T16:21:00.3512657Z,2019,41,16,33,26,0,5to,0,0,15,0,0,25,8,0,41,0,1,0
46813,3100,2020-11-18T16:21:00.3522657Z,2019,31,9,28,16,0,K,0,0,15,0,0,22,3,0,31,0,0,0
46813,3101,2020-11-18T16:21:01.0047016Z,2019,19,18,17,7,0,Sin Grado,0,0,12,0,0,1,2,0,19,0,0,0
46813,33107,2021-06-24T13:18:30.3051867Z,2021,28,10,25,12,0,1ro,1,0,16,0,0,18,3,0,27,0,0,0
46813,33108,2021-06-24T13:18:30.3051867Z,2021,31,14,31,16,0,2do,1,0,15,0,0,17,0,0,30,0,0,0
46813,33109,2021-06-24T13:18:30.3061872Z,2021,42,18,41,21,0,3ro,1,0,21,0,0,24,1,0,41,0,0,0
46813,33110,2021-06-24T13:18:30.3061872Z,2021,32,11,26,11,0,4to,0,0,21,0,0,21,6,0,32,0,0,0
46813,33111,2021-06-24T13:18:30.3061872Z,2021,30,14,29,9,0,5to,0,0,21,0,0,16,1,0,30,0,0,0
46813,33112,2021-06-24T13:18:30.3061872Z,2021,17,6,16,8,0,K,0,0,9,0,0,11,1,0,17,0,0,0
46813,33113,2021-06-24T13:18:30.3061872Z,2021,21,21,19,7,0,Sin Grado,0,0,14,0,0,0,2,0,21,0,0,0
46813,9109,2020-11-18T16:21:56.1274614Z,2020,32,9,32,16,0,1ro,0,0,16,0,0,23,0,0,32,0,0,0
46813,9110,2020-11-18T16:21:56.1284618Z,2020,41,18,37,20,0,2do,2,0,21,0,0,23,4,0,39,0,0,0
46813,9111,2020-11-18T16:21:56.1284618Z,2020,37,11,35,13,0,3ro,1,0,24,0,0,26,2,0,36,0,0,0
46813,9112,2020-11-18T16:21:56.1284618Z,2020,30,16,28,13,0,4to,0,0,17,0,0,14,2,0,30,0,0,0
46813,9113,2020-11-18T16:21:56.1284618Z,2020,39,19,33,18,0,5to,2,0,21,0,0,20,6,0,37,0,0,0
46813,9114,2020-11-18T16:21:56.1284618Z,2020,27,8,22,9,0,K,1,0,18,0,0,19,5,0,26,0,0,0
46813,9115,2020-11-18T16:21:56.1294627Z,2020,27,27,22,11,0,Sin Grado,0,0,16,0,0,0,5,0,27,0,0,0
58180,10051,2020-11-18T16:22:01.9443402Z,2020,171,27,117,107,0,10mo,0,5,64,0,0,144,54,1,170,0,0,0
58180,10052,2020-11-18T16:22:01.9443402Z,2020,142,23,95,76,0,11mo,2,10,66,0,0,119,47,0,140,0,0,0
58180,10053,2020-11-18T16:22:01.9443402Z,2020,181,27,110,101,0,12mo,0,5,80,0,0,154,71,0,181,0,0,0
58180,10054,2020-11-18T16:22:01.9443402Z,2020,156,27,99,78,0,9no,1,5,78,0,0,129,57,1,154,0,1,0
58180,34058,2021-06-24T13:18:36.9579571Z,2021,150,26,99,80,0,10mo,0,0,70,0,0,124,51,0,150,0,0,0
58180,34059,2021-06-24T13:18:36.9589576Z,2021,166,28,119,105,0,11mo,0,0,61,0,0,138,47,0,166,0,0,0
58180,34060,2021-06-24T13:18:36.9589576Z,2021,137,23,96,71,0,12mo,1,0,66,0,0,114,41,0,136,0,0,0
58180,34061,2021-06-24T13:18:36.9589576Z,2021,138,24,104,69,0,9no,1,0,69,0,0,114,34,0,137,0,0,0
58180,34062,2021-06-24T13:18:36.9589576Z,2021,1,1,0,0,0,Sin Grado,0,0,1,0,0,0,1,0,1,0,0,0
58180,4033,2020-11-18T16:21:07.2938968Z,2019,143,24,101,70,0,10mo,1,6,73,0,0,119,42,0,142,0,1,0
58180,4034,2020-11-18T16:21:07.2938968Z,2019,186,28,112,103,0,11mo,0,12,83,0,0,158,74,0,186,0,0,0
58180,4035,2020-11-18T16:21:07.2948972Z,2019,203,0,126,99,0,12mo,0,8,104,0,0,203,77,0,203,0,0,0
58180,4036,2020-11-18T16:21:07.2948972Z,2019,177,30,110,115,0,9no,1,7,62,0,0,147,67,1,175,0,1,0
50781,3324,2020-11-18T16:21:02.1364578Z,2019,26,8,22,12,0,1ro,1,8,14,0,0,18,4,0,25,0,1,0
50781,3325,2020-11-18T16:21:02.1364578Z,2019,18,2,14,7,0,2do,0,4,11,0,0,16,4,0,18,0,0,0
50781,3326,2020-11-18T16:21:02.1374587Z,2019,28,10,22,12,0,3ro,0,11,16,0,0,18,6,0,28,2,1,0
50781,3327,2020-11-18T16:21:02.1374587Z,2019,14,6,7,6,0,4to,0,1,8,0,0,8,7,0,14,0,0,0
50781,3328,2020-11-18T16:21:02.1374587Z,2019,15,6,13,4,0,5to,0,6,11,0,0,9,2,0,15,0,0,0
50781,3329,2020-11-18T16:21:02.1384592Z,2019,25,1,20,8,0,K,0,4,17,0,0,24,5,0,25,0,0,0
50781,3330,2020-11-18T16:21:02.1384592Z,2019,16,1,14,10,0,PK,0,5,6,0,0,15,2,0,16,0,0,0
50781,3331,2020-11-18T16:21:02.1384592Z,2019,12,12,11,7,0,Sin Grado,0,1,5,0,0,0,1,0,12,0,0,0
50781,33350,2021-06-24T13:18:31.5670918Z,2021,12,1,12,8,0,1ro,0,0,4,0,0,11,0,0,12,0,0,0
50781,33351,2021-06-24T13:18:31.5670918Z,2021,22,2,20,9,0,2do,0,6,13,0,0,20,2,0,22,0,0,0
50781,33352,2021-06-24T13:18:31.5680923Z,2021,19,7,15,5,0,3ro,1,6,14,0,0,12,4,0,18,0,1,0
50781,33353,2021-06-24T13:18:31.5680923Z,2021,15,5,13,3,0,4to,0,4,12,0,0,10,2,0,15,0,0,0
50781,33354,2021-06-24T13:18:31.5680923Z,2021,24,7,21,11,0,5to,0,10,13,0,0,17,3,0,24,2,1,0
50781,33355,2021-06-24T13:18:31.5690923Z,2021,14,6,12,7,0,K,0,1,7,0,0,8,2,0,14,0,0,0
50781,33356,2021-06-24T13:18:31.5690923Z,2021,11,2,8,5,0,PK,0,1,6,0,0,9,3,0,11,0,0,0
50781,33357,2021-06-24T13:18:31.5690923Z,2021,10,10,8,5,0,Sin Grado,0,0,5,0,0,0,2,0,10,0,0,0
50781,9344,2020-11-18T16:21:58.0007069Z,2020,26,3,20,13,0,1ro,0,10,13,0,0,23,6,0,26,0,0,0
50781,9345,2020-11-18T16:21:58.0007069Z,2020,22,4,20,7,0,2do,1,8,15,0,0,18,2,0,21,0,1,0
50781,9346,2020-11-18T16:21:58.0017078Z,2020,20,6,16,6,0,3ro,0,6,14,0,0,14,4,0,20,0,0,0
50781,9347,2020-11-18T16:21:58.0017078Z,2020,26,8,21,11,0,4to,0,11,15,0,0,18,5,0,26,2,1,0
50781,9348,2020-11-18T16:21:58.0017078Z,2020,16,5,10,7,0,5to,0,4,9,0,0,11,6,0,16,0,0,0
50781,9349,2020-11-18T16:21:58.0027091Z,2020,25,3,23,14,0,K,0,5,11,0,0,22,2,0,25,0,0,0
50781,9350,2020-11-18T16:21:58.0027091Z,2020,16,2,15,9,0,PK,0,2,7,0,0,14,1,0,16,0,0,0
50781,9351,2020-11-18T16:21:58.0027091Z,2020,8,8,7,4,0,Sin Grado,0,0,4,0,0,0,1,0,7,0,0,1
42267,2755,2020-11-18T16:20:58.7541989Z,2019,58,29,56,28,0,1ro,4,0,30,0,0,29,2,0,54,0,0,0
42267,2756,2020-11-18T16:20:58.7551989Z,2019,49,11,45,22,0,2do,2,0,27,0,0,38,4,0,47,1,0,0
42267,2757,2020-11-18T16:20:58.7551989Z,2019,51,25,49,25,0,3ro,1,0,26,0,0,26,2,0,50,0,0,0
42267,2758,2020-11-18T16:20:58.7551989Z,2019,46,23,42,19,0,4to,1,0,27,0,0,23,4,0,45,0,0,0
42267,2759,2020-11-18T16:20:58.7551989Z,2019,56,17,52,28,0,5to,1,0,28,0,0,39,4,0,55,0,0,0
42267,2760,2020-11-18T16:20:58.7551989Z,2019,76,29,70,33,0,6to,2,0,43,0,0,47,6,0,74,0,1,0
42267,2761,2020-11-18T16:20:58.756202Z,2019,89,30,76,42,0,7mo,4,0,47,0,0,59,13,0,85,1,0,0
42267,2762,2020-11-18T16:20:58.756202Z,2019,85,24,69,41,0,8vo,0,0,44,0,0,61,16,0,85,0,0,0
42267,2763,2020-11-18T16:20:58.756202Z,2019,33,13,32,17,0,K,0,0,16,0,0,20,1,0,33,0,0,0
42267,2764,2020-11-18T16:20:58.756202Z,2019,3,3,3,1,0,Sin Grado,0,0,2,0,0,0,0,0,3,0,0,0
42267,32762,2021-06-24T13:18:27.1789441Z,2021,37,14,36,19,0,1ro,1,0,18,0,0,23,1,0,36,0,0,0
42267,32763,2021-06-24T13:18:27.1789441Z,2021,28,14,28,12,0,2do,3,0,16,0,0,14,0,0,25,0,0,0
42267,32764,2021-06-24T13:18:27.1799446Z,2021,53,23,49,31,0,3ro,2,0,22,0,0,30,4,0,51,0,0,0
42267,32765,2021-06-24T13:18:27.1799446Z,2021,51,20,47,27,0,4to,2,0,24,0,0,31,4,0,49,1,0,0
42267,32766,2021-06-24T13:18:27.1799446Z,2021,43,21,41,14,0,5to,1,0,29,0,0,22,2,0,42,0,0,0
42267,32767,2021-06-24T13:18:27.180946Z,2021,63,27,60,33,0,6to,1,0,30,0,0,36,3,0,62,0,0,0
42267,32768,2021-06-24T13:18:27.180946Z,2021,68,21,62,37,0,7mo,3,0,31,0,0,47,6,0,65,0,0,0
42267,32769,2021-06-24T13:18:27.180946Z,2021,71,23,67,34,0,8vo,2,0,37,0,0,48,4,0,69,0,0,0
42267,32770,2021-06-24T13:18:27.1819469Z,2021,26,5,25,16,0,K,0,0,10,0,0,21,1,0,26,0,0,0
42267,32771,2021-06-24T13:18:27.1819469Z,2021,3,3,3,1,0,Sin Grado,0,0,2,0,0,0,0,0,3,0,0,0
42267,8766,2020-11-18T16:21:53.814919Z,2020,30,17,29,12,0,1ro,0,0,18,0,0,13,1,0,30,0,0,0
42267,8767,2020-11-18T16:21:53.8159181Z,2020,53,26,52,30,0,2do,3,0,23,0,0,27,1,0,50,0,0,0
42267,8768,2020-11-18T16:21:53.8159181Z,2020,50,20,46,26,0,3ro,2,0,24,0,0,30,4,0,48,1,0,0
42267,8769,2020-11-18T16:21:53.8159181Z,2020,45,22,44,18,0,4to,3,0,27,0,0,23,1,0,42,0,0,0
42267,8770,2020-11-18T16:21:53.8159181Z,2020,46,21,44,21,0,5to,0,0,25,0,0,25,2,0,45,0,0,1
42267,8771,2020-11-18T16:21:53.8159181Z,2020,68,21,64,36,0,6to,3,0,32,0,0,47,4,0,65,0,0,0
42267,8772,2020-11-18T16:21:53.8169181Z,2020,71,28,67,33,0,7mo,0,0,38,0,0,43,4,0,71,0,1,0
42267,8773,2020-11-18T16:21:53.8169181Z,2020,89,31,77,43,0,8vo,5,0,46,0,0,58,12,0,84,1,0,0
42267,8774,2020-11-18T16:21:53.8169181Z,2020,46,17,46,25,0,K,1,0,21,0,0,29,0,0,45,0,0,0
42267,8775,2020-11-18T16:21:53.8169181Z,2020,3,3,3,1,0,Sin Grado,0,0,2,0,0,0,0,0,3,0,0,0
62604,10451,2020-11-18T16:22:04.1438049Z,2020,53,14,52,36,0,1ro,0,0,17,0,0,39,1,0,53,0,0,0
62604,10452,2020-11-18T16:22:04.1438049Z,2020,74,27,74,31,0,2do,1,0,43,0,0,47,0,1,72,0,0,0
62604,10453,2020-11-18T16:22:04.1448054Z,2020,64,19,61,35,0,3ro,2,0,29,0,0,45,3,1,61,0,1,0
62604,10454,2020-11-18T16:22:04.1448054Z,2020,48,13,46,25,0,4to,1,0,23,0,0,35,2,0,46,0,0,1
62604,10455,2020-11-18T16:22:04.1458072Z,2020,63,9,61,38,0,5to,0,0,25,0,0,54,2,2,61,1,2,0
62604,10456,2020-11-18T16:22:04.1458072Z,2020,62,14,62,29,0,K,0,0,33,0,0,48,0,0,62,0,0,0
62604,10457,2020-11-18T16:22:04.1458072Z,2020,1,1,0,0,0,PK,0,0,1,0,0,0,1,0,1,0,0,0
62604,10458,2020-11-18T16:22:04.1468067Z,2020,27,24,27,11,0,Sin Grado,0,1,16,0,0,3,0,0,27,0,0,0
62604,34465,2021-06-24T13:18:39.4837683Z,2021,54,16,53,28,0,1ro,2,0,26,0,0,38,1,0,52,0,0,0
62604,34466,2021-06-24T13:18:39.4837683Z,2021,43,15,43,25,0,2do,0,0,18,0,0,28,0,0,43,0,0,0
62604,34467,2021-06-24T13:18:39.4837683Z,2021,56,18,55,23,0,3ro,1,0,33,0,0,38,1,0,55,0,0,0
62604,34468,2021-06-24T13:18:39.4847683Z,2021,51,13,50,31,0,4to,2,0,20,0,0,38,1,0,49,0,0,0
62604,34469,2021-06-24T13:18:39.4847683Z,2021,39,8,39,22,0,5to,0,0,17,0,0,31,0,0,39,0,0,0
62604,34470,2021-06-24T13:18:39.4847683Z,2021,23,6,23,10,0,K,0,0,13,0,0,17,0,0,23,0,0,0
62604,34471,2021-06-24T13:18:39.4847683Z,2021,36,32,36,9,0,Sin Grado,1,0,27,0,0,4,0,0,35,0,0,0
62604,4439,2020-11-18T16:21:10.1367894Z,2019,80,21,80,35,0,1ro,2,0,45,0,0,59,0,1,77,0,0,0
62604,4440,2020-11-18T16:21:10.1367894Z,2019,79,26,76,45,0,2do,2,2,34,0,0,53,3,1,76,0,1,0
62604,4441,2020-11-18T16:21:10.1367894Z,2019,64,13,62,31,0,3ro,1,0,33,0,0,51,2,0,62,0,0,1
62604,4442,2020-11-18T16:21:10.1367894Z,2019,63,12,62,39,0,4to,0,0,24,0,0,51,1,2,60,1,2,1
62604,4443,2020-11-18T16:21:10.1367894Z,2019,46,11,46,27,0,5to,0,0,19,0,0,35,0,0,46,0,0,0
62604,4444,2020-11-18T16:21:10.1377916Z,2019,1,0,1,0,0,6to,0,0,1,0,0,1,0,0,1,0,0,0
62604,4445,2020-11-18T16:21:10.1377916Z,2019,45,14,43,33,0,K,0,0,12,0,0,31,2,0,45,0,0,0
62604,4446,2020-11-18T16:21:10.1377916Z,2019,34,31,33,10,0,Sin Grado,0,1,24,0,0,3,1,0,34,0,0,0
63107,10609,2020-11-18T16:22:05.3275955Z,2020,43,13,39,18,0,1ro,3,0,25,0,0,30,4,0,40,0,0,0
63107,10610,2020-11-18T16:22:05.3285955Z,2020,59,23,55,30,0,2do,7,3,29,0,0,36,4,0,51,0,0,1
63107,10611,2020-11-18T16:22:05.3285955Z,2020,56,22,49,29,0,3ro,7,1,27,0,0,34,7,0,49,0,0,0
63107,10612,2020-11-18T16:22:05.3285955Z,2020,54,13,52,26,0,4to,11,0,28,0,0,41,2,0,43,0,0,0
63107,10613,2020-11-18T16:22:05.3285955Z,2020,62,17,58,39,0,5to,10,0,23,0,0,45,4,0,52,0,0,0
63107,10614,2020-11-18T16:22:05.3285955Z,2020,46,9,46,19,0,K,4,2,27,0,0,37,0,0,42,0,0,0
63107,10615,2020-11-18T16:22:05.3295959Z,2020,13,13,12,2,0,Sin Grado,3,0,11,0,0,0,1,0,10,0,0,0
63107,34624,2021-06-24T13:18:41.0869174Z,2021,43,15,39,18,0,1ro,3,1,25,0,0,28,4,0,40,0,0,0
63107,34625,2021-06-24T13:18:41.0869174Z,2021,37,12,35,19,0,2do,4,0,18,0,0,25,2,0,33,0,0,0
63107,34626,2021-06-24T13:18:41.0869174Z,2021,54,26,54,27,0,3ro,2,1,27,0,0,28,0,0,51,0,0,1
63107,34627,2021-06-24T13:18:41.0879183Z,2021,56,23,54,28,0,4to,7,2,28,0,0,33,2,0,49,0,0,0
63107,34628,2021-06-24T13:18:41.0879183Z,2021,50,12,49,26,0,5to,9,0,24,0,0,38,1,0,41,0,0,0
63107,34629,2021-06-24T13:18:41.0879183Z,2021,47,7,46,24,0,K,0,0,23,0,0,40,1,0,47,0,0,0
63107,34630,2021-06-24T13:18:41.0879183Z,2021,11,11,9,3,0,Sin Grado,2,0,8,0,0,0,2,0,9,0,0,0
63107,4598,2020-11-18T16:21:10.8432617Z,2019,64,27,63,30,0,1ro,6,1,34,0,0,37,1,0,57,0,0,1
63107,4599,2020-11-18T16:21:10.8432617Z,2019,65,28,60,35,0,2do,8,4,30,0,0,37,5,0,57,0,0,0
63107,4600,2020-11-18T16:21:10.8432617Z,2019,55,19,55,26,0,3ro,7,0,29,0,0,36,0,0,48,0,0,0
63107,4601,2020-11-18T16:21:11.2355229Z,2019,62,20,56,35,0,4to,10,0,27,0,0,42,6,0,52,0,0,0
63107,4602,2020-11-18T16:21:11.2365255Z,2019,57,22,54,29,0,5to,6,0,28,0,0,35,3,0,51,0,0,0
63107,4603,2020-11-18T16:21:11.2365255Z,2019,44,14,41,17,0,K,2,0,27,0,0,30,3,0,42,0,0,0
63107,4604,2020-11-18T16:21:11.2365255Z,2019,9,8,9,6,0,Sin Grado,0,0,3,0,0,1,0,0,9,0,0,0
70870,11145,2020-11-18T16:22:08.3265915Z,2020,14,4,14,6,0,1ro,0,1,8,0,0,10,0,0,14,0,0,0
70870,11146,2020-11-18T16:22:08.3265915Z,2020,19,8,17,6,0,2do,0,2,13,0,0,11,2,0,19,0,0,0
70870,11147,2020-11-18T16:22:08.3275928Z,2020,39,12,37,21,0,3ro,1,0,18,0,0,27,2,0,38,0,0,0
70870,11148,2020-11-18T16:22:08.3275928Z,2020,36,12,28,21,0,4to,0,0,15,0,0,24,8,0,36,0,0,0
70870,11149,2020-11-18T16:22:08.3275928Z,2020,48,12,43,29,0,5to,1,0,19,0,0,36,5,0,47,0,0,0
70870,11150,2020-11-18T16:22:08.3275928Z,2020,101,31,85,51,0,6to,0,4,50,0,0,70,16,0,101,0,0,0
70870,11151,2020-11-18T16:22:08.3275928Z,2020,115,43,101,54,0,7mo,1,6,61,0,0,72,14,0,114,0,0,0
70870,11152,2020-11-18T16:22:08.3285941Z,2020,107,24,87,61,0,8vo,0,1,46,0,0,83,20,0,107,0,0,0
70870,11153,2020-11-18T16:22:08.3285941Z,2020,22,6,19,9,0,K,0,0,13,0,0,16,3,0,22,0,0,0
70870,11154,2020-11-18T16:22:08.3285941Z,2020,20,20,17,4,0,Sin Grado,1,0,16,0,0,0,3,0,19,0,0,0
70870,35166,2021-06-24T13:18:44.553403Z,2021,25,6,24,11,0,1ro,0,0,14,0,0,19,1,0,25,0,0,0
70870,35167,2021-06-24T13:18:44.5544031Z,2021,15,3,15,9,0,2do,1,1,6,0,0,12,0,0,14,0,0,0
70870,35168,2021-06-24T13:18:44.5544031Z,2021,19,10,18,6,0,3ro,0,0,13,0,0,9,1,0,19,0,0,0
70870,35169,2021-06-24T13:18:44.5544031Z,2021,36,10,35,21,0,4to,1,0,15,0,0,26,1,0,35,0,0,0
70870,35170,2021-06-24T13:18:44.5554045Z,2021,34,12,31,20,0,5to,1,0,14,0,0,22,3,0,33,0,0,0
70870,35171,2021-06-24T13:18:44.5554045Z,2021,101,27,88,55,0,6to,1,0,46,0,0,74,13,0,100,0,0,0
70870,35172,2021-06-24T13:18:44.5554045Z,2021,102,31,94,55,0,7mo,0,3,47,0,0,71,8,0,102,0,0,0
70870,35173,2021-06-24T13:18:44.5554045Z,2021,111,43,96,52,0,8vo,1,4,59,0,0,68,15,0,110,0,0,0
70870,35174,2021-06-24T13:18:44.5564054Z,2021,19,7,18,11,0,K,1,0,8,0,0,12,1,0,18,0,0,0
70870,35175,2021-06-24T13:18:44.5564054Z,2021,23,23,22,6,0,Sin Grado,0,0,17,0,0,0,1,0,23,0,0,0
70870,5139,2020-11-18T16:21:14.0353925Z,2019,19,7,17,6,0,1ro,0,2,13,0,0,12,2,0,19,0,0,0
70870,5140,2020-11-18T16:21:14.0353925Z,2019,32,11,31,16,0,2do,1,0,16,0,0,21,1,0,31,0,0,0
70870,5141,2020-11-18T16:21:14.0353925Z,2019,40,11,32,23,0,3ro,0,3,17,0,0,29,8,0,40,0,0,0
70870,5142,2020-11-18T16:21:14.0353925Z,2019,45,12,40,28,0,4to,1,1,17,0,0,33,5,0,44,0,0,0
70870,5143,2020-11-18T16:21:14.0353925Z,2019,46,13,41,26,0,5to,0,4,20,0,0,33,5,0,46,0,0,0
70870,5144,2020-11-18T16:21:14.036393Z,2019,123,47,99,54,0,6to,2,8,69,0,0,76,24,0,121,0,0,0
70870,5145,2020-11-18T16:21:14.036393Z,2019,112,27,87,64,0,7mo,0,1,48,0,0,85,25,0,112,0,0,0
70870,5146,2020-11-18T16:21:14.036393Z,2019,135,43,115,72,0,8vo,0,1,63,0,0,92,20,0,135,0,0,0
70870,5147,2020-11-18T16:21:14.037393Z,2019,13,5,12,5,0,K,0,3,8,0,0,8,1,0,13,0,0,0
70870,5148,2020-11-18T16:21:14.037393Z,2019,18,18,14,2,0,Sin Grado,0,0,16,0,0,0,4,0,18,0,0,0
21832,1254,2020-11-18T16:20:45.087088Z,2019,34,7,16,2,0,10mo,0,0,32,0,0,27,18,0,34,0,0,0
21832,1255,2020-11-18T16:20:45.0880884Z,2019,18,3,14,0,0,11mo,0,0,18,0,0,15,4,0,18,0,0,0
21832,1256,2020-11-18T16:20:45.0880884Z,2019,10,0,5,0,0,12mo,0,0,10,0,0,10,5,0,10,0,0,0
21832,1257,2020-11-18T16:20:45.0880884Z,2019,22,5,12,0,0,9no,0,0,22,0,0,17,10,0,22,0,0,0
21832,31255,2021-06-24T13:18:14.0195031Z,2021,25,6,15,0,0,10mo,0,0,25,0,0,19,10,0,25,1,0,0
21832,31256,2021-06-24T13:18:14.0205036Z,2021,23,6,17,0,0,11mo,0,0,23,0,0,17,6,0,23,0,0,0
21832,31257,2021-06-24T13:18:14.0205036Z,2021,25,7,19,1,0,12mo,0,0,24,0,0,18,6,0,25,0,0,0
21832,31258,2021-06-24T13:18:14.0205036Z,2021,21,4,15,0,0,9no,0,1,21,0,0,17,6,0,21,0,0,0
21832,7259,2020-11-18T16:21:44.5967711Z,2020,25,5,14,0,0,10mo,0,0,25,0,0,20,11,0,25,0,0,0
21832,7260,2020-11-18T16:21:44.5977715Z,2020,29,7,17,1,0,11mo,0,0,28,0,0,22,12,0,29,0,0,0
21832,7261,2020-11-18T16:21:44.5977715Z,2020,18,3,15,0,0,12mo,0,1,18,0,0,15,3,0,18,0,0,0
21832,7262,2020-11-18T16:21:44.5977715Z,2020,25,5,10,0,0,9no,0,0,25,0,0,20,15,0,25,1,0,0
63024,10573,2020-11-18T16:22:04.9303303Z,2020,40,16,33,23,0,1ro,0,3,17,0,0,24,7,0,39,0,0,1
63024,10574,2020-11-18T16:22:04.9303303Z,2020,36,21,32,17,0,2do,1,9,19,0,0,15,4,0,35,0,0,0
63024,10575,2020-11-18T16:22:04.9313308Z,2020,38,18,33,16,0,3ro,0,4,22,0,0,20,5,0,38,0,0,0
63024,10576,2020-11-18T16:22:04.9313308Z,2020,36,14,30,22,0,4to,1,2,14,0,0,22,6,0,35,0,0,0
63024,10577,2020-11-18T16:22:04.9313308Z,2020,23,14,20,12,0,5to,0,1,11,0,0,9,3,0,23,0,0,0
63024,10578,2020-11-18T16:22:04.9313308Z,2020,11,4,8,5,0,6to,0,0,6,0,0,7,3,0,11,0,0,0
63024,10579,2020-11-18T16:22:04.9323312Z,2020,41,12,33,18,0,K,0,2,23,0,0,29,8,0,41,0,0,0
63024,10580,2020-11-18T16:22:04.9323312Z,2020,36,8,27,15,0,PK,0,2,21,0,0,28,9,0,36,0,0,0
63024,34587,2021-06-24T13:18:40.2573232Z,2021,43,18,37,20,0,1ro,0,2,23,0,0,25,6,0,43,0,0,0
63024,34588,2021-06-24T13:18:40.2573232Z,2021,39,15,36,23,0,2do,0,1,16,0,0,24,3,0,38,0,0,1
63024,34589,2021-06-24T13:18:40.2573232Z,2021,32,21,28,14,0,3ro,1,4,18,0,0,11,4,0,31,0,0,0
63024,34590,2021-06-24T13:18:40.2583228Z,2021,40,20,37,17,0,4to,0,1,23,0,0,20,3,0,40,0,0,0
63024,34591,2021-06-24T13:18:40.2583228Z,2021,33,15,28,21,0,5to,1,2,12,0,0,18,5,0,32,0,0,0
63024,34592,2021-06-24T13:18:40.2583228Z,2021,25,13,23,14,0,6to,0,0,11,0,0,12,2,0,25,0,0,0
63024,34593,2021-06-24T13:18:40.2593237Z,2021,10,3,9,5,0,7mo,0,0,5,0,0,7,1,0,10,0,0,0
63024,34594,2021-06-24T13:18:40.2593237Z,2021,40,12,36,17,0,K,0,1,23,0,0,28,4,1,39,0,0,0
63024,34595,2021-06-24T13:18:40.2593237Z,2021,36,4,23,20,0,PK,0,0,16,0,0,32,13,0,36,0,0,0
63024,4562,2020-11-18T16:21:10.8402599Z,2019,38,24,32,15,0,1ro,1,8,23,0,0,14,6,0,37,0,0,0
63024,4563,2020-11-18T16:21:10.8402599Z,2019,42,17,36,21,0,2do,0,6,21,0,0,25,6,0,42,0,0,0
63024,4564,2020-11-18T16:21:10.8402599Z,2019,38,15,29,23,0,3ro,1,2,15,0,0,23,9,0,37,0,0,0
63024,4565,2020-11-18T16:21:10.8412595Z,2019,26,14,23,14,0,4to,0,2,12,0,0,12,3,0,26,0,0,0
63024,4566,2020-11-18T16:21:10.8412595Z,2019,12,5,9,6,0,5to,0,0,6,0,0,7,3,0,12,0,0,0
63024,4567,2020-11-18T16:21:10.8412595Z,2019,7,2,6,1,0,6to,0,0,6,0,0,5,1,0,7,0,0,0
63024,4568,2020-11-18T16:21:10.8422608Z,2019,51,17,43,35,0,K,0,0,16,0,0,34,8,0,50,0,0,1
63024,4569,2020-11-18T16:21:10.8422608Z,2019,32,15,23,11,0,PK,0,0,21,0,0,17,9,0,32,0,0,0
66498,10794,2020-11-18T16:22:06.039071Z,2020,86,27,82,45,0,6to,2,0,41,0,0,59,4,0,83,0,1,1
66498,10795,2020-11-18T16:22:06.040071Z,2020,104,30,85,53,0,7mo,2,0,51,0,0,74,19,0,102,0,1,0
66498,10796,2020-11-18T16:22:06.040071Z,2020,114,26,102,58,0,8vo,3,1,56,0,0,88,12,0,111,0,1,0
66498,34811,2021-06-24T13:18:42.2327392Z,2021,85,24,78,44,0,6to,0,0,41,0,0,61,7,0,82,0,0,3
66498,34812,2021-06-24T13:18:42.2337402Z,2021,95,27,85,46,0,7mo,2,0,49,0,0,68,10,0,93,0,0,0
66498,34813,2021-06-24T13:18:42.2337402Z,2021,110,30,98,59,0,8vo,2,0,51,0,0,80,12,0,108,0,1,0
66498,4786,2020-11-18T16:21:11.9309877Z,2019,103,28,88,53,0,6to,4,0,50,0,0,75,15,0,99,0,1,0
66498,4787,2020-11-18T16:21:11.931989Z,2019,110,29,100,54,0,7mo,2,0,56,0,0,81,10,0,108,0,1,0
66498,4788,2020-11-18T16:21:11.931989Z,2019,106,33,91,49,0,8vo,6,0,57,0,0,73,15,0,100,0,1,0
51706,33461,2021-06-24T13:18:32.4837482Z,2021,69,16,61,37,0,1ro,6,0,32,0,0,53,8,0,63,0,1,0
51706,33462,2021-06-24T13:18:32.4837482Z,2021,50,16,43,27,0,2do,2,0,23,0,0,34,7,0,48,0,0,0
51706,33463,2021-06-24T13:18:32.4837482Z,2021,38,19,34,18,0,3ro,0,0,20,0,0,19,4,0,38,0,0,0
51706,33464,2021-06-24T13:18:32.4837482Z,2021,21,7,20,9,0,4to,1,0,12,0,0,14,1,0,20,0,0,0
51706,33465,2021-06-24T13:18:32.4847487Z,2021,63,16,48,26,0,K,0,0,37,0,0,47,15,1,61,0,0,1
51706,33466,2021-06-24T13:18:32.4847487Z,2021,9,3,6,6,0,PK,0,0,3,0,0,6,3,0,9,0,0,0
51706,33467,2021-06-24T13:18:32.4847487Z,2021,26,26,24,8,0,Sin Grado,0,0,18,0,0,0,2,0,26,0,0,0
51706,3437,2020-11-18T16:21:02.5557377Z,2019,79,42,67,38,0,1ro,3,4,41,0,0,37,12,0,76,0,1,0
51706,3438,2020-11-18T16:21:02.5557377Z,2019,50,18,42,21,0,2do,3,1,29,0,0,32,8,0,47,0,0,0
51706,3439,2020-11-18T16:21:02.5567381Z,2019,74,32,54,30,0,3ro,4,0,44,0,1,42,20,0,70,1,0,0
51706,3440,2020-11-18T16:21:02.5567381Z,2019,76,21,59,38,0,K,3,2,38,0,1,55,17,0,73,0,0,0
51706,3441,2020-11-18T16:21:02.5567381Z,2019,16,3,12,9,0,PK,0,1,7,0,0,13,4,0,16,0,0,0
51706,3442,2020-11-18T16:21:02.5567381Z,2019,24,22,23,10,0,Sin Grado,0,2,14,0,0,2,1,0,24,0,0,0
51706,9457,2020-11-18T16:21:58.423989Z,2020,69,22,58,37,0,1ro,4,1,32,0,0,47,11,0,65,0,1,0
51706,9458,2020-11-18T16:21:58.423989Z,2020,42,19,35,23,0,2do,0,2,19,0,0,23,7,0,42,0,0,0
51706,9459,2020-11-18T16:21:58.423989Z,2020,38,14,33,16,0,3ro,2,2,22,0,0,24,5,0,36,0,0,0
51706,9460,2020-11-18T16:21:58.423989Z,2020,31,7,19,18,0,4to,2,1,13,0,0,24,12,0,29,0,0,0
51706,9461,2020-11-18T16:21:58.423989Z,2020,74,18,53,39,0,K,3,1,35,0,0,56,21,0,71,0,0,0
51706,9462,2020-11-18T16:21:58.4249894Z,2020,16,0,11,10,0,PK,0,0,6,0,0,16,5,0,16,0,0,0
51706,9463,2020-11-18T16:21:58.4249894Z,2020,29,29,28,6,0,Sin Grado,0,0,23,0,0,0,1,0,29,0,0,0
47662,3160,2020-11-18T16:21:01.0267167Z,2019,81,17,66,48,0,10mo,8,3,33,0,0,64,15,0,73,0,1,0
47662,3161,2020-11-18T16:21:01.0277181Z,2019,91,20,71,54,0,11mo,6,3,37,0,0,71,20,0,85,1,0,0
47662,3162,2020-11-18T16:21:01.0277181Z,2019,99,1,81,44,0,12mo,1,2,55,0,0,98,18,0,98,0,2,0
47662,3163,2020-11-18T16:21:01.0277181Z,2019,84,28,65,29,0,9no,7,0,55,0,0,56,19,0,77,0,2,0
47662,3164,2020-11-18T16:21:01.0277181Z,2019,5,2,5,2,0,Sin Grado,0,0,3,0,0,3,0,0,5,0,0,0
47662,33177,2021-06-24T13:18:30.345215Z,2021,75,17,65,38,0,10mo,1,0,37,0,0,58,10,0,73,1,0,1
47662,33178,2021-06-24T13:18:30.345215Z,2021,77,23,63,34,0,11mo,3,0,43,0,0,54,14,0,74,0,2,0
47662,33179,2021-06-24T13:18:30.345215Z,2021,85,15,68,44,0,12mo,8,0,41,0,0,70,17,0,77,0,1,0
47662,33180,2021-06-24T13:18:30.3462159Z,2021,105,29,94,52,0,9no,3,0,53,0,0,76,11,0,102,2,1,0
47662,33181,2021-06-24T13:18:30.3462159Z,2021,8,8,7,2,0,Sin Grado,0,0,6,0,0,0,1,0,8,0,0,0
47662,9174,2020-11-18T16:21:56.1524787Z,2020,76,23,61,32,0,10mo,4,0,44,0,0,53,15,0,72,0,2,0
47662,9175,2020-11-18T16:21:56.1524787Z,2020,88,16,68,46,0,11mo,9,0,42,0,0,72,20,0,79,0,1,0
47662,9176,2020-11-18T16:21:56.1524787Z,2020,89,23,70,53,0,12mo,5,0,36,0,0,66,19,0,84,1,0,0
47662,9177,2020-11-18T16:21:56.1534787Z,2020,84,22,67,44,0,9no,1,0,40,0,0,62,17,1,81,1,0,1
47662,9178,2020-11-18T16:21:56.1534787Z,2020,4,4,3,1,0,Sin Grado,0,0,3,0,0,0,1,0,4,0,0,0
42945,2821,2020-11-18T16:20:59.1774814Z,2019,34,11,24,14,0,1ro,0,2,20,0,0,23,10,0,34,0,0,0
42945,2822,2020-11-18T16:20:59.1784823Z,2019,48,12,42,20,0,2do,1,11,28,0,0,36,6,0,47,0,0,0
42945,2823,2020-11-18T16:20:59.1784823Z,2019,39,12,34,19,0,3ro,1,0,20,0,0,27,5,0,38,1,0,0
42945,2824,2020-11-18T16:20:59.1784823Z,2019,53,22,43,27,0,4to,2,1,26,0,0,31,10,0,51,1,0,0
42945,2825,2020-11-18T16:20:59.1784823Z,2019,66,18,53,21,0,5to,2,10,45,0,0,48,13,0,64,1,0,0
42945,2826,2020-11-18T16:20:59.1784823Z,2019,91,18,77,56,0,6to,6,0,35,0,0,73,14,1,84,1,2,0
42945,2827,2020-11-18T16:20:59.1794828Z,2019,111,31,93,51,0,7mo,6,2,60,0,0,80,18,1,104,1,1,0
42945,2828,2020-11-18T16:20:59.1794828Z,2019,93,27,72,46,0,8vo,3,1,47,0,1,66,21,0,89,1,0,1
42945,2829,2020-11-18T16:20:59.1794828Z,2019,46,11,35,22,0,K,1,0,24,0,0,35,11,0,45,1,0,0
42945,2830,2020-11-18T16:20:59.1794828Z,2019,8,8,6,2,0,Sin Grado,0,0,6,0,0,0,2,0,8,0,0,0
42945,32828,2021-06-24T13:18:28.1976751Z,2021,48,12,39,25,0,1ro,0,0,23,0,0,36,9,0,48,0,0,0
42945,32829,2021-06-24T13:18:28.1976751Z,2021,52,22,49,29,0,2do,3,0,23,0,0,30,3,0,49,1,0,0
42945,32830,2021-06-24T13:18:28.1976751Z,2021,42,12,34,16,0,3ro,1,0,26,0,0,30,8,0,41,0,0,0
42945,32831,2021-06-24T13:18:28.1976751Z,2021,51,14,43,23,0,4to,1,0,28,0,0,37,8,0,50,0,0,0
42945,32832,2021-06-24T13:18:28.1976751Z,2021,43,12,39,23,0,5to,1,0,20,0,0,31,4,0,42,1,0,0
42945,32833,2021-06-24T13:18:28.1986755Z,2021,69,28,61,30,0,6to,3,1,39,0,0,41,8,0,66,1,0,0
42945,32834,2021-06-24T13:18:28.1986755Z,2021,106,37,90,37,0,7mo,5,0,69,0,0,69,16,0,101,2,0,0
42945,32835,2021-06-24T13:18:28.1986755Z,2021,91,19,78,57,0,8vo,6,1,34,0,0,72,13,1,84,0,1,0
42945,32836,2021-06-24T13:18:28.1986755Z,2021,40,5,30,17,0,K,1,0,23,0,0,35,10,0,39,0,0,0
42945,32837,2021-06-24T13:18:28.1986755Z,2021,8,8,7,3,0,Sin Grado,0,0,5,0,0,0,1,0,8,0,0,0
42945,8832,2020-11-18T16:21:54.2231891Z,2020,50,15,44,26,0,1ro,1,0,24,0,0,35,6,0,49,1,0,0
42945,8833,2020-11-18T16:21:54.2231891Z,2020,41,12,30,16,0,2do,1,2,25,0,0,29,11,0,40,0,0,0
42945,8834,2020-11-18T16:21:54.22419Z,2020,44,12,37,20,0,3ro,1,2,24,0,0,32,7,0,43,0,0,0
42945,8835,2020-11-18T16:21:54.22419Z,2020,38,10,31,20,0,4to,2,1,18,0,0,28,7,0,36,1,0,0
42945,8836,2020-11-18T16:21:54.22419Z,2020,61,27,52,29,0,5to,3,0,32,0,0,34,9,0,58,1,0,0
42945,8837,2020-11-18T16:21:54.22419Z,2020,74,25,60,23,0,6to,3,5,51,0,0,49,14,0,71,1,1,0
42945,8838,2020-11-18T16:21:54.22419Z,2020,92,18,77,59,0,7mo,6,0,33,0,0,74,15,1,85,0,1,0
42945,8839,2020-11-18T16:21:54.2251904Z,2020,106,27,93,51,0,8vo,6,1,55,0,0,79,13,0,100,2,1,0
42945,8840,2020-11-18T16:21:54.2251904Z,2020,44,10,38,25,0,K,1,2,19,0,0,34,6,0,43,0,0,0
42945,8841,2020-11-18T16:21:54.2251904Z,2020,7,7,7,2,0,Sin Grado,0,0,5,0,0,0,0,0,7,0,0,0
56101,33892,2021-06-24T13:18:35.7711056Z,2021,88,22,80,38,0,6to,2,0,50,0,0,66,8,0,86,0,0,0
56101,33893,2021-06-24T13:18:35.7711056Z,2021,84,23,75,38,0,7mo,1,1,46,0,0,61,9,0,82,0,0,1
56101,33894,2021-06-24T13:18:35.7711056Z,2021,109,29,97,61,0,8vo,1,0,48,0,0,80,12,0,108,0,0,0
56101,3869,2020-11-18T16:21:05.5797519Z,2019,115,35,101,60,0,6to,0,0,55,0,0,80,14,0,115,0,0,0
56101,3870,2020-11-18T16:21:05.5807524Z,2019,123,45,110,64,0,7mo,1,1,59,0,0,78,13,0,122,0,0,0
56101,3871,2020-11-18T16:21:05.5807524Z,2019,118,37,95,56,0,8vo,0,0,62,0,0,81,23,0,118,0,0,0
56101,9886,2020-11-18T16:22:00.5303958Z,2020,90,26,77,40,0,6to,0,0,50,0,0,64,13,0,89,0,0,1
56101,9887,2020-11-18T16:22:00.5303958Z,2020,114,34,95,62,0,7mo,1,1,52,0,0,80,19,0,113,0,0,0
56101,9888,2020-11-18T16:22:00.5313967Z,2020,119,40,95,61,0,8vo,2,1,58,0,0,79,24,0,117,0,0,0
53009,33662,2021-06-24T13:18:33.6816073Z,2021,66,15,59,39,0,6to,3,1,27,0,0,51,7,0,63,0,1,0
53009,33663,2021-06-24T13:18:33.6816073Z,2021,82,17,70,45,0,7mo,1,1,37,0,0,65,12,0,81,0,1,0
53009,33664,2021-06-24T13:18:33.6816073Z,2021,76,24,60,31,0,8vo,1,2,45,0,0,52,16,0,75,0,0,0
53009,33665,2021-06-24T13:18:33.6826078Z,2021,23,23,20,7,0,Sin Grado,0,0,16,0,0,0,3,0,23,0,0,0
53009,3637,2020-11-18T16:21:04.3239156Z,2019,82,26,61,38,0,6to,1,3,44,0,0,56,21,0,81,0,0,0
53009,3638,2020-11-18T16:21:04.3239156Z,2019,102,26,80,46,0,7mo,1,2,56,0,0,76,22,0,101,0,0,0
53009,3639,2020-11-18T16:21:04.3239156Z,2019,97,31,77,52,0,8vo,0,1,45,0,0,66,20,0,97,1,1,0
53009,3640,2020-11-18T16:21:04.3239156Z,2019,17,15,14,5,0,Sin Grado,0,0,12,0,0,2,3,0,17,0,0,0
53009,9656,2020-11-18T16:21:59.4947051Z,2020,85,18,72,47,0,6to,2,2,38,0,0,67,13,0,83,0,1,0
53009,9657,2020-11-18T16:21:59.495706Z,2020,74,27,56,32,0,7mo,1,3,42,0,0,47,18,0,73,0,0,0
53009,9658,2020-11-18T16:21:59.495706Z,2020,90,20,70,41,0,8vo,1,1,49,0,0,70,20,0,89,0,0,0
53009,9659,2020-11-18T16:21:59.495706Z,2020,19,19,14,8,0,Sin Grado,0,0,11,0,0,0,5,0,19,0,0,0
72082,11471,2020-11-18T16:22:10.5891031Z,2020,21,7,19,9,0,1ro,0,0,12,0,0,14,2,0,21,0,0,0
72082,11472,2020-11-18T16:22:10.5891031Z,2020,24,2,21,9,0,2do,0,0,15,0,0,22,3,0,24,0,0,0
72082,11473,2020-11-18T16:22:10.5891031Z,2020,22,11,19,10,0,3ro,0,0,12,0,0,11,3,0,22,0,0,0
72082,11474,2020-11-18T16:22:10.5891031Z,2020,31,13,28,17,0,4to,1,0,14,0,0,18,3,0,30,0,0,0
72082,11475,2020-11-18T16:22:10.5901039Z,2020,44,19,38,19,0,5to,1,1,25,0,0,25,6,0,43,0,1,0
72082,11476,2020-11-18T16:22:10.5901039Z,2020,137,45,127,60,0,6to,0,0,77,0,0,92,10,0,137,0,0,0
72082,11477,2020-11-18T16:22:10.5901039Z,2020,125,34,117,60,0,7mo,1,1,65,0,0,91,8,0,124,0,0,0
72082,11478,2020-11-18T16:22:10.5901039Z,2020,109,34,90,50,0,8vo,2,0,59,0,0,75,19,0,107,0,0,0
72082,11479,2020-11-18T16:22:10.5901039Z,2020,28,4,25,16,0,K,0,0,12,0,0,24,3,0,28,0,0,0
72082,11480,2020-11-18T16:22:10.5911048Z,2020,9,5,8,2,0,Sin Grado,0,0,7,0,0,4,1,0,9,0,0,0
72082,35492,2021-06-24T13:18:46.2556243Z,2021,22,3,21,14,0,1ro,0,0,8,0,0,19,1,0,22,0,0,0
72082,35493,2021-06-24T13:18:46.2556243Z,2021,25,9,24,12,0,2do,0,0,13,0,0,16,1,0,25,0,0,0
72082,35494,2021-06-24T13:18:46.2566248Z,2021,27,5,25,9,0,3ro,0,0,18,0,0,22,2,0,27,0,0,0
72082,35495,2021-06-24T13:18:46.2566248Z,2021,33,12,29,15,0,4to,0,0,18,0,0,21,4,0,33,0,0,0
72082,35496,2021-06-24T13:18:46.2566248Z,2021,41,15,38,21,0,5to,1,0,20,0,0,26,3,0,40,0,0,0
72082,35497,2021-06-24T13:18:46.2576257Z,2021,115,43,102,55,0,6to,2,0,60,0,0,72,13,0,113,0,1,0
72082,35498,2021-06-24T13:18:46.2576257Z,2021,136,47,123,61,0,7mo,0,0,75,0,0,89,13,0,136,0,0,0
72082,35499,2021-06-24T13:18:46.2576257Z,2021,116,29,102,56,0,8vo,1,0,60,0,0,87,14,0,115,0,0,0
72082,35500,2021-06-24T13:18:46.5528376Z,2021,25,5,24,16,0,K,0,0,9,0,0,20,1,0,25,0,0,0
72082,35501,2021-06-24T13:18:46.5538372Z,2021,5,4,5,1,0,Sin Grado,0,0,4,0,0,1,0,0,5,0,0,0
72082,5461,2020-11-18T16:21:15.4933611Z,2019,24,8,22,9,0,1ro,0,0,15,0,0,16,2,0,24,0,0,0
72082,5462,2020-11-18T16:21:15.4933611Z,2019,20,8,17,12,0,2do,2,0,8,0,0,12,3,0,18,0,0,0
72082,5463,2020-11-18T16:21:15.4943624Z,2019,29,13,25,11,0,3ro,1,0,18,0,0,16,4,0,28,0,0,0
72082,5464,2020-11-18T16:21:15.4943624Z,2019,43,18,36,21,0,4to,1,0,22,0,0,25,7,0,42,0,1,0
72082,5465,2020-11-18T16:21:15.4943624Z,2019,45,15,43,18,0,5to,0,0,27,0,0,30,2,0,45,0,0,0
72082,5466,2020-11-18T16:21:15.4953633Z,2019,134,42,125,60,0,6to,1,1,74,0,0,92,9,0,133,0,0,0
72082,5467,2020-11-18T16:21:15.4953633Z,2019,107,32,89,48,0,7mo,3,0,59,0,0,75,18,0,104,0,0,0
72082,5468,2020-11-18T16:21:15.4953633Z,2019,166,52,138,75,0,8vo,6,0,91,0,0,114,28,0,160,0,0,0
72082,5469,2020-11-18T16:21:15.4963629Z,2019,19,2,19,8,0,K,0,0,11,0,0,17,0,0,19,0,0,0
72082,5470,2020-11-18T16:21:15.4963629Z,2019,9,5,7,3,0,Sin Grado,0,0,6,0,0,4,2,0,9,0,0,0
47902,3169,2020-11-18T16:21:01.0317194Z,2019,257,64,206,127,0,10mo,2,0,130,0,0,193,51,0,254,0,3,1
47902,3170,2020-11-18T16:21:01.0317194Z,2019,189,50,153,96,0,11mo,1,0,93,0,0,139,36,0,188,0,0,0
47902,3171,2020-11-18T16:21:01.0317194Z,2019,213,0,166,108,0,12mo,3,0,105,0,0,213,47,0,210,0,0,0
47902,3172,2020-11-18T16:21:01.0317194Z,2019,242,68,185,121,0,9no,2,0,121,0,0,174,57,0,239,0,0,1
47902,3173,2020-11-18T16:21:01.0327216Z,2019,42,26,38,8,0,Sin Grado,0,0,34,0,0,16,4,0,42,0,0,0
47902,33187,2021-06-24T13:18:30.3502192Z,2021,271,74,204,130,0,10mo,3,0,141,0,0,197,67,0,268,0,0,0
47902,33188,2021-06-24T13:18:30.3512193Z,2021,201,55,163,93,0,11mo,3,0,108,0,0,146,38,0,198,0,1,0
47902,33189,2021-06-24T13:18:30.3512193Z,2021,201,47,166,102,0,12mo,1,0,99,0,0,154,35,0,199,0,3,1
47902,33190,2021-06-24T13:18:30.3512193Z,2021,279,76,237,138,0,9no,13,0,141,0,0,203,42,1,265,2,1,0
47902,33191,2021-06-24T13:18:30.3512193Z,2021,33,33,31,4,0,Sin Grado,0,0,29,0,0,0,2,0,33,0,0,0
47902,9183,2020-11-18T16:21:56.1524787Z,2020,215,63,169,104,0,10mo,2,0,111,0,0,152,46,0,213,0,0,0
47902,9184,2020-11-18T16:21:56.1524787Z,2020,224,57,173,113,0,11mo,1,0,111,0,0,167,51,0,222,0,3,1
47902,9185,2020-11-18T16:21:56.1524787Z,2020,172,50,141,87,0,12mo,1,0,85,0,0,122,31,0,171,0,0,0
47902,9186,2020-11-18T16:21:56.1534787Z,2020,258,70,193,126,0,9no,2,0,132,0,0,188,65,0,256,0,1,0
47902,9187,2020-11-18T16:21:56.1534787Z,2020,39,36,35,6,0,Sin Grado,0,0,33,0,0,3,4,0,39,0,0,0
31534,1966,2020-11-18T16:20:53.4086357Z,2019,28,8,23,16,0,1ro,0,0,12,0,0,20,5,0,28,0,0,0
31534,1967,2020-11-18T16:20:53.4086357Z,2019,17,5,15,7,0,2do,0,0,10,0,0,12,2,0,16,0,0,1
31534,1968,2020-11-18T16:20:53.4086357Z,2019,19,7,18,10,0,3ro,1,0,9,0,0,12,1,0,18,0,0,0
31534,1969,2020-11-18T16:20:53.4096361Z,2019,16,4,11,6,0,4to,1,0,10,0,0,12,5,0,15,0,0,0
31534,1970,2020-11-18T16:20:53.4096361Z,2019,16,7,16,6,0,5to,0,0,10,0,0,9,0,0,16,0,0,0
31534,1971,2020-11-18T16:20:53.4096361Z,2019,19,6,16,13,0,K,0,0,6,0,0,13,3,0,19,0,0,0
31534,1972,2020-11-18T16:20:53.4096361Z,2019,2,2,1,0,0,Sin Grado,0,0,2,0,0,0,1,0,2,0,0,0
31534,31975,2021-06-24T13:18:18.6928533Z,2021,24,2,22,11,0,1ro,0,0,13,0,0,22,2,0,24,0,0,0
31534,31976,2021-06-24T13:18:18.6928533Z,2021,16,8,16,6,0,2do,0,0,10,0,0,8,0,0,16,0,0,0
31534,31977,2021-06-24T13:18:18.6928533Z,2021,22,8,19,10,0,3ro,0,0,12,0,0,14,3,0,22,0,0,0
31534,31978,2021-06-24T13:18:18.6928533Z,2021,13,3,10,7,0,4to,0,0,6,0,0,10,3,0,12,0,0,1
31534,31979,2021-06-24T13:18:18.6938542Z,2021,17,6,15,9,0,5to,1,0,8,0,0,11,2,0,16,0,0,0
31534,31980,2021-06-24T13:18:18.6938542Z,2021,16,1,12,10,0,K,0,0,6,0,0,15,4,0,16,0,0,0
31534,7978,2020-11-18T16:21:49.1428027Z,2020,21,7,18,8,0,1ro,0,0,13,0,0,14,3,0,21,0,0,0
31534,7979,2020-11-18T16:21:49.1438023Z,2020,24,7,19,13,0,2do,0,0,11,0,0,17,5,0,24,0,0,0
31534,7980,2020-11-18T16:21:49.1438023Z,2020,15,3,13,7,0,3ro,0,0,8,0,0,12,2,0,14,0,0,1
31534,7981,2020-11-18T16:21:49.1438023Z,2020,20,7,18,11,0,4to,1,0,9,0,0,13,2,0,19,0,0,0
31534,7982,2020-11-18T16:21:49.1438023Z,2020,13,3,10,6,0,5to,1,0,7,0,0,10,3,0,12,0,0,0
31534,7983,2020-11-18T16:21:49.1448036Z,2020,23,6,19,9,0,K,0,0,14,0,0,17,4,0,23,0,0,0
31534,7984,2020-11-18T16:21:49.1448036Z,2020,1,1,0,0,0,Sin Grado,0,0,1,0,0,0,1,0,1,0,0,0
71472,11311,2020-11-18T16:22:10.1688232Z,2020,18,6,16,13,0,1ro,0,0,5,0,0,12,2,0,18,0,0,0
71472,11312,2020-11-18T16:22:10.1698241Z,2020,24,8,19,8,0,2do,13,1,16,0,0,16,5,0,11,0,0,0
71472,11313,2020-11-18T16:22:10.1698241Z,2020,32,7,29,19,0,3ro,6,1,13,0,0,25,3,0,26,0,0,0
71472,11314,2020-11-18T16:22:10.1698241Z,2020,24,9,20,10,0,4to,9,3,14,0,0,15,4,0,15,0,0,0
71472,11315,2020-11-18T16:22:10.1708241Z,2020,34,11,26,13,0,5to,1,1,21,0,0,23,8,0,33,0,0,0
71472,11316,2020-11-18T16:22:10.1708241Z,2020,46,14,39,20,0,6to,2,2,26,0,0,32,7,0,44,0,0,0
71472,11317,2020-11-18T16:22:10.1708241Z,2020,38,20,32,16,0,7mo,0,5,22,0,0,18,6,0,38,0,0,0
71472,11318,2020-11-18T16:22:10.1718241Z,2020,47,19,41,18,0,8vo,0,3,29,0,0,28,6,0,46,0,0,1
71472,11319,2020-11-18T16:22:10.1718241Z,2020,23,4,22,12,0,K,2,0,11,0,0,19,1,0,21,0,0,0
71472,11320,2020-11-18T16:22:10.1718241Z,2020,15,15,14,4,0,Sin Grado,1,1,11,0,0,0,1,0,14,0,0,0
71472,35332,2021-06-24T13:18:45.5781383Z,2021,23,8,23,12,0,1ro,2,1,11,0,0,15,0,0,21,0,0,0
71472,35333,2021-06-24T13:18:45.5791397Z,2021,20,10,19,14,0,2do,0,0,6,0,0,10,1,0,20,0,0,0
71472,35334,2021-06-24T13:18:45.5791397Z,2021,25,8,24,10,0,3ro,10,1,15,0,0,17,1,0,15,0,0,0
71472,35335,2021-06-24T13:18:45.5791397Z,2021,29,9,28,19,0,4to,4,1,10,0,0,20,1,0,25,0,0,0
71472,35336,2021-06-24T13:18:45.5801397Z,2021,29,12,24,12,0,5to,11,3,17,0,0,17,5,0,18,0,0,0
71472,35337,2021-06-24T13:18:45.5801397Z,2021,41,17,35,20,0,6to,0,1,21,0,0,24,6,0,41,0,0,0
71472,35338,2021-06-24T13:18:45.5801397Z,2021,47,14,41,19,0,7mo,5,0,28,0,0,33,6,0,42,0,0,0
71472,35339,2021-06-24T13:18:45.5801397Z,2021,38,17,31,14,0,8vo,2,4,24,0,0,21,7,0,36,0,0,0
71472,35340,2021-06-24T13:18:45.5811407Z,2021,36,15,35,18,0,K,16,0,18,0,0,21,1,0,20,0,0,0
71472,35341,2021-06-24T13:18:45.5811407Z,2021,11,11,11,4,0,Sin Grado,1,0,7,0,0,0,0,0,10,0,0,0
71472,5306,2020-11-18T16:21:15.0750821Z,2019,27,10,25,12,0,1ro,15,1,15,0,0,17,2,0,12,0,0,0
71472,5307,2020-11-18T16:21:15.0750821Z,2019,33,7,28,17,0,2do,6,0,16,0,0,26,5,0,27,0,0,0
71472,5308,2020-11-18T16:21:15.0750821Z,2019,25,9,21,11,0,3ro,9,4,14,0,0,16,4,0,16,0,0,0
71472,5309,2020-11-18T16:21:15.0750821Z,2019,33,11,24,12,0,4to,1,1,21,0,0,22,9,0,32,0,0,0
71472,5310,2020-11-18T16:21:15.0750821Z,2019,38,8,31,18,0,5to,2,6,20,0,0,30,7,0,36,0,0,0
71472,5311,2020-11-18T16:21:15.0760826Z,2019,36,18,30,16,0,6to,0,5,20,0,0,18,6,0,36,0,0,0
71472,5312,2020-11-18T16:21:15.0760826Z,2019,48,19,41,17,0,7mo,2,4,31,0,0,29,7,0,46,0,0,0
71472,5313,2020-11-18T16:21:15.0760826Z,2019,50,20,41,21,0,8vo,1,6,29,0,0,30,9,0,49,0,0,0
71472,5314,2020-11-18T16:21:15.0770844Z,2019,13,4,13,11,0,K,1,1,2,0,0,9,0,0,12,0,0,0
71472,5315,2020-11-18T16:21:15.0770844Z,2019,23,23,20,6,0,Sin Grado,1,2,17,0,0,0,3,0,22,0,0,0
21055,1145,2020-11-18T16:20:44.631784Z,2019,167,56,136,95,0,10mo,0,1,72,0,0,111,31,0,167,0,1,0
21055,1146,2020-11-18T16:20:44.6327836Z,2019,203,49,151,117,0,11mo,1,0,86,0,0,154,52,0,202,0,1,0
21055,1147,2020-11-18T16:20:44.6327836Z,2019,223,0,158,135,0,12mo,1,1,88,0,0,223,65,0,222,0,2,0
21055,1148,2020-11-18T16:20:44.6327836Z,2019,164,47,131,93,0,9no,2,0,71,0,0,117,33,0,162,0,0,0
21055,31146,2021-06-24T13:18:13.0888354Z,2021,145,60,120,67,0,10mo,3,0,78,0,0,85,25,1,141,0,0,0
21055,31147,2021-06-24T13:18:13.0898363Z,2021,129,34,98,74,0,11mo,0,0,55,0,0,95,31,0,129,0,0,0
21055,31148,2021-06-24T13:18:13.0898363Z,2021,144,46,116,83,0,12mo,0,0,61,0,0,98,28,0,144,0,1,0
21055,31149,2021-06-24T13:18:13.0908372Z,2021,103,38,84,60,0,9no,1,0,43,0,0,65,19,0,102,0,0,0
21055,7150,2020-11-18T16:21:44.1965041Z,2020,132,38,104,81,0,10mo,1,0,51,0,0,94,28,0,131,0,0,0
21055,7151,2020-11-18T16:21:44.1965041Z,2020,150,48,124,89,0,11mo,0,0,61,0,0,102,26,0,150,0,1,0
21055,7152,2020-11-18T16:21:44.1965041Z,2020,198,51,152,114,0,12mo,2,0,84,0,0,147,46,0,196,0,1,0
21055,7153,2020-11-18T16:21:44.1975046Z,2020,156,62,134,78,0,9no,3,0,78,0,0,94,22,0,153,0,0,0
46334,3071,2020-11-18T16:21:00.3392573Z,2019,85,27,71,36,0,6to,2,0,49,0,0,58,14,0,82,0,0,1
46334,3072,2020-11-18T16:21:00.3392573Z,2019,96,34,84,43,0,7mo,1,0,53,0,0,62,12,0,94,0,0,1
46334,3073,2020-11-18T16:21:00.3402582Z,2019,79,24,63,40,0,8vo,1,0,39,0,0,55,16,0,78,0,2,0
46334,33082,2021-06-24T13:18:29.8318466Z,2021,79,32,66,32,0,6to,3,0,47,0,0,47,13,0,76,0,0,0
46334,33083,2021-06-24T13:18:29.8318466Z,2021,83,26,61,35,0,7mo,0,0,48,0,0,57,22,0,82,0,0,1
46334,33084,2021-06-24T13:18:29.8328476Z,2021,62,21,55,22,0,8vo,1,0,40,0,0,41,7,0,61,0,0,0
46334,9085,2020-11-18T16:21:55.4430041Z,2020,90,28,73,38,0,6to,0,0,52,0,0,62,17,0,88,0,0,2
46334,9086,2020-11-18T16:21:55.4430041Z,2020,87,29,76,37,0,7mo,2,0,50,0,0,58,11,0,84,0,0,1
46334,9087,2020-11-18T16:21:55.4430041Z,2020,85,30,74,39,0,8vo,1,0,46,0,0,55,11,0,83,0,0,1
75838,11622,2020-11-18T16:22:11.719858Z,2020,153,47,124,76,0,10mo,1,0,77,0,0,106,29,0,151,4,0,1
75838,11623,2020-11-18T16:22:11.719858Z,2020,145,38,112,79,0,11mo,0,0,66,0,0,107,33,0,145,2,0,0
75838,11624,2020-11-18T16:22:11.719858Z,2020,183,51,146,104,0,12mo,1,0,79,0,0,132,37,1,181,6,1,0
75838,11625,2020-11-18T16:22:11.7208593Z,2020,170,57,141,95,0,9no,0,0,75,0,0,113,29,2,168,9,0,0
75838,35645,2021-06-24T13:18:47.3794299Z,2021,156,53,127,80,0,10mo,0,0,76,0,0,103,29,1,155,8,0,0
75838,35646,2021-06-24T13:18:47.3794299Z,2021,133,39,111,69,0,11mo,1,0,64,0,0,94,22,0,132,3,0,0
75838,35647,2021-06-24T13:18:47.3794299Z,2021,131,37,105,69,0,12mo,0,0,62,0,0,94,26,0,131,1,0,0
75838,35648,2021-06-24T13:18:47.3794299Z,2021,152,56,123,81,0,9no,5,0,71,0,0,96,29,0,147,1,0,0
75838,5615,2020-11-18T16:21:16.6051049Z,2019,163,45,131,86,0,10mo,0,0,77,0,0,118,32,0,163,3,0,0
75838,5616,2020-11-18T16:21:16.6051049Z,2019,191,57,148,108,0,11mo,1,0,83,0,0,134,43,1,189,6,1,0
75838,5617,2020-11-18T16:21:16.6051049Z,2019,209,1,153,117,0,12mo,2,0,92,0,0,208,56,0,207,2,0,0
75838,5618,2020-11-18T16:21:16.6051049Z,2019,172,50,134,87,0,9no,1,0,85,0,0,122,38,0,170,4,0,1
22053,1299,2020-11-18T16:20:45.1010969Z,2019,72,31,62,26,0,1ro,1,7,46,0,0,41,10,0,71,0,0,0
22053,1300,2020-11-18T16:20:45.1010969Z,2019,70,32,54,36,0,2do,0,2,34,0,0,38,16,0,70,1,0,0
22053,1301,2020-11-18T16:20:45.8746138Z,2019,75,37,63,31,0,3ro,0,1,44,0,0,38,12,0,75,0,0,0
22053,1302,2020-11-18T16:20:45.8746138Z,2019,69,32,57,38,0,4to,0,9,31,0,0,37,12,0,69,0,0,0
22053,1303,2020-11-18T16:20:45.8756151Z,2019,86,36,67,43,0,5to,0,4,43,0,0,50,19,0,86,2,0,0
22053,1304,2020-11-18T16:20:45.8756151Z,2019,55,12,44,27,0,K,0,1,28,0,0,43,11,0,55,0,0,0
22053,1305,2020-11-18T16:20:45.8756151Z,2019,52,51,44,19,0,Sin Grado,1,9,33,0,0,1,8,0,51,0,1,0
22053,31300,2021-06-24T13:18:14.5338715Z,2021,56,8,52,23,0,1ro,0,0,33,0,0,48,4,0,56,0,0,0
22053,31301,2021-06-24T13:18:14.5338715Z,2021,53,16,48,24,0,2do,2,3,29,0,0,37,5,0,51,0,0,0
22053,31302,2021-06-24T13:18:14.5348729Z,2021,62,28,53,28,0,3ro,1,1,34,0,0,34,9,0,61,0,0,0
22053,31303,2021-06-24T13:18:14.5348729Z,2021,66,30,52,32,0,4to,1,0,34,0,0,36,14,0,65,0,0,0
22053,31304,2021-06-24T13:18:14.535873Z,2021,68,30,60,28,0,5to,0,0,40,0,0,38,8,0,68,0,0,0
22053,31305,2021-06-24T13:18:14.535873Z,2021,45,14,42,22,0,K,2,2,23,0,0,31,3,0,43,0,0,0
22053,31306,2021-06-24T13:18:14.535873Z,2021,61,58,59,19,0,Sin Grado,1,3,42,0,0,3,2,0,60,0,1,0
22053,7304,2020-11-18T16:21:45.3172528Z,2020,60,20,51,29,0,1ro,1,6,31,0,0,40,9,0,59,0,0,0
22053,7305,2020-11-18T16:21:45.3182541Z,2020,66,28,59,31,0,2do,1,5,35,0,0,38,7,0,65,0,0,0
22053,7306,2020-11-18T16:21:45.3182541Z,2020,69,30,59,35,0,3ro,1,8,34,0,0,39,10,0,68,1,0,0
22053,7307,2020-11-18T16:21:45.3182541Z,2020,76,35,64,31,0,4to,0,2,45,0,0,41,12,0,76,0,0,0
22053,7308,2020-11-18T16:21:45.3192546Z,2020,61,28,51,37,0,5to,0,5,24,0,0,33,10,0,61,0,0,0
22053,7309,2020-11-18T16:21:45.3192546Z,2020,69,12,59,29,0,K,1,4,40,0,0,57,10,0,68,0,0,0
22053,7310,2020-11-18T16:21:45.3192546Z,2020,67,66,61,21,0,Sin Grado,2,6,46,0,0,1,6,0,65,0,1,0
73890,11504,2020-11-18T16:22:11.2945741Z,2020,68,25,57,44,0,1ro,1,0,24,0,0,43,11,0,67,0,0,0
73890,11505,2020-11-18T16:22:11.2945741Z,2020,65,20,59,27,0,2do,3,0,38,0,0,45,6,0,61,0,0,1
73890,11506,2020-11-18T16:22:11.2945741Z,2020,70,22,56,39,0,3ro,1,0,31,0,0,48,14,0,69,0,0,0
73890,11507,2020-11-18T16:22:11.295575Z,2020,77,30,60,35,0,4to,1,0,42,0,0,47,17,0,76,0,0,0
73890,11508,2020-11-18T16:22:11.295575Z,2020,73,32,62,34,0,5to,0,0,39,0,0,41,11,0,73,0,0,0
73890,11509,2020-11-18T16:22:11.295575Z,2020,71,17,64,26,0,K,3,0,45,0,0,54,7,0,68,0,0,0
73890,11510,2020-11-18T16:22:11.295575Z,2020,14,3,8,8,0,PK,0,0,6,0,0,11,6,0,14,0,0,0
73890,11511,2020-11-18T16:22:11.295575Z,2020,20,19,18,7,0,Sin Grado,0,0,13,0,0,1,2,0,20,0,0,0
73890,35526,2021-06-24T13:18:46.5728511Z,2021,59,16,52,24,0,1ro,1,0,35,0,0,43,7,0,58,0,0,0
73890,35527,2021-06-24T13:18:46.573852Z,2021,72,25,60,44,0,2do,2,0,28,0,0,47,12,0,70,0,0,0
73890,35528,2021-06-24T13:18:46.573852Z,2021,65,21,54,28,0,3ro,3,0,37,0,0,44,11,0,61,0,0,1
73890,35529,2021-06-24T13:18:46.573852Z,2021,66,22,56,36,0,4to,0,0,30,0,0,44,10,0,66,0,0,0
73890,35530,2021-06-24T13:18:46.573852Z,2021,77,31,61,39,0,5to,0,0,38,0,0,46,16,0,77,1,0,0
73890,35531,2021-06-24T13:18:46.5748525Z,2021,23,8,17,14,0,K,0,0,9,0,0,15,6,0,23,0,0,0
73890,35532,2021-06-24T13:18:46.5748525Z,2021,13,2,11,7,0,PK,0,0,6,0,0,11,2,0,13,0,0,0
73890,35533,2021-06-24T13:18:46.5748525Z,2021,11,11,7,4,0,Sin Grado,1,0,7,0,0,0,4,0,10,0,0,0
73890,5495,2020-11-18T16:21:15.4973656Z,2019,66,26,56,23,0,1ro,2,0,43,0,0,40,10,0,63,0,0,1
73890,5496,2020-11-18T16:21:15.4973656Z,2019,78,30,66,41,0,2do,1,0,37,0,0,48,12,0,77,0,0,0
73890,5497,2020-11-18T16:21:15.4973656Z,2019,74,37,59,33,0,3ro,0,0,41,0,0,37,15,0,73,0,0,1
73890,5498,2020-11-18T16:21:15.4983651Z,2019,76,33,63,38,0,4to,0,0,38,0,0,43,13,0,75,0,0,1
73890,5499,2020-11-18T16:21:15.4983651Z,2019,82,25,69,36,0,5to,3,0,46,0,0,57,13,0,79,0,0,0
73890,5500,2020-11-18T16:21:15.4983651Z,2019,1,0,0,1,0,6to,0,0,0,0,0,1,1,0,1,0,0,0
73890,5501,2020-11-18T16:21:16.1688125Z,2019,62,17,33,41,0,K,1,0,21,0,0,45,29,0,61,0,0,0
73890,5502,2020-11-18T16:21:16.1688125Z,2019,16,0,15,7,0,PK,0,0,9,0,0,16,1,0,16,0,0,0
73890,5503,2020-11-18T16:21:16.1698134Z,2019,19,19,18,6,0,Sin Grado,0,0,13,0,0,0,1,0,19,0,0,0
18192,30814,2021-06-24T13:18:11.4466576Z,2021,121,48,98,54,0,10mo,2,0,67,0,0,73,23,0,119,0,0,0
18192,30815,2021-06-24T13:18:11.4476576Z,2021,84,32,73,48,0,11mo,1,0,36,0,0,52,11,0,82,0,0,1
18192,30816,2021-06-24T13:18:11.4476576Z,2021,102,37,82,49,0,12mo,2,0,53,0,0,65,20,0,100,0,0,0
18192,30817,2021-06-24T13:18:11.4476576Z,2021,81,38,60,42,0,9no,2,0,39,0,0,43,21,0,79,0,1,0
18192,6817,2020-11-18T16:21:42.0340603Z,2020,83,35,76,43,0,10mo,1,0,40,0,0,48,7,0,82,0,0,0
18192,6818,2020-11-18T16:21:42.0350603Z,2020,111,41,98,52,0,11mo,3,1,59,0,0,70,13,0,108,0,0,0
18192,6819,2020-11-18T16:21:42.0350603Z,2020,140,47,118,67,0,12mo,0,0,73,0,0,93,22,0,140,0,0,0
18192,6820,2020-11-18T16:21:42.0350603Z,2020,124,48,103,50,0,9no,1,0,74,0,0,76,21,0,123,0,0,0
18192,816,2020-11-18T16:20:42.6344493Z,2019,104,45,87,51,0,10mo,4,1,53,0,0,59,17,0,100,0,0,0
18192,817,2020-11-18T16:20:42.6344493Z,2019,148,51,122,68,0,11mo,0,0,80,0,0,97,26,0,148,0,0,0
18192,818,2020-11-18T16:20:42.6344493Z,2019,142,0,104,61,0,12mo,0,1,81,0,0,142,38,0,142,0,1,0
18192,819,2020-11-18T16:20:42.6344493Z,2019,87,39,81,41,0,9no,1,0,46,0,0,48,6,0,86,0,0,0
25023,1477,2020-11-18T16:20:46.345928Z,2019,45,2,25,32,0,1ro,0,0,13,0,0,43,20,0,45,0,0,0
25023,1478,2020-11-18T16:20:46.3469289Z,2019,42,3,24,27,0,2do,0,0,15,0,0,39,18,0,42,0,0,0
25023,1479,2020-11-18T16:20:46.3469289Z,2019,37,6,21,18,0,3ro,0,0,19,0,0,31,16,0,37,0,0,0
25023,1480,2020-11-18T16:20:46.3469289Z,2019,31,1,17,13,0,4to,0,0,18,0,0,30,14,0,31,0,0,0
25023,1481,2020-11-18T16:20:46.3469289Z,2019,33,2,14,14,0,5to,4,0,19,0,0,31,19,0,29,0,2,0
25023,1482,2020-11-18T16:20:46.3469289Z,2019,27,2,15,15,0,6to,1,0,12,0,0,25,12,0,26,0,1,0
25023,1483,2020-11-18T16:20:46.3479315Z,2019,23,1,11,12,0,7mo,1,0,11,0,0,22,12,0,22,0,0,0
25023,1484,2020-11-18T16:20:46.3479315Z,2019,20,0,7,13,0,8vo,0,0,7,0,0,20,13,0,20,0,0,0
25023,1485,2020-11-18T16:20:46.3479315Z,2019,44,5,22,24,0,K,0,0,20,0,0,39,22,0,44,0,0,0
25023,31478,2021-06-24T13:18:14.9331576Z,2021,37,3,25,18,0,1ro,0,0,19,0,0,34,12,0,37,0,0,0
25023,31479,2021-06-24T13:18:14.9331576Z,2021,39,4,28,19,0,2do,0,0,20,0,0,35,11,0,39,0,0,0
25023,31480,2021-06-24T13:18:14.9331576Z,2021,38,2,24,26,0,3ro,0,0,12,0,0,36,14,0,38,0,0,0
25023,31481,2021-06-24T13:18:14.934159Z,2021,37,3,22,22,0,4to,0,0,15,0,0,34,15,0,37,0,0,0
25023,31482,2021-06-24T13:18:14.934159Z,2021,27,1,16,12,0,5to,0,0,15,0,0,26,11,0,27,0,0,0
25023,31483,2021-06-24T13:18:14.934159Z,2021,25,1,19,10,0,6to,0,0,15,0,0,24,6,0,25,0,0,0
25023,31484,2021-06-24T13:18:14.934159Z,2021,25,2,16,9,0,7mo,2,0,16,0,0,23,9,0,23,0,1,0
25023,31485,2021-06-24T13:18:14.9351591Z,2021,24,2,17,15,0,8vo,1,0,9,0,0,22,7,0,23,0,1,0
25023,31486,2021-06-24T13:18:14.9351591Z,2021,25,3,18,9,0,K,0,0,16,0,0,22,7,0,25,0,0,0
25023,7481,2020-11-18T16:21:45.7805618Z,2020,39,4,20,20,0,1ro,0,0,19,0,0,35,19,0,39,0,0,0
25023,7482,2020-11-18T16:21:45.7805618Z,2020,40,2,16,27,0,2do,0,0,13,0,0,38,24,0,40,0,0,0
25023,7483,2020-11-18T16:21:45.7815631Z,2020,40,3,18,25,0,3ro,0,0,15,0,0,37,22,0,40,0,0,0
25023,7484,2020-11-18T16:21:45.7815631Z,2020,28,2,18,12,0,4to,0,0,16,0,0,26,10,0,28,0,0,0
25023,7485,2020-11-18T16:21:45.7815631Z,2020,27,1,13,11,0,5to,0,0,16,0,0,26,14,0,27,0,0,0
25023,7486,2020-11-18T16:21:45.7825636Z,2020,30,2,15,12,0,6to,4,0,18,0,0,28,15,0,26,0,2,0
25023,7487,2020-11-18T16:21:45.7825636Z,2020,28,3,17,17,0,7mo,1,0,11,0,0,25,11,0,27,0,1,0
25023,7488,2020-11-18T16:21:45.7825636Z,2020,20,1,8,11,0,8vo,1,0,9,0,0,19,12,0,19,0,0,0
25023,7489,2020-11-18T16:21:45.7835644Z,2020,40,3,23,19,0,K,0,0,21,0,0,37,17,0,40,0,0,0
44545,2972,2020-11-18T16:20:59.918977Z,2019,30,6,27,14,0,1ro,0,0,16,0,0,24,3,0,30,0,0,0
44545,2973,2020-11-18T16:20:59.9199774Z,2019,22,5,22,14,0,2do,0,0,8,0,0,17,0,0,22,0,0,0
44545,2974,2020-11-18T16:20:59.9199774Z,2019,22,13,22,8,0,3ro,0,0,14,0,0,9,0,0,22,0,0,0
44545,2975,2020-11-18T16:20:59.9199774Z,2019,28,11,27,13,0,4to,1,0,15,0,0,17,1,0,27,0,0,0
44545,2976,2020-11-18T16:20:59.9209779Z,2019,33,19,33,23,0,5to,2,0,10,0,0,14,0,0,31,0,0,0
44545,2977,2020-11-18T16:20:59.9209779Z,2019,33,10,32,19,0,6to,0,0,14,0,0,23,1,0,33,0,0,0
44545,2978,2020-11-18T16:20:59.9209779Z,2019,31,12,29,15,0,7mo,1,0,16,0,0,19,2,0,30,0,0,0
44545,2979,2020-11-18T16:20:59.9209779Z,2019,34,16,33,15,0,8vo,0,0,19,0,0,18,1,0,34,0,0,0
44545,2980,2020-11-18T16:20:59.9219779Z,2019,19,2,16,12,0,K,1,0,7,0,0,17,3,0,18,0,0,0
44545,2981,2020-11-18T16:20:59.9219779Z,2019,85,72,80,30,0,Sin Grado,1,1,55,0,0,13,5,0,84,0,0,0
44545,32981,2021-06-24T13:18:28.9191931Z,2021,19,3,17,9,0,1ro,2,0,10,0,0,16,2,0,17,0,0,0
44545,32982,2021-06-24T13:18:28.9191931Z,2021,23,4,22,14,0,2do,0,1,9,0,0,19,1,0,23,0,0,0
44545,32983,2021-06-24T13:18:28.9191931Z,2021,22,6,20,9,0,3ro,0,1,13,0,0,16,2,0,22,0,0,0
44545,32984,2021-06-24T13:18:28.9201931Z,2021,18,4,17,12,0,4to,0,0,6,0,0,14,1,0,18,0,0,0
44545,32985,2021-06-24T13:18:28.9201931Z,2021,23,10,22,9,0,5to,1,0,14,0,0,13,1,1,21,0,0,0
44545,32986,2021-06-24T13:18:28.9201931Z,2021,27,11,25,15,0,6to,0,0,12,0,0,16,2,0,27,0,0,0
44545,32987,2021-06-24T13:18:28.9201931Z,2021,40,22,38,17,0,7mo,2,0,23,0,0,18,2,0,38,0,0,0
44545,32988,2021-06-24T13:18:28.9211945Z,2021,17,4,16,15,0,8vo,0,0,2,0,0,13,1,0,17,0,0,0
44545,32989,2021-06-24T13:18:28.9211945Z,2021,22,10,17,10,0,K,0,0,12,0,0,12,5,0,21,0,0,1
44545,32990,2021-06-24T13:18:28.9211945Z,2021,87,84,78,34,0,Sin Grado,1,0,53,0,0,3,9,0,86,0,0,0
44545,8986,2020-11-18T16:21:55.0057122Z,2020,26,4,26,16,0,1ro,0,0,10,0,0,22,0,0,26,0,0,0
44545,8987,2020-11-18T16:21:55.0057122Z,2020,21,8,21,8,0,2do,0,0,13,0,0,13,0,0,21,0,0,0
44545,8988,2020-11-18T16:21:55.0057122Z,2020,18,3,18,13,0,3ro,0,0,5,0,0,15,0,0,18,0,0,0
44545,8989,2020-11-18T16:21:55.0057122Z,2020,25,13,25,12,0,4to,1,0,13,0,0,12,0,1,23,0,0,0
44545,8990,2020-11-18T16:21:55.0067127Z,2020,24,11,23,12,0,5to,0,0,12,0,0,13,1,0,24,0,0,0
44545,8991,2020-11-18T16:21:55.0067127Z,2020,51,29,48,23,0,6to,4,0,28,0,0,22,3,0,47,0,0,0
44545,8992,2020-11-18T16:21:55.0067127Z,2020,24,11,24,18,0,7mo,0,0,6,0,0,13,0,0,24,0,0,0
44545,8993,2020-11-18T16:21:55.0067127Z,2020,30,12,29,14,0,8vo,1,0,16,0,0,18,1,0,29,0,0,0
44545,8994,2020-11-18T16:21:55.0077131Z,2020,26,6,25,11,0,K,1,0,15,0,0,20,1,0,24,0,0,1
44545,8995,2020-11-18T16:21:55.0077131Z,2020,66,66,63,20,0,Sin Grado,1,0,46,0,0,0,3,0,65,0,0,0
70557,11055,2020-11-18T16:22:07.6291274Z,2020,54,20,47,25,0,1ro,0,0,29,0,0,34,7,0,54,0,0,0
70557,11056,2020-11-18T16:22:07.6291274Z,2020,51,23,44,25,0,2do,2,0,26,0,0,28,7,0,49,0,0,0
70557,11057,2020-11-18T16:22:07.6291274Z,2020,48,26,40,19,0,3ro,0,0,29,0,0,22,8,0,48,0,0,0
70557,11058,2020-11-18T16:22:07.6291274Z,2020,52,15,43,33,0,4to,1,0,19,0,0,37,9,0,51,0,0,0
70557,11059,2020-11-18T16:22:07.6301279Z,2020,52,18,43,34,0,5to,3,0,18,0,0,34,9,1,48,0,1,0
70557,11060,2020-11-18T16:22:07.6301279Z,2020,49,14,45,25,0,K,4,0,24,0,0,35,4,0,45,0,0,0
70557,11061,2020-11-18T16:22:07.6301279Z,2020,12,12,9,5,0,Sin Grado,0,0,7,0,0,0,3,0,12,0,0,0
70557,35076,2021-06-24T13:18:43.7208069Z,2021,38,14,37,18,0,1ro,3,1,20,0,0,24,1,0,35,0,0,0
70557,35077,2021-06-24T13:18:43.7208069Z,2021,45,16,43,19,0,2do,1,1,26,0,0,29,2,0,44,0,0,0
70557,35078,2021-06-24T13:18:43.7208069Z,2021,49,20,38,26,0,3ro,5,0,23,0,0,29,11,0,44,0,0,0
70557,35079,2021-06-24T13:18:43.7208069Z,2021,41,23,37,16,0,4to,0,0,25,0,0,18,4,0,41,0,0,0
70557,35080,2021-06-24T13:18:43.7208069Z,2021,49,16,40,29,0,5to,1,1,20,0,0,33,9,0,48,0,0,0
70557,35081,2021-06-24T13:18:43.721807Z,2021,34,12,31,15,0,K,3,0,19,0,0,22,3,0,31,0,0,0
70557,35082,2021-06-24T13:18:43.721807Z,2021,12,12,12,6,0,Sin Grado,0,0,6,0,0,0,0,0,12,0,0,0
70557,5047,2020-11-18T16:21:13.4289895Z,2019,60,26,52,28,0,1ro,2,4,32,0,0,34,8,0,58,0,0,0
70557,5048,2020-11-18T16:21:13.4289895Z,2019,47,23,37,20,0,2do,2,1,27,0,0,24,10,0,45,0,0,0
70557,5049,2020-11-18T16:21:13.4289895Z,2019,51,15,39,30,0,3ro,1,3,21,0,0,36,12,0,50,0,0,0
70557,5050,2020-11-18T16:21:13.4289895Z,2019,47,18,33,30,0,4to,2,1,17,0,0,29,14,0,45,0,0,0
70557,5051,2020-11-18T16:21:13.4299903Z,2019,51,18,46,31,0,5to,2,2,20,0,0,33,5,0,49,0,0,0
70557,5052,2020-11-18T16:21:13.4299903Z,2019,2,0,2,0,0,6to,0,0,2,0,0,2,0,0,2,0,0,0
70557,5053,2020-11-18T16:21:13.4299903Z,2019,48,12,44,23,0,K,1,2,25,0,0,36,4,0,47,0,0,0
70557,5054,2020-11-18T16:21:13.4299903Z,2019,21,20,17,6,0,Sin Grado,0,1,15,0,0,1,4,0,21,0,0,0
30221,1778,2020-11-18T16:20:48.8736107Z,2019,15,3,15,9,0,1ro,0,0,6,0,0,12,0,0,15,0,0,0
30221,1779,2020-11-18T16:20:48.8736107Z,2019,9,2,9,7,0,2do,0,0,2,0,0,7,0,0,9,0,0,0
30221,1780,2020-11-18T16:20:48.8736107Z,2019,15,7,12,7,0,3ro,0,0,8,0,0,8,3,0,15,0,0,0
30221,1781,2020-11-18T16:20:48.8736107Z,2019,10,2,9,3,0,4to,0,0,7,0,0,8,1,0,10,0,0,0
30221,1782,2020-11-18T16:20:48.8746111Z,2019,15,5,14,3,0,5to,0,0,12,0,0,10,1,0,15,0,0,0
30221,1783,2020-11-18T16:20:48.8746111Z,2019,10,2,10,4,0,K,0,0,6,0,0,8,0,0,10,0,0,0
30221,31781,2021-06-24T13:18:17.2478176Z,2021,20,6,18,8,0,1ro,1,0,12,0,0,14,2,0,19,0,0,0
30221,31782,2021-06-24T13:18:17.2488185Z,2021,11,4,11,5,0,2do,0,0,6,0,0,7,0,0,11,0,0,0
30221,31783,2021-06-24T13:18:17.2488185Z,2021,18,6,17,9,0,3ro,0,0,9,0,0,12,1,0,18,0,0,0
30221,31784,2021-06-24T13:18:17.2488185Z,2021,19,8,18,10,0,4to,0,0,9,0,0,11,1,0,19,0,0,0
30221,31785,2021-06-24T13:18:17.2488185Z,2021,14,5,11,8,0,5to,0,0,6,0,0,9,3,0,14,0,0,0
30221,31786,2021-06-24T13:18:17.2498181Z,2021,15,4,12,11,0,K,0,0,4,0,0,11,3,0,15,0,0,0
30221,31787,2021-06-24T13:18:17.2498181Z,2021,1,1,1,1,0,Sin Grado,0,0,0,0,0,0,0,0,1,0,0,0
30221,7784,2020-11-18T16:21:47.9239876Z,2020,10,3,10,5,0,1ro,0,0,5,0,0,7,0,0,10,0,0,0
30221,7785,2020-11-18T16:21:47.9239876Z,2020,19,6,16,11,0,2do,1,0,8,0,0,13,3,0,18,0,0,0
30221,7786,2020-11-18T16:21:47.9239876Z,2020,17,6,17,10,0,3ro,0,0,7,0,0,11,0,0,17,0,0,0
30221,7787,2020-11-18T16:21:47.9239876Z,2020,14,6,11,9,0,4to,0,0,5,0,0,8,3,0,14,0,0,0
30221,7788,2020-11-18T16:21:47.9239876Z,2020,16,3,16,7,0,5to,0,0,9,0,0,13,0,0,16,0,0,0
30221,7789,2020-11-18T16:21:47.9239876Z,2020,20,6,19,7,0,K,1,0,13,0,0,14,1,0,19,0,0,0
30221,7790,2020-11-18T16:21:47.9249881Z,2020,3,3,2,3,0,Sin Grado,0,0,0,0,0,0,1,0,3,0,0,0
74476,11527,2020-11-18T16:22:11.3045808Z,2020,24,9,17,11,0,1ro,0,1,13,0,0,15,7,0,24,1,0,0
74476,11528,2020-11-18T16:22:11.3045808Z,2020,35,12,23,19,0,2do,1,0,16,0,0,23,12,0,34,1,0,0
74476,11529,2020-11-18T16:22:11.3045808Z,2020,35,13,26,20,0,3ro,1,1,15,0,0,22,9,0,34,0,0,0
74476,11530,2020-11-18T16:22:11.3045808Z,2020,39,16,29,16,0,4to,0,1,23,0,0,23,10,0,38,1,0,1
74476,11531,2020-11-18T16:22:11.3045808Z,2020,34,10,24,20,0,5to,0,0,14,0,0,24,10,0,34,1,0,0
74476,11532,2020-11-18T16:22:11.3055817Z,2020,24,7,20,8,0,K,0,1,16,0,0,17,4,0,24,0,0,0
74476,11533,2020-11-18T16:22:11.3055817Z,2020,10,10,6,1,0,Sin Grado,0,0,9,0,0,0,4,0,9,0,0,1
74476,35549,2021-06-24T13:18:46.5798559Z,2021,24,7,20,7,0,1ro,1,0,17,0,0,17,4,0,23,0,0,0
74476,35550,2021-06-24T13:18:46.5798559Z,2021,25,9,18,14,0,2do,0,0,11,0,0,16,7,0,25,1,0,0
74476,35551,2021-06-24T13:18:46.5808573Z,2021,39,12,24,21,0,3ro,1,0,18,0,0,27,15,0,38,1,0,0
74476,35552,2021-06-24T13:18:46.5808573Z,2021,38,12,30,19,0,4to,2,0,19,0,0,26,8,0,36,0,0,0
74476,35553,2021-06-24T13:18:46.5808573Z,2021,44,15,29,19,0,5to,0,0,25,0,0,29,15,0,43,0,0,1
74476,35554,2021-06-24T13:18:46.5808573Z,2021,24,6,18,4,0,K,0,0,20,0,0,18,6,0,24,0,0,0
74476,35555,2021-06-24T13:18:46.5818573Z,2021,8,8,5,1,0,Sin Grado,0,0,7,0,0,0,3,0,8,0,0,0
74476,5519,2020-11-18T16:21:16.1788201Z,2019,38,12,24,20,0,1ro,0,0,18,0,0,26,14,0,38,1,0,0
74476,5520,2020-11-18T16:21:16.1798206Z,2019,43,18,31,25,0,2do,2,1,18,0,0,25,12,0,41,0,0,0
74476,5521,2020-11-18T16:21:16.1798206Z,2019,40,15,28,19,0,3ro,0,1,21,0,0,25,12,0,40,0,0,0
74476,5522,2020-11-18T16:21:16.1798206Z,2019,45,16,34,23,0,4to,1,0,22,0,0,29,11,0,44,1,0,0
74476,5523,2020-11-18T16:21:16.1798206Z,2019,42,15,28,22,0,5to,1,0,20,0,0,27,14,0,41,0,0,0
74476,5524,2020-11-18T16:21:16.1808201Z,2019,21,5,14,8,0,K,0,0,13,0,0,16,7,0,21,0,0,0
74476,5525,2020-11-18T16:21:16.1808201Z,2019,11,11,9,1,0,Sin Grado,0,0,10,0,0,0,2,0,11,0,0,0
50799,3332,2020-11-18T16:21:02.1394605Z,2019,36,10,34,22,0,1ro,1,1,14,0,0,26,2,0,35,0,0,0
50799,3333,2020-11-18T16:21:02.1394605Z,2019,30,10,27,13,0,2do,1,2,17,0,0,20,3,0,29,0,0,0
50799,3334,2020-11-18T16:21:02.1394605Z,2019,29,15,28,11,0,3ro,0,4,18,0,0,14,1,0,29,0,0,0
50799,3335,2020-11-18T16:21:02.14046Z,2019,24,9,21,13,0,4to,0,3,11,0,0,15,3,0,24,0,0,0
50799,33358,2021-06-24T13:18:31.5660913Z,2021,23,8,19,10,0,1ro,0,3,13,0,0,15,4,0,23,0,0,0
50799,33359,2021-06-24T13:18:31.5660913Z,2021,13,5,13,8,0,2do,0,2,5,0,0,8,0,0,13,0,0,0
50799,3336,2020-11-18T16:21:02.14046Z,2019,26,11,24,11,0,5to,0,2,15,0,0,15,2,0,26,0,0,0
50799,33360,2021-06-24T13:18:31.5670918Z,2021,29,8,29,16,0,3ro,0,7,13,0,0,21,0,0,29,0,0,0
50799,33361,2021-06-24T13:18:31.5670918Z,2021,26,10,23,18,0,4to,0,9,8,0,0,16,3,0,26,0,0,0
50799,33362,2021-06-24T13:18:31.5670918Z,2021,24,11,23,10,0,5to,0,5,14,0,0,13,1,0,24,0,0,0
50799,33363,2021-06-24T13:18:31.5680923Z,2021,11,1,10,7,0,K,1,1,4,0,0,10,1,0,10,0,0,0
50799,33364,2021-06-24T13:18:31.5680923Z,2021,9,9,9,3,0,Sin Grado,0,2,6,0,0,0,0,0,9,0,0,0
50799,3337,2020-11-18T16:21:02.14046Z,2019,27,11,24,17,0,K,1,1,10,0,0,16,3,0,26,0,0,0
50799,3338,2020-11-18T16:21:02.1414614Z,2019,16,6,14,6,0,PK,0,4,10,0,0,10,2,0,16,0,0,0
50799,3339,2020-11-18T16:21:02.1414614Z,2019,19,18,17,8,0,Sin Grado,0,0,11,0,0,1,2,0,19,0,0,0
50799,9352,2020-11-18T16:21:58.0027091Z,2020,22,8,20,14,0,1ro,1,3,8,0,0,14,2,0,21,0,0,0
50799,9353,2020-11-18T16:21:58.00371Z,2020,42,11,40,21,0,2do,1,13,21,0,0,31,2,0,41,0,0,0
50799,9354,2020-11-18T16:21:58.00371Z,2020,36,12,34,22,0,3ro,1,11,14,0,0,24,2,0,35,0,0,0
50799,9355,2020-11-18T16:21:58.00371Z,2020,29,12,28,11,0,4to,0,13,18,0,0,17,1,0,29,0,0,0
50799,9356,2020-11-18T16:21:58.00371Z,2020,29,9,26,15,0,5to,0,10,14,0,0,20,3,0,29,0,0,0
50799,9357,2020-11-18T16:21:58.00471Z,2020,28,8,26,14,0,K,1,8,14,0,0,20,2,0,27,0,0,0
50799,9358,2020-11-18T16:21:58.00471Z,2020,16,2,13,9,0,PK,0,1,7,0,0,14,3,0,16,0,0,0
50799,9359,2020-11-18T16:21:58.00471Z,2020,13,12,13,5,0,Sin Grado,0,4,8,0,0,1,0,0,13,0,0,0
14373,30566,2021-06-24T13:18:10.3929018Z,2021,19,6,17,8,0,1ro,0,0,11,0,0,13,2,0,19,0,0,0
14373,30567,2021-06-24T13:18:10.3929018Z,2021,20,8,19,9,0,2do,1,0,11,0,0,12,1,0,19,0,0,0
14373,30568,2021-06-24T13:18:10.3939027Z,2021,33,13,31,14,0,3ro,1,0,19,0,0,20,2,0,32,0,0,0
14373,30569,2021-06-24T13:18:10.3939027Z,2021,22,4,20,9,0,4to,0,0,13,0,0,18,2,0,22,0,0,0
14373,30570,2021-06-24T13:18:10.3939027Z,2021,29,8,25,16,0,5to,1,0,13,0,0,21,4,0,28,0,0,0
14373,30571,2021-06-24T13:18:10.3949037Z,2021,14,2,11,3,0,K,2,0,11,0,0,12,3,0,12,0,0,0
14373,30572,2021-06-24T13:18:10.3949037Z,2021,10,10,9,1,0,Sin Grado,0,0,9,0,0,0,1,0,10,0,0,0
14373,568,2020-11-18T16:20:40.7812167Z,2019,40,14,37,17,0,1ro,0,1,23,0,0,26,3,0,40,0,0,0
14373,569,2020-11-18T16:20:40.7812167Z,2019,30,8,28,12,0,2do,0,5,18,0,0,22,2,0,30,0,0,0
14373,570,2020-11-18T16:20:40.7812167Z,2019,39,11,38,25,0,3ro,0,0,14,0,0,28,1,0,39,0,0,0
14373,571,2020-11-18T16:20:40.7812167Z,2019,38,10,35,18,0,4to,2,0,20,0,0,28,3,0,36,0,0,0
14373,572,2020-11-18T16:20:40.7822176Z,2019,40,10,39,16,0,5to,1,2,24,0,0,30,1,0,39,0,0,0
14373,573,2020-11-18T16:20:40.7822176Z,2019,24,7,19,12,0,K,2,1,12,0,0,17,5,0,22,0,0,0
14373,574,2020-11-18T16:20:40.7822176Z,2019,30,30,27,6,0,Sin Grado,3,2,24,0,0,0,3,0,27,0,1,0
14373,6568,2020-11-18T16:21:40.3619484Z,2020,25,11,24,9,0,1ro,2,0,16,0,0,14,1,0,23,0,0,0
14373,6569,2020-11-18T16:21:40.3619484Z,2020,33,12,31,14,0,2do,1,2,19,0,0,21,2,0,32,0,0,0
14373,6570,2020-11-18T16:21:40.3629493Z,2020,26,7,25,11,0,3ro,0,0,15,0,0,19,1,0,26,0,0,0
14373,6571,2020-11-18T16:21:40.3629493Z,2020,31,9,29,19,0,4to,1,0,12,0,0,22,2,0,30,0,0,0
14373,6572,2020-11-18T16:21:40.3629493Z,2020,35,7,32,19,0,5to,1,1,16,0,0,28,3,0,34,0,0,0
14373,6573,2020-11-18T16:21:40.3629493Z,2020,23,4,18,8,0,K,0,0,15,0,0,19,5,0,23,0,0,0
14373,6574,2020-11-18T16:21:40.3629493Z,2020,28,28,25,5,0,Sin Grado,2,1,23,0,0,0,3,0,26,0,0,0
44842,2986,2020-11-18T16:20:59.9209779Z,2019,25,17,23,13,0,1ro,0,0,12,0,0,8,2,0,24,0,0,1
44842,2987,2020-11-18T16:20:59.9209779Z,2019,19,9,18,5,0,2do,1,0,14,0,0,10,1,0,18,0,0,0
44842,2988,2020-11-18T16:20:59.9209779Z,2019,17,12,17,4,0,3ro,0,0,13,0,0,5,0,0,17,0,0,0
44842,2989,2020-11-18T16:20:59.9219779Z,2019,14,4,14,7,0,4to,0,0,7,0,0,10,0,0,14,0,0,0
44842,2990,2020-11-18T16:20:59.9219779Z,2019,21,8,21,10,0,5to,0,0,11,0,0,13,0,0,21,0,0,0
44842,2991,2020-11-18T16:20:59.9219779Z,2019,23,7,23,13,0,K,1,0,10,0,0,16,0,0,22,0,0,0
44842,32995,2021-06-24T13:18:28.9221946Z,2021,18,4,17,7,0,1ro,0,0,11,0,0,14,1,0,18,0,0,0
44842,32996,2021-06-24T13:18:28.9221946Z,2021,19,11,19,8,0,2do,1,0,11,0,0,8,0,0,18,0,0,0
44842,32997,2021-06-24T13:18:28.9221946Z,2021,22,13,21,14,0,3ro,0,0,8,0,0,9,1,0,22,0,0,0
44842,32998,2021-06-24T13:18:28.9231964Z,2021,14,8,13,5,0,4to,0,0,9,0,0,6,1,0,14,0,0,0
44842,32999,2021-06-24T13:18:28.9231964Z,2021,9,7,9,3,0,5to,0,0,6,0,0,2,0,0,9,0,0,0
44842,33000,2021-06-24T13:18:29.7898169Z,2021,10,2,10,7,0,K,1,0,3,0,0,8,0,0,9,0,0,0
44842,9000,2020-11-18T16:21:54.9987078Z,2020,22,10,22,11,0,1ro,1,0,11,0,0,12,0,0,21,0,0,0
44842,9001,2020-11-18T16:21:55.4119841Z,2020,23,14,21,13,0,2do,0,0,10,0,0,9,2,0,23,0,0,0
44842,9002,2020-11-18T16:21:55.4119841Z,2020,18,8,16,7,0,3ro,1,0,11,0,0,10,2,0,17,0,0,0
44842,9003,2020-11-18T16:21:55.4119841Z,2020,14,11,14,3,0,4to,0,0,11,0,0,3,0,0,14,0,0,0
44842,9004,2020-11-18T16:21:55.4119841Z,2020,10,3,10,5,0,5to,0,0,5,0,0,7,0,0,10,0,0,0
44842,9005,2020-11-18T16:21:55.4129845Z,2020,15,3,12,6,0,K,0,0,9,0,0,12,3,0,15,0,0,0
35840,2380,2020-11-18T16:20:55.7451953Z,2019,41,4,35,21,0,1ro,1,0,20,0,0,37,6,0,40,0,0,0
35840,2381,2020-11-18T16:20:55.7451953Z,2019,28,5,25,15,0,2do,1,0,13,0,0,23,3,0,27,0,0,0
35840,2382,2020-11-18T16:20:55.7461958Z,2019,33,3,27,18,0,3ro,0,0,15,0,0,30,6,0,33,0,0,0
35840,2383,2020-11-18T16:20:55.7461958Z,2019,29,3,24,17,0,4to,1,0,12,0,0,26,5,0,27,0,0,1
35840,2384,2020-11-18T16:20:55.7461958Z,2019,36,8,30,16,0,5to,2,0,20,0,0,28,6,0,34,0,0,0
35840,2385,2020-11-18T16:20:55.7461958Z,2019,29,1,22,11,0,K,0,0,18,0,0,28,7,0,29,0,0,0
35840,2386,2020-11-18T16:20:55.7471962Z,2019,11,11,11,3,0,Sin Grado,0,0,8,0,0,0,0,0,11,0,0,0
35840,32387,2021-06-24T13:18:23.3581982Z,2021,23,3,15,6,0,1ro,0,0,17,0,0,20,8,0,23,0,0,0
35840,32388,2021-06-24T13:18:23.3581982Z,2021,33,4,28,14,0,2do,1,0,19,0,0,29,5,0,32,0,0,0
35840,32389,2021-06-24T13:18:23.3581982Z,2021,39,7,34,21,0,3ro,2,0,18,0,0,32,5,0,37,0,0,0
35840,32390,2021-06-24T13:18:23.3581982Z,2021,31,7,26,15,0,4to,0,0,16,0,0,24,5,0,31,0,0,0
35840,32391,2021-06-24T13:18:23.3592005Z,2021,28,3,23,14,0,5to,0,0,14,0,0,25,5,0,28,0,0,0
35840,32392,2021-06-24T13:18:23.3592005Z,2021,24,10,17,15,0,K,0,0,9,0,0,14,7,0,23,0,0,1
35840,32393,2021-06-24T13:18:23.3592005Z,2021,12,12,12,3,0,Sin Grado,0,0,9,0,0,0,0,0,12,0,0,0
35840,8392,2020-11-18T16:21:51.418319Z,2020,32,2,27,13,0,1ro,1,0,19,0,0,30,5,0,31,0,0,0
35840,8393,2020-11-18T16:21:51.418319Z,2020,43,3,38,24,0,2do,2,0,19,0,0,40,5,0,41,0,0,0
35840,8394,2020-11-18T16:21:51.418319Z,2020,32,7,28,15,0,3ro,0,0,17,0,0,25,4,0,32,0,0,0
35840,8395,2020-11-18T16:21:51.418319Z,2020,31,4,27,16,0,4to,0,0,15,0,0,27,4,0,31,0,0,0
35840,8396,2020-11-18T16:21:51.4193203Z,2020,23,2,18,14,0,5to,1,0,9,0,0,21,5,0,22,0,0,0
35840,8397,2020-11-18T16:21:51.4193203Z,2020,25,5,22,7,0,K,0,0,18,0,0,20,3,1,24,0,0,0
35840,8398,2020-11-18T16:21:51.4193203Z,2020,8,7,8,3,0,Sin Grado,0,0,5,0,0,1,0,0,8,0,0,0
74039,11512,2020-11-18T16:22:11.2925728Z,2020,68,16,54,37,0,10mo,3,0,31,0,0,52,14,0,65,0,0,0
74039,11513,2020-11-18T16:22:11.2925728Z,2020,88,19,65,49,0,11mo,2,0,39,0,0,69,23,0,86,0,0,0
74039,11514,2020-11-18T16:22:11.2925728Z,2020,81,22,62,36,0,12mo,4,0,45,0,0,59,19,0,77,0,0,0
74039,11515,2020-11-18T16:22:11.2935736Z,2020,88,31,73,43,0,9no,1,0,45,0,0,57,15,0,87,0,0,0
74039,11516,2020-11-18T16:22:11.2935736Z,2020,5,5,5,3,0,Sin Grado,0,0,2,0,0,0,0,0,5,0,0,0
74039,35534,2021-06-24T13:18:46.573852Z,2021,87,33,65,43,0,10mo,2,0,44,0,0,54,22,0,85,0,0,0
74039,35535,2021-06-24T13:18:46.5748525Z,2021,73,14,51,43,0,11mo,5,0,30,0,0,59,22,0,68,0,0,0
74039,35536,2021-06-24T13:18:46.5748525Z,2021,91,19,69,52,0,12mo,2,0,39,0,0,72,22,0,89,0,0,0
74039,35537,2021-06-24T13:18:46.5748525Z,2021,86,31,74,40,0,9no,0,0,46,0,0,55,12,0,85,1,0,1
74039,35538,2021-06-24T13:18:46.5748525Z,2021,5,5,5,3,0,Sin Grado,0,0,2,0,0,0,0,0,5,0,0,0
74039,5504,2020-11-18T16:21:16.1728156Z,2019,106,24,80,55,0,10mo,2,0,51,0,0,82,26,0,104,0,0,0
74039,5505,2020-11-18T16:21:16.1738165Z,2019,89,23,67,44,0,11mo,3,0,45,0,0,66,22,0,86,0,0,0
74039,5506,2020-11-18T16:21:16.1738165Z,2019,83,1,60,47,0,12mo,3,0,36,0,0,82,23,0,80,0,0,0
74039,5507,2020-11-18T16:21:16.1738165Z,2019,69,16,58,37,0,9no,3,0,32,0,0,53,11,0,66,0,0,0
74039,5508,2020-11-18T16:21:16.1738165Z,2019,5,4,5,3,0,Sin Grado,0,0,2,0,0,1,0,0,5,0,0,0
64956,10678,2020-11-18T16:22:05.3586164Z,2020,58,16,52,40,0,1ro,1,0,18,0,0,42,6,1,55,0,0,1
64956,10679,2020-11-18T16:22:05.3596169Z,2020,52,13,47,25,0,2do,0,0,27,0,0,39,5,0,52,0,0,0
64956,10680,2020-11-18T16:22:05.3596169Z,2020,70,19,64,39,0,3ro,1,0,31,0,0,51,6,0,68,0,0,1
64956,10681,2020-11-18T16:22:05.3596169Z,2020,56,16,49,24,0,4to,2,1,32,0,0,40,7,0,54,0,0,0
64956,10682,2020-11-18T16:22:05.3606169Z,2020,51,17,43,22,0,5to,0,1,29,0,0,34,8,0,51,0,0,0
64956,10683,2020-11-18T16:22:05.3606169Z,2020,44,8,38,19,0,K,1,0,25,0,0,36,6,0,43,0,0,0
64956,34695,2021-06-24T13:18:41.1119351Z,2021,53,9,51,26,0,1ro,2,0,27,0,0,44,2,0,51,0,0,0
64956,34696,2021-06-24T13:18:41.1119351Z,2021,60,17,55,40,0,2do,1,0,20,0,0,43,5,0,59,0,0,0
64956,34697,2021-06-24T13:18:41.112936Z,2021,69,16,58,38,0,3ro,0,0,31,0,0,53,11,0,69,0,0,0
64956,34698,2021-06-24T13:18:41.112936Z,2021,71,23,66,40,0,4to,1,0,31,0,0,48,5,0,70,0,0,0
64956,34699,2021-06-24T13:18:41.112936Z,2021,58,16,54,26,0,5to,1,0,32,0,0,42,4,0,57,0,0,0
64956,34700,2021-06-24T13:18:41.4291628Z,2021,53,12,49,24,0,K,1,0,29,0,0,41,4,0,52,0,0,0
64956,4666,2020-11-18T16:21:11.2645425Z,2019,61,23,56,23,0,1ro,0,0,38,0,0,38,5,0,61,0,0,0
64956,4667,2020-11-18T16:21:11.2645425Z,2019,73,21,67,42,0,2do,0,0,31,0,0,52,6,0,73,0,0,0
64956,4668,2020-11-18T16:21:11.2645425Z,2019,67,19,60,32,0,3ro,1,1,35,0,0,48,7,0,66,0,0,0
64956,4669,2020-11-18T16:21:11.2645425Z,2019,56,16,48,22,0,4to,0,1,34,0,0,40,8,0,56,0,0,0
64956,4670,2020-11-18T16:21:11.2645425Z,2019,73,21,64,40,0,5to,4,0,33,0,0,52,9,0,69,0,0,0
64956,4671,2020-11-18T16:21:11.2655456Z,2019,51,10,49,40,0,K,0,0,11,0,0,41,2,0,51,0,0,0
70367,10974,2020-11-18T16:22:07.2198559Z,2020,34,9,31,14,0,1ro,1,0,20,0,0,25,3,0,33,0,0,0
70367,10975,2020-11-18T16:22:07.2198559Z,2020,35,10,30,17,0,2do,1,0,18,0,0,25,5,0,34,0,0,0
70367,10976,2020-11-18T16:22:07.2198559Z,2020,28,7,26,18,0,3ro,1,0,10,0,0,21,2,0,27,0,0,0
70367,10977,2020-11-18T16:22:07.2198559Z,2020,29,16,25,13,0,4to,2,0,16,0,0,13,4,0,27,0,1,0
70367,10978,2020-11-18T16:22:07.2208563Z,2020,31,8,25,12,0,5to,0,0,19,0,0,23,6,0,31,0,1,0
70367,10979,2020-11-18T16:22:07.2208563Z,2020,62,17,54,26,0,6to,1,1,36,0,0,45,8,0,61,0,1,0
70367,10980,2020-11-18T16:22:07.2208563Z,2020,72,28,59,36,0,7mo,0,0,36,0,0,44,13,0,72,0,0,0
70367,10981,2020-11-18T16:22:07.2208563Z,2020,64,27,54,31,0,8vo,0,0,33,0,0,37,10,0,64,0,0,0
70367,10982,2020-11-18T16:22:07.2208563Z,2020,41,11,38,18,0,K,0,0,23,0,0,30,3,0,41,0,0,0
70367,10983,2020-11-18T16:22:07.2208563Z,2020,22,22,19,5,0,Sin Grado,0,0,17,0,0,0,3,0,22,0,0,0
70367,34995,2021-06-24T13:18:43.3625491Z,2021,33,10,30,15,0,1ro,0,0,18,0,0,23,3,0,33,0,0,0
70367,34996,2021-06-24T13:18:43.3625491Z,2021,33,10,28,16,0,2do,1,0,17,0,0,23,5,0,32,0,0,0
70367,34997,2021-06-24T13:18:43.363551Z,2021,35,11,30,15,0,3ro,0,0,20,0,0,24,5,0,35,0,0,0
70367,34998,2021-06-24T13:18:43.363551Z,2021,28,9,26,16,0,4to,1,0,12,0,0,19,2,0,27,0,0,0
70367,34999,2021-06-24T13:18:43.363551Z,2021,27,15,23,12,0,5to,2,0,15,0,0,12,4,0,25,0,0,0
70367,35000,2021-06-24T13:18:43.689784Z,2021,45,10,36,18,0,6to,0,0,27,0,0,35,9,0,45,0,0,0
70367,35001,2021-06-24T13:18:43.6907849Z,2021,62,17,54,25,0,7mo,1,0,37,0,0,45,8,0,61,0,0,0
70367,35002,2021-06-24T13:18:43.6907849Z,2021,66,25,53,32,0,8vo,0,0,34,0,0,41,13,0,66,0,0,0
70367,35003,2021-06-24T13:18:43.6907849Z,2021,35,3,25,17,0,K,0,0,18,0,0,32,10,0,35,0,0,0
70367,35004,2021-06-24T13:18:43.6907849Z,2021,16,16,11,7,0,Sin Grado,0,1,9,0,0,0,5,0,16,0,0,0
70367,4966,2020-11-18T16:21:13.0307221Z,2019,42,13,34,19,0,1ro,0,0,23,0,0,29,8,0,42,0,0,0
70367,4967,2020-11-18T16:21:13.0307221Z,2019,26,6,25,14,0,2do,0,0,12,0,0,20,1,0,26,0,0,0
70367,4968,2020-11-18T16:21:13.0307221Z,2019,38,15,34,16,0,3ro,2,0,22,0,1,23,4,0,36,0,1,0
70367,4969,2020-11-18T16:21:13.031723Z,2019,37,7,28,16,0,4to,0,0,21,0,0,30,9,0,37,0,1,0
70367,4970,2020-11-18T16:21:13.031723Z,2019,54,19,46,28,0,5to,0,0,26,0,1,35,8,0,54,0,1,0
70367,4971,2020-11-18T16:21:13.031723Z,2019,74,27,56,33,0,6to,0,0,41,0,0,47,18,0,74,0,0,0
70367,4972,2020-11-18T16:21:13.0327239Z,2019,62,24,54,31,0,7mo,0,0,31,0,0,38,8,0,62,0,0,0
70367,4973,2020-11-18T16:21:13.0327239Z,2019,58,24,49,28,0,8vo,0,0,30,0,0,34,9,0,58,0,0,0
70367,4974,2020-11-18T16:21:13.0327239Z,2019,40,14,29,29,0,K,0,0,11,0,0,26,11,0,40,0,0,0
70367,4975,2020-11-18T16:21:13.0327239Z,2019,30,29,27,6,0,Sin Grado,0,1,24,0,0,1,3,0,30,0,0,0
43299,2874,2020-11-18T16:20:59.2014975Z,2019,12,5,11,4,0,1ro,0,0,8,0,0,7,1,0,12,0,0,0
43299,2875,2020-11-18T16:20:59.2014975Z,2019,9,2,8,3,0,2do,0,0,6,0,0,7,1,0,9,0,0,0
43299,2876,2020-11-18T16:20:59.2014975Z,2019,7,4,6,3,0,3ro,0,0,4,0,0,3,1,0,7,0,0,0
43299,2877,2020-11-18T16:20:59.2014975Z,2019,16,7,13,5,0,4to,0,0,11,0,0,9,3,0,16,0,0,0
43299,2878,2020-11-18T16:20:59.2014975Z,2019,9,5,7,3,0,5to,0,0,6,0,0,4,2,0,9,0,0,0
43299,2879,2020-11-18T16:20:59.2024979Z,2019,9,3,9,4,0,6to,0,0,5,0,0,6,0,0,9,0,0,0
43299,2880,2020-11-18T16:20:59.2024979Z,2019,12,4,12,5,0,K,0,0,7,0,0,8,0,0,12,0,0,0
43299,2881,2020-11-18T16:20:59.2024979Z,2019,9,2,7,8,0,PK,0,0,1,0,0,7,2,0,9,0,0,0
43299,2882,2020-11-18T16:20:59.2024979Z,2019,7,6,7,4,0,Sin Grado,0,0,3,0,0,1,0,0,7,0,0,0
43299,32882,2021-06-24T13:18:28.2246942Z,2021,14,4,13,12,0,1ro,0,0,2,0,0,10,1,0,14,0,0,0
43299,32883,2021-06-24T13:18:28.2246942Z,2021,15,7,13,8,0,2do,0,0,7,0,0,8,2,0,15,0,0,0
43299,32884,2021-06-24T13:18:28.2246942Z,2021,16,7,16,8,0,3ro,0,0,8,0,0,9,0,0,16,0,0,0
43299,32885,2021-06-24T13:18:28.2246942Z,2021,12,4,11,5,0,4to,0,0,7,0,0,8,1,0,12,0,0,0
43299,32886,2021-06-24T13:18:28.2256951Z,2021,8,4,8,3,0,5to,0,0,5,0,0,4,0,0,8,0,0,0
43299,32887,2021-06-24T13:18:28.2256951Z,2021,10,4,8,3,0,6to,0,0,7,0,0,6,2,0,10,0,0,0
43299,32888,2021-06-24T13:18:28.2256951Z,2021,9,1,9,4,0,K,0,0,5,0,0,8,0,0,9,0,0,0
43299,32889,2021-06-24T13:18:28.2256951Z,2021,9,1,8,6,0,PK,0,0,3,0,0,8,1,0,9,0,0,0
43299,32890,2021-06-24T13:18:28.2266961Z,2021,6,6,6,4,0,Sin Grado,0,0,2,0,0,0,0,0,6,0,0,0
43299,8886,2020-11-18T16:21:54.2462051Z,2020,12,5,12,4,0,1ro,0,0,8,0,0,7,0,0,12,0,0,0
43299,8887,2020-11-18T16:21:54.2462051Z,2020,16,7,14,8,0,2do,0,0,8,0,0,9,2,0,16,0,0,0
43299,8888,2020-11-18T16:21:54.2462051Z,2020,10,4,9,3,0,3ro,0,0,7,0,0,6,1,0,10,0,0,0
43299,8889,2020-11-18T16:21:54.2472051Z,2020,8,4,8,3,0,4to,0,0,5,0,0,4,0,0,8,0,0,0
43299,8890,2020-11-18T16:21:54.2472051Z,2020,13,7,10,4,0,5to,0,0,9,0,0,6,3,0,13,0,0,0
43299,8891,2020-11-18T16:21:54.2472051Z,2020,8,3,8,2,0,6to,0,0,6,0,0,5,0,0,8,0,0,0
43299,8892,2020-11-18T16:21:54.2472051Z,2020,14,4,12,11,0,K,0,0,3,0,0,10,2,0,14,0,0,0
43299,8893,2020-11-18T16:21:54.2472051Z,2020,5,1,5,1,0,PK,0,0,4,0,0,4,0,0,5,0,0,0
43299,8894,2020-11-18T16:21:54.2472051Z,2020,8,7,8,5,0,Sin Grado,0,0,3,0,0,1,0,0,8,0,0,0
75747,11582,2020-11-18T16:22:11.3275964Z,2020,34,10,29,14,0,1ro,0,0,20,0,0,24,5,0,34,0,0,0
75747,11583,2020-11-18T16:22:11.3275964Z,2020,28,5,23,13,0,2do,0,0,15,0,0,23,5,0,28,0,0,0
75747,11584,2020-11-18T16:22:11.3275964Z,2020,47,15,39,22,0,3ro,0,0,25,0,0,32,8,0,47,0,0,0
75747,11585,2020-11-18T16:22:11.3285968Z,2020,46,15,39,20,0,4to,0,0,26,0,0,31,7,0,46,1,0,0
75747,11586,2020-11-18T16:22:11.3285968Z,2020,43,13,37,18,0,5to,0,0,25,0,0,30,6,0,43,0,0,0
75747,11587,2020-11-18T16:22:11.3285968Z,2020,43,6,40,17,0,K,0,0,26,0,0,37,3,0,43,0,0,0
75747,11588,2020-11-18T16:22:11.3285968Z,2020,8,8,8,3,0,Sin Grado,0,0,5,0,0,0,0,0,8,1,0,0
75747,35605,2021-06-24T13:18:47.363418Z,2021,22,1,20,8,0,1ro,0,0,14,0,0,21,2,0,22,0,0,0
75747,35606,2021-06-24T13:18:47.363418Z,2021,24,9,22,10,0,2do,0,0,14,0,0,15,2,0,24,0,0,0
75747,35607,2021-06-24T13:18:47.363418Z,2021,23,6,22,11,0,3ro,0,0,12,0,0,17,1,0,23,0,0,0
75747,35608,2021-06-24T13:18:47.363418Z,2021,42,13,37,21,0,4to,1,0,21,0,0,29,5,0,41,0,0,0
75747,35609,2021-06-24T13:18:47.3644185Z,2021,38,14,36,17,0,5to,0,0,21,0,0,24,2,0,38,1,0,0
75747,35610,2021-06-24T13:18:47.3644185Z,2021,23,3,22,13,0,K,1,0,10,0,0,20,1,0,22,0,0,0
75747,35611,2021-06-24T13:18:47.3644185Z,2021,8,8,8,4,0,Sin Grado,0,0,4,0,0,0,0,0,8,0,0,0
75747,5574,2020-11-18T16:21:16.198833Z,2019,40,13,28,16,0,1ro,0,0,24,0,0,27,12,0,40,0,0,0
75747,5575,2020-11-18T16:21:16.198833Z,2019,49,13,37,22,0,2do,0,1,27,0,0,36,12,0,49,0,0,0
75747,5576,2020-11-18T16:21:16.198833Z,2019,48,18,44,22,0,3ro,0,1,26,0,0,30,4,0,48,1,0,0
75747,5577,2020-11-18T16:21:16.1998339Z,2019,48,15,40,20,0,4to,0,1,28,0,0,33,8,0,48,0,0,0
75747,5578,2020-11-18T16:21:16.1998339Z,2019,32,11,26,18,0,5to,3,0,14,0,0,21,6,0,29,0,0,0
75747,5579,2020-11-18T16:21:16.1998339Z,2019,36,6,31,19,0,K,0,2,17,0,0,30,5,0,36,0,0,0
75747,5580,2020-11-18T16:21:16.2008335Z,2019,7,7,7,2,0,Sin Grado,0,0,5,0,0,0,0,0,7,1,0,0
70573,11063,2020-11-18T16:22:07.6311283Z,2020,57,20,53,31,0,6to,4,0,26,0,0,37,4,0,53,0,0,0
70573,11064,2020-11-18T16:22:07.6311283Z,2020,69,28,58,35,0,7mo,0,1,34,0,0,41,11,0,69,0,0,0
70573,11065,2020-11-18T16:22:07.6321287Z,2020,73,38,63,41,0,8vo,3,6,32,0,0,35,10,0,70,0,0,0
70573,11066,2020-11-18T16:22:07.6321287Z,2020,60,59,54,16,0,Sin Grado,1,2,44,0,0,1,6,0,59,0,0,0
70573,35084,2021-06-24T13:18:43.7208069Z,2021,58,27,52,34,0,6to,4,1,24,0,0,31,6,0,54,0,0,0
70573,35085,2021-06-24T13:18:43.7208069Z,2021,67,26,62,35,0,7mo,4,0,32,0,0,41,5,0,63,0,0,0
70573,35086,2021-06-24T13:18:43.7208069Z,2021,75,28,65,38,0,8vo,1,2,37,0,0,47,10,0,74,0,0,0
70573,35087,2021-06-24T13:18:43.7208069Z,2021,52,51,45,12,0,Sin Grado,0,0,40,0,0,1,7,0,52,0,0,0
70573,5056,2020-11-18T16:21:13.4299903Z,2019,66,27,60,35,0,6to,3,5,31,0,0,39,6,0,63,0,0,0
70573,5057,2020-11-18T16:21:13.4299903Z,2019,75,36,66,36,0,7mo,2,2,39,0,0,39,9,0,73,0,0,0
70573,5058,2020-11-18T16:21:13.4299903Z,2019,105,40,91,48,0,8vo,4,1,57,0,0,65,14,0,101,0,0,0
70573,5059,2020-11-18T16:21:13.4299903Z,2019,78,77,65,26,0,Sin Grado,3,6,52,0,0,1,13,0,75,0,0,0
42283,2765,2020-11-18T16:20:58.756202Z,2019,48,20,41,23,0,1ro,0,0,25,0,0,28,7,0,48,1,0,0
42283,2766,2020-11-18T16:20:58.756202Z,2019,49,20,39,22,0,2do,1,0,27,0,1,29,10,0,48,0,0,0
42283,2767,2020-11-18T16:20:58.7572002Z,2019,53,24,43,19,0,3ro,0,0,34,0,0,29,10,0,53,0,0,0
42283,2768,2020-11-18T16:20:58.7572002Z,2019,44,13,39,27,0,4to,1,0,17,0,0,31,5,0,43,0,0,0
42283,2769,2020-11-18T16:20:58.7572002Z,2019,51,20,41,21,0,5to,2,0,30,0,0,31,10,0,49,0,0,0
42283,2770,2020-11-18T16:20:58.7572002Z,2019,41,13,40,31,0,K,3,0,10,0,0,28,1,0,38,0,0,0
42283,2771,2020-11-18T16:20:58.7572002Z,2019,1,1,1,0,0,Sin Grado,0,0,1,0,0,0,0,0,1,0,0,0
42283,32772,2021-06-24T13:18:27.1959565Z,2021,44,14,41,25,0,1ro,0,0,19,0,0,30,3,0,44,0,0,0
42283,32773,2021-06-24T13:18:27.1959565Z,2021,46,15,43,27,0,2do,3,0,19,0,0,31,3,0,43,0,0,0
42283,32774,2021-06-24T13:18:27.1969575Z,2021,41,18,35,21,0,3ro,0,0,20,0,0,23,6,0,41,1,0,0
42283,32775,2021-06-24T13:18:27.1969575Z,2021,35,15,30,15,0,4to,1,0,20,0,0,20,5,0,34,0,0,0
42283,32776,2021-06-24T13:18:27.1969575Z,2021,39,11,31,11,0,5to,1,0,28,0,0,28,8,0,38,0,1,0
42283,32777,2021-06-24T13:18:27.1969575Z,2021,42,7,41,17,0,K,1,0,25,0,0,35,1,0,41,0,0,0
42283,8776,2020-11-18T16:21:53.8169181Z,2020,43,15,40,31,0,1ro,2,0,12,0,0,28,3,0,41,0,0,0
42283,8777,2020-11-18T16:21:53.8169181Z,2020,44,19,32,21,0,2do,0,0,23,0,0,25,12,0,44,1,0,0
42283,8778,2020-11-18T16:21:53.8169181Z,2020,41,19,35,15,0,3ro,1,0,26,0,0,22,6,0,40,0,0,0
42283,8779,2020-11-18T16:21:53.817919Z,2020,48,18,39,14,0,4to,0,0,34,0,0,30,9,0,48,0,0,0
42283,8780,2020-11-18T16:21:53.817919Z,2020,41,11,38,25,0,5to,1,0,16,0,0,30,3,0,40,0,0,0
42283,8781,2020-11-18T16:21:53.817919Z,2020,50,12,46,30,0,K,0,0,20,0,0,38,4,1,49,0,0,0
32524,2066,2020-11-18T16:20:53.9089676Z,2019,29,12,25,20,0,1ro,0,0,9,0,0,17,4,0,29,0,0,0
32524,2067,2020-11-18T16:20:53.9089676Z,2019,13,3,9,7,0,2do,0,0,6,0,0,10,4,0,13,0,0,0
32524,2068,2020-11-18T16:20:53.9089676Z,2019,20,5,17,7,0,3ro,0,0,13,0,0,15,3,0,18,0,0,2
32524,2069,2020-11-18T16:20:53.9099685Z,2019,19,6,14,11,0,4to,0,0,8,0,0,13,5,0,19,0,0,0
32524,2070,2020-11-18T16:20:53.9099685Z,2019,22,3,16,15,0,5to,1,0,7,0,0,19,6,0,21,0,0,0
32524,2071,2020-11-18T16:20:53.9099685Z,2019,22,6,11,8,0,K,0,0,14,0,0,16,11,0,22,0,0,0
32524,2072,2020-11-18T16:20:53.9099685Z,2019,12,1,9,6,0,PK,0,0,6,0,0,11,3,0,12,0,0,0
32524,2073,2020-11-18T16:20:53.9109694Z,2019,7,6,6,2,0,Sin Grado,0,0,5,0,0,1,1,0,7,0,0,0
32524,32072,2021-06-24T13:18:20.1008632Z,2021,19,5,17,8,0,1ro,0,0,11,0,0,14,2,0,19,0,0,0
32524,32073,2021-06-24T13:18:20.1008632Z,2021,21,11,19,8,0,2do,0,0,13,0,0,10,2,0,21,0,0,0
32524,32074,2021-06-24T13:18:20.1008632Z,2021,20,10,19,13,0,3ro,0,0,7,0,0,10,1,0,20,0,0,0
32524,32075,2021-06-24T13:18:20.1018636Z,2021,15,5,13,6,0,4to,0,0,9,0,0,10,2,0,15,0,0,0
32524,32076,2021-06-24T13:18:20.1018636Z,2021,14,3,14,4,0,5to,0,0,10,0,0,11,0,0,13,0,0,1
32524,32077,2021-06-24T13:18:20.1018636Z,2021,19,4,17,10,0,K,0,0,9,0,0,15,2,0,19,0,0,0
32524,32078,2021-06-24T13:18:20.1018636Z,2021,5,1,4,3,0,PK,0,0,2,0,0,4,1,0,5,0,0,0
32524,32079,2021-06-24T13:18:20.1028646Z,2021,11,11,9,1,0,Sin Grado,0,0,10,0,0,0,2,0,11,0,0,0
32524,8078,2020-11-18T16:21:49.5720901Z,2020,21,7,15,8,0,1ro,0,0,13,0,0,14,6,0,21,0,0,0
32524,8079,2020-11-18T16:21:49.5720901Z,2020,24,9,21,15,0,2do,0,0,9,0,0,15,3,0,24,0,0,0
32524,8080,2020-11-18T16:21:49.5720901Z,2020,16,5,11,8,0,3ro,0,0,8,0,0,11,5,0,16,0,0,0
32524,8081,2020-11-18T16:21:49.5720901Z,2020,14,4,13,5,0,4to,0,0,9,0,0,10,1,0,13,0,0,1
32524,8082,2020-11-18T16:21:49.5730906Z,2020,12,4,7,5,0,5to,0,0,7,0,0,8,5,0,12,0,0,0
32524,8083,2020-11-18T16:21:49.5730906Z,2020,15,2,12,7,0,K,0,0,8,0,0,13,3,0,15,0,0,0
32524,8084,2020-11-18T16:21:49.5730906Z,2020,9,0,8,4,0,PK,0,0,5,0,0,9,1,0,9,0,0,0
32524,8085,2020-11-18T16:21:49.5730906Z,2020,8,8,7,1,0,Sin Grado,0,0,7,0,0,0,1,0,8,0,0,0
70250,10938,2020-11-18T16:22:07.2078484Z,2020,81,23,61,38,0,1ro,2,0,43,0,0,58,20,1,78,0,0,0
70250,10939,2020-11-18T16:22:07.2078484Z,2020,91,23,65,49,0,2do,3,0,42,0,0,68,26,0,88,0,0,0
70250,10940,2020-11-18T16:22:07.2078484Z,2020,87,26,63,51,0,3ro,2,0,36,0,0,61,24,0,84,0,1,1
70250,10941,2020-11-18T16:22:07.2078484Z,2020,90,24,55,50,0,4to,0,0,40,0,0,66,35,1,89,0,1,0
70250,10942,2020-11-18T16:22:07.2078484Z,2020,78,15,51,34,0,5to,0,0,44,0,0,63,27,0,77,0,0,1
70250,10943,2020-11-18T16:22:07.2088484Z,2020,35,7,17,15,0,6to,1,0,20,0,0,28,18,0,34,0,0,0
70250,10944,2020-11-18T16:22:07.2088484Z,2020,35,9,16,21,0,7mo,1,0,14,0,0,26,19,0,34,0,1,0
70250,10945,2020-11-18T16:22:07.2088484Z,2020,27,5,17,9,0,8vo,2,0,18,0,0,22,10,0,25,0,0,0
70250,10946,2020-11-18T16:22:07.2088484Z,2020,71,14,36,33,0,K,0,0,38,0,0,57,35,0,71,0,0,0
70250,34959,2021-06-24T13:18:43.3465372Z,2021,67,16,41,31,0,1ro,2,0,36,0,0,51,26,0,65,0,0,0
70250,34960,2021-06-24T13:18:43.3465372Z,2021,76,19,55,35,0,2do,0,0,41,0,0,57,21,1,75,0,0,0
70250,34961,2021-06-24T13:18:43.3465372Z,2021,75,20,61,38,0,3ro,3,0,37,0,0,55,14,0,72,0,0,0
70250,34962,2021-06-24T13:18:43.3475381Z,2021,85,24,63,49,0,4to,2,0,36,0,0,61,22,0,82,0,0,1
70250,34963,2021-06-24T13:18:43.3475381Z,2021,83,25,56,47,0,5to,0,0,36,0,0,58,27,1,82,0,0,0
70250,34964,2021-06-24T13:18:43.3475381Z,2021,29,6,19,18,0,6to,0,0,11,0,0,23,10,0,28,0,1,1
70250,34965,2021-06-24T13:18:43.3475381Z,2021,34,7,20,13,0,7mo,1,0,21,0,0,27,14,0,33,0,2,0
70250,34966,2021-06-24T13:18:43.3485386Z,2021,32,6,23,19,0,8vo,0,0,13,0,0,26,9,0,32,0,0,0
70250,34967,2021-06-24T13:18:43.3485386Z,2021,66,19,51,31,0,K,0,0,35,0,0,47,15,0,66,0,0,0
70250,4930,2020-11-18T16:21:12.9946998Z,2019,96,28,74,47,0,1ro,4,0,49,0,0,68,22,0,91,0,0,1
70250,4931,2020-11-18T16:21:12.9956998Z,2019,90,27,59,51,0,2do,2,0,39,0,0,63,31,0,87,0,2,1
70250,4932,2020-11-18T16:21:12.9956998Z,2019,93,27,56,56,0,3ro,0,0,37,0,0,66,37,1,92,0,1,0
70250,4933,2020-11-18T16:21:12.9956998Z,2019,86,16,50,35,0,4to,0,0,51,0,0,70,36,1,84,0,1,1
70250,4934,2020-11-18T16:21:12.9956998Z,2019,96,16,59,43,0,5to,2,0,53,0,0,80,37,0,94,0,1,0
70250,4935,2020-11-18T16:21:12.9956998Z,2019,47,8,26,30,0,6to,2,0,17,0,0,39,21,1,43,0,1,1
70250,4936,2020-11-18T16:21:12.9956998Z,2019,42,10,27,15,0,7mo,2,0,27,0,0,32,15,0,40,0,0,0
70250,4937,2020-11-18T16:21:12.9966998Z,2019,39,3,21,20,0,8vo,0,0,19,0,0,36,18,0,39,1,1,0
70250,4938,2020-11-18T16:21:12.9966998Z,2019,71,19,53,33,0,K,1,0,38,0,0,52,18,1,69,0,0,0
52944,33648,2021-06-24T13:18:33.6776045Z,2021,54,13,46,23,0,1ro,0,3,31,0,0,41,8,0,54,0,0,0
52944,33649,2021-06-24T13:18:33.6776045Z,2021,52,17,47,28,0,2do,2,3,24,0,0,35,5,0,50,0,0,0
52944,33650,2021-06-24T13:18:33.6776045Z,2021,51,12,47,19,0,3ro,0,5,32,0,0,39,4,0,51,0,1,0
52944,33651,2021-06-24T13:18:33.6786068Z,2021,51,16,46,27,0,4to,2,2,24,0,0,35,5,0,49,0,0,0
52944,33652,2021-06-24T13:18:33.6786068Z,2021,68,15,61,28,0,5to,2,3,40,0,0,53,7,0,66,0,0,0
52944,33653,2021-06-24T13:18:33.6786068Z,2021,71,22,51,38,0,K,3,4,33,0,0,49,20,0,68,0,0,0
52944,33654,2021-06-24T13:18:33.6786068Z,2021,19,19,17,8,0,Sin Grado,1,0,11,0,0,0,2,0,18,0,0,0
52944,3623,2020-11-18T16:21:04.325917Z,2019,67,22,63,29,0,1ro,3,1,38,0,0,45,4,0,64,0,1,0
52944,3624,2020-11-18T16:21:04.325917Z,2019,56,13,49,32,0,2do,2,2,24,0,0,43,7,0,54,0,1,0
52944,3625,2020-11-18T16:21:04.325917Z,2019,66,17,56,27,0,3ro,2,9,39,0,0,49,10,0,64,0,1,0
52944,3626,2020-11-18T16:21:04.325917Z,2019,56,14,50,32,0,4to,3,4,24,0,0,42,6,0,53,0,0,0
52944,3627,2020-11-18T16:21:04.3269174Z,2019,63,12,51,34,0,5to,0,4,29,0,0,51,12,0,63,0,0,0
52944,3628,2020-11-18T16:21:04.3269174Z,2019,53,10,45,22,0,K,0,0,31,0,0,43,8,0,53,0,0,0
52944,3629,2020-11-18T16:21:04.3269174Z,2019,19,17,17,5,0,Sin Grado,1,0,14,0,0,2,2,0,18,0,0,0
52944,9642,2020-11-18T16:21:59.4917038Z,2020,56,16,53,30,0,1ro,3,3,26,0,0,40,3,0,53,0,0,0
52944,9643,2020-11-18T16:21:59.4917038Z,2020,52,14,46,19,0,2do,1,3,33,0,0,38,6,0,51,0,2,0
52944,9644,2020-11-18T16:21:59.4917038Z,2020,50,14,45,29,0,3ro,2,4,21,0,0,36,5,0,48,0,0,0
52944,9645,2020-11-18T16:21:59.4927038Z,2020,69,17,61,29,0,4to,2,12,40,0,0,52,8,0,67,0,1,0
52944,9646,2020-11-18T16:21:59.4927038Z,2020,48,11,42,27,0,5to,3,5,21,0,0,37,6,0,45,0,0,0
52944,9647,2020-11-18T16:21:59.4927038Z,2020,64,17,55,26,0,K,0,6,38,0,0,47,9,0,64,0,0,0
52944,9648,2020-11-18T16:21:59.4927038Z,2020,21,21,17,6,0,Sin Grado,1,0,15,0,0,0,4,0,20,0,0,0
78832,11727,2020-11-18T16:22:12.3202604Z,2020,26,5,23,13,0,1ro,0,0,13,0,0,21,3,0,26,0,0,0
78832,11728,2020-11-18T16:22:12.3202604Z,2020,21,6,20,12,0,2do,0,0,9,0,0,15,1,0,21,0,0,0
78832,11729,2020-11-18T16:22:12.3202604Z,2020,30,10,29,13,0,3ro,0,0,17,0,0,20,1,0,30,0,0,0
78832,11730,2020-11-18T16:22:12.3212626Z,2020,33,14,29,18,0,4to,0,0,15,0,0,19,4,0,33,0,0,0
78832,11731,2020-11-18T16:22:12.3212626Z,2020,28,15,26,14,0,5to,2,0,14,0,0,13,2,0,26,0,0,0
78832,11732,2020-11-18T16:22:12.3212626Z,2020,62,23,58,37,0,6to,1,0,25,0,0,39,4,0,61,1,0,0
78832,11733,2020-11-18T16:22:12.3222613Z,2020,79,30,68,41,0,7mo,1,0,38,0,0,49,11,0,78,0,0,0
78832,11734,2020-11-18T16:22:12.3222613Z,2020,74,26,61,48,0,8vo,0,0,26,0,0,48,13,0,74,0,0,0
78832,11735,2020-11-18T16:22:12.3222613Z,2020,18,2,16,9,0,K,0,0,9,0,0,16,2,0,18,0,0,0
78832,11736,2020-11-18T16:22:12.3222613Z,2020,27,27,25,10,0,Sin Grado,1,0,17,0,0,0,2,0,26,0,0,0
78832,35749,2021-06-24T13:18:47.7506959Z,2021,24,4,19,11,0,1ro,0,0,13,0,0,20,5,0,24,0,1,0
78832,35750,2021-06-24T13:18:47.7506959Z,2021,25,4,22,8,0,2do,0,0,17,0,0,21,3,0,25,0,0,0
78832,35751,2021-06-24T13:18:47.7506959Z,2021,21,4,21,14,0,3ro,0,0,7,0,0,17,0,0,20,0,0,1
78832,35752,2021-06-24T13:18:47.7506959Z,2021,29,11,27,13,0,4to,0,0,16,0,0,18,2,0,29,0,0,0
78832,35753,2021-06-24T13:18:47.7516968Z,2021,38,14,29,22,0,5to,0,0,16,0,0,24,9,0,38,0,0,0
78832,35754,2021-06-24T13:18:47.7516968Z,2021,44,20,39,26,0,6to,3,0,18,0,0,24,5,0,41,0,0,0
78832,35755,2021-06-24T13:18:47.7516968Z,2021,56,25,52,34,0,7mo,0,0,22,0,0,31,4,0,56,1,0,0
78832,35756,2021-06-24T13:18:47.7516968Z,2021,79,28,66,44,0,8vo,2,0,35,0,0,51,13,0,77,0,0,0
78832,35757,2021-06-24T13:18:47.7526978Z,2021,16,3,10,5,0,K,0,0,11,0,0,13,6,0,16,0,0,0
78832,35758,2021-06-24T13:18:47.7526978Z,2021,20,20,16,5,0,Sin Grado,0,0,15,0,0,0,4,0,20,0,0,0
78832,5721,2020-11-18T16:21:17.1514689Z,2019,22,7,20,11,0,1ro,0,0,11,0,0,15,2,0,21,0,0,1
78832,5722,2020-11-18T16:21:17.1514689Z,2019,34,11,33,16,0,2do,0,0,18,0,0,23,1,0,34,0,0,0
78832,5723,2020-11-18T16:21:17.1524698Z,2019,40,15,36,18,0,3ro,0,0,22,0,0,25,4,0,40,0,0,0
78832,5724,2020-11-18T16:21:17.1524698Z,2019,30,17,27,14,0,4to,1,0,16,0,0,13,3,0,29,0,0,0
78832,5725,2020-11-18T16:21:17.1524698Z,2019,44,15,39,24,0,5to,1,0,20,0,0,29,5,0,43,0,0,0
78832,5726,2020-11-18T16:21:17.1524698Z,2019,84,32,75,47,1,6to,2,0,37,0,0,52,9,0,82,0,0,0
78832,5727,2020-11-18T16:21:17.1524698Z,2019,89,32,73,53,0,7mo,0,1,36,0,0,57,16,0,89,0,0,0
78832,5728,2020-11-18T16:21:17.1534707Z,2019,87,35,66,45,2,8vo,2,1,42,0,0,52,21,0,85,0,1,0
78832,5729,2020-11-18T16:21:17.1534707Z,2019,26,6,22,15,0,K,0,0,11,0,0,20,4,0,26,0,0,0
78832,5730,2020-11-18T16:21:17.1534707Z,2019,29,26,26,9,1,Sin Grado,1,0,20,0,0,3,3,0,28,0,0,0
15396,30598,2021-06-24T13:18:10.3989056Z,2021,22,3,18,11,0,1ro,0,0,11,0,0,19,4,0,22,0,0,0
15396,30599,2021-06-24T13:18:10.399907Z,2021,33,7,30,19,0,2do,1,1,14,0,0,26,3,0,32,0,0,0
15396,30600,2021-06-24T13:18:10.6300721Z,2021,40,11,37,23,0,3ro,0,0,17,0,0,29,3,0,40,0,0,0
15396,30601,2021-06-24T13:18:10.6300721Z,2021,37,10,34,18,0,4to,0,0,19,0,0,27,3,0,37,0,0,0
15396,30602,2021-06-24T13:18:10.6310726Z,2021,22,6,18,11,0,5to,0,0,11,0,0,16,4,0,22,0,0,0
15396,30603,2021-06-24T13:18:10.6310726Z,2021,46,16,39,23,0,K,1,0,23,0,0,30,7,0,45,0,0,0
15396,600,2020-11-18T16:20:40.7832181Z,2019,45,11,41,22,0,1ro,0,3,23,0,0,34,4,0,45,0,0,0
15396,601,2020-11-18T16:20:41.1694774Z,2019,33,8,26,18,0,2do,0,0,15,0,0,25,7,0,33,0,0,0
15396,602,2020-11-18T16:20:41.1694774Z,2019,32,10,27,13,0,3ro,0,1,19,0,0,22,5,0,32,0,1,0
15396,603,2020-11-18T16:20:41.1694774Z,2019,33,11,20,14,0,4to,0,0,19,0,0,22,13,0,33,0,0,0
15396,604,2020-11-18T16:20:41.1704774Z,2019,39,13,31,22,0,5to,0,0,17,0,0,26,8,0,39,0,0,0
15396,605,2020-11-18T16:20:41.1704774Z,2019,35,9,30,23,0,K,1,1,12,0,0,26,5,0,34,0,0,0
15396,6600,2020-11-18T16:21:40.3629493Z,2020,29,4,25,18,0,1ro,1,0,11,0,0,25,4,0,28,0,0,0
15396,6601,2020-11-18T16:21:40.7372002Z,2020,39,9,33,21,0,2do,0,0,18,0,0,30,6,0,39,0,0,0
15396,6602,2020-11-18T16:21:40.7382002Z,2020,30,8,26,14,0,3ro,0,0,16,0,0,22,4,0,30,0,0,0
15396,6603,2020-11-18T16:21:40.7382002Z,2020,24,5,20,10,0,4to,0,0,14,0,0,19,4,0,24,0,0,0
15396,6604,2020-11-18T16:21:40.7382002Z,2020,30,11,23,10,0,5to,1,0,20,0,0,19,7,0,29,0,0,0
15396,6605,2020-11-18T16:21:40.7392015Z,2020,27,3,22,12,0,K,0,0,15,0,0,24,5,0,27,0,0,0
22012,1286,2020-11-18T16:20:45.1000969Z,2019,156,55,114,73,0,6to,2,3,83,0,0,101,42,0,154,0,0,0
22012,1287,2020-11-18T16:20:45.1010969Z,2019,155,57,121,76,0,7mo,1,0,79,0,0,98,34,0,154,1,0,0
22012,1288,2020-11-18T16:20:45.1010969Z,2019,191,69,144,96,0,8vo,0,0,95,0,0,122,47,0,191,0,0,0
22012,31287,2021-06-24T13:18:14.0255066Z,2021,149,53,122,86,0,6to,0,5,63,0,0,96,27,0,149,0,0,0
22012,31288,2021-06-24T13:18:14.0265071Z,2021,153,54,125,73,0,7mo,1,10,80,0,0,99,28,0,152,2,0,0
22012,31289,2021-06-24T13:18:14.0265071Z,2021,153,54,121,73,0,8vo,2,11,80,0,0,99,32,0,151,0,0,0
22012,7291,2020-11-18T16:21:44.6047769Z,2020,158,55,131,77,0,6to,0,13,81,0,0,103,27,0,158,2,0,0
22012,7292,2020-11-18T16:21:44.6047769Z,2020,161,61,117,77,0,7mo,2,12,84,0,0,100,44,0,159,0,0,0
22012,7293,2020-11-18T16:21:44.6047769Z,2020,138,41,109,67,0,8vo,1,8,71,0,0,97,29,0,137,1,0,0
69047,10839,2020-11-18T16:22:06.5333999Z,2020,125,51,100,58,0,10mo,5,3,67,0,0,74,25,0,120,0,1,0
69047,10840,2020-11-18T16:22:06.5344007Z,2020,128,25,102,67,0,11mo,2,0,61,0,0,103,26,0,126,0,0,0
69047,10841,2020-11-18T16:22:06.5344007Z,2020,152,47,112,88,0,12mo,5,0,64,0,0,105,40,0,147,1,0,0
69047,10842,2020-11-18T16:22:06.5344007Z,2020,143,48,123,69,0,9no,1,5,74,0,0,95,20,0,142,2,0,0
69047,10843,2020-11-18T16:22:06.5344007Z,2020,6,6,6,0,0,Sin Grado,1,0,6,0,0,0,0,0,5,0,0,0
69047,34860,2021-06-24T13:18:42.5709813Z,2021,128,45,110,67,0,10mo,1,1,61,0,0,83,18,0,127,2,0,0
69047,34861,2021-06-24T13:18:42.5709813Z,2021,105,39,90,52,0,11mo,4,1,53,0,0,66,15,0,101,0,1,0
69047,34862,2021-06-24T13:18:42.5709813Z,2021,125,23,106,68,0,12mo,1,0,57,0,0,102,19,0,124,0,0,0
69047,34863,2021-06-24T13:18:42.5719822Z,2021,116,37,96,59,0,9no,3,1,57,0,0,79,20,0,113,0,0,0
69047,34864,2021-06-24T13:18:42.5719822Z,2021,13,13,12,1,0,Sin Grado,0,0,12,0,0,0,1,0,13,0,0,0
69047,4832,2020-11-18T16:21:12.3842916Z,2019,132,27,115,63,0,10mo,1,0,69,0,0,105,17,0,131,0,0,0
69047,4833,2020-11-18T16:21:12.3842916Z,2019,171,55,131,96,0,11mo,4,1,75,0,0,116,40,0,167,1,0,0
69047,4834,2020-11-18T16:21:12.3842916Z,2019,170,0,122,85,0,12mo,7,0,85,0,0,170,48,0,163,0,0,0
69047,4835,2020-11-18T16:21:12.385292Z,2019,142,56,120,64,0,9no,4,2,78,0,0,86,22,0,138,0,1,0
69047,4836,2020-11-18T16:21:12.385292Z,2019,9,6,7,0,0,Sin Grado,0,0,9,0,0,3,2,0,9,0,0,0
31245,1924,2020-11-18T16:20:53.5107032Z,2019,67,5,62,26,0,1ro,3,19,41,0,0,62,5,0,64,0,0,0
31245,1925,2020-11-18T16:20:53.5107032Z,2019,95,9,85,42,0,2do,3,35,53,0,0,86,10,0,92,0,0,0
31245,1926,2020-11-18T16:20:53.5107032Z,2019,81,13,77,41,0,3ro,5,25,40,0,0,68,4,1,75,0,0,0
31245,1927,2020-11-18T16:20:53.5117045Z,2019,81,10,71,36,0,4to,3,11,45,0,0,71,10,1,77,0,0,0
31245,1928,2020-11-18T16:20:53.5117045Z,2019,105,14,93,50,0,5to,2,14,55,0,0,91,12,5,98,1,2,0
31245,1929,2020-11-18T16:20:53.5117045Z,2019,69,4,62,36,0,K,0,26,33,0,0,65,7,0,69,0,0,0
31245,1930,2020-11-18T16:20:53.5117045Z,2019,13,13,12,4,0,Sin Grado,0,0,9,0,0,0,1,0,13,0,0,0
31245,31932,2021-06-24T13:18:18.6768423Z,2021,48,10,48,25,0,1ro,1,2,23,0,0,38,0,0,47,0,0,0
31245,31933,2021-06-24T13:18:18.6768423Z,2021,67,4,66,32,0,2do,0,11,35,0,0,63,1,0,67,0,0,0
31245,31934,2021-06-24T13:18:18.6768423Z,2021,65,13,65,23,0,3ro,3,11,42,0,0,52,0,0,62,0,0,0
31245,31935,2021-06-24T13:18:18.6768423Z,2021,83,9,78,39,0,4to,3,19,44,0,0,74,5,0,80,0,0,0
31245,31936,2021-06-24T13:18:18.6778428Z,2021,74,11,72,41,0,5to,4,11,33,0,0,63,2,1,69,0,0,0
31245,31937,2021-06-24T13:18:18.6778428Z,2021,51,3,48,27,0,K,0,1,24,0,0,48,3,0,51,0,0,0
31245,31938,2021-06-24T13:18:18.6778428Z,2021,8,8,6,2,0,Sin Grado,0,2,6,0,0,0,2,0,8,0,0,0
31245,7935,2020-11-18T16:21:49.1287929Z,2020,74,3,67,38,0,1ro,0,23,36,0,0,71,7,0,74,0,0,0
31245,7936,2020-11-18T16:21:49.1287929Z,2020,63,7,61,23,0,2do,3,11,40,0,0,56,2,0,60,0,0,0
31245,7937,2020-11-18T16:21:49.1287929Z,2020,87,9,76,38,0,3ro,3,32,49,0,0,78,11,0,84,0,0,0
31245,7938,2020-11-18T16:21:49.1287929Z,2020,78,13,67,40,0,4to,3,20,38,0,0,65,11,1,74,0,0,0
31245,7939,2020-11-18T16:21:49.1297942Z,2020,76,7,69,36,0,5to,3,11,40,0,0,69,7,2,71,0,1,0
31245,7940,2020-11-18T16:21:49.1297942Z,2020,60,7,57,30,0,K,1,9,30,0,0,53,3,0,59,0,0,0
31245,7941,2020-11-18T16:21:49.1297942Z,2020,11,11,9,3,0,Sin Grado,0,0,8,0,0,0,2,0,11,0,0,0
73668,11500,2020-11-18T16:22:10.5911048Z,2020,79,26,70,40,0,6to,0,0,39,0,0,53,9,0,78,0,0,1
73668,11501,2020-11-18T16:22:11.2895705Z,2020,69,18,58,34,0,7mo,0,0,35,0,0,51,11,0,69,0,0,0
73668,11502,2020-11-18T16:22:11.2895705Z,2020,65,22,60,35,0,8vo,3,0,30,0,0,43,5,0,62,0,0,0
73668,11503,2020-11-18T16:22:11.2895705Z,2020,32,32,29,11,0,Sin Grado,1,0,21,0,0,0,3,0,31,0,0,0
73668,35522,2021-06-24T13:18:46.5658463Z,2021,87,27,74,45,0,6to,1,0,42,0,0,60,13,0,86,0,0,0
73668,35523,2021-06-24T13:18:46.5658463Z,2021,73,27,68,33,0,7mo,0,0,40,0,0,46,5,0,73,0,0,0
73668,35524,2021-06-24T13:18:46.5658463Z,2021,62,15,56,30,0,8vo,0,0,32,0,0,47,6,0,62,0,0,0
73668,35525,2021-06-24T13:18:46.5668468Z,2021,37,37,34,16,0,Sin Grado,1,0,21,0,0,0,3,0,36,0,0,0
73668,5491,2020-11-18T16:21:15.4913602Z,2019,86,24,74,48,0,6to,1,0,38,0,0,62,12,0,85,0,0,0
73668,5492,2020-11-18T16:21:15.4923607Z,2019,70,24,66,38,0,7mo,3,0,32,0,0,46,4,0,67,0,0,0
73668,5493,2020-11-18T16:21:15.4923607Z,2019,69,20,57,37,0,8vo,1,0,32,0,0,49,12,0,68,0,0,0
73668,5494,2020-11-18T16:21:15.4923607Z,2019,23,22,23,8,0,Sin Grado,0,0,15,0,0,1,0,0,23,0,0,0
71217,11241,2020-11-18T16:22:09.5674212Z,2020,121,42,107,66,0,6to,3,5,55,0,0,79,14,0,118,0,0,0
71217,11242,2020-11-18T16:22:09.5674212Z,2020,133,47,102,69,0,7mo,4,11,64,0,0,86,31,0,129,3,0,0
71217,11243,2020-11-18T16:22:09.5674212Z,2020,143,54,100,66,0,8vo,2,8,77,0,0,89,43,0,141,1,0,0
71217,11244,2020-11-18T16:22:09.5674212Z,2020,37,37,33,10,0,Sin Grado,0,2,27,0,0,0,4,0,37,0,0,0
71217,35262,2021-06-24T13:18:44.8266001Z,2021,102,47,85,45,0,6to,1,0,57,0,0,55,17,0,101,2,0,0
71217,35263,2021-06-24T13:18:44.8266001Z,2021,117,40,106,68,0,7mo,3,4,49,0,0,77,11,0,114,1,0,0
71217,35264,2021-06-24T13:18:44.8275997Z,2021,128,43,105,65,0,8vo,4,11,63,0,0,85,23,0,124,3,0,0
71217,35265,2021-06-24T13:18:44.8275997Z,2021,31,31,27,6,0,Sin Grado,0,1,25,0,0,0,4,0,31,0,0,0
71217,5236,2020-11-18T16:21:14.458672Z,2019,141,54,108,76,0,6to,4,11,65,0,0,87,33,0,137,3,0,0
71217,5237,2020-11-18T16:21:14.458672Z,2019,142,48,102,64,0,7mo,2,6,78,0,0,94,40,0,140,1,0,0
71217,5238,2020-11-18T16:21:14.458672Z,2019,147,36,114,80,0,8vo,4,3,67,0,0,111,33,0,143,6,0,0
71217,5239,2020-11-18T16:21:14.458672Z,2019,31,29,27,6,0,Sin Grado,0,4,25,0,0,2,4,0,31,0,0,0
51375,33403,2021-06-24T13:18:32.4507247Z,2021,33,5,19,21,0,1ro,0,0,12,0,0,28,14,0,33,0,0,0
51375,33404,2021-06-24T13:18:32.4507247Z,2021,20,8,16,11,0,2do,1,0,9,0,0,12,4,0,19,0,0,0
51375,33405,2021-06-24T13:18:32.4507247Z,2021,23,4,19,13,0,3ro,0,0,10,0,0,19,4,0,23,0,0,0
51375,33406,2021-06-24T13:18:32.4507247Z,2021,32,7,20,15,0,4to,0,0,17,0,0,25,12,0,32,0,0,0
51375,33407,2021-06-24T13:18:32.4517257Z,2021,24,5,19,9,0,5to,0,0,15,0,0,19,5,0,24,0,1,0
51375,33408,2021-06-24T13:18:32.4517257Z,2021,23,7,16,14,0,K,0,0,9,0,0,16,7,0,23,0,0,0
51375,33409,2021-06-24T13:18:32.4517257Z,2021,17,1,12,10,0,PK,0,0,7,0,0,16,5,0,17,0,0,0
51375,33410,2021-06-24T13:18:32.4527262Z,2021,3,3,3,0,0,Sin Grado,0,0,3,0,0,0,0,0,3,0,0,0
51375,3378,2020-11-18T16:21:02.1494667Z,2019,32,4,21,19,0,1ro,0,1,13,0,0,28,11,0,32,0,0,0
51375,3379,2020-11-18T16:21:02.1494667Z,2019,33,8,20,13,0,2do,0,1,20,0,0,25,13,0,33,0,0,0
51375,3380,2020-11-18T16:21:02.1504676Z,2019,31,7,20,12,0,3ro,1,1,19,0,0,24,11,0,30,0,2,0
51375,3381,2020-11-18T16:21:02.1504676Z,2019,33,10,18,14,0,4to,0,1,19,0,0,23,15,0,33,1,0,0
51375,3382,2020-11-18T16:21:02.1504676Z,2019,26,6,13,16,0,5to,0,0,10,0,0,20,13,0,26,0,0,0
51375,3383,2020-11-18T16:21:02.1514681Z,2019,30,8,21,18,0,K,1,1,12,0,0,22,9,0,29,0,0,0
51375,3384,2020-11-18T16:21:02.1514681Z,2019,17,2,9,12,0,PK,0,2,5,0,0,15,8,0,17,0,0,0
51375,3385,2020-11-18T16:21:02.1514681Z,2019,4,3,3,1,0,Sin Grado,0,0,3,0,0,1,1,0,4,0,0,0
51375,9398,2020-11-18T16:21:58.0107136Z,2020,29,7,16,16,0,1ro,1,0,13,0,0,22,13,0,28,0,0,0
51375,9399,2020-11-18T16:21:58.0117149Z,2020,34,7,21,21,0,2do,0,0,13,0,0,27,13,0,34,0,0,0
51375,9400,2020-11-18T16:21:58.0117149Z,2020,33,7,18,13,0,3ro,0,0,20,0,0,26,15,0,33,0,0,0
51375,9401,2020-11-18T16:21:58.4009738Z,2020,26,5,16,11,0,4to,0,0,15,0,0,21,10,0,26,0,1,0
51375,9402,2020-11-18T16:21:58.4009738Z,2020,30,8,13,12,0,5to,0,0,18,0,0,22,17,0,30,1,0,0
51375,9403,2020-11-18T16:21:58.4019747Z,2020,40,8,11,25,0,K,0,0,15,0,0,32,29,0,40,0,0,0
51375,9404,2020-11-18T16:21:58.4019747Z,2020,18,1,5,11,0,PK,0,0,7,0,0,17,13,0,18,0,0,0
51375,9405,2020-11-18T16:21:58.4019747Z,2020,3,3,3,0,0,Sin Grado,0,0,3,0,0,0,0,0,3,0,0,0
70615,11082,2020-11-18T16:22:07.6361318Z,2020,83,35,59,38,0,10mo,1,3,45,0,0,48,24,0,82,0,1,0
70615,11083,2020-11-18T16:22:07.6371327Z,2020,99,33,75,48,0,11mo,3,0,51,0,0,66,24,1,95,0,0,0
70615,11084,2020-11-18T16:22:07.6371327Z,2020,114,32,88,66,0,12mo,2,0,48,0,0,82,26,0,112,0,1,0
70615,11085,2020-11-18T16:22:07.6371327Z,2020,107,54,94,55,0,9no,5,4,52,0,0,53,13,0,102,0,1,0
70615,11086,2020-11-18T16:22:07.6381327Z,2020,37,36,25,6,0,Sin Grado,0,2,31,0,0,1,12,0,37,0,1,0
70615,35103,2021-06-24T13:18:44.477349Z,2021,82,31,70,45,0,10mo,4,5,37,0,0,51,12,0,78,0,0,0
70615,35104,2021-06-24T13:18:44.4783499Z,2021,61,17,48,33,0,11mo,2,2,28,0,0,44,13,0,59,0,1,0
70615,35105,2021-06-24T13:18:44.4783499Z,2021,74,19,52,40,0,12mo,5,0,34,0,0,55,22,1,68,0,0,0
70615,35106,2021-06-24T13:18:44.4783499Z,2021,27,10,24,12,0,9no,1,0,15,0,0,17,3,1,25,0,0,0
70615,35107,2021-06-24T13:18:44.4783499Z,2021,87,85,67,24,0,Sin Grado,0,1,63,0,0,2,20,0,87,0,1,0
70615,5076,2020-11-18T16:21:13.4339917Z,2019,117,37,91,57,0,10mo,4,2,60,0,0,80,26,0,113,0,0,0
70615,5077,2020-11-18T16:21:13.4339917Z,2019,128,34,95,71,0,11mo,4,1,57,0,0,94,33,0,124,0,1,0
70615,5078,2020-11-18T16:21:13.4339917Z,2019,124,0,92,59,0,12mo,2,2,65,0,0,124,32,0,122,0,0,0
70615,5079,2020-11-18T16:21:13.4349926Z,2019,75,32,52,35,0,9no,1,2,40,0,0,43,23,0,74,0,1,0
70615,5080,2020-11-18T16:21:13.4349926Z,2019,28,25,18,6,0,Sin Grado,0,1,22,0,0,3,10,0,28,0,1,0
57323,33962,2021-06-24T13:18:36.6607438Z,2021,35,8,33,21,0,1ro,0,1,14,0,0,27,2,0,35,0,0,0
57323,33963,2021-06-24T13:18:36.6607438Z,2021,45,15,41,24,0,2do,0,0,21,0,0,30,4,0,45,0,0,0
57323,33964,2021-06-24T13:18:36.6617443Z,2021,40,13,40,18,0,3ro,0,2,22,0,0,27,0,0,40,1,0,0
57323,33965,2021-06-24T13:18:36.6617443Z,2021,41,15,39,18,0,4to,0,0,23,0,0,26,2,0,41,1,0,0
57323,33966,2021-06-24T13:18:36.6617443Z,2021,42,11,38,24,0,5to,0,1,18,0,0,31,4,0,42,0,0,0
57323,33967,2021-06-24T13:18:36.6617443Z,2021,41,7,38,24,0,K,0,2,17,0,0,34,3,0,41,0,0,0
57323,33968,2021-06-24T13:18:36.6627448Z,2021,6,5,6,2,0,Sin Grado,0,0,4,0,0,1,0,0,5,0,0,1
57323,3938,2020-11-18T16:21:06.795563Z,2019,57,16,53,21,0,1ro,0,7,36,0,0,41,4,0,57,1,0,0
57323,3939,2020-11-18T16:21:06.795563Z,2019,54,22,47,26,0,2do,0,2,28,0,0,32,7,0,54,1,0,0
57323,3940,2020-11-18T16:21:06.795563Z,2019,59,17,52,28,0,3ro,0,5,31,0,0,42,7,0,59,0,0,0
57323,3941,2020-11-18T16:21:06.7965643Z,2019,50,16,44,28,0,4to,0,3,22,0,0,34,6,0,50,0,0,0
57323,3942,2020-11-18T16:21:06.7965643Z,2019,52,17,42,27,0,5to,0,2,25,0,0,35,10,0,51,0,0,1
57323,3943,2020-11-18T16:21:06.7965643Z,2019,57,15,51,33,0,K,0,3,24,0,0,42,6,0,57,0,0,0
57323,3944,2020-11-18T16:21:06.7975648Z,2019,14,13,13,5,0,Sin Grado,0,3,9,0,0,1,1,0,14,0,0,0
57323,9955,2020-11-18T16:22:01.5540808Z,2020,51,16,44,26,0,1ro,0,7,25,0,0,35,7,0,51,0,0,0
57323,9956,2020-11-18T16:22:01.5550808Z,2020,53,15,51,25,0,2do,0,10,28,0,0,38,2,0,53,1,0,0
57323,9957,2020-11-18T16:22:01.5550808Z,2020,49,17,43,22,0,3ro,0,3,27,0,0,32,6,0,49,1,0,0
57323,9958,2020-11-18T16:22:01.5550808Z,2020,49,15,41,26,0,4to,0,9,23,0,0,34,8,0,49,0,0,0
57323,9959,2020-11-18T16:22:01.5560817Z,2020,48,13,41,26,0,5to,0,6,22,0,0,35,7,0,48,0,0,0
57323,9960,2020-11-18T16:22:01.5560817Z,2020,52,13,47,30,0,K,0,3,22,0,0,39,5,0,52,0,0,0
57323,9961,2020-11-18T16:22:01.5560817Z,2020,10,10,10,3,0,Sin Grado,0,2,7,0,0,0,0,0,10,0,0,0
23531,1380,2020-11-18T16:20:45.9006307Z,2019,140,43,106,69,0,10mo,2,0,71,0,0,97,34,0,138,0,0,0
23531,1381,2020-11-18T16:20:45.9006307Z,2019,187,58,127,85,0,11mo,3,0,102,0,0,129,60,0,184,0,1,0
23531,1382,2020-11-18T16:20:45.9016316Z,2019,198,1,143,90,0,12mo,1,0,108,0,0,197,55,0,197,0,0,0
23531,1383,2020-11-18T16:20:45.9016316Z,2019,132,49,96,63,0,9no,1,0,69,0,0,83,36,0,131,0,0,0
23531,31381,2021-06-24T13:18:14.644951Z,2021,120,41,98,67,0,10mo,0,3,53,0,0,79,22,0,120,0,0,0
23531,31382,2021-06-24T13:18:14.644951Z,2021,130,49,101,65,0,11mo,2,4,65,0,0,81,29,0,128,0,0,0
23531,31383,2021-06-24T13:18:14.644951Z,2021,135,40,101,68,0,12mo,1,2,67,0,0,95,34,0,134,0,0,0
23531,31384,2021-06-24T13:18:14.644951Z,2021,135,57,100,63,0,9no,1,0,72,0,0,78,35,0,134,1,0,0
23531,7384,2020-11-18T16:21:45.3492742Z,2020,132,52,91,66,0,10mo,2,4,66,0,0,80,41,0,130,0,0,0
23531,7385,2020-11-18T16:21:45.3492742Z,2020,142,45,107,73,0,11mo,2,2,69,0,0,97,35,0,140,0,0,0
23531,7386,2020-11-18T16:21:45.350276Z,2020,186,56,127,85,0,12mo,2,3,101,0,0,130,59,0,184,0,1,0
23531,7387,2020-11-18T16:21:45.350276Z,2020,121,36,88,68,0,9no,1,3,53,0,0,85,33,1,118,0,0,1
70276,10947,2020-11-18T16:22:07.2048466Z,2020,160,44,104,96,0,10mo,1,0,64,0,0,116,56,1,158,0,0,0
70276,10948,2020-11-18T16:22:07.2048466Z,2020,152,43,81,77,0,11mo,4,0,75,0,0,109,71,0,148,0,0,0
70276,10949,2020-11-18T16:22:07.2048466Z,2020,151,41,95,76,0,12mo,3,0,75,0,0,110,56,0,148,0,0,0
70276,10950,2020-11-18T16:22:07.2058471Z,2020,153,58,94,76,0,9no,0,0,77,0,0,95,59,0,153,0,0,0
70276,34968,2021-06-24T13:18:43.3475381Z,2021,149,55,110,75,0,10mo,2,0,74,0,0,94,39,1,146,0,0,0
70276,34969,2021-06-24T13:18:43.3475381Z,2021,161,44,106,96,0,11mo,2,0,65,0,0,117,55,1,158,0,0,0
70276,34970,2021-06-24T13:18:43.3475381Z,2021,139,38,102,70,0,12mo,3,0,69,0,0,101,37,0,136,0,1,0
70276,34971,2021-06-24T13:18:43.3475381Z,2021,155,48,120,78,0,9no,1,0,77,0,0,107,35,0,154,2,1,0
70276,4939,2020-11-18T16:21:13.0077092Z,2019,149,43,83,72,0,10mo,4,0,77,0,0,106,66,0,145,0,0,0
70276,4940,2020-11-18T16:21:13.0087078Z,2019,148,40,96,75,0,11mo,3,0,73,0,0,108,52,0,145,0,0,0
70276,4941,2020-11-18T16:21:13.0087078Z,2019,158,0,94,87,0,12mo,5,0,71,0,0,158,64,0,153,0,0,0
70276,4942,2020-11-18T16:21:13.0087078Z,2019,150,36,96,92,0,9no,1,0,58,0,0,114,54,1,148,0,0,0
62398,10397,2020-11-18T16:22:03.7295291Z,2020,157,47,134,92,0,10mo,9,0,65,0,0,110,23,0,148,0,0,0
62398,10398,2020-11-18T16:22:03.7295291Z,2020,204,61,170,106,0,11mo,13,4,98,0,0,143,34,0,191,0,0,0
62398,10399,2020-11-18T16:22:03.7305286Z,2020,200,69,173,112,0,12mo,8,3,88,0,0,131,27,0,191,0,0,1
62398,10400,2020-11-18T16:22:03.7305286Z,2020,220,83,188,115,0,9no,10,0,105,0,0,137,32,0,209,0,1,1
62398,10401,2020-11-18T16:22:04.1127831Z,2020,72,68,66,18,0,Sin Grado,5,4,54,0,0,4,6,0,67,0,0,0
62398,34412,2021-06-24T13:18:39.428729Z,2021,217,82,177,115,0,10mo,8,0,102,0,0,135,40,0,208,0,1,1
62398,34413,2021-06-24T13:18:39.428729Z,2021,153,46,122,91,0,11mo,11,0,62,0,0,107,31,0,142,0,0,0
62398,34414,2021-06-24T13:18:39.428729Z,2021,178,48,136,94,0,12mo,12,0,84,0,0,130,42,0,166,0,0,0
62398,34415,2021-06-24T13:18:39.4297295Z,2021,250,96,220,129,0,9no,9,0,121,0,0,154,30,1,239,0,0,1
62398,34416,2021-06-24T13:18:39.4297295Z,2021,73,69,60,16,0,Sin Grado,3,1,57,0,0,4,13,0,70,0,0,0
62398,4384,2020-11-18T16:21:09.7065019Z,2019,230,69,190,118,0,10mo,16,2,112,0,0,161,40,0,214,0,0,0
62398,4385,2020-11-18T16:21:09.7075028Z,2019,226,67,195,127,0,11mo,9,3,99,0,0,159,31,0,216,0,0,1
62398,4386,2020-11-18T16:21:09.7075028Z,2019,206,0,172,107,0,12mo,10,0,99,0,0,206,34,0,196,0,0,0
62398,4387,2020-11-18T16:21:09.7075028Z,2019,144,45,123,85,0,9no,8,1,59,0,0,99,21,0,136,0,0,0
62398,4388,2020-11-18T16:21:09.7085033Z,2019,89,38,79,22,0,Sin Grado,1,3,67,0,0,51,10,0,88,0,0,0
46987,3106,2020-11-18T16:21:01.0107056Z,2019,138,33,101,71,0,10mo,5,0,67,0,0,105,37,0,133,0,1,0
46987,3107,2020-11-18T16:21:01.011706Z,2019,114,27,88,55,0,11mo,3,0,59,0,0,87,26,0,111,0,0,0
46987,3108,2020-11-18T16:21:01.011706Z,2019,105,0,80,55,0,12mo,1,0,50,0,0,105,25,0,104,0,1,0
46987,3109,2020-11-18T16:21:01.011706Z,2019,146,39,114,81,0,9no,5,0,65,0,0,107,32,0,141,0,2,0
46987,33119,2021-06-24T13:18:30.3071872Z,2021,122,35,103,56,0,10mo,2,0,66,0,0,87,19,0,120,0,1,0
46987,33120,2021-06-24T13:18:30.3071872Z,2021,124,32,94,72,0,11mo,5,0,52,0,0,92,30,0,119,0,0,0
46987,33121,2021-06-24T13:18:30.3081882Z,2021,117,27,94,64,0,12mo,2,0,53,0,0,90,23,0,114,0,1,1
46987,33122,2021-06-24T13:18:30.3081882Z,2021,105,38,81,53,0,9no,1,0,52,0,0,67,24,0,104,0,0,0
46987,33123,2021-06-24T13:18:30.3081882Z,2021,13,13,10,1,0,Sin Grado,0,0,12,0,0,0,3,0,13,0,1,0
46987,9120,2020-11-18T16:21:56.1344663Z,2020,131,34,104,72,0,10mo,5,0,59,0,0,97,27,0,126,0,0,0
46987,9121,2020-11-18T16:21:56.1344663Z,2020,132,31,98,71,0,11mo,3,0,61,0,0,101,34,0,129,0,1,0
46987,9122,2020-11-18T16:21:56.1344663Z,2020,93,25,69,46,0,12mo,2,0,47,0,0,68,24,0,91,0,0,0
46987,9123,2020-11-18T16:21:56.1344663Z,2020,130,41,102,59,0,9no,2,0,71,0,0,89,28,1,127,0,1,0
23135,1348,2020-11-18T16:20:45.8926258Z,2019,55,17,41,29,0,1ro,1,0,26,0,0,38,14,0,54,0,1,0
23135,1349,2020-11-18T16:20:45.8926258Z,2019,43,12,35,19,0,2do,0,0,24,0,0,31,8,0,43,1,0,0
23135,1350,2020-11-18T16:20:45.8926258Z,2019,51,16,43,29,0,3ro,1,0,22,0,0,35,8,0,50,0,1,0
23135,1351,2020-11-18T16:20:45.8936272Z,2019,42,18,36,20,0,4to,0,0,22,0,0,24,6,0,42,0,0,0
23135,1352,2020-11-18T16:20:45.8936272Z,2019,47,22,40,20,0,5to,0,0,27,0,0,25,7,0,47,0,0,0
23135,1353,2020-11-18T16:20:45.8936272Z,2019,33,9,28,18,0,K,0,0,15,0,0,24,5,2,31,0,0,0
23135,1354,2020-11-18T16:20:45.8946267Z,2019,16,13,14,7,0,Sin Grado,1,0,9,0,0,3,2,0,15,0,0,0
23135,31350,2021-06-24T13:18:14.5969161Z,2021,38,14,34,19,0,1ro,0,0,19,0,0,24,4,0,38,0,0,0
23135,31351,2021-06-24T13:18:14.5969161Z,2021,28,7,28,13,0,2do,0,0,15,0,0,21,0,0,28,0,0,0
23135,31352,2021-06-24T13:18:14.597917Z,2021,49,19,44,23,0,3ro,1,0,26,0,0,30,5,0,48,0,1,0
23135,31353,2021-06-24T13:18:14.597917Z,2021,36,10,34,15,0,4to,0,0,21,0,0,26,2,0,36,1,0,0
23135,31354,2021-06-24T13:18:14.597917Z,2021,49,17,45,28,0,5to,0,0,21,0,0,32,4,0,49,0,1,0
23135,31355,2021-06-24T13:18:14.597917Z,2021,25,6,24,14,0,K,0,0,11,0,0,19,1,0,25,0,0,0
23135,31356,2021-06-24T13:18:14.5989179Z,2021,8,8,8,2,0,Sin Grado,1,0,6,0,0,0,0,0,7,0,0,0
23135,7353,2020-11-18T16:21:45.3402702Z,2020,29,8,24,14,0,1ro,0,0,15,0,0,21,5,0,29,0,0,0
23135,7354,2020-11-18T16:21:45.3412693Z,2020,48,16,38,24,0,2do,1,0,24,0,0,32,10,0,47,0,1,0
23135,7355,2020-11-18T16:21:45.3412693Z,2020,36,10,31,16,0,3ro,0,0,20,0,0,26,5,0,36,1,0,0
23135,7356,2020-11-18T16:21:45.3412693Z,2020,46,17,41,28,0,4to,0,0,18,0,0,29,5,0,46,1,1,0
23135,7357,2020-11-18T16:21:45.3422697Z,2020,39,15,31,18,0,5to,0,0,21,0,0,24,8,0,39,0,0,0
23135,7358,2020-11-18T16:21:45.3422697Z,2020,34,11,25,19,0,K,0,0,15,0,0,23,9,0,34,0,0,0
23135,7359,2020-11-18T16:21:45.3422697Z,2020,14,14,12,3,0,Sin Grado,1,0,11,0,0,0,2,0,13,0,0,0
17871,30782,2021-06-24T13:18:11.2124901Z,2021,41,10,37,24,0,1ro,0,0,17,0,0,31,4,0,41,0,0,0
17871,30783,2021-06-24T13:18:11.2124901Z,2021,39,12,32,19,0,2do,0,1,20,0,0,27,7,0,39,0,0,0
17871,30784,2021-06-24T13:18:11.2124901Z,2021,51,19,45,22,0,3ro,0,0,29,0,0,32,6,0,51,0,0,0
17871,30785,2021-06-24T13:18:11.2134906Z,2021,34,15,29,17,0,4to,0,0,17,0,0,19,5,0,34,0,0,0
17871,30786,2021-06-24T13:18:11.2134906Z,2021,45,20,40,24,0,5to,0,1,21,0,0,25,5,0,45,0,0,0
17871,30787,2021-06-24T13:18:11.2134906Z,2021,48,16,39,27,0,6to,0,0,21,0,0,32,9,0,48,0,0,0
17871,30788,2021-06-24T13:18:11.2144911Z,2021,55,20,46,25,0,7mo,0,0,30,0,0,35,9,0,55,0,0,0
17871,30789,2021-06-24T13:18:11.2144911Z,2021,67,14,55,25,0,8vo,0,0,42,0,0,53,12,0,67,0,0,0
17871,30790,2021-06-24T13:18:11.2144911Z,2021,39,11,35,20,0,K,0,0,19,0,0,28,4,0,39,0,0,0
17871,30791,2021-06-24T13:18:11.2154916Z,2021,9,9,8,2,0,Sin Grado,1,0,7,0,0,0,1,0,8,0,0,0
17871,6785,2020-11-18T16:21:41.458677Z,2020,48,17,41,22,0,1ro,0,0,26,0,0,31,7,0,48,0,0,0
17871,6786,2020-11-18T16:21:41.458677Z,2020,52,19,42,25,0,2do,0,0,27,0,0,33,10,0,52,0,0,0
17871,6787,2020-11-18T16:21:41.4596783Z,2020,37,14,28,19,0,3ro,0,0,18,0,0,23,9,0,37,0,0,0
17871,6788,2020-11-18T16:21:41.4596783Z,2020,42,18,36,23,0,4to,0,1,19,0,0,24,6,0,42,0,0,0
17871,6789,2020-11-18T16:21:41.4596783Z,2020,42,14,38,26,0,5to,0,0,16,0,0,28,4,0,42,0,0,0
17871,6790,2020-11-18T16:21:41.4606787Z,2020,52,17,42,23,0,6to,0,0,29,0,0,35,10,0,52,0,0,0
17871,6791,2020-11-18T16:21:41.4606787Z,2020,68,16,57,23,0,7mo,0,0,45,0,0,52,11,0,68,0,0,0
17871,6792,2020-11-18T16:21:41.4606787Z,2020,80,17,64,37,0,8vo,0,0,43,0,0,63,16,0,80,0,0,0
17871,6793,2020-11-18T16:21:41.4606787Z,2020,44,7,39,25,0,K,0,0,19,0,0,37,5,0,44,0,0,0
17871,6794,2020-11-18T16:21:41.4616792Z,2020,9,9,8,4,0,Sin Grado,0,0,5,0,0,0,1,0,9,0,0,0
17871,784,2020-11-18T16:20:42.125112Z,2019,61,27,50,28,0,1ro,0,1,33,0,0,34,11,0,61,0,0,0
17871,785,2020-11-18T16:20:42.125112Z,2019,38,17,32,18,0,2do,0,0,20,0,0,21,6,0,38,0,0,0
17871,786,2020-11-18T16:20:42.125112Z,2019,43,20,38,23,0,3ro,0,0,20,0,0,23,5,0,43,0,0,0
17871,787,2020-11-18T16:20:42.125112Z,2019,40,14,35,25,0,4to,0,1,15,0,0,26,5,0,40,0,0,0
17871,788,2020-11-18T16:20:42.125112Z,2019,45,21,36,21,0,5to,0,0,24,0,0,24,9,0,45,0,0,0
17871,789,2020-11-18T16:20:42.1261133Z,2019,72,19,64,24,0,6to,0,0,48,0,0,53,8,0,72,0,0,0
17871,790,2020-11-18T16:20:42.1261133Z,2019,78,17,62,43,0,7mo,0,0,35,0,0,61,16,0,78,0,0,0
17871,791,2020-11-18T16:20:42.1261133Z,2019,71,15,51,32,0,8vo,0,1,39,0,0,56,20,0,71,1,0,0
17871,792,2020-11-18T16:20:42.1261133Z,2019,50,15,44,22,0,K,0,2,28,0,0,35,6,0,50,0,0,0
17871,793,2020-11-18T16:20:42.1261133Z,2019,10,10,10,2,0,Sin Grado,0,0,8,0,0,0,0,0,10,0,0,0
65946,10720,2020-11-18T16:22:06.0150549Z,2020,21,6,21,17,0,1ro,0,0,4,0,0,15,0,0,21,0,0,0
65946,10721,2020-11-18T16:22:06.0150549Z,2020,16,2,16,8,0,2do,0,0,8,0,0,14,0,0,16,0,0,0
65946,10722,2020-11-18T16:22:06.0160558Z,2020,16,2,15,7,0,3ro,0,0,9,0,0,14,1,0,15,0,0,1
65946,10723,2020-11-18T16:22:06.0160558Z,2020,16,5,16,7,0,4to,0,0,9,0,0,11,0,0,16,0,0,0
65946,10724,2020-11-18T16:22:06.0160558Z,2020,22,8,21,12,0,5to,0,0,10,0,0,14,1,0,22,0,0,0
65946,10725,2020-11-18T16:22:06.0170554Z,2020,15,2,15,6,0,K,0,0,9,0,0,13,0,0,15,0,0,0
65946,10726,2020-11-18T16:22:06.0170554Z,2020,6,6,6,0,0,Sin Grado,0,0,6,0,0,0,0,0,6,0,0,0
65946,34737,2021-06-24T13:18:41.46619Z,2021,16,3,15,8,0,1ro,0,0,8,0,0,13,1,0,16,0,0,0
65946,34738,2021-06-24T13:18:41.46619Z,2021,20,6,19,16,0,2do,0,0,4,0,0,14,1,0,20,0,0,0
65946,34739,2021-06-24T13:18:41.46619Z,2021,18,3,15,7,0,3ro,0,0,11,0,0,15,3,0,18,0,0,0
65946,34740,2021-06-24T13:18:41.46619Z,2021,19,2,16,7,0,4to,0,0,12,0,0,17,3,0,18,0,0,1
65946,34741,2021-06-24T13:18:41.4671901Z,2021,17,7,16,9,0,5to,0,0,8,0,0,10,1,0,17,0,0,0
65946,34742,2021-06-24T13:18:41.4671901Z,2021,11,5,5,6,0,K,0,0,5,0,0,6,6,0,11,0,0,0
65946,34743,2021-06-24T13:18:41.4671901Z,2021,10,10,8,1,0,Sin Grado,0,0,9,0,0,0,2,0,10,0,0,0
65946,4708,2020-11-18T16:21:11.9079725Z,2019,29,5,29,15,0,1ro,0,0,14,0,0,24,0,0,29,0,0,0
65946,4709,2020-11-18T16:21:11.9079725Z,2019,37,5,36,18,0,2do,1,0,19,0,0,32,1,0,35,0,0,1
65946,4710,2020-11-18T16:21:11.9079725Z,2019,28,4,28,13,0,3ro,0,0,15,0,0,24,0,0,28,0,0,0
65946,4711,2020-11-18T16:21:11.9079725Z,2019,45,15,44,23,1,4to,0,0,22,0,0,30,1,0,45,0,0,0
65946,4712,2020-11-18T16:21:11.9089734Z,2019,32,13,32,17,0,5to,0,1,15,0,0,19,0,0,32,0,0,0
65946,4713,2020-11-18T16:21:11.9089734Z,2019,31,9,29,17,0,6to,0,0,14,0,0,22,2,0,31,0,0,0
65946,4714,2020-11-18T16:21:11.9089734Z,2019,20,6,20,8,0,7mo,0,0,12,0,0,14,0,0,20,0,0,0
65946,4715,2020-11-18T16:21:11.9099739Z,2019,30,11,29,12,0,8vo,0,0,18,0,0,19,1,0,30,0,0,0
65946,4716,2020-11-18T16:21:11.9099739Z,2019,30,6,30,26,0,K,0,0,4,0,0,24,0,0,30,0,0,0
65946,4717,2020-11-18T16:21:11.9099739Z,2019,19,15,19,1,0,Sin Grado,0,0,18,0,0,4,0,0,19,0,0,0
20594,1028,2020-11-18T16:20:43.8042301Z,2019,44,17,42,28,0,1ro,1,6,16,0,0,27,2,0,43,0,0,0
20594,1029,2020-11-18T16:20:43.8042301Z,2019,21,9,14,10,0,2do,1,3,11,0,0,12,7,0,20,0,0,0
20594,1030,2020-11-18T16:20:43.8042301Z,2019,24,10,19,15,0,3ro,0,4,9,0,0,14,5,0,24,0,0,0
20594,1031,2020-11-18T16:20:43.805231Z,2019,24,11,21,12,0,4to,0,5,12,0,0,13,3,0,24,0,0,0
20594,1032,2020-11-18T16:20:43.805231Z,2019,24,8,19,13,0,5to,0,5,11,0,0,16,5,0,24,0,0,0
20594,1033,2020-11-18T16:20:43.805231Z,2019,97,33,77,48,0,6to,1,8,49,0,0,64,20,0,96,0,0,0
20594,1034,2020-11-18T16:20:43.805231Z,2019,80,38,68,31,0,7mo,0,7,49,0,0,42,12,0,80,0,0,0
20594,1035,2020-11-18T16:20:43.8062323Z,2019,44,14,38,18,0,8vo,0,5,26,0,0,30,6,0,44,0,0,0
20594,1036,2020-11-18T16:20:43.8062323Z,2019,19,5,0,12,0,K,0,0,7,0,0,14,19,0,19,0,0,0
20594,1037,2020-11-18T16:20:43.8062323Z,2019,20,20,20,8,0,Sin Grado,0,0,12,0,0,0,0,0,20,0,0,0
20594,31027,2021-06-24T13:18:12.0620991Z,2021,24,13,21,11,0,1ro,2,2,13,0,0,11,3,0,22,0,0,0
20594,31028,2021-06-24T13:18:12.0630996Z,2021,23,9,18,13,0,2do,0,4,10,0,0,14,5,0,23,0,0,0
20594,31029,2021-06-24T13:18:12.0630996Z,2021,31,12,23,18,0,3ro,1,5,13,0,0,19,8,0,30,0,0,0
20594,31030,2021-06-24T13:18:12.0641006Z,2021,28,12,25,16,0,4to,0,5,12,0,0,16,3,0,28,0,0,0
20594,31031,2021-06-24T13:18:12.0641006Z,2021,33,10,29,21,0,5to,2,8,12,0,0,23,4,0,31,0,0,0
20594,31032,2021-06-24T13:18:12.0641006Z,2021,60,28,50,27,0,6to,0,6,33,0,0,32,10,0,58,0,0,2
20594,31033,2021-06-24T13:18:12.0651015Z,2021,55,20,47,28,0,7mo,2,7,27,0,0,35,8,0,52,0,1,1
20594,31034,2021-06-24T13:18:12.0651015Z,2021,70,27,55,31,0,8vo,3,3,39,0,0,43,15,0,66,0,0,1
20594,31035,2021-06-24T13:18:12.0651015Z,2021,24,8,16,13,0,K,2,0,11,0,0,16,8,1,21,0,0,0
20594,31036,2021-06-24T13:18:12.0661016Z,2021,43,43,40,14,0,Sin Grado,0,1,29,0,0,0,3,0,43,0,0,0
20594,7031,2020-11-18T16:21:43.6331289Z,2020,26,10,24,17,0,1ro,0,9,9,0,0,16,2,0,26,0,0,0
20594,7032,2020-11-18T16:21:43.6341294Z,2020,30,11,27,19,0,2do,1,8,11,0,0,19,3,0,29,0,0,0
20594,7033,2020-11-18T16:21:43.6341294Z,2020,25,10,21,14,0,3ro,0,5,11,0,0,15,4,0,25,0,0,0
20594,7034,2020-11-18T16:21:43.6341294Z,2020,28,10,24,17,0,4to,0,9,11,0,0,18,4,0,28,0,0,0
20594,7035,2020-11-18T16:21:43.6341294Z,2020,24,10,21,12,0,5to,0,5,12,0,0,14,3,0,23,0,0,1
20594,7036,2020-11-18T16:21:43.6351289Z,2020,61,24,55,30,0,6to,1,11,31,0,0,37,6,0,59,0,0,1
20594,7037,2020-11-18T16:21:43.6351289Z,2020,73,27,60,34,0,7mo,2,8,39,0,0,46,13,0,70,0,0,1
20594,7038,2020-11-18T16:21:43.6351289Z,2020,51,17,43,20,0,8vo,0,4,31,0,0,34,8,0,51,0,0,0
20594,7039,2020-11-18T16:21:43.6351289Z,2020,25,14,21,9,0,K,2,1,16,0,0,11,4,0,23,0,0,0
20594,7040,2020-11-18T16:21:43.6361307Z,2020,25,25,24,10,0,Sin Grado,0,0,15,0,0,0,1,0,25,0,0,0
71381,11293,2020-11-18T16:22:09.5894355Z,2020,160,45,135,75,0,10mo,1,0,85,0,0,115,25,0,159,0,0,0
71381,11294,2020-11-18T16:22:09.5894355Z,2020,120,38,86,65,0,11mo,0,0,55,0,0,82,34,0,120,0,0,0
71381,11295,2020-11-18T16:22:09.5894355Z,2020,123,20,93,71,0,12mo,1,0,52,0,0,103,30,0,122,0,0,0
71381,11296,2020-11-18T16:22:09.5894355Z,2020,160,53,143,73,0,9no,3,0,87,0,0,107,17,0,157,0,0,0
71381,11297,2020-11-18T16:22:09.5904373Z,2020,9,7,7,3,0,Sin Grado,0,0,6,0,0,2,2,0,9,0,0,0
71381,35314,2021-06-24T13:18:45.555122Z,2021,142,49,111,66,0,10mo,2,0,76,0,0,93,31,0,140,0,0,0
71381,35315,2021-06-24T13:18:45.555122Z,2021,138,40,109,65,0,11mo,1,0,73,0,0,98,29,0,137,0,0,0
71381,35316,2021-06-24T13:18:45.555122Z,2021,113,35,87,65,0,12mo,0,0,48,0,0,78,26,0,113,0,0,0
71381,35317,2021-06-24T13:18:45.5561225Z,2021,141,41,119,70,0,9no,0,0,71,0,0,100,22,0,141,0,0,0
71381,35318,2021-06-24T13:18:45.5561225Z,2021,22,22,21,5,0,Sin Grado,0,0,17,0,0,0,1,0,22,0,0,0
71381,5288,2020-11-18T16:21:14.4716803Z,2019,141,43,106,74,0,10mo,1,0,67,0,0,98,35,0,140,0,0,0
71381,5289,2020-11-18T16:21:14.4716803Z,2019,127,22,94,73,0,11mo,1,0,54,0,0,105,33,0,125,0,0,1
71381,5290,2020-11-18T16:21:14.4726808Z,2019,133,1,100,71,0,12mo,5,0,62,0,0,132,33,0,128,0,1,0
71381,5291,2020-11-18T16:21:14.4726808Z,2019,144,39,120,75,0,9no,1,0,69,0,0,105,24,0,143,0,0,0
71381,5292,2020-11-18T16:21:14.4726808Z,2019,8,5,7,1,0,Sin Grado,0,0,7,0,0,3,1,0,8,0,0,0
56077,33875,2021-06-24T13:18:35.7651013Z,2021,32,8,30,12,0,1ro,0,0,20,0,0,24,2,0,32,0,0,0
56077,33876,2021-06-24T13:18:35.7651013Z,2021,41,13,38,16,0,2do,0,0,25,0,0,28,3,0,41,0,0,0
56077,33877,2021-06-24T13:18:35.7651013Z,2021,37,14,34,18,0,3ro,1,0,19,0,0,23,3,0,36,0,0,0
56077,33878,2021-06-24T13:18:35.7651013Z,2021,39,16,30,22,0,4to,0,0,17,0,0,23,9,0,39,0,0,0
56077,33879,2021-06-24T13:18:35.7661027Z,2021,55,26,45,28,0,5to,0,0,27,0,0,29,10,0,55,1,0,0
56077,33880,2021-06-24T13:18:35.7661027Z,2021,23,3,20,14,0,K,0,0,9,0,0,20,3,0,23,0,0,0
56077,3852,2020-11-18T16:21:05.5747488Z,2019,52,23,42,28,0,1ro,0,0,24,0,0,29,10,0,52,0,0,0
56077,3853,2020-11-18T16:21:05.5747488Z,2019,48,19,39,26,0,2do,1,0,22,0,0,29,9,0,47,0,0,0
56077,3854,2020-11-18T16:21:05.5757488Z,2019,51,24,40,25,0,3ro,0,0,26,0,1,27,11,0,51,1,0,0
56077,3855,2020-11-18T16:21:05.5757488Z,2019,67,17,52,33,0,4to,0,0,34,0,0,50,15,0,67,0,0,0
56077,3856,2020-11-18T16:21:05.5757488Z,2019,72,26,56,36,0,5to,0,4,36,0,0,46,16,0,72,0,0,0
56077,3857,2020-11-18T16:21:05.5757488Z,2019,41,8,36,19,0,K,0,0,22,0,1,33,5,0,41,0,0,0
56077,9869,2020-11-18T16:22:00.5303958Z,2020,45,15,39,18,0,1ro,0,3,27,0,0,30,6,0,45,0,0,0
56077,9870,2020-11-18T16:22:00.5303958Z,2020,43,15,37,21,0,2do,0,1,22,0,0,28,6,0,43,0,0,0
56077,9871,2020-11-18T16:22:00.5303958Z,2020,41,16,35,24,0,3ro,1,0,17,0,0,25,6,0,40,0,0,0
56077,9872,2020-11-18T16:22:00.5303958Z,2020,53,27,43,28,0,4to,0,0,25,0,0,26,10,0,53,1,0,0
56077,9873,2020-11-18T16:22:00.5303958Z,2020,68,18,53,30,0,5to,0,0,38,0,0,50,15,0,68,0,0,0
56077,9874,2020-11-18T16:22:00.5313967Z,2020,35,5,32,16,0,K,0,1,19,0,0,30,3,0,35,0,0,0
13912,30535,2021-06-24T13:18:10.3989056Z,2021,69,2,27,43,0,10mo,2,0,26,0,0,67,42,0,67,0,0,0
13912,30536,2021-06-24T13:18:10.3989056Z,2021,48,0,19,25,0,11mo,0,0,23,0,0,48,29,0,48,0,0,0
13912,30537,2021-06-24T13:18:10.3989056Z,2021,75,3,29,36,0,12mo,1,0,39,0,0,72,46,0,74,0,0,0
13912,30538,2021-06-24T13:18:10.3989056Z,2021,51,12,38,31,0,1ro,1,0,20,0,0,39,13,0,50,0,0,0
13912,30539,2021-06-24T13:18:10.399907Z,2021,39,10,27,18,0,2do,1,0,21,0,0,29,12,0,38,0,0,0
13912,30540,2021-06-24T13:18:10.399907Z,2021,48,15,36,26,0,3ro,1,0,22,0,0,33,12,0,47,0,0,0
13912,30541,2021-06-24T13:18:10.399907Z,2021,42,8,29,20,0,4to,2,0,22,0,0,34,13,0,40,0,0,0
13912,30542,2021-06-24T13:18:10.399907Z,2021,44,3,28,21,0,5to,1,0,23,0,0,41,16,0,43,0,0,0
13912,30543,2021-06-24T13:18:10.4009075Z,2021,64,4,41,31,0,6to,1,0,33,0,0,60,23,0,63,0,0,0
13912,30544,2021-06-24T13:18:10.4009075Z,2021,56,4,32,25,0,7mo,0,0,31,0,0,52,24,0,56,0,0,0
13912,30545,2021-06-24T13:18:10.4009075Z,2021,48,4,19,27,0,8vo,0,0,21,0,0,44,29,0,48,0,0,0
13912,30546,2021-06-24T13:18:10.4009075Z,2021,76,2,34,40,0,9no,0,0,36,0,0,74,42,0,76,0,0,0
13912,30547,2021-06-24T13:18:10.4009075Z,2021,44,2,33,23,0,K,0,0,21,0,0,42,11,0,44,0,0,0
13912,30548,2021-06-24T13:18:10.401908Z,2021,28,28,26,8,0,Sin Grado,0,0,20,0,0,0,2,0,28,0,0,0
13912,538,2020-11-18T16:20:40.7742136Z,2019,81,2,26,42,0,10mo,1,0,39,0,0,79,55,0,80,0,0,0
13912,539,2020-11-18T16:20:40.7742136Z,2019,56,0,20,35,0,11mo,2,0,21,0,0,56,36,0,54,0,0,0
13912,540,2020-11-18T16:20:40.7742136Z,2019,65,0,16,39,0,12mo,0,0,26,0,0,65,49,1,64,0,0,0
13912,541,2020-11-18T16:20:40.7752136Z,2019,31,14,26,19,0,1ro,0,0,12,0,0,17,5,0,31,0,0,0
13912,542,2020-11-18T16:20:40.7752136Z,2019,24,12,22,15,0,2do,0,0,9,0,0,12,2,0,24,0,0,0
13912,543,2020-11-18T16:20:40.7752136Z,2019,18,7,17,12,0,3ro,1,0,6,0,0,11,1,0,17,0,0,0
13912,544,2020-11-18T16:20:40.7752136Z,2019,24,6,23,12,0,4to,0,0,12,0,0,18,1,0,24,0,0,0
13912,545,2020-11-18T16:20:40.776215Z,2019,24,9,21,13,0,5to,2,0,11,0,0,15,3,0,22,0,0,0
13912,546,2020-11-18T16:20:40.776215Z,2019,39,3,27,22,0,6to,2,0,17,0,0,36,12,0,37,0,0,0
13912,547,2020-11-18T16:20:40.776215Z,2019,72,2,35,36,0,7mo,0,0,36,0,0,70,37,0,72,0,0,0
13912,548,2020-11-18T16:20:40.776215Z,2019,59,1,23,36,0,8vo,1,0,23,0,0,58,36,0,58,0,0,0
13912,549,2020-11-18T16:20:40.776215Z,2019,48,0,17,25,0,9no,0,0,23,0,0,48,31,0,48,0,0,0
13912,550,2020-11-18T16:20:40.777215Z,2019,27,8,24,12,0,K,0,0,15,0,0,19,3,0,27,0,0,0
13912,551,2020-11-18T16:20:40.777215Z,2019,33,32,27,10,0,Sin Grado,0,1,23,0,0,1,6,0,33,0,1,0
13912,6537,2020-11-18T16:21:40.3599471Z,2020,52,0,17,25,0,10mo,0,0,27,0,0,52,35,0,52,0,0,0
13912,6538,2020-11-18T16:21:40.3599471Z,2020,76,3,25,39,0,11mo,1,0,37,0,0,73,51,0,75,0,0,0
13912,6539,2020-11-18T16:21:40.3599471Z,2020,48,0,15,30,0,12mo,1,0,18,0,0,48,33,0,47,0,0,0
13912,6540,2020-11-18T16:21:40.3599471Z,2020,36,8,29,14,0,1ro,0,0,22,0,0,28,7,0,36,0,0,0
13912,6541,2020-11-18T16:21:40.3609475Z,2020,42,14,34,22,0,2do,0,0,20,0,0,28,8,0,42,0,0,0
13912,6542,2020-11-18T16:21:40.3609475Z,2020,38,9,30,17,0,3ro,1,0,21,0,0,29,8,0,37,0,0,0
13912,6543,2020-11-18T16:21:40.3609475Z,2020,33,4,25,16,0,4to,2,0,17,0,0,29,8,0,31,0,0,0
13912,6544,2020-11-18T16:21:40.3609475Z,2020,46,5,32,23,0,5to,1,0,23,0,0,41,14,0,45,0,0,0
13912,6545,2020-11-18T16:21:40.3609475Z,2020,62,6,27,31,0,6to,1,0,31,0,0,56,35,0,61,0,0,0
13912,6546,2020-11-18T16:21:40.3619484Z,2020,43,2,26,25,0,7mo,1,0,18,0,0,41,17,0,42,0,0,0
13912,6547,2020-11-18T16:21:40.3619484Z,2020,66,3,32,33,0,8vo,0,0,33,0,0,63,34,0,66,0,0,0
13912,6548,2020-11-18T16:21:40.3619484Z,2020,63,2,26,40,0,9no,1,0,23,0,0,61,37,0,62,0,0,0
13912,6549,2020-11-18T16:21:40.3619484Z,2020,42,9,32,28,0,K,0,0,14,0,0,33,10,0,42,0,0,0
13912,6550,2020-11-18T16:21:40.3619484Z,2020,35,34,30,10,0,Sin Grado,1,0,25,0,0,1,5,0,34,0,1,0
17657,30730,2021-06-24T13:18:11.1874711Z,2021,41,8,35,10,0,1ro,0,1,31,0,0,33,6,0,41,0,0,0
17657,30731,2021-06-24T13:18:11.188472Z,2021,37,8,32,25,0,2do,0,0,12,0,0,29,5,0,37,0,0,0
17657,30732,2021-06-24T13:18:11.188472Z,2021,37,10,27,17,0,3ro,1,0,20,0,0,27,10,0,35,0,0,1
17657,30733,2021-06-24T13:18:11.188472Z,2021,51,16,45,26,0,4to,0,0,25,0,0,35,6,0,51,0,0,0
17657,30734,2021-06-24T13:18:11.189473Z,2021,45,14,39,23,0,5to,1,0,22,0,0,31,6,0,44,0,0,0
17657,30735,2021-06-24T13:18:11.189473Z,2021,31,11,30,13,0,K,2,0,18,0,0,20,1,1,27,0,0,1
17657,30736,2021-06-24T13:18:11.1904735Z,2021,7,1,6,3,0,PK,0,0,4,0,0,6,1,0,7,0,0,0
17657,30737,2021-06-24T13:18:11.1904735Z,2021,26,26,23,8,0,Sin Grado,0,0,18,0,0,0,3,0,26,0,0,0
17657,6732,2020-11-18T16:21:41.4386646Z,2020,34,7,30,25,0,1ro,0,0,9,0,0,27,4,0,34,0,0,0
17657,6733,2020-11-18T16:21:41.4386646Z,2020,29,8,24,12,0,2do,1,0,17,0,0,21,5,0,28,0,0,0
17657,6734,2020-11-18T16:21:41.4386646Z,2020,56,17,48,30,0,3ro,1,0,26,0,0,39,8,0,55,0,0,0
17657,6735,2020-11-18T16:21:41.4396651Z,2020,44,12,39,23,0,4to,1,0,21,0,0,32,5,0,43,0,0,0
17657,6736,2020-11-18T16:21:41.4396651Z,2020,51,21,44,22,0,5to,1,0,29,0,0,30,7,0,50,0,0,0
17657,6737,2020-11-18T16:21:41.4396651Z,2020,38,4,34,14,0,K,0,0,24,0,0,34,4,0,38,0,0,0
17657,6738,2020-11-18T16:21:41.4396651Z,2020,18,4,15,10,0,PK,1,0,8,0,0,14,3,0,17,0,0,0
17657,6739,2020-11-18T16:21:41.4406655Z,2020,44,43,34,11,0,Sin Grado,2,0,33,0,0,1,10,0,42,0,0,0
17657,731,2020-11-18T16:20:42.1071001Z,2019,33,10,26,16,0,1ro,1,0,17,0,0,23,7,0,32,0,0,0
17657,732,2020-11-18T16:20:42.1071001Z,2019,59,15,48,34,0,2do,2,0,25,0,0,44,11,0,57,0,0,0
17657,733,2020-11-18T16:20:42.108101Z,2019,49,13,39,27,0,3ro,1,0,22,0,0,36,10,0,48,0,0,0
17657,734,2020-11-18T16:20:42.108101Z,2019,56,23,48,24,0,4to,2,0,32,0,0,33,8,0,54,0,0,0
17657,735,2020-11-18T16:20:42.108101Z,2019,71,27,56,30,0,5to,2,0,41,0,0,44,15,0,69,0,0,0
17657,736,2020-11-18T16:20:42.108101Z,2019,35,4,30,18,0,K,1,0,17,0,0,31,5,0,34,0,0,0
17657,737,2020-11-18T16:20:42.1091014Z,2019,14,0,13,7,0,PK,0,0,7,0,0,14,1,0,14,0,0,0
17657,738,2020-11-18T16:20:42.1091014Z,2019,37,37,23,10,0,Sin Grado,2,0,27,0,0,0,14,0,35,0,0,0
79087,11759,2020-11-18T16:22:12.325263Z,2020,46,13,32,23,0,1ro,0,4,23,0,0,33,14,0,46,0,0,0
79087,11760,2020-11-18T16:22:12.325263Z,2020,67,24,52,33,0,2do,4,3,34,0,0,43,15,0,63,0,0,0
79087,11761,2020-11-18T16:22:12.3262635Z,2020,76,25,59,36,0,3ro,0,13,40,0,0,51,17,0,76,0,0,0
79087,11762,2020-11-18T16:22:12.3262635Z,2020,53,19,37,30,0,4to,0,5,23,0,0,34,16,0,53,0,0,0
79087,11763,2020-11-18T16:22:12.3262635Z,2020,65,22,56,32,0,5to,0,7,33,0,0,43,9,0,64,0,0,1
79087,11764,2020-11-18T16:22:12.3272644Z,2020,49,7,39,26,0,K,1,1,23,0,0,42,10,0,48,0,0,0
79087,11765,2020-11-18T16:22:12.3272644Z,2020,17,17,13,5,0,Sin Grado,0,0,12,0,0,0,4,0,17,0,0,0
79087,35781,2021-06-24T13:18:47.8427619Z,2021,49,5,43,28,0,1ro,1,0,21,0,0,44,6,0,48,0,0,0
79087,35782,2021-06-24T13:18:47.8427619Z,2021,41,10,35,21,0,2do,1,0,20,0,0,31,6,0,40,0,0,0
79087,35783,2021-06-24T13:18:47.843762Z,2021,62,21,59,30,0,3ro,5,0,32,0,0,41,3,0,57,0,0,0
79087,35784,2021-06-24T13:18:47.843762Z,2021,61,22,57,25,0,4to,0,0,36,0,0,39,4,0,61,0,0,0
79087,35785,2021-06-24T13:18:47.843762Z,2021,43,17,36,24,0,5to,0,0,19,0,0,26,7,0,43,0,0,0
79087,35786,2021-06-24T13:18:47.843762Z,2021,48,15,43,20,0,K,2,0,28,0,0,33,5,0,46,0,0,0
79087,35787,2021-06-24T13:18:47.8447634Z,2021,16,16,14,5,0,Sin Grado,0,0,11,0,0,0,2,0,16,0,0,0
79087,5753,2020-11-18T16:21:17.1554712Z,2019,73,27,65,32,0,1ro,3,0,41,0,0,46,8,0,70,0,0,0
79087,5754,2020-11-18T16:21:17.1554712Z,2019,73,17,61,34,0,2do,1,0,39,0,0,56,12,0,72,0,0,0
79087,5755,2020-11-18T16:21:17.1564721Z,2019,66,24,54,34,0,3ro,0,0,32,0,0,42,12,0,66,0,0,0
79087,5756,2020-11-18T16:21:17.1564721Z,2019,74,21,61,37,0,4to,0,0,37,0,0,53,13,0,73,0,0,1
79087,5757,2020-11-18T16:21:17.1564721Z,2019,75,14,70,42,0,5to,0,0,33,0,0,61,5,0,75,0,0,0
79087,5758,2020-11-18T16:21:17.1564721Z,2019,40,6,32,25,0,K,0,0,15,0,0,34,8,0,40,0,0,0
79087,5759,2020-11-18T16:21:17.1564721Z,2019,16,16,12,3,0,Sin Grado,0,0,13,0,0,0,4,0,16,0,0,0
78253,11715,2020-11-18T16:22:12.3142564Z,2020,51,10,44,28,0,1ro,0,0,23,0,0,41,7,0,51,0,0,0
78253,11716,2020-11-18T16:22:12.3152572Z,2020,55,17,49,27,0,2do,2,0,28,0,0,38,6,0,53,0,0,0
78253,11717,2020-11-18T16:22:12.3152572Z,2020,55,19,52,34,0,3ro,0,0,21,0,0,36,3,0,55,0,0,0
78253,11718,2020-11-18T16:22:12.3152572Z,2020,48,22,46,28,0,4to,1,0,20,0,0,26,2,0,47,0,0,0
78253,11719,2020-11-18T16:22:12.3162572Z,2020,60,24,57,28,0,5to,0,0,32,0,0,36,3,0,60,0,1,0
78253,11720,2020-11-18T16:22:12.3162572Z,2020,48,15,42,20,0,K,2,0,28,0,0,33,6,0,46,0,0,0
78253,11721,2020-11-18T16:22:12.3162572Z,2020,20,3,12,12,0,PK,0,0,8,0,0,17,8,0,19,0,0,1
78253,11722,2020-11-18T16:22:12.3162572Z,2020,69,69,61,15,0,Sin Grado,3,0,54,0,0,0,8,0,66,1,1,0
78253,35737,2021-06-24T13:18:47.7446912Z,2021,44,13,40,22,0,1ro,2,0,22,0,0,31,4,0,42,0,0,0
78253,35738,2021-06-24T13:18:47.7446912Z,2021,50,15,44,25,0,2do,0,0,25,0,0,35,6,0,50,0,0,0
78253,35739,2021-06-24T13:18:47.7446912Z,2021,51,18,47,27,0,3ro,2,0,24,0,0,33,4,0,49,0,0,0
78253,35740,2021-06-24T13:18:47.7456916Z,2021,55,21,51,34,0,4to,0,0,21,0,0,34,4,0,55,0,0,0
78253,35741,2021-06-24T13:18:47.7456916Z,2021,51,20,47,31,0,5to,3,0,20,0,0,31,4,0,48,0,0,0
78253,35742,2021-06-24T13:18:47.7456916Z,2021,38,4,25,22,0,K,0,0,16,0,0,34,13,1,37,0,0,0
78253,35743,2021-06-24T13:18:47.7456916Z,2021,18,1,12,11,0,PK,0,0,7,0,0,17,6,0,18,0,0,0
78253,35744,2021-06-24T13:18:47.746693Z,2021,73,70,61,12,0,Sin Grado,2,0,61,0,0,3,12,0,71,1,0,0
78253,5708,2020-11-18T16:21:17.1484667Z,2019,60,20,53,28,0,1ro,2,0,32,0,0,40,7,0,58,0,0,0
78253,5709,2020-11-18T16:21:17.1484667Z,2019,56,22,50,30,0,2do,0,0,26,0,0,34,6,0,56,0,0,0
78253,5710,2020-11-18T16:21:17.1484667Z,2019,54,25,47,32,0,3ro,1,0,22,0,0,29,7,0,53,0,0,0
78253,5711,2020-11-18T16:21:17.1494676Z,2019,60,23,56,29,0,4to,1,0,31,0,0,37,4,0,59,0,1,0
78253,5712,2020-11-18T16:21:17.1494676Z,2019,66,31,54,30,0,5to,0,0,36,0,0,35,12,0,66,1,0,0
78253,5713,2020-11-18T16:21:17.1494676Z,2019,1,0,0,1,0,6to,0,0,0,0,0,1,1,0,1,0,0,0
78253,5714,2020-11-18T16:21:17.1494676Z,2019,46,11,36,23,0,K,0,0,23,0,0,35,10,0,46,0,0,0
78253,5715,2020-11-18T16:21:17.1494676Z,2019,23,4,15,15,0,PK,0,0,8,0,0,19,8,0,22,0,0,1
78253,5716,2020-11-18T16:21:17.1504685Z,2019,71,70,61,16,0,Sin Grado,2,0,55,0,0,1,10,0,69,2,1,0
76257,11640,2020-11-18T16:22:11.727866Z,2020,19,4,16,10,0,1ro,0,2,9,0,0,15,3,0,19,0,0,0
76257,11641,2020-11-18T16:22:11.7288655Z,2020,19,4,19,8,0,2do,3,2,11,0,0,15,0,0,16,0,0,0
76257,11642,2020-11-18T16:22:11.7288655Z,2020,18,7,15,8,0,3ro,0,1,10,0,0,11,3,0,18,0,0,0
76257,11643,2020-11-18T16:22:11.7288655Z,2020,21,5,20,12,0,4to,0,1,9,0,0,16,1,0,21,0,0,0
76257,11644,2020-11-18T16:22:11.729866Z,2020,17,4,16,12,0,5to,0,0,5,0,0,13,1,0,17,0,0,0
76257,11645,2020-11-18T16:22:11.729866Z,2020,15,5,11,4,0,6to,0,0,11,0,0,10,4,0,15,0,0,0
76257,11646,2020-11-18T16:22:11.729866Z,2020,21,8,17,10,0,7mo,0,0,11,0,0,13,4,0,21,0,0,0
76257,11647,2020-11-18T16:22:11.7308655Z,2020,13,2,11,9,0,8vo,0,1,4,0,0,11,2,0,13,0,0,0
76257,11648,2020-11-18T16:22:11.7308655Z,2020,22,5,19,8,0,K,0,5,14,0,0,17,3,0,22,1,0,0
76257,11649,2020-11-18T16:22:11.7308655Z,2020,4,4,4,1,0,Sin Grado,0,0,3,0,0,0,0,0,4,0,0,0
76257,35663,2021-06-24T13:18:47.4134534Z,2021,21,5,19,9,0,1ro,0,5,12,0,0,16,2,0,21,0,0,0
76257,35664,2021-06-24T13:18:47.4134534Z,2021,20,4,20,9,0,2do,0,5,11,0,0,16,0,0,20,0,0,0
76257,35665,2021-06-24T13:18:47.4144539Z,2021,16,5,16,7,0,3ro,3,2,9,0,0,11,0,0,13,0,0,0
76257,35666,2021-06-24T13:18:47.4144539Z,2021,20,5,16,9,0,4to,0,2,11,0,0,15,4,0,20,0,0,0
76257,35667,2021-06-24T13:18:47.4144539Z,2021,22,7,19,13,0,5to,0,2,9,0,0,15,3,0,22,0,0,0
76257,35668,2021-06-24T13:18:47.4144539Z,2021,18,5,18,12,0,6to,1,0,6,0,0,13,0,0,17,0,0,0
76257,35669,2021-06-24T13:18:47.4154557Z,2021,18,7,14,5,0,7mo,0,0,13,0,0,11,4,0,18,0,0,0
76257,35670,2021-06-24T13:18:47.4154557Z,2021,18,7,15,8,0,8vo,0,0,10,0,0,11,3,0,18,0,0,0
76257,35671,2021-06-24T13:18:47.4154557Z,2021,15,2,14,7,0,K,0,1,8,0,0,13,1,0,15,0,0,0
76257,35672,2021-06-24T13:18:47.4154557Z,2021,7,7,7,1,0,Sin Grado,0,1,6,0,0,0,0,0,7,0,0,0
76257,5633,2020-11-18T16:21:16.6151111Z,2019,17,5,17,8,0,1ro,1,1,9,0,0,12,0,0,16,0,0,0
76257,5634,2020-11-18T16:21:16.6151111Z,2019,21,8,17,9,0,2do,0,1,12,0,0,13,4,0,21,0,0,0
76257,5635,2020-11-18T16:21:16.6151111Z,2019,22,4,21,13,0,3ro,0,1,9,0,0,18,1,0,22,0,0,0
76257,5636,2020-11-18T16:21:16.6151111Z,2019,21,7,20,14,0,4to,0,5,7,0,0,14,1,0,21,0,0,0
76257,5637,2020-11-18T16:21:16.6151111Z,2019,16,5,11,5,0,5to,0,1,11,0,0,11,5,0,16,0,0,0
76257,5638,2020-11-18T16:21:16.616112Z,2019,17,7,14,8,0,6to,0,2,9,0,0,10,3,0,17,0,0,0
76257,5639,2020-11-18T16:21:16.616112Z,2019,17,5,14,11,0,7mo,0,3,6,0,0,12,3,0,17,0,0,0
76257,5640,2020-11-18T16:21:16.616112Z,2019,11,6,10,4,0,8vo,0,3,7,0,0,5,1,0,11,0,0,0
76257,5641,2020-11-18T16:21:16.616112Z,2019,17,4,12,6,0,K,0,1,11,0,0,13,5,0,17,0,0,0
76257,5642,2020-11-18T16:21:16.6171124Z,2019,5,5,5,1,0,Sin Grado,0,2,4,0,0,0,0,0,5,0,0,0
18184,30810,2021-06-24T13:18:11.4436548Z,2021,98,35,89,50,0,6to,1,0,48,0,0,63,9,0,97,0,1,0
18184,30811,2021-06-24T13:18:11.4436548Z,2021,99,30,85,46,0,7mo,2,1,53,0,0,69,14,0,97,0,0,0
18184,30812,2021-06-24T13:18:11.4446562Z,2021,103,37,87,45,0,8vo,1,0,58,0,0,66,16,0,102,0,0,0
18184,30813,2021-06-24T13:18:11.4446562Z,2021,20,20,14,4,0,Sin Grado,0,0,16,0,0,0,6,0,20,0,0,0
18184,6813,2020-11-18T16:21:42.0340603Z,2020,98,31,87,47,0,6to,2,0,51,0,0,67,11,0,96,0,0,0
18184,6814,2020-11-18T16:21:42.0340603Z,2020,112,43,92,50,0,7mo,1,0,62,0,0,69,20,0,111,0,0,0
18184,6815,2020-11-18T16:21:42.0340603Z,2020,89,19,71,53,0,8vo,2,0,36,0,0,70,18,0,87,0,0,0
18184,6816,2020-11-18T16:21:42.0350603Z,2020,37,37,33,9,0,Sin Grado,0,0,28,0,0,0,4,0,37,0,0,0
18184,812,2020-11-18T16:20:42.6344493Z,2019,122,47,104,54,0,6to,2,0,68,0,0,75,18,0,120,0,0,0
18184,813,2020-11-18T16:20:42.6344493Z,2019,103,26,86,56,0,7mo,3,0,47,0,0,77,17,0,100,0,0,0
18184,814,2020-11-18T16:20:42.6344493Z,2019,111,33,92,58,0,8vo,0,0,53,0,0,78,19,0,111,0,0,0
18184,815,2020-11-18T16:20:42.6344493Z,2019,29,29,25,9,0,Sin Grado,0,0,20,0,0,0,4,0,29,0,1,0
17418,30701,2021-06-24T13:18:11.1664567Z,2021,17,1,17,9,0,1ro,0,0,8,0,0,16,0,0,17,0,0,0
17418,30702,2021-06-24T13:18:11.1674576Z,2021,22,6,19,14,0,2do,0,0,8,0,0,16,3,0,22,0,0,0
17418,30703,2021-06-24T13:18:11.1674576Z,2021,27,9,23,13,0,3ro,0,1,14,0,0,18,4,0,27,0,0,0
17418,30704,2021-06-24T13:18:11.1684581Z,2021,47,13,41,24,0,4to,0,1,23,0,0,34,6,0,47,0,0,0
17418,30705,2021-06-24T13:18:11.1684581Z,2021,39,14,34,18,0,5to,0,0,21,0,0,25,5,0,39,0,0,0
17418,30706,2021-06-24T13:18:11.1684581Z,2021,74,31,62,36,0,6to,1,0,38,0,0,43,12,0,73,0,0,0
17418,30707,2021-06-24T13:18:11.1694591Z,2021,92,37,76,44,0,7mo,4,0,48,0,0,55,16,0,87,0,0,1
17418,30708,2021-06-24T13:18:11.1694591Z,2021,94,39,81,41,0,8vo,3,0,53,0,0,55,13,0,91,0,0,0
17418,30709,2021-06-24T13:18:11.1694591Z,2021,21,9,14,5,0,K,0,0,16,0,0,12,7,0,21,0,0,0
17418,6703,2020-11-18T16:21:41.4326602Z,2020,18,6,17,12,0,1ro,0,0,6,0,0,12,1,0,18,0,0,0
17418,6704,2020-11-18T16:21:41.4326602Z,2020,25,6,23,14,0,2do,0,0,11,0,0,19,2,0,25,0,0,0
17418,6705,2020-11-18T16:21:41.4326602Z,2020,41,12,37,21,0,3ro,0,0,20,0,0,29,4,0,41,0,0,0
17418,6706,2020-11-18T16:21:41.4326602Z,2020,38,14,32,19,0,4to,0,0,19,0,0,24,6,0,38,0,0,0
17418,6707,2020-11-18T16:21:41.4326602Z,2020,51,19,46,24,0,5to,1,0,27,0,0,32,5,0,50,0,0,0
17418,6708,2020-11-18T16:21:41.4336624Z,2020,90,36,77,44,0,6to,3,0,46,0,0,54,13,0,87,0,0,0
17418,6709,2020-11-18T16:21:41.4336624Z,2020,106,41,98,46,0,7mo,4,0,60,0,0,65,8,0,102,0,0,0
17418,6710,2020-11-18T16:21:41.4336624Z,2020,101,32,81,41,0,8vo,1,0,60,0,0,69,20,0,100,0,0,0
17418,6711,2020-11-18T16:21:41.434662Z,2020,24,3,22,11,0,K,0,0,13,0,0,21,2,0,24,0,0,0
17418,702,2020-11-18T16:20:42.1010965Z,2019,36,10,32,16,0,1ro,0,1,20,0,0,26,4,0,36,0,0,0
17418,703,2020-11-18T16:20:42.1010965Z,2019,33,8,33,21,0,2do,1,1,12,0,0,25,0,0,32,0,0,0
17418,704,2020-11-18T16:20:42.1010965Z,2019,41,14,35,24,0,3ro,1,0,17,0,0,27,6,0,40,0,0,0
17418,705,2020-11-18T16:20:42.1020979Z,2019,50,20,41,24,0,4to,1,0,26,0,0,30,9,0,48,0,0,1
17418,706,2020-11-18T16:20:42.1020979Z,2019,61,23,54,31,0,5to,1,0,30,0,0,38,7,0,60,0,0,0
17418,707,2020-11-18T16:20:42.1020979Z,2019,112,44,98,48,0,6to,2,1,64,0,0,68,14,0,109,0,0,1
17418,708,2020-11-18T16:20:42.1020979Z,2019,113,36,91,48,0,7mo,1,0,65,0,0,77,22,0,111,0,0,1
17418,709,2020-11-18T16:20:42.1020979Z,2019,101,30,91,45,0,8vo,1,0,56,0,0,71,10,0,100,0,0,0
17418,710,2020-11-18T16:20:42.1030974Z,2019,20,4,13,17,0,K,0,0,3,0,0,16,7,0,20,0,0,0
77669,11710,2020-11-18T16:22:12.3102528Z,2020,97,16,48,55,0,10mo,1,0,42,0,0,81,49,0,96,0,0,0
77669,11711,2020-11-18T16:22:12.3112532Z,2020,86,12,46,44,0,11mo,0,0,42,0,0,74,40,0,86,0,0,0
77669,11712,2020-11-18T16:22:12.3112532Z,2020,96,13,53,44,0,12mo,0,1,52,0,0,83,43,0,96,0,0,0
77669,11713,2020-11-18T16:22:12.3112532Z,2020,123,27,81,61,0,9no,0,0,62,0,0,96,42,0,123,1,0,0
77669,11714,2020-11-18T16:22:12.3122546Z,2020,14,14,12,7,0,Sin Grado,0,0,7,0,0,0,2,0,14,0,0,0
77669,35732,2021-06-24T13:18:47.7366859Z,2021,123,25,94,57,0,10mo,0,5,66,0,0,98,29,0,123,1,0,0
77669,35733,2021-06-24T13:18:47.7366859Z,2021,94,16,55,52,0,11mo,1,0,42,0,0,78,39,0,93,1,0,0
77669,35734,2021-06-24T13:18:47.7366859Z,2021,78,10,49,38,0,12mo,0,0,40,0,0,68,29,0,78,0,0,0
77669,35735,2021-06-24T13:18:47.7376868Z,2021,118,30,93,63,0,9no,0,0,55,0,0,88,25,0,118,1,0,0
77669,35736,2021-06-24T13:18:47.7376868Z,2021,11,11,7,6,0,Sin Grado,0,0,5,0,0,0,4,0,11,0,0,0
77669,5703,2020-11-18T16:21:17.1434636Z,2019,93,12,49,51,0,10mo,0,0,42,0,0,81,44,0,93,0,0,0
77669,5704,2020-11-18T16:21:17.1434636Z,2019,104,13,58,47,0,11mo,0,1,57,0,0,91,46,0,104,0,0,0
77669,5705,2020-11-18T16:21:17.1444654Z,2019,103,0,53,49,0,12mo,0,1,54,0,0,103,50,0,103,0,0,0
77669,5706,2020-11-18T16:21:17.1444654Z,2019,100,15,47,56,0,9no,0,1,44,0,0,85,53,0,100,0,0,0
77669,5707,2020-11-18T16:21:17.1444654Z,2019,14,12,14,6,0,Sin Grado,0,1,8,0,0,2,0,0,14,0,0,0
36335,2459,2020-11-18T16:20:56.2605389Z,2019,117,11,93,52,0,10mo,1,0,65,0,0,106,24,0,116,0,0,0
36335,2460,2020-11-18T16:20:56.2605389Z,2019,128,6,105,68,0,11mo,6,0,60,0,0,122,23,0,122,0,0,0
36335,2461,2020-11-18T16:20:56.2605389Z,2019,141,0,99,72,0,12mo,1,1,69,0,0,141,42,2,138,0,0,0
36335,2462,2020-11-18T16:20:56.2615398Z,2019,126,15,102,69,0,9no,2,0,57,0,0,111,24,2,122,0,0,0
36335,2463,2020-11-18T16:20:56.2615398Z,2019,11,9,11,4,0,Sin Grado,0,0,7,0,0,2,0,0,11,0,0,0
36335,32466,2021-06-24T13:18:24.7241828Z,2021,124,16,109,59,0,10mo,2,0,65,0,0,108,15,1,121,0,0,0
36335,32467,2021-06-24T13:18:24.7241828Z,2021,118,12,104,68,0,11mo,2,3,50,0,0,106,14,2,114,0,0,0
36335,32468,2021-06-24T13:18:24.7241828Z,2021,104,10,87,48,0,12mo,1,0,56,0,0,94,17,0,103,0,0,0
36335,32469,2021-06-24T13:18:24.7251842Z,2021,123,16,104,59,0,9no,0,1,64,0,0,107,19,3,120,0,0,0
36335,32470,2021-06-24T13:18:24.7251842Z,2021,7,7,5,3,0,Sin Grado,0,0,4,0,0,0,2,0,7,0,0,0
36335,8471,2020-11-18T16:21:51.8015714Z,2020,126,15,102,72,0,10mo,2,0,54,0,0,111,24,2,122,0,0,0
36335,8472,2020-11-18T16:21:51.8025732Z,2020,111,10,89,50,0,11mo,1,0,61,0,0,101,22,0,110,0,0,0
36335,8473,2020-11-18T16:21:51.8025732Z,2020,124,5,102,66,0,12mo,6,0,58,0,0,119,22,0,118,0,0,0
36335,8474,2020-11-18T16:21:51.8035745Z,2020,132,18,105,61,0,9no,3,0,71,0,0,114,27,1,128,0,0,0
36335,8475,2020-11-18T16:21:51.8035745Z,2020,7,7,7,3,0,Sin Grado,0,0,4,0,0,0,0,0,7,0,0,0
18291,30858,2021-06-24T13:18:11.46367Z,2021,45,19,39,26,0,1ro,0,0,19,0,0,26,6,0,45,0,0,0
18291,30859,2021-06-24T13:18:11.46367Z,2021,48,19,43,29,0,2do,1,0,19,0,0,29,5,0,47,0,0,0
18291,30860,2021-06-24T13:18:11.46367Z,2021,55,20,53,30,0,3ro,0,0,25,0,0,35,2,0,54,0,0,1
18291,30861,2021-06-24T13:18:11.4646705Z,2021,58,26,53,27,0,4to,1,0,31,0,0,32,5,0,57,0,1,0
18291,30862,2021-06-24T13:18:11.4646705Z,2021,53,22,42,24,0,5to,0,0,29,0,0,31,11,0,52,0,0,1
18291,30863,2021-06-24T13:18:11.4646705Z,2021,93,34,85,43,0,6to,0,0,50,0,0,59,8,0,93,0,0,0
18291,30864,2021-06-24T13:18:11.4656719Z,2021,90,27,76,30,0,7mo,0,0,60,0,0,63,14,0,89,0,0,1
18291,30865,2021-06-24T13:18:11.4656719Z,2021,93,27,83,46,0,8vo,2,0,47,0,0,66,10,0,91,0,0,0
18291,30866,2021-06-24T13:18:11.4666728Z,2021,42,13,39,24,0,K,2,0,18,0,0,29,3,0,40,0,0,0
18291,30867,2021-06-24T13:18:11.4666728Z,2021,54,10,40,26,0,PK,0,0,28,0,0,44,14,0,54,0,0,0
18291,30868,2021-06-24T13:18:11.4666728Z,2021,22,22,21,8,0,Sin Grado,0,0,14,0,0,0,1,0,22,0,0,0
18291,6862,2020-11-18T16:21:42.0540737Z,2020,54,14,47,33,0,1ro,1,0,21,0,0,40,7,0,53,0,0,0
18291,6863,2020-11-18T16:21:42.0540737Z,2020,51,16,46,27,0,2do,0,0,24,0,0,35,5,0,50,0,0,1
18291,6864,2020-11-18T16:21:42.0540737Z,2020,60,26,49,32,0,3ro,1,0,28,0,0,34,11,0,59,0,1,0
18291,6865,2020-11-18T16:21:42.0540737Z,2020,56,21,43,24,0,4to,0,0,32,0,0,35,13,0,55,0,1,1
18291,6866,2020-11-18T16:21:42.0540737Z,2020,67,19,56,34,0,5to,0,0,33,0,0,48,11,0,67,0,0,0
18291,6867,2020-11-18T16:21:42.0550732Z,2020,95,27,76,34,0,6to,0,0,61,0,0,68,19,0,94,0,1,1
18291,6868,2020-11-18T16:21:42.0550732Z,2020,101,29,83,52,0,7mo,2,0,49,0,0,72,18,0,99,0,0,0
18291,6869,2020-11-18T16:21:42.0550732Z,2020,97,31,77,44,0,8vo,1,0,53,0,0,66,20,0,96,0,0,0
18291,6870,2020-11-18T16:21:42.0550732Z,2020,32,12,27,15,0,K,0,0,17,0,0,20,5,0,32,0,0,0
18291,6871,2020-11-18T16:21:42.0550732Z,2020,56,16,44,34,0,PK,1,0,22,0,0,40,12,0,54,0,0,1
18291,6872,2020-11-18T16:21:42.0560745Z,2020,30,29,27,10,0,Sin Grado,0,0,20,0,0,1,3,0,30,0,0,0
18291,861,2020-11-18T16:20:42.6524625Z,2019,56,17,52,30,0,1ro,0,0,26,0,0,39,4,0,55,0,0,1
18291,862,2020-11-18T16:20:42.6524625Z,2019,64,30,58,37,0,2do,1,0,27,0,0,34,6,0,63,0,1,0
18291,863,2020-11-18T16:20:42.6524625Z,2019,54,19,44,23,0,3ro,0,0,31,0,0,35,10,0,53,0,1,1
18291,864,2020-11-18T16:20:42.6524625Z,2019,61,18,56,27,0,4to,0,0,34,0,0,43,5,0,61,0,0,0
18291,865,2020-11-18T16:20:42.6534625Z,2019,68,22,57,32,0,5to,0,0,36,0,0,46,11,0,67,0,1,1
18291,866,2020-11-18T16:20:42.6534625Z,2019,101,32,77,47,0,6to,1,0,54,0,0,69,24,0,100,0,0,0
18291,867,2020-11-18T16:20:42.6534625Z,2019,102,37,82,44,0,7mo,0,0,58,0,1,65,20,0,102,0,0,0
18291,868,2020-11-18T16:20:42.6534625Z,2019,119,35,92,64,0,8vo,5,0,55,0,0,84,27,0,114,1,2,0
18291,869,2020-11-18T16:20:42.6544625Z,2019,58,18,48,39,0,K,1,0,19,0,0,40,10,0,57,0,0,0
18291,870,2020-11-18T16:20:42.6544625Z,2019,24,13,17,14,0,PK,1,0,10,0,0,11,7,0,23,0,0,0
18291,871,2020-11-18T16:20:42.6544625Z,2019,26,24,23,9,0,Sin Grado,0,0,17,0,0,2,3,0,26,0,0,0
42259,2749,2020-11-18T16:20:58.7511962Z,2019,33,13,30,17,0,1ro,1,1,16,0,0,20,3,0,32,0,0,0
42259,2750,2020-11-18T16:20:58.7511962Z,2019,36,16,29,22,0,2do,1,0,14,0,0,20,7,0,35,1,0,0
42259,2751,2020-11-18T16:20:58.7511962Z,2019,40,19,35,13,0,3ro,1,0,27,0,0,21,5,0,39,0,0,0
42259,2752,2020-11-18T16:20:58.7511962Z,2019,34,10,29,16,0,4to,0,0,18,0,1,24,5,0,34,0,0,0
42259,2753,2020-11-18T16:20:58.7521971Z,2019,39,16,32,16,0,5to,2,0,23,0,0,23,7,0,37,0,1,0
42259,2754,2020-11-18T16:20:58.7521971Z,2019,33,8,23,21,0,K,0,0,12,0,0,25,10,0,33,0,0,0
42259,32756,2021-06-24T13:18:27.1689378Z,2021,27,4,24,17,0,1ro,1,0,10,0,0,23,3,0,26,0,0,0
42259,32757,2021-06-24T13:18:27.1689378Z,2021,30,7,25,12,0,2do,0,0,18,0,0,23,5,0,30,0,0,0
42259,32758,2021-06-24T13:18:27.1699383Z,2021,24,8,22,16,0,3ro,1,0,8,0,0,16,2,0,23,0,0,0
42259,32759,2021-06-24T13:18:27.1699383Z,2021,32,14,30,18,0,4to,0,0,14,0,0,18,2,0,32,1,0,0
42259,32760,2021-06-24T13:18:27.1699383Z,2021,30,14,28,13,0,5to,1,0,17,0,0,16,2,0,29,0,0,0
42259,32761,2021-06-24T13:18:27.1699383Z,2021,27,6,23,15,0,K,0,0,12,0,0,21,4,0,27,0,0,0
42259,8760,2020-11-18T16:21:53.8129159Z,2020,30,8,22,16,0,1ro,0,0,14,0,0,22,8,0,30,0,0,0
42259,8761,2020-11-18T16:21:53.8129159Z,2020,36,12,31,20,0,2do,1,0,16,0,0,24,5,0,35,0,0,0
42259,8762,2020-11-18T16:21:53.8129159Z,2020,30,12,25,18,0,3ro,1,0,12,0,0,18,5,0,29,1,0,0
42259,8763,2020-11-18T16:21:53.8129159Z,2020,35,16,25,15,0,4to,1,0,20,0,0,19,10,0,34,0,0,0
42259,8764,2020-11-18T16:21:53.8139159Z,2020,28,9,20,14,0,5to,0,0,14,0,0,19,8,0,28,0,0,0
42259,8765,2020-11-18T16:21:53.8139159Z,2020,40,10,34,24,0,K,0,0,16,0,0,30,6,0,40,0,0,0
70805,11137,2020-11-18T16:22:08.3185866Z,2020,85,28,76,39,0,6to,3,0,46,0,0,57,9,0,82,0,0,0
70805,11138,2020-11-18T16:22:08.3195883Z,2020,100,37,89,45,0,7mo,4,0,55,0,0,63,11,0,96,0,1,0
70805,11139,2020-11-18T16:22:08.3195883Z,2020,103,29,89,54,0,8vo,1,0,49,0,0,74,14,0,101,0,0,1
70805,11140,2020-11-18T16:22:08.3195883Z,2020,10,10,10,5,0,Sin Grado,0,0,5,0,0,0,0,0,10,0,0,0
70805,35158,2021-06-24T13:18:44.4983642Z,2021,57,14,53,38,0,6to,3,0,19,0,0,43,4,0,54,0,0,0
70805,35159,2021-06-24T13:18:44.4983642Z,2021,82,31,79,37,0,7mo,3,0,45,0,0,51,3,0,79,0,0,0
70805,35160,2021-06-24T13:18:44.4993643Z,2021,94,34,85,43,0,8vo,2,0,51,0,0,60,9,0,92,0,1,0
70805,35161,2021-06-24T13:18:44.4993643Z,2021,13,13,13,6,0,Sin Grado,1,0,7,0,0,0,0,0,12,0,0,0
70805,5131,2020-11-18T16:21:14.0333899Z,2019,98,40,87,39,0,6to,2,0,59,0,0,58,11,0,96,0,1,0
70805,5132,2020-11-18T16:21:14.0343925Z,2019,109,32,94,59,0,7mo,4,0,50,0,0,77,15,0,105,0,0,0
70805,5133,2020-11-18T16:21:14.0343925Z,2019,103,32,90,40,0,8vo,1,0,63,0,0,71,13,0,102,0,0,0
70805,5134,2020-11-18T16:21:14.0343925Z,2019,10,10,10,5,0,Sin Grado,0,0,5,0,0,0,0,0,10,0,0,0
24950,1461,2020-11-18T16:20:46.3649413Z,2019,64,19,46,36,0,1ro,0,0,28,0,0,45,18,0,64,0,0,0
24950,1462,2020-11-18T16:20:46.3659418Z,2019,53,19,47,18,0,2do,0,0,35,0,0,34,6,0,53,0,0,0
24950,1463,2020-11-18T16:20:46.3659418Z,2019,55,20,44,28,0,3ro,1,0,27,0,0,35,11,0,54,0,1,0
24950,1464,2020-11-18T16:20:46.3659418Z,2019,59,21,48,25,0,4to,0,2,34,0,0,38,11,0,59,0,0,0
24950,1465,2020-11-18T16:20:46.3659418Z,2019,65,21,55,42,0,5to,4,0,23,0,0,44,10,0,61,0,0,0
24950,1466,2020-11-18T16:20:46.3659418Z,2019,52,12,35,25,0,K,1,0,27,0,0,40,17,0,51,0,0,0
24950,1467,2020-11-18T16:20:46.3669422Z,2019,19,19,13,4,0,Sin Grado,0,0,15,0,0,0,6,0,19,0,0,0
24950,31462,2021-06-24T13:18:14.9221491Z,2021,50,10,46,17,0,1ro,4,1,33,0,0,40,4,0,46,0,0,0
24950,31463,2021-06-24T13:18:14.9221491Z,2021,40,9,30,20,0,2do,1,1,20,0,0,31,10,0,39,0,0,0
24950,31464,2021-06-24T13:18:14.9221491Z,2021,47,16,44,22,0,3ro,2,1,25,0,0,31,3,0,45,0,0,0
24950,31465,2021-06-24T13:18:14.9231522Z,2021,50,16,41,15,0,4to,0,0,35,0,0,34,9,0,50,0,0,0
24950,31466,2021-06-24T13:18:14.9231522Z,2021,60,21,51,34,0,5to,1,0,26,0,0,39,9,0,59,0,0,0
24950,31467,2021-06-24T13:18:14.9231522Z,2021,42,16,34,16,0,K,1,0,26,0,0,26,8,0,41,0,0,0
24950,31468,2021-06-24T13:18:14.9231522Z,2021,11,11,9,3,0,Sin Grado,0,0,8,0,0,0,2,0,11,0,0,0
24950,7465,2020-11-18T16:21:45.7765596Z,2020,40,8,27,18,0,1ro,0,0,22,0,0,32,13,0,40,0,0,0
24950,7466,2020-11-18T16:21:45.77756Z,2020,50,14,41,28,0,2do,0,1,22,0,0,36,9,0,50,0,0,0
24950,7467,2020-11-18T16:21:45.77756Z,2020,51,18,45,15,0,3ro,0,0,36,0,0,33,6,0,51,0,0,0
24950,7468,2020-11-18T16:21:45.77856Z,2020,57,19,47,30,0,4to,1,0,27,0,0,38,10,0,56,0,1,0
24950,7469,2020-11-18T16:21:45.77856Z,2020,57,24,41,24,0,5to,0,0,33,0,0,33,16,0,57,0,0,0
24950,7470,2020-11-18T16:21:45.77856Z,2020,56,11,51,20,0,K,3,1,36,0,0,45,5,0,53,0,0,0
24950,7471,2020-11-18T16:21:45.77856Z,2020,15,15,10,3,0,Sin Grado,0,0,12,0,0,0,5,0,15,0,0,0
70201,10924,2020-11-18T16:22:07.2028444Z,2020,65,10,30,43,0,10mo,1,0,22,0,0,55,35,0,64,0,0,0
70201,10925,2020-11-18T16:22:07.2038449Z,2020,84,8,29,58,0,11mo,0,1,26,0,0,76,55,0,84,0,0,0
70201,10926,2020-11-18T16:22:07.2038449Z,2020,79,12,36,55,0,12mo,2,0,24,0,0,67,43,1,76,0,0,0
70201,10927,2020-11-18T16:22:07.2038449Z,2020,78,20,38,53,0,6to,1,0,25,0,0,58,40,0,77,0,0,0
70201,10928,2020-11-18T16:22:07.2038449Z,2020,64,11,35,41,0,7mo,0,0,23,0,0,53,29,0,64,0,0,0
70201,10929,2020-11-18T16:22:07.2038449Z,2020,61,13,22,39,0,8vo,0,0,22,0,0,48,39,0,60,0,0,1
70201,10930,2020-11-18T16:22:07.2038449Z,2020,87,13,30,61,0,9no,0,0,26,0,0,74,57,0,87,0,1,0
70201,34945,2021-06-24T13:18:43.3435353Z,2021,81,11,37,56,0,10mo,0,0,25,0,0,70,44,0,81,0,0,0
70201,34946,2021-06-24T13:18:43.3445362Z,2021,59,9,33,42,0,11mo,1,0,17,0,0,50,26,0,58,0,0,0
70201,34947,2021-06-24T13:18:43.3445362Z,2021,80,7,48,54,0,12mo,0,0,26,0,0,73,32,0,79,0,0,1
70201,34948,2021-06-24T13:18:43.3445362Z,2021,41,9,26,22,0,6to,2,0,19,0,0,32,15,0,38,1,0,1
70201,34949,2021-06-24T13:18:43.3445362Z,2021,77,18,46,53,0,7mo,0,0,24,0,0,59,31,0,76,0,0,1
70201,34950,2021-06-24T13:18:43.3445362Z,2021,62,10,43,39,0,8vo,1,0,23,0,0,52,19,0,61,0,0,0
70201,34951,2021-06-24T13:18:43.3455372Z,2021,63,13,35,41,0,9no,0,0,22,0,0,50,28,0,62,0,0,1
70201,4916,2020-11-18T16:21:12.9926971Z,2019,81,7,32,57,0,10mo,0,0,24,0,0,74,49,0,81,0,0,0
70201,4917,2020-11-18T16:21:12.9926971Z,2019,80,11,31,57,0,11mo,2,0,23,0,0,69,49,1,77,0,0,0
70201,4918,2020-11-18T16:21:12.9936976Z,2019,70,0,34,42,0,12mo,1,0,28,0,0,70,36,0,69,0,0,0
70201,4919,2020-11-18T16:21:12.9936976Z,2019,40,6,18,25,0,6to,0,0,15,0,0,34,22,0,40,0,0,0
70201,4920,2020-11-18T16:21:12.9936976Z,2019,56,11,24,34,0,7mo,0,0,22,0,0,45,32,0,55,0,0,1
70201,4921,2020-11-18T16:21:12.9936976Z,2019,71,14,29,45,0,8vo,0,0,26,0,0,57,42,0,71,0,1,0
70201,4922,2020-11-18T16:21:12.9936976Z,2019,66,10,31,43,0,9no,1,0,23,0,0,56,35,0,65,0,0,0
20560,1016,2020-11-18T16:20:43.7982274Z,2019,120,39,100,68,0,10mo,0,0,52,0,0,81,20,0,120,0,1,0
20560,1017,2020-11-18T16:20:43.7982274Z,2019,103,25,80,56,0,11mo,0,0,47,0,0,78,23,0,103,0,0,0
20560,1018,2020-11-18T16:20:43.7982274Z,2019,123,0,88,70,0,12mo,0,1,53,0,0,123,35,1,122,0,0,0
20560,1019,2020-11-18T16:20:43.7992274Z,2019,136,53,108,61,0,9no,0,1,75,0,0,83,28,0,136,0,0,0
20560,1020,2020-11-18T16:20:43.7992274Z,2019,38,34,36,11,0,Sin Grado,1,0,27,0,0,4,2,0,37,0,0,0
20560,31015,2021-06-24T13:18:12.051091Z,2021,149,57,131,67,0,10mo,1,0,82,0,0,92,18,0,148,0,0,0
20560,31016,2021-06-24T13:18:12.051091Z,2021,105,31,83,56,0,11mo,0,0,49,0,0,74,22,0,105,0,0,0
20560,31017,2021-06-24T13:18:12.051091Z,2021,98,28,83,54,0,12mo,0,0,44,0,0,70,15,0,98,0,1,0
20560,31018,2021-06-24T13:18:12.0520915Z,2021,148,44,129,78,0,9no,1,0,70,0,0,104,19,0,147,2,0,0
20560,31019,2021-06-24T13:18:12.0520915Z,2021,38,38,34,13,0,Sin Grado,1,0,25,0,0,0,4,0,37,0,0,0
20560,7019,2020-11-18T16:21:43.6251231Z,2020,112,39,83,59,0,10mo,0,0,53,0,0,73,29,0,112,0,0,0
20560,7020,2020-11-18T16:21:43.6251231Z,2020,106,29,83,58,0,11mo,0,0,48,0,0,77,23,0,106,0,1,0
20560,7021,2020-11-18T16:21:43.6261236Z,2020,95,25,68,53,0,12mo,0,1,42,0,0,70,27,0,95,0,0,0
20560,7022,2020-11-18T16:21:43.6261236Z,2020,146,62,123,68,0,9no,1,0,78,0,0,84,23,0,145,0,0,0
20560,7023,2020-11-18T16:21:43.6261236Z,2020,40,40,37,16,0,Sin Grado,1,0,24,0,0,0,3,0,39,0,0,0
62463,10412,2020-11-18T16:22:04.1247911Z,2020,110,43,93,47,0,6to,6,0,63,0,0,67,17,0,103,0,0,1
62463,10413,2020-11-18T16:22:04.1247911Z,2020,117,44,101,58,0,7mo,4,0,59,0,0,73,16,0,113,0,0,0
62463,10414,2020-11-18T16:22:04.1247911Z,2020,103,34,81,60,0,8vo,4,0,43,0,0,69,22,0,99,0,0,0
62463,34426,2021-06-24T13:18:39.428729Z,2021,100,38,95,49,0,6to,2,0,51,0,0,62,5,0,96,0,0,2
62463,34427,2021-06-24T13:18:39.428729Z,2021,108,48,94,43,0,7mo,6,0,65,0,0,60,14,0,101,0,0,1
62463,34428,2021-06-24T13:18:39.428729Z,2021,112,41,97,53,0,8vo,6,0,59,0,0,71,15,0,106,0,0,0
62463,4399,2020-11-18T16:21:09.711505Z,2019,111,45,95,57,0,6to,4,2,54,0,0,66,16,0,107,0,0,0
62463,4400,2020-11-18T16:21:09.711505Z,2019,90,34,74,46,0,7mo,4,1,44,0,0,56,16,0,86,0,0,0
62463,4401,2020-11-18T16:21:10.1187778Z,2019,106,42,92,58,0,8vo,4,2,48,0,0,64,14,0,101,0,1,1
62463,4402,2020-11-18T16:21:10.1197778Z,2019,26,26,25,7,0,Sin Grado,0,2,19,0,0,0,1,0,26,0,0,0
61747,10364,2020-11-18T16:22:03.7215224Z,2020,39,5,25,23,0,10mo,7,0,16,0,0,34,14,0,32,0,0,0
61747,10365,2020-11-18T16:22:03.7215224Z,2020,36,3,17,20,0,11mo,3,0,16,0,0,33,19,0,33,0,0,0
61747,10366,2020-11-18T16:22:03.7225228Z,2020,39,2,12,21,0,12mo,1,0,18,0,0,37,27,0,38,0,0,0
61747,10367,2020-11-18T16:22:03.7225228Z,2020,37,9,16,22,0,6to,3,0,15,0,0,28,21,0,34,0,0,0
61747,10368,2020-11-18T16:22:03.7225228Z,2020,49,5,22,24,0,7mo,5,0,25,0,0,44,27,0,44,0,1,0
61747,10369,2020-11-18T16:22:03.7225228Z,2020,39,4,18,20,0,8vo,1,0,19,0,0,35,21,2,36,0,0,0
61747,10370,2020-11-18T16:22:03.7235237Z,2020,57,8,25,30,0,9no,2,0,27,0,0,49,32,2,53,0,1,0
61747,34379,2021-06-24T13:18:38.6251521Z,2021,56,7,31,31,0,10mo,1,0,25,0,0,49,25,1,54,0,1,0
61747,34380,2021-06-24T13:18:38.6251521Z,2021,42,5,33,26,0,11mo,7,0,16,0,0,37,9,0,35,0,0,0
61747,34381,2021-06-24T13:18:38.6251521Z,2021,35,3,21,19,0,12mo,2,0,16,0,0,32,14,0,33,0,0,0
61747,34382,2021-06-24T13:18:38.6261531Z,2021,31,7,22,19,0,6to,3,0,12,0,0,24,9,1,27,0,0,0
61747,34383,2021-06-24T13:18:38.6261531Z,2021,50,7,32,31,0,7mo,4,0,19,0,0,43,18,0,46,0,0,0
61747,34384,2021-06-24T13:18:38.6261531Z,2021,52,5,28,26,0,8vo,5,0,26,0,0,47,24,1,46,0,1,0
61747,34385,2021-06-24T13:18:38.6261531Z,2021,39,4,18,23,0,9no,0,0,16,0,0,35,21,1,38,0,0,0
61747,4351,2020-11-18T16:21:09.7024993Z,2019,34,2,15,19,0,10mo,2,0,15,0,0,32,19,0,31,0,0,1
61747,4352,2020-11-18T16:21:09.7024993Z,2019,39,3,16,20,0,11mo,1,0,19,0,0,36,23,0,38,0,0,0
61747,4353,2020-11-18T16:21:09.7024993Z,2019,35,1,20,16,0,12mo,4,1,19,0,0,34,15,0,31,0,2,0
61747,4354,2020-11-18T16:21:09.7024993Z,2019,39,8,20,17,0,6to,3,1,22,0,0,31,19,0,34,0,1,2
61747,4355,2020-11-18T16:21:09.7024993Z,2019,33,4,11,20,0,7mo,2,1,13,0,0,29,22,1,30,0,0,0
61747,4356,2020-11-18T16:21:09.7034997Z,2019,52,8,25,26,0,8vo,1,0,26,0,0,44,27,1,49,0,1,1
61747,4357,2020-11-18T16:21:09.7034997Z,2019,38,4,25,20,0,9no,5,0,18,0,0,34,13,0,32,0,0,1
77552,11698,2020-11-18T16:22:11.7398718Z,2020,127,20,75,61,0,10mo,1,0,66,0,0,107,52,0,126,0,0,0
77552,11699,2020-11-18T16:22:11.7398718Z,2020,174,21,98,74,0,11mo,5,0,100,0,0,153,76,0,169,0,0,0
77552,11700,2020-11-18T16:22:11.7398718Z,2020,148,31,82,89,0,12mo,3,1,59,0,0,117,66,0,145,1,0,0
77552,11701,2020-11-18T16:22:12.3312688Z,2020,79,14,41,38,0,6to,2,1,41,0,0,65,38,1,76,0,0,0
77552,11702,2020-11-18T16:22:12.3322679Z,2020,77,11,38,37,0,7mo,1,0,40,0,0,66,39,0,76,0,0,0
77552,11703,2020-11-18T16:22:12.3322679Z,2020,86,11,37,44,0,8vo,3,0,42,0,0,75,49,1,82,0,0,0
77552,11704,2020-11-18T16:22:12.3322679Z,2020,71,6,35,37,0,9no,1,0,34,0,0,65,36,1,68,0,0,1
77552,35720,2021-06-24T13:18:47.7286801Z,2021,87,6,55,42,0,10mo,3,0,45,0,0,81,32,0,83,0,0,1
77552,35721,2021-06-24T13:18:47.7286801Z,2021,119,20,70,57,0,11mo,1,0,62,0,0,99,49,0,118,0,0,0
77552,35722,2021-06-24T13:18:47.7296806Z,2021,154,20,87,66,0,12mo,3,0,88,0,0,134,67,0,151,0,0,0
77552,35723,2021-06-24T13:18:47.7296806Z,2021,47,9,28,14,0,6to,2,0,33,0,0,38,19,0,45,0,1,0
77552,35724,2021-06-24T13:18:47.7296806Z,2021,84,14,54,45,0,7mo,2,0,39,0,0,70,30,0,82,0,0,0
77552,35725,2021-06-24T13:18:47.7306811Z,2021,83,12,49,41,0,8vo,1,0,42,0,0,71,34,0,82,0,0,0
77552,35726,2021-06-24T13:18:47.7306811Z,2021,96,12,57,51,0,9no,4,0,45,0,0,84,39,1,91,0,0,0
77552,5691,2020-11-18T16:21:16.6341245Z,2019,179,29,101,74,0,10mo,6,0,105,0,0,150,78,1,172,0,0,0
77552,5692,2020-11-18T16:21:16.6341245Z,2019,144,32,85,84,0,11mo,3,3,60,0,0,112,59,0,141,2,0,0
77552,5693,2020-11-18T16:21:16.6341245Z,2019,132,0,77,77,0,12mo,5,0,55,0,0,132,55,0,127,0,0,0
77552,5694,2020-11-18T16:21:16.6341245Z,2019,68,11,35,33,0,6to,1,0,35,0,0,57,33,0,67,0,0,0
77552,5695,2020-11-18T16:21:16.6341245Z,2019,72,10,27,40,0,7mo,1,0,32,0,0,62,45,1,70,0,0,0
77552,5696,2020-11-18T16:21:16.6351249Z,2019,61,6,28,32,0,8vo,1,0,29,0,0,55,33,0,59,0,0,1
77552,5697,2020-11-18T16:21:16.6351249Z,2019,142,31,80,66,0,9no,0,0,76,0,0,111,62,0,142,0,0,0
60400,10163,2020-11-18T16:22:02.7088457Z,2020,60,15,53,27,0,1ro,4,2,33,0,0,45,7,0,55,0,0,1
60400,10164,2020-11-18T16:22:02.7088457Z,2020,53,12,47,24,0,2do,5,2,29,0,0,41,6,0,48,0,0,0
60400,10165,2020-11-18T16:22:02.7088457Z,2020,47,11,41,25,0,3ro,3,2,22,0,0,36,6,0,43,0,0,1
60400,10166,2020-11-18T16:22:02.7088457Z,2020,53,15,48,24,0,4to,3,0,29,0,0,38,5,0,50,0,0,0
60400,10167,2020-11-18T16:22:02.7098457Z,2020,50,11,44,25,0,5to,5,1,25,0,0,39,6,0,45,0,0,0
60400,10168,2020-11-18T16:22:02.7098457Z,2020,39,8,32,19,0,K,2,0,20,0,0,31,7,0,37,0,0,0
60400,10169,2020-11-18T16:22:02.7098457Z,2020,16,16,13,6,0,Sin Grado,0,0,10,0,0,0,3,0,15,0,0,1
60400,34180,2021-06-24T13:18:37.4963432Z,2021,44,12,41,18,0,1ro,2,2,26,0,0,32,3,0,42,0,0,0
60400,34181,2021-06-24T13:18:37.4963432Z,2021,56,13,52,27,0,2do,4,3,29,0,0,43,4,0,51,0,0,1
60400,34182,2021-06-24T13:18:37.4963432Z,2021,52,13,51,25,0,3ro,5,0,27,0,0,39,1,0,47,0,0,0
60400,34183,2021-06-24T13:18:37.4963432Z,2021,47,11,42,27,0,4to,4,1,20,0,0,36,5,0,42,0,0,1
60400,34184,2021-06-24T13:18:37.4973432Z,2021,57,19,54,27,0,5to,4,0,30,0,0,38,3,0,53,0,0,0
60400,34185,2021-06-24T13:18:37.4973432Z,2021,27,5,23,16,0,K,0,0,11,0,0,22,4,0,27,0,0,0
60400,34186,2021-06-24T13:18:37.4973432Z,2021,10,10,9,4,0,Sin Grado,0,0,6,0,0,0,1,0,10,0,0,0
60400,4143,2020-11-18T16:21:07.9963665Z,2019,68,17,65,30,0,1ro,5,2,38,0,0,51,3,0,63,0,0,0
60400,4144,2020-11-18T16:21:07.9963665Z,2019,54,8,47,30,0,2do,4,1,24,0,0,46,7,1,49,0,0,0
60400,4145,2020-11-18T16:21:07.9973674Z,2019,63,20,57,35,0,3ro,0,1,28,0,0,43,6,1,61,0,0,1
60400,4146,2020-11-18T16:21:07.9973674Z,2019,63,15,53,32,0,4to,7,2,31,0,0,48,10,0,56,0,0,0
60400,4147,2020-11-18T16:21:07.9973674Z,2019,58,16,51,33,0,5to,6,4,25,0,0,42,7,0,52,0,1,0
60400,4148,2020-11-18T16:21:07.9983696Z,2019,43,7,38,23,0,K,1,0,20,0,0,36,5,1,40,0,0,1
60400,4149,2020-11-18T16:21:07.9983696Z,2019,16,16,14,5,0,Sin Grado,0,2,11,0,0,0,2,1,14,0,1,1
47126,3123,2020-11-18T16:21:01.0477305Z,2019,222,30,145,113,0,10mo,3,4,109,0,0,192,77,0,219,6,0,0
47126,3124,2020-11-18T16:21:01.048731Z,2019,239,29,146,130,0,11mo,2,0,109,0,0,210,93,0,237,8,1,0
47126,3125,2020-11-18T16:21:01.048731Z,2019,221,0,128,105,0,12mo,1,0,116,0,0,221,93,0,220,0,1,0
47126,3126,2020-11-18T16:21:01.048731Z,2019,230,40,147,114,0,9no,1,0,116,0,2,190,83,0,229,6,1,0
47126,33138,2021-06-24T13:18:30.3181963Z,2021,183,24,113,98,0,10mo,1,0,85,0,0,159,70,1,181,6,1,0
47126,33139,2021-06-24T13:18:30.3181963Z,2021,242,39,156,128,0,11mo,3,0,114,0,0,203,86,0,238,6,1,1
47126,33140,2021-06-24T13:18:30.3181963Z,2021,189,21,121,110,0,12mo,1,0,79,0,0,168,68,0,187,6,0,1
47126,33141,2021-06-24T13:18:30.3181963Z,2021,87,8,59,44,0,9no,1,2,43,0,0,79,28,0,86,0,0,0
47126,33142,2021-06-24T13:18:30.3191959Z,2021,9,9,8,1,0,Sin Grado,0,0,8,0,0,0,1,0,9,0,1,0
47126,9137,2020-11-18T16:21:56.1364671Z,2020,251,45,148,125,0,10mo,3,0,126,0,0,206,103,0,247,7,1,1
47126,9138,2020-11-18T16:21:56.1364671Z,2020,192,25,115,109,0,11mo,3,3,83,0,0,167,77,0,189,6,0,0
47126,9139,2020-11-18T16:21:56.1374685Z,2020,213,29,124,112,0,12mo,1,0,101,0,0,184,89,0,212,8,1,0
47126,9140,2020-11-18T16:21:56.1374685Z,2020,186,28,122,93,0,9no,2,0,93,0,0,158,64,2,182,6,0,0
20941,1108,2020-11-18T16:20:44.6247778Z,2019,22,9,19,9,0,1ro,0,0,13,0,0,13,3,0,22,0,0,0
20941,1109,2020-11-18T16:20:44.6247778Z,2019,19,6,16,8,0,2do,1,0,11,0,0,13,3,0,18,0,1,0
20941,1110,2020-11-18T16:20:44.6247778Z,2019,18,11,16,7,0,3ro,0,0,11,0,0,7,2,0,18,0,0,0
20941,1111,2020-11-18T16:20:44.6257791Z,2019,21,10,18,11,1,4to,1,1,10,0,0,11,3,0,20,0,0,0
20941,1112,2020-11-18T16:20:44.6257791Z,2019,23,7,20,12,0,5to,0,0,11,0,0,16,3,0,23,0,0,0
20941,1113,2020-11-18T16:20:44.6257791Z,2019,21,7,18,10,0,K,0,0,11,0,0,14,3,0,21,0,0,0
20941,1114,2020-11-18T16:20:44.6257791Z,2019,8,3,7,5,0,PK,0,0,3,0,0,5,1,0,8,0,0,0
20941,1115,2020-11-18T16:20:44.6257791Z,2019,6,6,5,3,0,Sin Grado,0,0,3,0,0,0,1,0,6,0,0,0
20941,31109,2021-06-24T13:18:13.0788286Z,2021,21,9,20,10,0,1ro,0,0,11,0,0,12,1,0,21,0,0,0
20941,31110,2021-06-24T13:18:13.0788286Z,2021,23,7,21,15,0,2do,0,0,8,0,0,16,2,0,23,0,0,0
20941,31111,2021-06-24T13:18:13.0788286Z,2021,23,6,18,10,0,3ro,0,0,13,0,0,17,5,0,23,0,0,0
20941,31112,2021-06-24T13:18:13.0798296Z,2021,21,7,19,9,0,4to,1,0,12,0,0,14,2,0,20,0,1,0
20941,31113,2021-06-24T13:18:13.0798296Z,2021,22,12,19,9,0,5to,0,0,13,0,0,10,3,0,22,0,0,0
20941,31114,2021-06-24T13:18:13.0808292Z,2021,19,7,15,12,0,K,1,0,7,0,0,12,4,0,18,0,0,0
20941,31115,2021-06-24T13:18:13.0808292Z,2021,7,3,5,3,0,PK,0,0,4,0,0,4,2,0,7,0,0,0
20941,31116,2021-06-24T13:18:13.0808292Z,2021,4,4,4,2,0,Sin Grado,0,0,2,0,0,0,0,0,4,0,0,0
20941,7113,2020-11-18T16:21:44.1905001Z,2020,22,6,18,14,0,1ro,0,0,8,0,0,16,4,0,22,0,0,0
20941,7114,2020-11-18T16:21:44.191501Z,2020,22,7,18,10,0,2do,0,0,12,0,0,15,4,0,22,0,0,0
20941,7115,2020-11-18T16:21:44.191501Z,2020,22,7,21,9,0,3ro,1,0,13,0,0,15,1,0,21,0,1,0
20941,7116,2020-11-18T16:21:44.191501Z,2020,20,12,17,9,0,4to,0,0,11,0,0,8,3,0,20,0,0,0
20941,7117,2020-11-18T16:21:44.191501Z,2020,19,10,17,9,0,5to,1,0,10,0,0,9,2,0,18,0,0,0
20941,7118,2020-11-18T16:21:44.1925015Z,2020,25,11,22,10,0,K,0,0,15,0,0,14,3,0,25,0,0,0
20941,7119,2020-11-18T16:21:44.1925015Z,2020,4,3,3,3,0,PK,0,0,1,0,0,1,1,0,4,0,0,0
20941,7120,2020-11-18T16:21:44.1925015Z,2020,6,6,5,3,0,Sin Grado,0,0,3,0,0,0,1,0,6,0,0,0
11080,132,2020-11-18T16:20:37.5620678Z,2019,37,7,32,16,0,1ro,0,0,21,0,0,30,5,0,37,0,0,0
11080,133,2020-11-18T16:20:37.5620678Z,2019,41,20,38,21,0,2do,0,0,20,0,0,21,3,0,41,0,0,0
11080,134,2020-11-18T16:20:37.5620678Z,2019,38,17,31,16,0,3ro,2,0,22,0,0,21,7,0,36,1,0,0
11080,135,2020-11-18T16:20:37.5630696Z,2019,29,13,25,21,0,4to,0,0,8,0,0,16,4,0,29,1,0,0
11080,136,2020-11-18T16:20:37.5630696Z,2019,39,18,32,18,0,5to,0,0,21,0,0,21,7,0,39,0,0,0
11080,137,2020-11-18T16:20:37.5630696Z,2019,28,7,13,16,0,K,2,0,12,0,0,21,15,0,26,0,0,0
11080,138,2020-11-18T16:20:37.5640696Z,2019,6,6,3,0,0,Sin Grado,0,0,6,0,0,0,3,0,6,0,0,0
11080,30131,2021-06-24T13:18:06.2969654Z,2021,18,4,16,5,0,1ro,0,0,13,0,0,14,2,0,18,0,0,0
11080,30132,2021-06-24T13:18:06.2969654Z,2021,24,6,20,14,0,2do,1,0,10,0,0,18,4,0,23,0,0,0
11080,30133,2021-06-24T13:18:06.2969654Z,2021,33,11,28,14,0,3ro,1,0,19,0,0,22,5,0,32,0,0,0
11080,30134,2021-06-24T13:18:06.2969654Z,2021,37,15,32,19,0,4to,1,0,18,0,0,22,5,0,36,0,0,0
11080,30135,2021-06-24T13:18:06.297965Z,2021,37,16,32,18,0,5to,3,0,19,0,0,21,5,0,34,1,0,0
11080,30136,2021-06-24T13:18:06.297965Z,2021,19,5,16,13,0,K,1,0,6,0,0,14,3,0,18,0,0,0
11080,30137,2021-06-24T13:18:06.297965Z,2021,4,3,4,0,0,Sin Grado,0,0,4,0,0,1,0,0,4,0,1,0
11080,6133,2020-11-18T16:21:38.244534Z,2020,25,6,22,13,0,1ro,1,0,12,0,0,19,3,0,24,0,0,0
11080,6134,2020-11-18T16:21:38.244534Z,2020,37,11,29,17,0,2do,0,0,20,0,0,26,8,0,37,0,0,0
11080,6135,2020-11-18T16:21:38.244534Z,2020,37,16,35,17,0,3ro,0,0,20,0,0,21,2,0,37,0,0,0
11080,6136,2020-11-18T16:21:38.2455353Z,2020,37,18,34,16,0,4to,2,0,21,0,0,19,3,0,35,1,0,0
11080,6137,2020-11-18T16:21:38.2455353Z,2020,29,14,24,20,0,5to,1,0,9,0,0,15,5,0,28,1,0,0
11080,6138,2020-11-18T16:21:38.2455353Z,2020,27,6,24,8,0,K,0,0,19,0,0,21,3,0,27,0,0,0
11080,6139,2020-11-18T16:21:38.2455353Z,2020,5,5,2,0,0,Sin Grado,0,0,5,0,0,0,3,0,5,0,0,0
30643,1820,2020-11-18T16:20:52.4750162Z,2019,24,8,21,13,0,1ro,0,0,11,0,0,16,3,0,24,0,0,0
30643,1821,2020-11-18T16:20:52.4750162Z,2019,28,9,20,16,0,2do,1,1,12,0,0,19,8,0,27,0,0,0
30643,1822,2020-11-18T16:20:52.4750162Z,2019,27,8,23,16,0,3ro,1,1,11,0,0,19,4,0,26,0,0,0
30643,1823,2020-11-18T16:20:52.4750162Z,2019,36,10,31,13,0,4to,0,2,23,0,0,26,5,0,36,0,0,0
30643,1824,2020-11-18T16:20:52.4760175Z,2019,46,13,36,25,0,5to,0,2,21,0,0,33,10,0,46,0,0,0
30643,1825,2020-11-18T16:20:52.4760175Z,2019,58,13,44,24,0,6to,1,4,34,0,0,45,14,0,56,0,0,1
30643,1826,2020-11-18T16:20:52.4760175Z,2019,20,3,16,10,0,7mo,1,1,10,0,0,17,4,0,19,0,0,0
30643,1827,2020-11-18T16:20:52.4760175Z,2019,43,16,31,23,0,8vo,0,0,20,0,0,27,12,0,43,0,0,0
30643,1828,2020-11-18T16:20:52.4760175Z,2019,21,2,18,9,0,K,1,0,12,0,0,19,3,0,20,0,0,0
30643,31823,2021-06-24T13:18:17.7531793Z,2021,34,2,28,17,0,1ro,0,0,17,0,0,32,6,0,34,0,0,0
30643,31824,2021-06-24T13:18:17.7541829Z,2021,24,2,20,10,0,2do,1,0,14,0,0,22,4,0,23,0,1,0
30643,31825,2021-06-24T13:18:17.7541829Z,2021,26,9,23,11,0,3ro,0,0,15,0,0,17,3,0,26,0,0,0
30643,31826,2021-06-24T13:18:17.7541829Z,2021,38,10,31,22,0,4to,2,0,16,0,0,28,7,0,35,0,0,1
30643,31827,2021-06-24T13:18:17.7541829Z,2021,29,7,25,20,0,5to,2,0,9,0,0,22,4,0,27,0,0,0
30643,31828,2021-06-24T13:18:17.7551807Z,2021,43,11,42,17,0,6to,1,1,26,0,0,32,1,0,42,0,0,0
30643,31829,2021-06-24T13:18:17.7551807Z,2021,67,16,55,37,0,7mo,0,1,30,0,0,51,12,0,67,0,0,0
30643,31830,2021-06-24T13:18:17.7551807Z,2021,56,10,46,22,0,8vo,0,3,34,0,0,46,10,0,55,0,0,1
30643,31831,2021-06-24T13:18:17.7551807Z,2021,19,2,16,6,0,K,0,0,13,0,0,17,3,0,19,0,0,0
30643,7826,2020-11-18T16:21:48.4703531Z,2020,21,2,17,8,0,1ro,0,0,13,0,0,19,4,0,21,0,0,0
30643,7827,2020-11-18T16:21:48.471354Z,2020,20,7,17,9,0,2do,0,0,11,0,0,13,3,0,20,0,0,0
30643,7828,2020-11-18T16:21:48.471354Z,2020,35,12,28,22,0,3ro,1,0,13,0,0,23,7,0,33,0,0,1
30643,7829,2020-11-18T16:21:48.471354Z,2020,22,7,16,14,0,4to,1,0,8,0,0,15,6,0,21,0,0,0
30643,7830,2020-11-18T16:21:48.471354Z,2020,39,12,37,15,0,5to,1,0,24,0,0,27,2,0,38,0,0,0
30643,7831,2020-11-18T16:21:48.471354Z,2020,66,18,52,37,0,6to,0,0,29,0,0,48,14,0,66,0,0,0
30643,7832,2020-11-18T16:21:48.4723544Z,2020,52,8,41,22,0,7mo,0,0,30,0,0,44,11,0,51,0,0,1
30643,7833,2020-11-18T16:21:48.4723544Z,2020,20,3,17,11,0,8vo,1,0,9,0,0,17,3,0,19,0,0,0
30643,7834,2020-11-18T16:21:48.4723544Z,2020,35,2,32,14,0,K,0,0,21,0,0,33,3,0,35,0,0,0
66357,10789,2020-11-18T16:22:06.0370692Z,2020,107,106,82,40,0,Sin Grado,4,5,67,0,0,1,25,0,103,0,0,0
66357,34806,2021-06-24T13:18:42.2227329Z,2021,90,89,68,31,0,Sin Grado,3,2,59,0,0,1,22,0,87,0,0,0
66357,4781,2020-11-18T16:21:11.982022Z,2019,110,89,87,40,0,Sin Grado,3,3,70,0,0,21,23,0,107,0,0,0
61481,10255,2020-11-18T16:22:03.1261236Z,2020,33,12,25,20,0,1ro,2,1,13,0,0,21,8,0,31,0,0,0
61481,10256,2020-11-18T16:22:03.1271244Z,2020,25,6,18,14,0,2do,3,1,11,0,0,19,7,0,21,0,0,1
61481,10257,2020-11-18T16:22:03.1271244Z,2020,21,6,13,11,0,3ro,0,0,10,0,0,15,8,1,20,1,1,0
61481,10258,2020-11-18T16:22:03.1271244Z,2020,27,10,24,17,0,4to,0,0,10,0,0,17,3,0,27,0,0,0
61481,10259,2020-11-18T16:22:03.1271244Z,2020,23,7,20,11,0,5to,1,0,12,0,0,16,3,0,22,1,0,0
61481,10260,2020-11-18T16:22:03.1271244Z,2020,24,3,22,13,0,K,1,1,11,0,0,21,2,0,23,0,0,0
61481,10261,2020-11-18T16:22:03.1281253Z,2020,9,9,6,3,0,Sin Grado,0,0,6,0,0,0,3,0,9,0,0,0
61481,34270,2021-06-24T13:18:38.087767Z,2021,23,5,21,12,0,1ro,1,1,11,0,0,18,2,0,21,0,0,1
61481,34271,2021-06-24T13:18:38.087767Z,2021,33,13,25,17,0,2do,2,0,16,0,0,20,8,0,31,0,0,0
61481,34272,2021-06-24T13:18:38.087767Z,2021,24,6,16,13,0,3ro,3,0,11,0,0,18,8,0,20,0,0,1
61481,34273,2021-06-24T13:18:38.0887684Z,2021,22,8,16,10,0,4to,0,0,12,0,0,14,6,1,21,1,1,0
61481,34274,2021-06-24T13:18:38.0887684Z,2021,27,9,25,15,0,5to,0,0,12,0,0,18,2,0,27,0,0,0
61481,34275,2021-06-24T13:18:38.0887684Z,2021,25,9,22,13,0,K,0,1,12,0,0,16,3,0,25,0,0,0
61481,34276,2021-06-24T13:18:38.0887684Z,2021,5,5,4,3,0,Sin Grado,0,0,2,0,0,0,1,0,5,0,0,0
61481,4240,2020-11-18T16:21:09.0180477Z,2019,31,10,21,17,0,1ro,3,1,14,0,0,21,10,0,27,0,0,1
61481,4241,2020-11-18T16:21:09.0190477Z,2019,27,8,20,13,0,2do,1,0,14,0,0,19,7,1,25,1,1,0
61481,4242,2020-11-18T16:21:09.0190477Z,2019,27,12,25,15,0,3ro,1,0,12,0,0,15,2,0,26,0,0,0
61481,4243,2020-11-18T16:21:09.0190477Z,2019,27,7,26,12,0,4to,2,0,15,0,0,20,1,0,25,1,0,0
61481,4244,2020-11-18T16:21:09.0190477Z,2019,26,6,22,18,0,5to,3,0,8,0,0,20,4,0,23,0,0,0
61481,4245,2020-11-18T16:21:09.0190477Z,2019,24,11,18,12,1,K,0,0,12,0,0,13,6,0,24,0,0,0
61481,4246,2020-11-18T16:21:09.0200481Z,2019,5,4,3,2,0,Sin Grado,0,0,3,0,0,1,2,0,5,0,0,0
58172,10041,2020-11-18T16:22:01.9473429Z,2020,35,15,32,14,0,1ro,0,1,21,0,0,20,3,0,35,0,0,0
58172,10042,2020-11-18T16:22:01.9483438Z,2020,28,12,24,12,0,2do,0,2,16,0,0,16,4,0,28,0,0,0
58172,10043,2020-11-18T16:22:01.9483438Z,2020,33,6,24,17,0,3ro,0,0,16,0,0,27,9,0,33,1,0,0
58172,10044,2020-11-18T16:22:01.9483438Z,2020,31,13,24,16,0,4to,0,0,15,0,0,18,7,0,31,0,0,0
58172,10045,2020-11-18T16:22:01.9493442Z,2020,40,14,31,22,0,5to,0,1,18,0,0,26,9,0,40,1,1,0
58172,10046,2020-11-18T16:22:01.9493442Z,2020,49,16,39,26,0,6to,1,2,23,0,0,33,10,0,48,0,1,0
58172,10047,2020-11-18T16:22:01.9493442Z,2020,41,10,34,21,0,7mo,0,1,20,0,0,31,7,0,41,1,1,0
58172,10048,2020-11-18T16:22:01.9493442Z,2020,39,18,30,16,0,8vo,1,2,23,0,0,21,9,0,38,0,0,0
58172,10049,2020-11-18T16:22:01.9503433Z,2020,35,8,29,14,0,K,1,0,21,0,0,27,6,0,34,0,0,0
58172,10050,2020-11-18T16:22:01.9503433Z,2020,12,12,10,4,0,Sin Grado,1,0,8,0,0,0,2,0,11,0,0,0
58172,34048,2021-06-24T13:18:36.9629605Z,2021,28,8,23,14,0,1ro,0,0,14,0,0,20,5,0,28,0,0,0
58172,34049,2021-06-24T13:18:36.9629605Z,2021,29,14,25,12,0,2do,0,1,17,0,0,15,4,0,29,0,1,0
58172,34050,2021-06-24T13:18:36.9639623Z,2021,25,12,23,10,0,3ro,0,2,15,0,0,13,2,0,25,0,0,0
58172,34051,2021-06-24T13:18:36.9639623Z,2021,28,6,23,13,0,4to,0,0,15,0,0,22,5,0,28,1,0,0
58172,34052,2021-06-24T13:18:36.9639623Z,2021,23,10,19,11,0,5to,0,0,12,0,0,13,4,0,23,0,0,0
58172,34053,2021-06-24T13:18:36.9639623Z,2021,47,16,36,22,0,6to,0,1,25,0,0,31,11,0,47,1,1,0
58172,34054,2021-06-24T13:18:36.9649619Z,2021,48,16,40,23,0,7mo,0,1,25,0,0,32,8,0,48,0,0,0
58172,34055,2021-06-24T13:18:36.9649619Z,2021,39,9,36,24,0,8vo,0,1,15,0,0,30,3,0,39,1,1,0
58172,34056,2021-06-24T13:18:36.9649619Z,2021,17,0,15,9,0,K,0,0,8,0,0,17,2,0,17,0,0,0
58172,34057,2021-06-24T13:18:36.9659624Z,2021,9,9,9,5,0,Sin Grado,0,0,4,0,0,0,0,0,9,0,0,0
58172,4023,2020-11-18T16:21:07.2999003Z,2019,26,11,21,7,0,1ro,0,1,19,0,0,15,5,0,26,0,0,0
58172,4024,2020-11-18T16:21:07.2999003Z,2019,34,8,22,17,0,2do,0,1,17,0,0,26,12,0,34,0,0,0
58172,4025,2020-11-18T16:21:07.2999003Z,2019,28,12,23,14,0,3ro,0,0,14,0,0,16,5,0,28,0,0,0
58172,4026,2020-11-18T16:21:07.2999003Z,2019,37,12,29,22,0,4to,0,0,15,0,0,25,8,0,37,1,1,0
58172,4027,2020-11-18T16:21:07.2999003Z,2019,46,12,34,24,0,5to,1,2,22,0,0,34,12,0,45,0,2,0
58172,4028,2020-11-18T16:21:07.3009012Z,2019,39,11,33,18,0,6to,0,1,21,0,0,28,6,0,39,1,1,0
58172,4029,2020-11-18T16:21:07.3009012Z,2019,37,16,28,19,0,7mo,0,1,18,0,0,21,9,0,37,0,0,0
58172,4030,2020-11-18T16:21:07.3009012Z,2019,36,7,30,23,0,8vo,0,1,13,0,0,29,6,0,36,0,0,0
58172,4031,2020-11-18T16:21:07.3009012Z,2019,33,12,25,18,0,K,0,0,15,0,0,21,8,0,33,0,0,0
58172,4032,2020-11-18T16:21:07.3009012Z,2019,11,10,9,4,0,Sin Grado,0,0,7,0,0,1,2,0,11,0,0,0
33233,2145,2020-11-18T16:20:54.5884226Z,2019,166,22,142,99,0,10mo,2,0,67,0,0,144,24,1,163,1,0,0
33233,2146,2020-11-18T16:20:54.5884226Z,2019,185,40,153,91,0,11mo,3,0,94,0,0,145,32,1,181,0,1,0
33233,2147,2020-11-18T16:20:54.5894226Z,2019,171,0,127,94,0,12mo,3,0,77,0,0,171,44,0,168,0,0,0
33233,2148,2020-11-18T16:20:54.5894226Z,2019,135,24,115,69,0,9no,3,0,66,0,0,111,20,0,132,1,0,0
33233,2149,2020-11-18T16:20:54.5894226Z,2019,5,3,3,1,0,Sin Grado,0,0,4,0,0,2,2,0,5,0,0,0
33233,32152,2021-06-24T13:18:20.9034382Z,2021,201,48,171,110,0,10mo,2,0,91,0,0,153,30,1,198,0,0,0
33233,32153,2021-06-24T13:18:20.9044396Z,2021,140,23,116,82,0,11mo,1,0,58,0,0,117,24,0,139,1,0,0
33233,32154,2021-06-24T13:18:20.9044396Z,2021,161,18,124,99,0,12mo,3,0,62,0,0,143,37,1,157,1,0,0
33233,32155,2021-06-24T13:18:20.9044396Z,2021,179,39,145,74,0,9no,7,0,105,0,0,140,34,1,171,2,0,0
33233,32156,2021-06-24T13:18:20.9044396Z,2021,4,4,2,0,0,Sin Grado,0,0,4,0,0,0,2,0,4,0,0,0
33233,8158,2020-11-18T16:21:50.2255251Z,2020,142,26,121,76,0,10mo,3,0,66,0,0,116,21,0,139,1,0,0
33233,8159,2020-11-18T16:21:50.2255251Z,2020,165,19,141,103,0,11mo,1,0,62,0,0,146,24,1,163,1,0,0
33233,8160,2020-11-18T16:21:50.2255251Z,2020,185,42,151,94,0,12mo,4,0,91,0,0,143,34,1,180,0,0,0
33233,8161,2020-11-18T16:21:50.226526Z,2020,195,50,162,108,0,9no,2,1,87,0,0,145,33,1,192,0,0,0
33233,8162,2020-11-18T16:21:50.226526Z,2020,4,4,3,1,0,Sin Grado,0,0,3,0,0,0,1,0,4,0,0,0
53058,33666,2021-06-24T13:18:33.6876117Z,2021,31,7,22,14,0,1ro,0,0,17,0,0,24,9,0,31,0,0,0
53058,33667,2021-06-24T13:18:33.6876117Z,2021,40,10,32,18,0,2do,3,0,22,0,0,30,8,0,37,0,0,0
53058,33668,2021-06-24T13:18:33.6886126Z,2021,42,13,33,19,0,3ro,0,0,23,0,0,29,9,0,42,0,0,0
53058,33669,2021-06-24T13:18:33.6886126Z,2021,41,12,34,26,0,4to,0,0,15,0,0,29,7,0,40,0,0,1
53058,33670,2021-06-24T13:18:33.6886126Z,2021,40,13,32,19,0,5to,2,0,21,0,0,27,8,0,38,0,0,0
53058,33671,2021-06-24T13:18:33.6886126Z,2021,53,12,47,32,0,6to,2,0,21,0,0,41,6,0,51,0,1,0
53058,33672,2021-06-24T13:18:33.6896131Z,2021,46,13,34,21,0,7mo,0,0,25,0,0,33,12,0,46,0,0,0
53058,33673,2021-06-24T13:18:33.6896131Z,2021,48,8,33,28,0,8vo,0,0,20,0,0,40,15,0,48,0,1,0
53058,33674,2021-06-24T13:18:33.6896131Z,2021,28,8,18,13,0,K,0,0,15,0,0,20,10,0,28,0,0,0
53058,3641,2020-11-18T16:21:04.3279183Z,2019,50,12,38,26,0,1ro,0,0,24,0,0,38,12,0,50,0,0,0
53058,3642,2020-11-18T16:21:04.328921Z,2019,47,14,40,25,0,2do,0,0,22,0,0,33,7,0,47,0,0,0
53058,3643,2020-11-18T16:21:04.328921Z,2019,49,14,40,23,0,3ro,1,0,26,0,0,35,9,0,48,0,0,0
53058,3644,2020-11-18T16:21:04.328921Z,2019,50,13,40,28,0,4to,1,0,22,0,0,37,10,0,49,0,1,0
53058,3645,2020-11-18T16:21:04.3299192Z,2019,49,11,28,26,0,5to,0,0,23,0,0,38,21,0,49,0,0,0
53058,3646,2020-11-18T16:21:04.3299192Z,2019,47,11,31,24,0,6to,0,0,23,0,0,36,16,0,47,0,1,0
53058,3647,2020-11-18T16:21:04.3299192Z,2019,40,17,24,12,0,7mo,0,0,28,0,0,23,16,0,40,0,0,0
53058,3648,2020-11-18T16:21:04.3299192Z,2019,47,11,33,23,0,8vo,0,0,24,0,0,36,14,0,47,1,0,0
53058,3649,2020-11-18T16:21:04.3309201Z,2019,46,7,34,18,0,K,0,0,28,0,0,39,12,0,46,0,0,0
53058,9660,2020-11-18T16:21:59.4997091Z,2020,40,10,31,17,0,1ro,0,0,23,0,0,30,9,0,40,0,0,0
53058,9661,2020-11-18T16:21:59.4997091Z,2020,47,12,32,26,0,2do,0,0,21,0,0,35,15,0,47,0,0,0
53058,9662,2020-11-18T16:21:59.4997091Z,2020,39,11,34,24,0,3ro,0,0,15,0,0,28,5,0,39,0,0,0
53058,9663,2020-11-18T16:21:59.50071Z,2020,49,13,40,25,0,4to,2,0,24,0,0,36,9,0,47,0,0,0
53058,9664,2020-11-18T16:21:59.50071Z,2020,51,13,38,31,0,5to,2,0,20,0,0,38,13,0,49,0,1,0
53058,9665,2020-11-18T16:21:59.50071Z,2020,50,12,30,25,0,6to,0,0,25,0,0,38,20,0,50,0,0,0
53058,9666,2020-11-18T16:21:59.50171Z,2020,51,9,34,29,0,7mo,0,0,22,0,0,42,17,0,51,0,1,0
53058,9667,2020-11-18T16:21:59.50171Z,2020,42,18,27,15,0,8vo,0,0,27,0,0,24,15,0,42,0,0,0
53058,9668,2020-11-18T16:21:59.50171Z,2020,43,9,30,19,0,K,0,0,24,0,0,34,13,0,43,0,0,0
20669,1038,2020-11-18T16:20:43.8062323Z,2019,42,5,35,19,0,1ro,0,7,23,0,0,37,7,0,42,0,0,0
20669,1039,2020-11-18T16:20:43.8062323Z,2019,40,21,34,18,0,2do,0,7,22,0,0,19,6,0,40,0,0,0
20669,1040,2020-11-18T16:20:43.8062323Z,2019,42,17,32,24,0,3ro,0,8,18,0,0,25,10,0,42,1,0,0
20669,1041,2020-11-18T16:20:43.8062323Z,2019,52,19,40,29,0,4to,0,12,23,0,0,33,12,0,52,1,0,0
20669,1042,2020-11-18T16:20:43.8072332Z,2019,58,22,33,31,0,5to,0,12,27,0,0,36,25,0,58,0,0,0
20669,1043,2020-11-18T16:20:43.8072332Z,2019,45,12,34,29,0,K,0,8,16,0,0,33,11,0,45,0,0,0
20669,31037,2021-06-24T13:18:12.0630996Z,2021,46,13,38,19,0,1ro,1,6,27,0,0,33,8,0,45,0,0,0
20669,31038,2021-06-24T13:18:12.0641006Z,2021,53,14,44,29,0,2do,0,8,24,0,0,39,9,0,53,0,0,0
20669,31039,2021-06-24T13:18:12.0641006Z,2021,38,8,32,17,0,3ro,0,7,21,0,0,30,6,0,38,0,0,0
20669,31040,2021-06-24T13:18:12.0641006Z,2021,39,19,34,17,0,4to,0,1,22,0,0,20,5,0,39,0,0,0
20669,31041,2021-06-24T13:18:12.0651015Z,2021,51,19,44,30,0,5to,0,7,21,0,0,32,7,0,51,1,0,0
20669,31042,2021-06-24T13:18:12.0651015Z,2021,39,10,32,14,0,K,0,3,25,0,0,29,7,0,39,0,0,0
20669,31043,2021-06-24T13:18:12.0651015Z,2021,4,4,3,0,0,Sin Grado,0,0,4,0,0,0,1,0,4,0,0,0
20669,7041,2020-11-18T16:21:43.6351289Z,2020,45,11,32,27,0,1ro,0,11,18,0,0,34,13,0,45,0,0,0
20669,7042,2020-11-18T16:21:43.6351289Z,2020,42,8,33,17,0,2do,0,14,25,0,0,34,9,0,42,0,0,0
20669,7043,2020-11-18T16:21:43.6351289Z,2020,41,21,27,19,0,3ro,0,2,22,0,0,20,14,0,41,0,0,0
20669,7044,2020-11-18T16:21:43.6351289Z,2020,52,19,36,30,0,4to,0,18,22,0,0,33,16,0,52,1,0,0
20669,7045,2020-11-18T16:21:43.6361307Z,2020,54,20,42,29,0,5to,0,9,25,0,0,34,12,0,54,2,0,0
20669,7046,2020-11-18T16:21:43.6361307Z,2020,35,8,25,9,0,K,1,7,26,0,0,27,10,0,34,0,0,0
20669,7047,2020-11-18T16:21:43.6361307Z,2020,2,2,1,0,0,Sin Grado,0,0,2,0,0,0,1,0,2,0,0,0
60418,10170,2020-11-18T16:22:02.710847Z,2020,61,14,52,30,0,1ro,0,0,31,0,0,47,9,0,60,0,0,1
60418,10171,2020-11-18T16:22:02.710847Z,2020,59,12,58,28,0,2do,0,0,31,0,0,47,1,0,59,0,0,0
60418,10172,2020-11-18T16:22:02.710847Z,2020,50,14,45,25,0,3ro,0,0,25,0,0,36,5,0,50,0,0,0
60418,10173,2020-11-18T16:22:02.710847Z,2020,52,16,47,21,0,4to,3,0,31,0,0,36,5,0,48,0,0,1
60418,10174,2020-11-18T16:22:02.7118475Z,2020,49,12,46,29,0,5to,2,0,20,0,0,37,3,0,45,0,0,2
60418,10175,2020-11-18T16:22:02.7118475Z,2020,49,13,46,22,0,K,0,0,27,0,0,36,3,0,49,0,0,0
60418,10176,2020-11-18T16:22:02.7118475Z,2020,32,31,27,13,0,Sin Grado,0,0,19,0,0,1,5,0,32,0,0,0
60418,34187,2021-06-24T13:18:37.5023479Z,2021,47,13,45,22,0,1ro,0,0,25,0,0,34,2,0,47,0,0,0
60418,34188,2021-06-24T13:18:37.503348Z,2021,63,17,58,34,0,2do,0,0,29,0,0,46,5,0,61,0,0,2
60418,34189,2021-06-24T13:18:37.503348Z,2021,55,11,52,24,0,3ro,0,0,31,0,0,44,3,0,55,0,0,0
60418,34190,2021-06-24T13:18:37.503348Z,2021,52,16,46,24,0,4to,1,0,28,0,0,36,6,0,50,0,0,1
60418,34191,2021-06-24T13:18:37.5043485Z,2021,53,18,46,21,0,5to,3,0,32,0,0,35,7,0,49,0,0,1
60418,34192,2021-06-24T13:18:37.5043485Z,2021,50,14,46,28,0,K,1,0,22,0,0,36,4,0,49,0,0,0
60418,34193,2021-06-24T13:18:37.5043485Z,2021,28,28,26,9,0,Sin Grado,1,0,19,0,0,0,2,0,27,0,0,0
60418,4150,2020-11-18T16:21:08.0073731Z,2019,70,16,66,25,0,1ro,0,0,45,0,0,54,4,0,69,0,0,1
60418,4151,2020-11-18T16:21:08.0073731Z,2019,65,21,57,36,0,2do,1,2,29,0,0,44,8,0,63,0,0,1
60418,4152,2020-11-18T16:21:08.008374Z,2019,61,17,54,27,0,3ro,0,0,34,0,0,44,7,0,61,0,0,0
60418,4153,2020-11-18T16:21:08.008374Z,2019,49,11,47,31,0,4to,2,1,18,0,0,38,2,0,46,0,0,1
60418,4154,2020-11-18T16:21:08.008374Z,2019,67,24,58,34,0,5to,2,2,33,0,0,43,9,0,65,0,0,0
60418,4155,2020-11-18T16:21:08.0093754Z,2019,1,0,1,0,0,6to,0,0,1,0,0,1,0,0,1,0,0,0
60418,4156,2020-11-18T16:21:08.0093754Z,2019,49,7,45,28,0,K,0,0,21,0,0,42,4,0,47,0,0,2
60418,4157,2020-11-18T16:21:08.0093754Z,2019,32,31,30,7,0,Sin Grado,0,0,25,0,0,1,2,0,32,0,0,0
40980,2625,2020-11-18T16:20:58.0547359Z,2019,103,44,85,45,0,6to,4,1,58,0,0,59,18,0,99,1,0,0
40980,2626,2020-11-18T16:20:58.0557364Z,2019,81,22,67,37,0,7mo,3,0,44,0,0,59,14,0,78,0,2,0
40980,2627,2020-11-18T16:20:58.0557364Z,2019,86,34,74,45,0,8vo,1,1,41,0,0,52,12,0,85,0,1,0
40980,2628,2020-11-18T16:20:58.0567359Z,2019,29,23,22,10,0,Sin Grado,1,0,19,0,0,6,7,0,28,0,0,0
40980,32632,2021-06-24T13:18:26.2472767Z,2021,81,36,74,40,0,6to,2,0,41,0,0,45,7,0,79,0,0,0
40980,32633,2021-06-24T13:18:26.2472767Z,2021,83,25,73,49,0,7mo,2,0,34,0,0,58,10,0,81,0,0,0
40980,32634,2021-06-24T13:18:26.2472767Z,2021,97,37,87,46,0,8vo,4,0,51,0,0,60,10,0,93,1,0,0
40980,32635,2021-06-24T13:18:26.2482777Z,2021,18,18,15,7,0,Sin Grado,1,0,11,0,0,0,3,0,17,0,0,0
40980,8636,2020-11-18T16:21:53.0524079Z,2020,95,30,79,58,0,6to,2,0,37,0,0,65,16,0,93,0,0,0
40980,8637,2020-11-18T16:21:53.0524079Z,2020,99,40,81,44,0,7mo,4,0,55,0,0,59,18,0,95,1,0,0
40980,8638,2020-11-18T16:21:53.0534083Z,2020,83,22,66,38,0,8vo,5,0,45,0,0,61,17,0,78,0,2,0
40980,8639,2020-11-18T16:21:53.0534083Z,2020,35,33,28,12,0,Sin Grado,4,0,23,0,0,2,7,0,31,0,0,0
73650,11493,2020-11-18T16:22:10.5931057Z,2020,36,26,35,18,0,10mo,0,2,18,0,0,10,1,0,36,0,0,0
73650,11494,2020-11-18T16:22:10.5931057Z,2020,24,10,22,13,0,11mo,1,2,11,0,0,14,2,0,23,0,0,0
73650,11495,2020-11-18T16:22:10.5931057Z,2020,27,5,23,18,0,12mo,1,1,9,0,0,22,4,0,26,0,1,0
73650,11496,2020-11-18T16:22:10.5931057Z,2020,30,7,29,19,0,7mo,0,0,11,0,0,23,1,0,30,0,0,0
73650,11497,2020-11-18T16:22:10.5941071Z,2020,34,16,30,21,0,8vo,0,0,13,0,0,18,4,0,34,0,0,0
73650,11498,2020-11-18T16:22:10.5941071Z,2020,41,21,35,21,0,9no,2,0,20,0,0,20,6,0,39,0,0,0
73650,11499,2020-11-18T16:22:10.5941071Z,2020,40,40,33,19,0,Sin Grado,0,1,21,0,0,0,7,0,40,1,1,0
73650,35515,2021-06-24T13:18:46.5648449Z,2021,43,24,41,20,0,10mo,3,1,23,0,0,19,2,0,40,0,0,0
73650,35516,2021-06-24T13:18:46.5658463Z,2021,37,23,34,18,0,11mo,1,1,19,0,0,14,3,0,36,0,0,0
73650,35517,2021-06-24T13:18:46.5658463Z,2021,33,16,27,16,0,12mo,2,0,17,0,0,17,6,0,31,0,0,0
73650,35518,2021-06-24T13:18:46.5658463Z,2021,19,7,17,11,0,7mo,0,0,8,0,0,12,2,0,19,0,0,0
73650,35519,2021-06-24T13:18:46.5658463Z,2021,30,8,28,20,0,8vo,0,0,10,0,0,22,2,0,30,0,0,0
73650,35520,2021-06-24T13:18:46.5658463Z,2021,44,27,39,24,0,9no,0,1,20,0,0,17,5,0,44,0,0,0
73650,35521,2021-06-24T13:18:46.5668468Z,2021,14,14,12,9,0,Sin Grado,0,0,5,0,0,0,2,0,13,0,0,1
73650,5483,2020-11-18T16:21:15.4943624Z,2019,25,9,23,13,0,10mo,1,1,12,0,0,16,2,0,24,0,0,0
73650,5484,2020-11-18T16:21:15.4943624Z,2019,31,4,28,23,0,11mo,1,2,8,0,0,27,3,0,30,0,0,0
73650,5485,2020-11-18T16:21:15.4943624Z,2019,25,0,20,14,0,12mo,2,0,11,0,0,25,5,0,23,0,0,0
73650,5486,2020-11-18T16:21:15.4943624Z,2019,1,0,0,1,0,6to,0,0,0,0,0,1,1,0,1,0,0,0
73650,5487,2020-11-18T16:21:15.4953633Z,2019,36,18,30,20,0,7mo,0,0,16,0,0,18,6,0,36,0,0,0
73650,5488,2020-11-18T16:21:15.4953633Z,2019,31,10,28,18,0,8vo,1,0,13,0,0,21,3,0,30,0,0,0
73650,5489,2020-11-18T16:21:15.4953633Z,2019,28,17,26,14,0,9no,0,3,14,0,0,11,2,0,28,0,0,0
73650,5490,2020-11-18T16:21:15.4953633Z,2019,59,48,50,29,0,Sin Grado,0,3,30,0,0,11,9,0,59,1,1,0
25932,1545,2020-11-18T16:20:47.6507996Z,2019,45,17,36,23,0,1ro,0,6,22,0,0,28,9,0,45,0,0,0
25932,1546,2020-11-18T16:20:47.6507996Z,2019,40,21,34,19,0,2do,0,3,21,0,0,19,6,0,40,0,0,0
25932,1547,2020-11-18T16:20:47.651801Z,2019,33,10,25,21,0,3ro,1,8,12,0,0,23,8,0,32,0,0,0
25932,1548,2020-11-18T16:20:47.651801Z,2019,42,22,29,16,0,4to,0,6,26,0,0,20,13,0,42,0,0,0
25932,1549,2020-11-18T16:20:47.651801Z,2019,34,12,24,12,0,5to,2,3,22,0,0,22,10,0,32,0,0,0
25932,1550,2020-11-18T16:20:47.652801Z,2019,35,13,22,21,0,K,1,2,14,0,0,22,13,0,34,0,0,0
25932,1551,2020-11-18T16:20:47.652801Z,2019,29,28,25,5,0,Sin Grado,0,0,24,0,0,1,4,0,29,0,0,0
25932,31547,2021-06-24T13:18:15.8277991Z,2021,28,8,21,17,0,1ro,1,7,11,0,0,20,7,0,27,0,0,0
25932,31548,2021-06-24T13:18:15.8288001Z,2021,32,10,25,18,0,2do,1,2,14,0,0,22,7,0,31,0,0,0
25932,31549,2021-06-24T13:18:15.8288001Z,2021,37,12,34,20,0,3ro,0,7,17,0,0,25,3,0,37,0,0,0
25932,31550,2021-06-24T13:18:15.8298006Z,2021,37,15,31,18,0,4to,0,5,19,0,0,22,6,0,37,0,0,0
25932,31551,2021-06-24T13:18:15.8298006Z,2021,30,9,26,16,0,5to,1,5,14,0,0,21,4,0,29,0,0,0
25932,31552,2021-06-24T13:18:15.8298006Z,2021,23,8,17,13,0,K,2,5,10,0,0,15,6,0,21,0,0,0
25932,31553,2021-06-24T13:18:15.8308011Z,2021,25,25,17,2,0,Sin Grado,0,3,23,0,0,0,8,0,24,0,0,1
25932,7550,2020-11-18T16:21:46.3779578Z,2020,39,13,30,21,0,1ro,2,8,18,0,0,26,9,0,37,0,0,0
25932,7551,2020-11-18T16:21:46.3779578Z,2020,44,15,42,24,0,2do,0,10,20,0,0,29,2,0,44,0,0,0
25932,7552,2020-11-18T16:21:46.3779578Z,2020,40,17,33,21,0,3ro,0,5,19,0,0,23,7,0,40,0,0,0
25932,7553,2020-11-18T16:21:46.3779578Z,2020,39,12,29,20,0,4to,1,10,19,0,0,27,10,0,38,0,0,0
25932,7554,2020-11-18T16:21:46.3789582Z,2020,39,19,32,15,0,5to,0,7,24,0,0,20,7,0,39,0,0,0
25932,7555,2020-11-18T16:21:46.3789582Z,2020,37,12,29,24,0,K,0,9,13,0,0,25,8,0,37,0,0,0
25932,7556,2020-11-18T16:21:46.3789582Z,2020,31,30,24,5,0,Sin Grado,0,3,26,0,0,1,7,0,31,0,0,0
21063,1149,2020-11-18T16:20:44.6347854Z,2019,47,23,41,21,0,1ro,0,0,26,0,0,24,6,0,47,0,0,0
21063,1150,2020-11-18T16:20:44.6347854Z,2019,50,21,42,25,0,2do,1,0,25,0,0,29,8,0,49,0,1,0
21063,1151,2020-11-18T16:20:44.6357863Z,2019,40,20,28,23,0,3ro,0,0,17,0,0,20,12,0,40,0,0,0
21063,1152,2020-11-18T16:20:44.6357863Z,2019,44,12,38,26,0,4to,0,0,18,0,0,32,6,0,44,0,0,0
21063,1153,2020-11-18T16:20:44.6357863Z,2019,37,11,29,20,0,5to,0,0,17,0,0,26,8,0,37,0,0,0
21063,1154,2020-11-18T16:20:44.6357863Z,2019,40,12,30,26,0,K,0,0,14,0,0,28,10,0,40,0,0,0
21063,31150,2021-06-24T13:18:13.0928382Z,2021,36,7,29,22,0,1ro,0,0,14,0,0,29,7,0,36,0,0,0
21063,31151,2021-06-24T13:18:13.0928382Z,2021,16,3,13,10,0,2do,0,0,6,0,0,13,3,0,16,0,0,0
21063,31152,2021-06-24T13:18:13.0928382Z,2021,30,12,23,16,0,3ro,0,0,14,0,0,18,7,0,30,0,0,0
21063,31153,2021-06-24T13:18:13.0938383Z,2021,38,17,30,18,0,4to,1,0,20,0,0,21,8,0,37,0,0,0
21063,31154,2021-06-24T13:18:13.0938383Z,2021,30,11,21,17,0,5to,0,0,13,0,0,19,9,0,30,0,0,0
21063,31155,2021-06-24T13:18:13.0948392Z,2021,25,6,20,13,0,K,0,0,12,0,0,19,5,0,24,0,0,1
21063,7154,2020-11-18T16:21:44.1995068Z,2020,25,5,22,17,0,1ro,0,0,8,0,0,20,3,0,25,0,0,0
21063,7155,2020-11-18T16:21:44.2005073Z,2020,30,12,27,17,0,2do,0,0,13,0,0,18,3,0,30,0,0,0
21063,7156,2020-11-18T16:21:44.2005073Z,2020,45,19,35,20,0,3ro,1,0,25,0,0,26,10,0,44,0,0,0
21063,7157,2020-11-18T16:21:44.2005073Z,2020,31,13,22,18,0,4to,0,0,13,0,0,18,9,0,31,0,0,0
21063,7158,2020-11-18T16:21:44.2005073Z,2020,31,11,25,19,0,5to,0,0,12,0,0,20,6,0,31,0,0,0
21063,7159,2020-11-18T16:21:44.2015077Z,2020,43,9,38,24,0,K,1,0,19,0,0,34,5,0,42,0,0,0
17350,30687,2021-06-24T13:18:10.6701008Z,2021,162,47,141,78,0,10mo,2,0,84,0,0,115,21,0,160,0,0,0
17350,30688,2021-06-24T13:18:10.6711017Z,2021,156,26,123,79,0,11mo,1,0,77,0,0,130,33,0,155,0,0,0
17350,30689,2021-06-24T13:18:10.6711017Z,2021,93,12,66,54,0,12mo,0,0,39,0,0,81,27,0,93,0,0,0
17350,30690,2021-06-24T13:18:10.6711017Z,2021,148,45,120,62,0,9no,2,0,86,0,0,103,28,0,146,0,0,0
17350,30691,2021-06-24T13:18:10.6711017Z,2021,10,10,7,2,0,Sin Grado,0,0,8,0,0,0,3,0,10,0,0,0
17350,6689,2020-11-18T16:21:40.7722227Z,2020,171,30,134,80,0,10mo,1,0,91,0,0,141,37,0,170,0,0,0
17350,6690,2020-11-18T16:21:40.773224Z,2020,101,13,70,62,0,11mo,0,0,39,0,0,88,31,0,101,0,0,0
17350,6691,2020-11-18T16:21:40.773224Z,2020,145,29,109,65,0,12mo,2,0,80,0,0,116,36,0,143,0,1,0
17350,6692,2020-11-18T16:21:40.773224Z,2020,155,41,118,76,0,9no,2,0,79,0,0,114,37,0,153,0,0,0
17350,6693,2020-11-18T16:21:40.773224Z,2020,8,8,6,3,0,Sin Grado,0,0,5,0,0,0,2,0,8,0,0,0
17350,688,2020-11-18T16:20:41.1974962Z,2019,97,11,65,55,0,10mo,1,0,42,0,0,86,32,0,96,0,0,0
17350,689,2020-11-18T16:20:41.1974962Z,2019,161,31,116,73,0,11mo,2,0,88,0,0,130,45,1,158,0,1,0
17350,690,2020-11-18T16:20:41.1974962Z,2019,208,0,136,98,0,12mo,0,0,110,0,0,208,72,0,208,0,0,0
17350,691,2020-11-18T16:20:41.1984966Z,2019,145,36,118,65,0,9no,1,1,80,0,0,109,27,0,144,0,0,0
17350,692,2020-11-18T16:20:41.1984966Z,2019,4,3,1,2,0,Sin Grado,0,0,2,0,0,1,3,0,4,0,0,0
34884,2280,2020-11-18T16:20:55.0177087Z,2019,148,21,93,71,0,10mo,1,0,77,0,0,127,55,0,147,0,0,0
34884,2281,2020-11-18T16:20:55.0177087Z,2019,191,19,117,102,0,11mo,2,0,89,0,0,172,74,0,189,0,1,0
34884,2282,2020-11-18T16:20:55.0177087Z,2019,190,0,102,98,0,12mo,3,0,92,0,0,190,88,0,187,0,0,0
34884,2283,2020-11-18T16:20:55.0177087Z,2019,83,10,59,45,0,9no,2,0,38,0,0,73,24,0,81,0,0,0
34884,32287,2021-06-24T13:18:21.7690614Z,2021,119,13,75,64,0,10mo,0,0,55,0,0,106,44,0,117,0,0,2
34884,32288,2021-06-24T13:18:21.7690614Z,2021,88,8,60,49,0,11mo,2,0,39,0,0,80,28,0,86,0,0,0
34884,32289,2021-06-24T13:18:21.7700601Z,2021,129,14,76,64,0,12mo,2,0,65,0,0,115,53,0,127,0,0,0
34884,32290,2021-06-24T13:18:21.7700601Z,2021,70,21,53,32,0,9no,1,0,38,0,0,49,17,0,69,1,1,0
34884,8292,2020-11-18T16:21:50.7048455Z,2020,96,13,67,52,0,10mo,2,0,44,0,0,83,29,0,94,0,0,0
34884,8293,2020-11-18T16:21:50.7048455Z,2020,141,18,82,67,0,11mo,2,0,74,0,0,123,59,0,139,0,0,0
34884,8294,2020-11-18T16:21:50.7058464Z,2020,185,18,115,100,0,12mo,2,0,85,0,0,167,70,0,183,0,0,0
34884,8295,2020-11-18T16:21:50.7058464Z,2020,98,14,77,55,0,9no,0,0,43,0,0,84,21,0,98,0,0,0
66480,10790,2020-11-18T16:22:06.039071Z,2020,84,32,76,33,0,6to,0,0,51,0,0,52,8,0,84,0,0,0
66480,10791,2020-11-18T16:22:06.040071Z,2020,97,26,84,53,0,7mo,3,0,44,0,0,71,13,0,94,0,0,0
66480,10792,2020-11-18T16:22:06.040071Z,2020,100,28,85,55,0,8vo,3,0,45,0,0,72,15,0,97,0,0,0
66480,10793,2020-11-18T16:22:06.040071Z,2020,137,136,129,30,0,Sin Grado,3,12,107,0,0,1,8,0,134,0,0,0
66480,34807,2021-06-24T13:18:42.2287363Z,2021,40,12,37,22,0,6to,1,0,18,0,0,28,3,0,39,0,0,0
66480,34808,2021-06-24T13:18:42.2287363Z,2021,70,26,62,32,0,7mo,0,0,38,0,0,44,8,0,70,0,0,0
66480,34809,2021-06-24T13:18:42.2297368Z,2021,74,21,62,35,0,8vo,3,0,39,0,0,53,12,0,71,0,0,0
66480,34810,2021-06-24T13:18:42.2297368Z,2021,121,116,112,28,0,Sin Grado,1,6,93,0,0,5,9,0,120,0,0,0
66480,4782,2020-11-18T16:21:11.9329895Z,2019,129,43,111,67,0,6to,2,1,62,0,0,86,18,0,127,0,0,0
66480,4783,2020-11-18T16:21:11.9329895Z,2019,121,41,105,67,0,7mo,3,0,54,0,0,80,16,0,118,0,0,0
66480,4784,2020-11-18T16:21:11.9339899Z,2019,117,36,109,51,0,8vo,3,0,66,0,0,81,8,0,114,0,0,0
66480,4785,2020-11-18T16:21:11.9339899Z,2019,166,156,155,38,0,Sin Grado,3,9,128,0,0,10,11,0,163,0,0,0
60913,10188,2020-11-18T16:22:02.7148497Z,2020,92,25,79,49,0,10mo,1,0,43,0,0,67,13,0,91,0,0,0
60913,10189,2020-11-18T16:22:02.7148497Z,2020,66,13,56,43,0,11mo,1,0,23,0,0,53,10,0,65,0,0,0
60913,10190,2020-11-18T16:22:02.7148497Z,2020,70,13,56,41,0,12mo,2,0,29,0,0,57,14,0,68,0,0,0
60913,10191,2020-11-18T16:22:02.7148497Z,2020,100,40,91,45,0,7mo,2,0,55,0,0,60,9,0,98,0,0,0
60913,10192,2020-11-18T16:22:02.7148497Z,2020,117,41,102,48,0,8vo,4,0,69,0,0,76,15,0,113,0,0,0
60913,10193,2020-11-18T16:22:02.7158501Z,2020,127,43,106,59,0,9no,1,0,68,0,0,84,21,0,126,0,0,0
60913,10194,2020-11-18T16:22:02.7158501Z,2020,22,22,21,8,0,Sin Grado,0,2,14,0,0,0,1,0,22,0,0,0
60913,34205,2021-06-24T13:18:38.0407335Z,2021,111,35,87,49,0,10mo,1,1,62,0,0,76,24,0,110,0,0,0
60913,34206,2021-06-24T13:18:38.0407335Z,2021,69,19,55,42,0,11mo,2,0,27,0,0,50,14,0,67,0,0,0
60913,34207,2021-06-24T13:18:38.041734Z,2021,49,11,39,30,0,12mo,1,0,19,0,0,38,10,0,48,0,1,0
60913,34208,2021-06-24T13:18:38.041734Z,2021,100,38,87,48,0,8vo,3,1,52,0,0,62,13,0,97,0,0,0
60913,34209,2021-06-24T13:18:38.041734Z,2021,128,47,103,46,0,9no,5,0,82,0,0,81,25,0,123,0,0,0
60913,34210,2021-06-24T13:18:38.041734Z,2021,29,29,24,12,0,Sin Grado,0,2,17,0,0,0,5,0,29,0,0,0
60913,4170,2020-11-18T16:21:08.0153789Z,2019,93,22,78,54,0,10mo,1,0,39,0,0,71,15,0,92,0,0,0
60913,4171,2020-11-18T16:21:08.0153789Z,2019,126,18,101,72,0,11mo,2,2,54,0,0,108,25,0,124,0,0,0
60913,4172,2020-11-18T16:21:08.0163798Z,2019,128,1,91,62,0,12mo,5,0,66,0,0,127,37,0,121,0,0,2
60913,4173,2020-11-18T16:21:08.0163798Z,2019,50,17,45,23,0,6to,2,0,27,0,0,33,5,0,48,0,0,0
60913,4174,2020-11-18T16:21:08.0163798Z,2019,94,31,83,39,0,7mo,4,0,55,0,0,63,11,0,90,0,0,0
60913,4175,2020-11-18T16:21:08.0173812Z,2019,86,22,73,36,0,8vo,1,0,50,0,0,64,13,0,85,0,0,0
60913,4176,2020-11-18T16:21:08.0173812Z,2019,110,25,95,61,0,9no,2,0,49,0,0,85,15,0,108,1,0,0
60913,4177,2020-11-18T16:21:08.0173812Z,2019,38,28,32,11,0,Sin Grado,0,2,27,0,0,10,6,0,38,0,0,0
20404,30961,2021-06-24T13:18:11.8199259Z,2021,34,9,31,17,0,1ro,0,0,17,0,0,25,3,0,34,0,0,0
20404,30962,2021-06-24T13:18:11.8199259Z,2021,35,7,35,16,0,2do,0,0,19,0,0,28,0,0,35,0,0,0
20404,30963,2021-06-24T13:18:11.8209264Z,2021,37,7,32,21,0,3ro,0,0,16,0,0,30,5,0,37,0,0,0
20404,30964,2021-06-24T13:18:11.8209264Z,2021,32,12,31,13,0,4to,0,0,19,0,0,20,1,0,32,0,0,0
20404,30965,2021-06-24T13:18:11.8209264Z,2021,34,13,29,19,0,5to,0,0,15,0,0,21,5,0,34,0,0,0
20404,30966,2021-06-24T13:18:11.8209264Z,2021,47,15,40,23,0,6to,0,0,24,0,0,32,7,0,47,0,0,0
20404,30967,2021-06-24T13:18:11.8219265Z,2021,57,22,52,22,0,7mo,2,0,35,0,0,35,5,2,53,1,0,0
20404,30968,2021-06-24T13:18:11.8219265Z,2021,51,21,42,31,0,8vo,1,0,20,0,0,30,9,0,50,0,0,0
20404,30969,2021-06-24T13:18:11.8219265Z,2021,42,7,41,21,0,K,0,0,21,0,0,35,1,0,42,0,0,0
20404,30970,2021-06-24T13:18:11.8229274Z,2021,19,4,17,6,0,PK,0,0,13,0,0,15,2,0,19,0,0,0
20404,30971,2021-06-24T13:18:11.8229274Z,2021,10,9,10,1,0,Sin Grado,0,0,9,0,0,1,0,0,10,0,0,0
20404,6964,2020-11-18T16:21:42.5924328Z,2020,35,8,34,15,0,1ro,1,0,20,0,0,27,1,0,34,0,0,0
20404,6965,2020-11-18T16:21:42.5924328Z,2020,43,8,36,24,0,2do,0,0,19,0,0,35,7,0,43,0,0,0
20404,6966,2020-11-18T16:21:42.5924328Z,2020,33,13,29,12,0,3ro,0,0,21,0,0,20,4,0,33,0,0,0
20404,6967,2020-11-18T16:21:42.5924328Z,2020,37,14,28,20,0,4to,0,0,17,0,0,23,9,0,37,0,0,0
20404,6968,2020-11-18T16:21:42.5924328Z,2020,48,16,41,22,0,5to,0,0,26,0,0,32,7,0,48,0,0,0
20404,6969,2020-11-18T16:21:42.5934328Z,2020,43,19,39,16,0,6to,1,0,27,0,0,24,4,0,42,0,0,0
20404,6970,2020-11-18T16:21:42.5934328Z,2020,47,18,37,29,0,7mo,0,0,18,0,0,29,10,0,47,0,0,0
20404,6971,2020-11-18T16:21:42.5934328Z,2020,42,7,34,21,0,8vo,0,0,21,0,0,35,8,0,42,0,0,0
20404,6972,2020-11-18T16:21:42.5934328Z,2020,43,6,38,21,0,K,0,0,22,0,0,37,5,0,43,0,0,0
20404,6973,2020-11-18T16:21:42.5934328Z,2020,24,4,21,16,0,PK,0,0,8,0,0,20,3,0,24,0,0,0
20404,6974,2020-11-18T16:21:42.5944337Z,2020,14,14,13,1,0,Sin Grado,0,0,13,0,0,0,1,0,14,0,0,0
20404,963,2020-11-18T16:20:43.3879538Z,2019,47,12,39,23,0,1ro,0,0,24,0,0,35,8,0,47,0,0,0
20404,964,2020-11-18T16:20:43.3889538Z,2019,33,13,29,13,0,2do,0,0,20,0,0,20,4,0,33,0,0,0
20404,965,2020-11-18T16:20:43.3889538Z,2019,37,15,27,20,0,3ro,0,0,17,0,0,22,10,0,37,0,0,0
20404,966,2020-11-18T16:20:43.3889538Z,2019,45,12,40,21,0,4to,1,0,24,0,0,33,5,0,44,0,0,0
20404,967,2020-11-18T16:20:43.3889538Z,2019,41,16,35,16,0,5to,0,0,25,0,0,25,6,0,41,0,0,0
20404,968,2020-11-18T16:20:43.3899547Z,2019,45,19,31,25,0,6to,0,0,20,0,0,26,14,0,45,0,0,0
20404,969,2020-11-18T16:20:43.3899547Z,2019,45,7,35,22,0,7mo,0,0,23,0,0,38,10,0,45,1,0,0
20404,970,2020-11-18T16:20:43.3899547Z,2019,64,22,48,31,0,8vo,0,0,33,0,0,42,16,0,64,0,0,0
20404,971,2020-11-18T16:20:43.3899547Z,2019,36,8,34,17,0,K,1,0,19,0,0,28,2,0,35,0,0,0
20404,972,2020-11-18T16:20:43.3909551Z,2019,19,2,13,12,0,PK,0,0,7,0,0,17,6,0,19,0,0,0
20404,973,2020-11-18T16:20:43.3909551Z,2019,17,17,14,2,0,Sin Grado,0,0,15,0,0,0,3,0,17,0,0,0
32367,2028,2020-11-18T16:20:53.8939592Z,2019,31,9,30,15,0,1ro,1,0,16,0,0,22,1,0,30,0,0,0
32367,2029,2020-11-18T16:20:53.8939592Z,2019,48,6,46,28,0,2do,0,0,20,0,0,42,2,0,48,0,0,0
32367,2030,2020-11-18T16:20:53.8949587Z,2019,28,3,25,13,0,3ro,1,0,15,0,0,25,3,0,27,0,0,0
32367,2031,2020-11-18T16:20:53.8949587Z,2019,31,6,31,14,0,4to,1,0,17,0,0,25,0,0,30,0,0,0
32367,2032,2020-11-18T16:20:53.8949587Z,2019,35,4,34,16,0,5to,2,0,19,0,0,31,1,0,33,0,1,0
32367,2033,2020-11-18T16:20:53.8949587Z,2019,27,4,26,15,0,K,1,0,12,0,0,23,1,0,26,0,0,0
32367,2034,2020-11-18T16:20:53.8959605Z,2019,35,4,30,20,0,PK,0,0,15,0,0,31,5,0,35,0,0,0
32367,32037,2021-06-24T13:18:20.0808484Z,2021,29,5,23,14,0,1ro,0,0,15,0,0,24,6,0,29,0,0,0
32367,32038,2021-06-24T13:18:20.0808484Z,2021,43,12,33,24,0,2do,1,0,19,0,0,31,10,0,42,0,0,0
32367,32039,2021-06-24T13:18:20.0818497Z,2021,23,7,18,7,0,3ro,0,0,16,0,0,16,5,0,23,0,0,0
32367,32040,2021-06-24T13:18:20.0818497Z,2021,48,8,27,29,0,4to,1,0,19,0,0,40,21,0,47,0,0,0
32367,32041,2021-06-24T13:18:20.0818497Z,2021,27,2,19,12,0,5to,1,0,15,0,0,25,8,0,26,0,0,0
32367,32042,2021-06-24T13:18:20.0828502Z,2021,18,3,12,10,0,K,0,0,8,0,0,15,6,0,18,0,0,0
32367,32043,2021-06-24T13:18:20.0828502Z,2021,27,3,16,12,0,PK,0,0,15,0,0,24,11,0,27,0,0,0
32367,8041,2020-11-18T16:21:49.5620821Z,2020,43,11,39,25,0,1ro,2,0,18,0,0,32,4,0,41,0,0,0
32367,8042,2020-11-18T16:21:49.5620821Z,2020,26,5,24,9,0,2do,1,0,17,0,0,21,2,0,25,0,0,0
32367,8043,2020-11-18T16:21:49.5620821Z,2020,50,7,45,30,0,3ro,2,0,20,0,0,43,5,0,48,0,0,0
32367,8044,2020-11-18T16:21:49.5620821Z,2020,30,2,27,15,0,4to,1,0,15,0,0,28,3,0,29,0,0,0
32367,8045,2020-11-18T16:21:49.563083Z,2020,33,6,30,14,0,5to,1,0,19,0,0,27,3,0,32,0,0,0
32367,8046,2020-11-18T16:21:49.563083Z,2020,43,4,41,23,0,K,2,0,20,0,0,39,2,0,41,0,0,0
32367,8047,2020-11-18T16:21:49.563083Z,2020,16,1,13,10,0,PK,1,0,6,0,0,15,3,0,15,0,0,0
52514,33583,2021-06-24T13:18:33.4094117Z,2021,159,43,133,83,0,10mo,0,2,76,0,0,116,26,1,158,0,0,0
52514,33584,2021-06-24T13:18:33.4094117Z,2021,199,63,156,101,0,11mo,2,0,98,0,0,136,43,0,197,0,0,0
52514,33585,2021-06-24T13:18:33.4104131Z,2021,170,37,140,84,0,12mo,0,0,86,0,0,133,30,0,170,0,0,0
52514,33586,2021-06-24T13:18:33.4104131Z,2021,140,48,119,73,0,9no,2,1,67,0,0,92,21,0,138,1,1,0
52514,3558,2020-11-18T16:21:03.2672132Z,2019,252,50,207,121,0,10mo,1,0,131,0,0,202,45,0,251,1,0,0
52514,3559,2020-11-18T16:21:03.2672132Z,2019,203,41,174,110,0,11mo,3,0,93,0,0,162,29,0,200,0,0,0
52514,3560,2020-11-18T16:21:03.2682141Z,2019,212,2,166,112,0,12mo,3,0,100,0,0,210,46,0,209,1,1,0
52514,3561,2020-11-18T16:21:03.2682141Z,2019,309,88,246,152,0,9no,4,0,157,0,0,221,63,0,305,0,0,0
52514,9577,2020-11-18T16:21:59.0954377Z,2020,265,78,208,136,0,10mo,2,3,129,0,0,187,57,0,263,0,0,0
52514,9578,2020-11-18T16:21:59.0954377Z,2020,232,48,189,109,0,11mo,0,2,123,0,0,184,43,0,232,1,0,0
52514,9579,2020-11-18T16:21:59.0964382Z,2020,194,33,162,108,0,12mo,4,2,86,0,0,161,32,0,190,0,0,0
52514,9580,2020-11-18T16:21:59.0964382Z,2020,188,51,165,95,0,9no,1,1,93,0,0,137,23,1,186,0,0,0
35543,2347,2020-11-18T16:20:55.7271829Z,2019,55,53,44,21,0,Sin Grado,1,0,34,0,0,2,11,1,53,0,1,0
35543,32354,2021-06-24T13:18:23.3331814Z,2021,62,62,52,20,0,Sin Grado,1,0,42,0,0,0,10,0,61,0,0,0
35543,8359,2020-11-18T16:21:51.4003066Z,2020,61,61,50,21,0,Sin Grado,1,0,40,0,0,0,11,0,60,0,0,0
62182,10390,2020-11-18T16:22:03.7295291Z,2020,70,14,55,42,0,1ro,0,1,28,0,0,56,15,0,68,0,0,2
62182,10391,2020-11-18T16:22:03.7305286Z,2020,81,26,67,39,0,2do,1,1,42,0,0,55,14,0,80,0,0,0
62182,10392,2020-11-18T16:22:03.7305286Z,2020,68,18,54,37,0,3ro,0,0,31,0,0,50,14,0,68,0,0,0
62182,10393,2020-11-18T16:22:03.7305286Z,2020,89,26,74,48,0,4to,0,0,41,0,0,63,15,0,89,0,0,0
62182,10394,2020-11-18T16:22:03.7315286Z,2020,75,22,61,30,0,5to,0,0,45,0,0,53,14,0,75,0,0,0
62182,10395,2020-11-18T16:22:03.7315286Z,2020,63,18,57,27,0,K,0,1,36,0,0,45,6,0,62,0,0,1
62182,10396,2020-11-18T16:22:03.7315286Z,2020,23,23,20,7,0,Sin Grado,0,1,16,0,0,0,3,0,23,0,0,0
62182,34405,2021-06-24T13:18:39.4247253Z,2021,59,21,52,24,0,1ro,0,1,35,0,0,38,7,0,59,0,0,0
62182,34406,2021-06-24T13:18:39.4257275Z,2021,67,16,56,39,0,2do,0,1,28,0,0,51,11,0,65,0,0,2
62182,34407,2021-06-24T13:18:39.4257275Z,2021,73,27,61,32,0,3ro,1,1,41,0,0,46,12,0,72,0,0,0
62182,34408,2021-06-24T13:18:39.4257275Z,2021,69,18,58,36,0,4to,0,0,33,0,0,51,11,0,69,0,0,0
62182,34409,2021-06-24T13:18:39.4257275Z,2021,76,20,64,36,0,5to,0,0,40,0,0,56,12,0,76,0,0,0
62182,34410,2021-06-24T13:18:39.4267271Z,2021,49,9,45,20,0,K,0,1,29,0,0,40,4,0,49,0,0,0
62182,34411,2021-06-24T13:18:39.4267271Z,2021,12,12,10,5,0,Sin Grado,0,0,7,0,0,0,2,0,12,0,0,0
62182,4377,2020-11-18T16:21:09.7285175Z,2019,92,28,79,46,0,1ro,0,1,46,0,0,64,13,0,92,0,0,0
62182,4378,2020-11-18T16:21:09.7295184Z,2019,79,26,62,45,0,2do,1,1,34,0,0,53,17,0,78,0,0,0
62182,4379,2020-11-18T16:21:09.7295184Z,2019,97,32,82,53,0,3ro,1,0,44,0,0,65,15,0,96,0,0,0
62182,4380,2020-11-18T16:21:09.7295184Z,2019,76,22,62,32,0,4to,0,0,44,0,0,54,14,0,76,0,0,0
62182,4381,2020-11-18T16:21:09.7295184Z,2019,88,24,74,50,0,5to,2,1,38,0,0,64,14,0,86,0,0,0
62182,4382,2020-11-18T16:21:09.7295184Z,2019,81,18,62,45,0,K,0,1,36,0,0,63,19,0,79,0,0,2
62182,4383,2020-11-18T16:21:09.7305189Z,2019,23,23,19,8,0,Sin Grado,0,0,15,0,0,0,4,0,23,0,0,0
47951,3174,2020-11-18T16:21:01.0317194Z,2019,117,38,84,69,0,6to,3,0,48,0,0,79,33,0,114,1,0,0
47951,3175,2020-11-18T16:21:01.0317194Z,2019,164,65,127,71,0,7mo,2,1,93,0,0,99,37,0,162,1,1,0
47951,3176,2020-11-18T16:21:01.0317194Z,2019,147,39,116,63,0,8vo,3,0,84,0,0,108,31,0,144,0,0,0
47951,3177,2020-11-18T16:21:01.0327216Z,2019,263,74,169,139,0,9no,6,0,124,0,1,189,94,0,256,2,2,1
47951,33192,2021-06-24T13:18:30.3542216Z,2021,24,8,23,11,0,1ro,0,0,13,0,0,16,1,0,24,0,0,0
47951,33193,2021-06-24T13:18:30.3542216Z,2021,20,1,12,13,0,2do,0,0,7,0,0,19,8,0,20,0,0,0
47951,33194,2021-06-24T13:18:30.3542216Z,2021,12,5,9,2,0,3ro,4,0,10,0,0,7,3,0,8,0,0,0
47951,33195,2021-06-24T13:18:30.3542216Z,2021,14,3,11,5,0,4to,1,0,9,0,0,11,3,0,13,0,0,0
47951,33196,2021-06-24T13:18:30.3552221Z,2021,13,3,10,7,0,5to,1,0,6,0,0,10,3,0,12,0,0,0
47951,33197,2021-06-24T13:18:30.3552221Z,2021,106,30,90,52,0,6to,3,0,54,0,0,76,16,0,102,0,0,1
47951,33198,2021-06-24T13:18:30.3552221Z,2021,132,37,104,70,0,7mo,1,0,62,0,0,95,28,0,131,0,0,0
47951,33199,2021-06-24T13:18:30.3552221Z,2021,148,47,124,83,0,8vo,4,1,65,0,0,101,24,0,143,1,0,1
47951,33200,2021-06-24T13:18:30.8565814Z,2021,165,54,128,77,0,9no,4,0,88,0,0,111,37,0,161,0,0,0
47951,33201,2021-06-24T13:18:30.8575824Z,2021,16,7,12,9,0,K,0,0,7,0,0,9,4,0,16,0,0,0
47951,33202,2021-06-24T13:18:30.8575824Z,2021,35,3,29,19,0,PK,2,0,16,0,0,32,6,0,33,0,0,0
47951,9188,2020-11-18T16:21:56.156481Z,2020,14,0,8,10,0,1ro,0,0,4,0,0,14,6,0,14,0,0,0
47951,9189,2020-11-18T16:21:56.156481Z,2020,12,6,9,3,0,2do,3,0,9,0,0,6,3,0,9,0,0,0
47951,9190,2020-11-18T16:21:56.1574814Z,2020,4,2,4,1,0,3ro,0,0,3,0,0,2,0,0,4,0,0,0
47951,9191,2020-11-18T16:21:56.1574814Z,2020,10,2,8,6,0,4to,0,0,4,0,0,8,2,0,10,0,0,0
47951,9192,2020-11-18T16:21:56.1574814Z,2020,12,2,10,6,0,5to,0,0,6,0,0,10,2,0,12,0,0,0
47951,9193,2020-11-18T16:21:56.1574814Z,2020,101,31,75,61,0,6to,1,0,40,0,0,70,26,0,100,0,0,0
47951,9194,2020-11-18T16:21:56.1574814Z,2020,148,53,112,80,0,7mo,4,0,68,0,0,95,36,0,144,1,0,0
47951,9195,2020-11-18T16:21:56.1584819Z,2020,146,44,107,63,0,8vo,5,0,83,0,0,102,39,0,141,1,1,0
47951,9196,2020-11-18T16:21:56.1584819Z,2020,223,51,161,107,0,9no,4,0,116,0,0,172,62,0,219,2,0,0
47951,9197,2020-11-18T16:21:56.1584819Z,2020,11,1,9,7,0,K,0,0,4,0,0,10,2,0,11,0,0,0
47951,9198,2020-11-18T16:21:56.1584819Z,2020,26,4,22,12,0,PK,1,0,14,0,0,22,4,0,25,0,0,0
58099,10009,2020-11-18T16:22:01.9423394Z,2020,23,4,18,10,0,1ro,0,0,13,0,0,19,5,0,23,0,0,0
58099,10010,2020-11-18T16:22:01.9433393Z,2020,21,3,17,10,0,2do,1,0,11,0,0,18,4,0,20,0,0,0
58099,10011,2020-11-18T16:22:01.9433393Z,2020,30,8,27,15,0,3ro,0,1,15,0,0,22,3,0,30,0,0,0
58099,10012,2020-11-18T16:22:01.9433393Z,2020,26,10,18,13,0,4to,0,1,13,0,0,16,8,0,26,0,0,0
58099,10013,2020-11-18T16:22:01.9433393Z,2020,23,9,12,11,0,5to,0,1,12,0,0,14,11,0,23,0,0,0
58099,10014,2020-11-18T16:22:01.9443402Z,2020,44,14,36,22,0,6to,0,1,22,0,0,30,8,0,44,0,0,0
58099,10015,2020-11-18T16:22:01.9443402Z,2020,60,18,51,25,0,7mo,0,0,35,0,0,42,9,0,60,0,0,0
58099,10016,2020-11-18T16:22:01.9443402Z,2020,41,11,31,19,0,8vo,0,0,22,0,0,30,10,0,41,0,0,0
58099,10017,2020-11-18T16:22:01.9443402Z,2020,24,1,19,13,0,K,0,0,11,0,0,23,5,0,24,0,0,0
58099,10018,2020-11-18T16:22:01.9453407Z,2020,16,0,11,7,0,PK,0,0,9,0,0,16,5,0,16,0,0,0
58099,10019,2020-11-18T16:22:01.9453407Z,2020,3,3,3,0,0,Sin Grado,0,0,3,0,0,0,0,0,3,0,0,0
58099,34016,2021-06-24T13:18:36.9319389Z,2021,16,1,16,7,0,1ro,0,0,9,0,0,15,0,0,16,0,0,0
58099,34017,2021-06-24T13:18:36.9319389Z,2021,17,2,14,7,0,2do,0,0,10,0,0,15,3,0,17,0,0,0
58099,34018,2021-06-24T13:18:36.932939Z,2021,17,4,15,8,0,3ro,0,3,9,0,0,13,2,0,17,0,0,0
58099,34019,2021-06-24T13:18:36.932939Z,2021,23,5,22,11,0,4to,0,0,12,0,0,18,1,0,23,0,0,0
58099,34020,2021-06-24T13:18:36.932939Z,2021,22,8,20,11,0,5to,0,0,11,0,0,14,2,0,22,0,0,0
58099,34021,2021-06-24T13:18:36.9339403Z,2021,27,11,17,8,0,6to,1,0,19,0,0,16,10,0,26,0,0,0
58099,34022,2021-06-24T13:18:36.9339403Z,2021,42,14,38,18,0,7mo,0,1,24,0,0,28,4,0,42,0,0,0
58099,34023,2021-06-24T13:18:36.9349413Z,2021,48,15,43,21,0,8vo,0,1,27,0,0,33,5,1,47,0,0,0
58099,34024,2021-06-24T13:18:36.9349413Z,2021,12,3,11,5,0,K,0,0,7,0,0,9,1,0,12,0,0,0
58099,34025,2021-06-24T13:18:36.9349413Z,2021,8,0,7,2,0,PK,0,0,6,0,0,8,1,0,8,0,0,0
58099,34026,2021-06-24T13:18:36.9359409Z,2021,3,3,3,0,0,Sin Grado,0,0,3,0,0,0,0,0,3,0,0,0
58099,3992,2020-11-18T16:21:06.9006343Z,2019,17,3,14,8,0,1ro,0,0,9,0,0,14,3,0,17,0,0,0
58099,3993,2020-11-18T16:21:06.9006343Z,2019,26,7,23,14,0,2do,0,0,12,0,0,19,3,0,26,0,0,0
58099,3994,2020-11-18T16:21:06.9006343Z,2019,27,12,20,12,0,3ro,0,0,15,0,0,15,7,0,27,0,0,0
58099,3995,2020-11-18T16:21:06.9006343Z,2019,22,10,11,8,0,4to,0,0,14,0,0,12,11,0,22,0,0,0
58099,3996,2020-11-18T16:21:06.9016343Z,2019,28,9,23,14,0,5to,0,0,14,0,0,19,5,0,28,0,0,0
58099,3997,2020-11-18T16:21:06.9016343Z,2019,45,14,34,22,0,6to,0,0,23,0,0,31,11,0,45,0,0,0
58099,3998,2020-11-18T16:21:06.9016343Z,2019,49,16,43,16,0,7mo,0,0,33,0,0,33,6,0,49,0,0,0
58099,3999,2020-11-18T16:21:06.9016343Z,2019,42,10,26,17,0,8vo,0,0,25,0,0,32,16,0,42,2,0,0
58099,4000,2020-11-18T16:21:06.9026352Z,2019,20,1,13,9,0,K,0,0,11,0,0,19,7,0,20,0,0,0
58099,4001,2020-11-18T16:21:07.2818887Z,2019,16,2,14,8,0,PK,0,0,8,0,0,14,2,0,16,0,0,0
58099,4002,2020-11-18T16:21:07.2818887Z,2019,3,3,3,1,0,Sin Grado,0,1,2,0,0,0,0,0,3,0,0,0
50542,3279,2020-11-18T16:21:01.4660095Z,2019,51,22,37,19,0,1ro,1,0,32,0,0,29,14,0,50,0,0,0
50542,3280,2020-11-18T16:21:01.4660095Z,2019,52,18,37,24,0,2do,0,1,28,0,0,34,15,0,52,0,0,0
50542,3281,2020-11-18T16:21:01.46701Z,2019,48,21,40,24,0,3ro,0,0,24,0,0,27,8,0,48,0,0,0
50542,3282,2020-11-18T16:21:01.46701Z,2019,45,12,36,23,0,4to,0,0,22,0,0,33,9,0,45,0,0,0
50542,3283,2020-11-18T16:21:01.46701Z,2019,53,21,39,28,0,5to,0,0,25,0,0,32,14,0,53,0,0,0
50542,3284,2020-11-18T16:21:01.46701Z,2019,45,10,36,24,0,K,0,1,21,0,0,35,9,0,45,0,0,0
50542,3285,2020-11-18T16:21:01.46701Z,2019,11,11,10,4,0,Sin Grado,0,0,7,0,0,0,1,0,11,0,0,0
50542,33305,2021-06-24T13:18:31.5440746Z,2021,41,9,37,16,0,1ro,0,0,25,0,0,32,4,0,41,0,0,0
50542,33306,2021-06-24T13:18:31.5440746Z,2021,50,19,43,26,0,2do,0,0,24,0,0,31,7,0,50,0,0,0
50542,33307,2021-06-24T13:18:31.5440746Z,2021,52,18,44,20,0,3ro,0,0,32,0,0,34,8,0,52,0,0,0
50542,33308,2021-06-24T13:18:31.5440746Z,2021,53,18,47,24,0,4to,0,0,29,0,0,35,6,0,53,0,0,0
50542,33309,2021-06-24T13:18:31.5440746Z,2021,52,17,44,24,0,5to,0,0,28,0,0,35,8,0,52,0,0,0
50542,33310,2021-06-24T13:18:31.5450751Z,2021,39,12,33,22,0,K,0,0,17,0,0,27,6,0,38,0,0,1
50542,33311,2021-06-24T13:18:31.5450751Z,2021,16,16,15,5,0,Sin Grado,0,0,11,0,0,0,1,0,16,0,0,0
50542,9299,2020-11-18T16:21:57.3502748Z,2020,54,22,43,24,0,1ro,0,0,30,0,0,32,11,0,54,0,0,0
50542,9300,2020-11-18T16:21:57.3502748Z,2020,52,20,41,18,0,2do,0,0,34,0,0,32,11,0,52,0,0,0
50542,9301,2020-11-18T16:21:57.9836949Z,2020,51,21,38,25,0,3ro,0,0,26,0,0,30,13,0,51,0,0,0
50542,9302,2020-11-18T16:21:57.9836949Z,2020,49,17,38,23,0,4to,0,0,26,0,0,32,11,0,49,0,0,0
50542,9303,2020-11-18T16:21:57.9846957Z,2020,43,10,32,24,0,5to,0,0,19,0,0,33,11,0,43,0,0,0
50542,9304,2020-11-18T16:21:57.9846957Z,2020,39,7,29,16,0,K,0,0,23,0,0,32,10,0,39,0,0,0
50542,9305,2020-11-18T16:21:57.9846957Z,2020,13,13,9,4,0,Sin Grado,0,0,9,0,0,0,4,0,13,0,0,0
31609,1987,2020-11-18T16:20:53.4126392Z,2019,26,5,23,11,0,1ro,1,0,15,0,0,21,3,0,25,0,0,0
31609,1988,2020-11-18T16:20:53.4126392Z,2019,42,18,36,17,0,2do,0,0,25,0,0,24,6,0,42,0,0,0
31609,1989,2020-11-18T16:20:53.4126392Z,2019,38,10,32,22,0,3ro,1,0,16,0,0,28,6,0,37,0,0,0
31609,1990,2020-11-18T16:20:53.4126392Z,2019,37,7,29,18,0,4to,2,0,19,0,0,30,8,0,35,0,0,0
31609,1991,2020-11-18T16:20:53.4136387Z,2019,40,6,31,25,0,5to,0,0,15,0,0,34,9,0,40,0,0,0
31609,1992,2020-11-18T16:20:53.4136387Z,2019,31,6,24,13,0,K,0,0,18,0,0,25,7,0,31,0,0,0
31609,31995,2021-06-24T13:18:18.7028605Z,2021,40,13,29,17,0,1ro,0,2,23,0,0,27,11,0,40,0,0,0
31609,31996,2021-06-24T13:18:18.7038614Z,2021,22,3,17,13,0,2do,0,0,9,0,0,19,5,0,22,0,0,0
31609,31997,2021-06-24T13:18:18.7038614Z,2021,37,11,34,13,0,3ro,1,0,24,0,0,26,3,0,36,1,0,0
31609,31998,2021-06-24T13:18:18.7048619Z,2021,40,15,32,16,0,4to,0,1,24,0,0,25,8,0,40,0,0,0
31609,31999,2021-06-24T13:18:18.7048619Z,2021,42,9,34,25,0,5to,1,0,17,0,0,33,8,0,41,0,0,0
31609,32000,2021-06-24T13:18:20.059834Z,2021,26,4,21,7,0,K,0,0,19,0,0,22,5,0,25,0,0,1
31609,7999,2020-11-18T16:21:49.1418009Z,2020,20,2,17,12,0,1ro,0,0,8,0,0,18,3,0,20,0,0,0
31609,8000,2020-11-18T16:21:49.1428027Z,2020,36,12,34,13,0,2do,1,0,23,0,0,24,2,0,35,0,0,0
31609,8001,2020-11-18T16:21:49.540067Z,2020,41,13,32,18,0,3ro,0,0,23,0,0,28,9,0,41,0,0,0
31609,8002,2020-11-18T16:21:49.540067Z,2020,39,10,28,21,0,4to,1,0,18,0,0,29,11,0,38,0,0,0
31609,8003,2020-11-18T16:21:49.540067Z,2020,35,7,25,19,0,5to,2,0,16,0,0,28,10,0,33,0,0,0
31609,8004,2020-11-18T16:21:49.540067Z,2020,41,12,34,15,0,K,0,0,26,0,0,29,7,0,41,0,0,0
51292,33384,2021-06-24T13:18:31.5730956Z,2021,37,6,32,14,0,1ro,0,0,23,0,0,31,5,0,37,0,0,0
51292,33385,2021-06-24T13:18:31.5740961Z,2021,40,8,32,17,0,2do,1,0,23,0,0,32,8,0,39,0,0,0
51292,33386,2021-06-24T13:18:31.5740961Z,2021,29,10,27,14,0,3ro,1,1,15,0,0,19,2,0,28,0,0,0
51292,33387,2021-06-24T13:18:31.5740961Z,2021,45,15,36,23,0,4to,2,0,22,0,0,30,9,0,43,0,0,0
51292,33388,2021-06-24T13:18:31.5750975Z,2021,34,9,25,23,0,5to,1,0,11,0,0,25,9,0,33,0,0,0
51292,33389,2021-06-24T13:18:31.5750975Z,2021,24,1,15,16,0,K,0,0,8,0,0,23,9,0,24,0,0,0
51292,33390,2021-06-24T13:18:31.5750975Z,2021,16,0,11,10,0,PK,0,0,6,0,0,16,5,0,16,0,0,0
51292,3359,2020-11-18T16:21:02.1444632Z,2019,39,9,36,20,0,1ro,0,11,19,0,0,30,3,0,39,0,0,0
51292,3360,2020-11-18T16:21:02.1444632Z,2019,41,9,25,23,0,2do,2,18,18,0,0,32,16,0,39,0,0,0
51292,3361,2020-11-18T16:21:02.1454641Z,2019,45,17,38,26,0,3ro,0,4,19,0,0,28,7,0,45,0,0,0
51292,3362,2020-11-18T16:21:02.1454641Z,2019,26,9,16,12,0,4to,0,9,14,0,0,17,10,0,26,0,0,0
51292,3363,2020-11-18T16:21:02.1454641Z,2019,25,5,21,12,0,5to,0,2,13,0,0,20,4,0,25,0,0,0
51292,3364,2020-11-18T16:21:02.1454641Z,2019,48,11,39,26,0,K,1,8,22,0,0,37,9,0,47,0,0,0
51292,3365,2020-11-18T16:21:02.1464645Z,2019,18,2,11,10,0,PK,0,1,8,0,0,16,7,0,18,0,0,0
51292,9379,2020-11-18T16:21:58.0117149Z,2020,42,8,34,20,0,1ro,1,6,22,0,0,34,8,0,41,0,0,0
51292,9380,2020-11-18T16:21:58.0117149Z,2020,34,10,29,16,0,2do,0,8,18,0,0,24,5,0,34,1,0,0
51292,9381,2020-11-18T16:21:58.0117149Z,2020,45,15,33,23,0,3ro,2,14,22,0,0,30,12,0,43,0,0,0
51292,9382,2020-11-18T16:21:58.0127154Z,2020,35,11,27,22,0,4to,1,2,13,0,0,24,8,0,34,0,0,0
51292,9383,2020-11-18T16:21:58.0127154Z,2020,22,7,14,11,0,5to,0,6,11,0,0,15,8,0,22,0,0,0
51292,9384,2020-11-18T16:21:58.0127154Z,2020,35,6,30,13,0,K,0,1,22,0,0,29,5,0,35,0,0,0
51292,9385,2020-11-18T16:21:58.0137162Z,2020,13,1,5,8,0,PK,0,0,5,0,0,12,8,0,13,0,0,0
20305,30920,2021-06-24T13:18:11.8059154Z,2021,35,9,32,21,0,1ro,0,1,14,0,0,26,3,0,35,0,0,0
20305,30921,2021-06-24T13:18:11.8059154Z,2021,21,2,16,9,0,2do,0,1,12,0,0,19,5,0,21,0,0,0
20305,30922,2021-06-24T13:18:11.8069159Z,2021,30,9,25,14,0,3ro,0,0,16,0,0,21,5,0,30,1,0,0
20305,30923,2021-06-24T13:18:11.8069159Z,2021,35,13,25,17,0,4to,0,1,18,0,0,22,10,0,35,2,0,0
20305,30924,2021-06-24T13:18:11.8069159Z,2021,28,10,24,13,0,5to,0,2,15,0,0,18,4,0,28,3,0,0
20305,30925,2021-06-24T13:18:11.8079173Z,2021,22,2,21,13,0,K,0,1,9,0,0,20,1,0,21,0,0,1
20305,30926,2021-06-24T13:18:11.8079173Z,2021,2,2,2,1,0,Sin Grado,0,0,1,0,0,0,0,0,2,0,0,0
20305,6924,2020-11-18T16:21:42.5804244Z,2020,23,3,19,11,0,1ro,0,1,12,0,0,20,4,0,23,0,0,0
20305,6925,2020-11-18T16:21:42.5804244Z,2020,31,9,22,14,0,2do,0,3,17,0,0,22,9,0,31,1,0,0
20305,6926,2020-11-18T16:21:42.5804244Z,2020,37,13,21,19,0,3ro,0,3,18,0,0,24,16,0,37,2,0,0
20305,6927,2020-11-18T16:21:42.5804244Z,2020,31,11,21,16,0,4to,0,3,15,0,0,20,10,0,31,3,0,0
20305,6928,2020-11-18T16:21:42.5804244Z,2020,41,11,26,21,0,5to,0,3,20,0,0,30,15,0,41,0,0,0
20305,6929,2020-11-18T16:21:42.5814253Z,2020,34,8,30,19,0,K,0,1,15,0,0,26,4,0,34,0,0,0
20305,6930,2020-11-18T16:21:42.5814253Z,2020,2,2,2,1,0,Sin Grado,0,0,1,0,0,0,0,0,2,0,0,0
20305,923,2020-11-18T16:20:43.3709409Z,2019,28,9,22,14,0,1ro,1,2,14,0,0,19,6,0,27,1,0,0
20305,924,2020-11-18T16:20:43.3709409Z,2019,36,15,26,20,0,2do,0,4,16,0,0,21,10,0,36,2,0,0
20305,925,2020-11-18T16:20:43.3709409Z,2019,34,14,22,17,0,3ro,0,5,17,0,0,20,12,0,34,3,0,0
20305,926,2020-11-18T16:20:43.3709409Z,2019,36,9,20,19,0,4to,0,3,17,0,0,27,16,0,36,0,0,0
20305,927,2020-11-18T16:20:43.3709409Z,2019,43,20,26,19,0,5to,1,4,24,0,0,23,17,0,42,2,0,0
20305,928,2020-11-18T16:20:43.3719418Z,2019,18,6,11,12,0,6to,1,1,6,0,0,12,7,0,17,3,0,0
20305,929,2020-11-18T16:20:43.3719418Z,2019,20,5,18,10,0,K,0,2,10,0,0,15,2,0,20,0,0,0
20305,930,2020-11-18T16:20:43.3719418Z,2019,3,3,3,0,0,Sin Grado,0,0,3,0,0,0,0,0,3,0,0,0
24927,1453,2020-11-18T16:20:46.3409249Z,2019,34,16,20,16,0,1ro,0,0,18,0,0,18,14,0,34,1,0,0
24927,1454,2020-11-18T16:20:46.3409249Z,2019,16,4,12,9,0,2do,0,0,7,0,0,12,4,0,16,0,0,0
24927,1455,2020-11-18T16:20:46.3419253Z,2019,24,12,15,8,0,3ro,0,0,16,0,0,12,9,0,24,0,1,0
24927,1456,2020-11-18T16:20:46.3419253Z,2019,26,10,20,12,0,4to,0,0,14,0,0,16,6,0,26,0,0,0
24927,1457,2020-11-18T16:20:46.3419253Z,2019,23,8,14,15,0,5to,1,0,8,0,0,15,9,0,22,0,0,0
24927,1458,2020-11-18T16:20:46.3419253Z,2019,28,9,22,13,0,6to,1,0,15,0,0,19,6,0,27,0,2,0
24927,1459,2020-11-18T16:20:46.3419253Z,2019,20,9,17,10,0,K,0,0,10,0,0,11,3,0,20,0,0,0
24927,1460,2020-11-18T16:20:46.3429257Z,2019,66,11,29,32,0,PK,0,0,34,0,0,55,37,0,66,1,0,0
24927,31453,2021-06-24T13:18:14.9211486Z,2021,22,5,16,9,0,1ro,0,2,13,0,0,17,6,0,22,1,0,0
24927,31454,2021-06-24T13:18:14.9221491Z,2021,19,10,14,11,0,2do,0,0,8,0,0,9,5,0,19,0,0,0
24927,31455,2021-06-24T13:18:14.9221491Z,2021,25,8,20,12,0,3ro,0,1,13,0,0,17,5,0,25,1,0,0
24927,31456,2021-06-24T13:18:14.9221491Z,2021,18,6,14,8,0,4to,0,0,10,0,0,12,4,0,18,0,0,0
24927,31457,2021-06-24T13:18:14.9221491Z,2021,20,9,16,9,0,5to,0,0,11,0,0,11,4,0,20,0,1,0
24927,31458,2021-06-24T13:18:14.9231522Z,2021,17,4,16,4,0,6to,0,0,13,0,0,13,1,0,17,0,0,0
24927,31459,2021-06-24T13:18:14.9231522Z,2021,28,3,22,12,0,K,0,0,16,0,0,25,6,0,28,0,0,0
24927,31460,2021-06-24T13:18:14.9231522Z,2021,58,2,36,33,0,PK,0,0,25,0,0,56,22,0,58,0,0,0
24927,31461,2021-06-24T13:18:14.9231522Z,2021,5,5,5,2,0,Sin Grado,0,0,3,0,0,0,0,0,5,0,0,0
24927,7456,2020-11-18T16:21:45.7745583Z,2020,23,13,18,12,0,1ro,0,0,11,0,0,10,5,0,23,0,0,0
24927,7457,2020-11-18T16:21:45.7745583Z,2020,24,7,14,13,0,2do,0,0,11,0,0,17,10,0,24,1,0,0
24927,7458,2020-11-18T16:21:45.7745583Z,2020,21,7,14,9,0,3ro,0,0,12,0,0,14,7,0,21,0,0,0
24927,7459,2020-11-18T16:21:45.7745583Z,2020,25,10,18,9,0,4to,1,0,16,0,0,15,7,0,24,0,1,0
24927,7460,2020-11-18T16:21:45.7745583Z,2020,23,8,18,8,0,5to,0,1,15,0,0,15,5,0,23,0,0,0
24927,7461,2020-11-18T16:21:45.7755605Z,2020,11,3,5,8,0,6to,0,0,3,0,0,8,6,0,11,0,0,0
24927,7462,2020-11-18T16:21:45.7755605Z,2020,23,3,8,10,0,K,0,0,13,0,0,20,15,0,23,1,0,0
24927,7463,2020-11-18T16:21:45.7755605Z,2020,67,5,32,37,0,PK,0,0,30,0,0,62,35,0,67,0,0,0
24927,7464,2020-11-18T16:21:45.7755605Z,2020,3,3,3,1,0,Sin Grado,0,0,2,0,0,0,0,0,3,0,0,0
54551,33799,2021-06-24T13:18:35.2767516Z,2021,107,37,97,51,0,6to,3,0,56,0,0,70,10,0,103,0,0,1
54551,33800,2021-06-24T13:18:35.7010554Z,2021,110,27,90,57,0,7mo,3,0,53,0,0,83,20,0,107,0,0,0
54551,33801,2021-06-24T13:18:35.7010554Z,2021,102,33,92,49,0,8vo,1,0,53,0,0,69,10,0,101,0,1,0
54551,33802,2021-06-24T13:18:35.7010554Z,2021,10,10,9,4,0,Sin Grado,0,0,6,0,0,0,1,0,10,0,0,0
54551,3776,2020-11-18T16:21:05.1244476Z,2019,105,31,93,52,0,6to,1,4,53,0,0,74,12,0,104,0,1,0
54551,3777,2020-11-18T16:21:05.1254485Z,2019,101,21,83,50,0,7mo,0,3,51,0,0,80,18,0,101,0,1,0
54551,3778,2020-11-18T16:21:05.1254485Z,2019,99,15,81,53,0,8vo,0,2,46,0,0,84,18,0,99,0,1,0
54551,3779,2020-11-18T16:21:05.1254485Z,2019,12,11,9,6,0,Sin Grado,0,0,6,0,0,1,3,0,12,0,0,0
54551,9793,2020-11-18T16:22:00.131132Z,2020,120,31,102,60,0,6to,4,5,60,0,0,89,18,0,116,0,0,0
54551,9794,2020-11-18T16:22:00.131132Z,2020,106,33,95,51,0,7mo,1,0,55,0,0,73,11,0,105,0,2,0
54551,9795,2020-11-18T16:22:00.131132Z,2020,104,22,83,53,0,8vo,2,3,51,0,0,82,21,0,102,0,0,0
54551,9796,2020-11-18T16:22:00.1321311Z,2020,14,14,11,6,0,Sin Grado,0,0,8,0,0,0,3,0,14,0,0,0
70417,10992,2020-11-18T16:22:07.2278608Z,2020,31,8,27,24,0,1ro,1,0,7,0,0,23,4,0,30,0,0,0
70417,10993,2020-11-18T16:22:07.2278608Z,2020,43,16,41,21,0,2do,0,0,22,0,0,27,2,0,43,0,0,0
70417,10994,2020-11-18T16:22:07.2278608Z,2020,39,15,30,12,0,3ro,0,0,27,0,0,24,9,0,39,0,0,0
70417,10995,2020-11-18T16:22:07.2278608Z,2020,38,19,29,20,0,4to,3,0,18,0,0,19,9,0,35,0,0,0
70417,10996,2020-11-18T16:22:07.2278608Z,2020,53,20,44,27,0,5to,2,0,26,0,0,33,9,0,51,0,0,0
70417,10997,2020-11-18T16:22:07.2288621Z,2020,68,31,49,33,0,6to,2,0,35,0,0,37,19,0,66,0,0,0
70417,10998,2020-11-18T16:22:07.2288621Z,2020,75,28,62,33,0,7mo,2,1,42,0,0,47,13,0,72,0,0,1
70417,10999,2020-11-18T16:22:07.2288621Z,2020,66,24,46,38,0,8vo,0,1,28,0,0,42,20,0,66,0,0,0
70417,11000,2020-11-18T16:22:07.2288621Z,2020,39,13,32,19,0,K,0,0,20,0,0,26,7,0,39,0,0,0
70417,11001,2020-11-18T16:22:07.6031098Z,2020,42,42,32,12,0,Sin Grado,0,0,30,0,0,0,10,0,42,0,1,0
70417,35013,2021-06-24T13:18:43.7007917Z,2021,43,15,37,19,0,1ro,1,0,24,0,0,28,6,0,42,0,1,0
70417,35014,2021-06-24T13:18:43.7007917Z,2021,42,16,35,29,0,2do,1,0,13,0,0,26,7,0,41,0,0,0
70417,35015,2021-06-24T13:18:43.7007917Z,2021,49,18,44,24,0,3ro,1,2,25,0,0,31,5,0,48,0,0,0
70417,35016,2021-06-24T13:18:43.7007917Z,2021,44,20,38,14,0,4to,0,0,30,0,0,24,6,0,44,0,0,0
70417,35017,2021-06-24T13:18:43.7017922Z,2021,51,26,47,27,0,5to,3,0,24,0,0,25,4,0,48,0,0,0
70417,35018,2021-06-24T13:18:43.7017922Z,2021,79,31,70,45,0,6to,4,0,34,0,0,48,9,0,75,0,1,0
70417,35019,2021-06-24T13:18:43.7017922Z,2021,75,37,60,36,0,7mo,2,2,39,0,0,38,15,0,73,0,1,0
70417,35020,2021-06-24T13:18:43.7017922Z,2021,77,29,62,32,0,8vo,2,1,45,0,0,48,15,0,74,0,1,1
70417,35021,2021-06-24T13:18:43.7027931Z,2021,32,7,28,18,0,K,1,0,14,0,0,25,4,0,31,0,0,0
70417,35022,2021-06-24T13:18:43.7027931Z,2021,43,43,38,13,0,Sin Grado,1,0,30,0,0,0,5,0,42,0,1,0
70417,4983,2020-11-18T16:21:13.0327239Z,2019,50,22,45,25,0,1ro,0,0,25,0,0,28,5,0,50,0,0,0
70417,4984,2020-11-18T16:21:13.0337243Z,2019,40,14,33,13,0,2do,0,0,27,0,0,26,7,0,40,0,0,0
70417,4985,2020-11-18T16:21:13.0337243Z,2019,41,22,32,21,0,3ro,2,0,20,0,0,19,9,0,39,0,0,0
70417,4986,2020-11-18T16:21:13.0337243Z,2019,49,22,40,22,0,4to,3,0,27,0,0,27,9,0,46,0,0,0
70417,4987,2020-11-18T16:21:13.0337243Z,2019,50,22,34,25,0,5to,1,0,25,0,0,28,16,0,49,0,0,0
70417,4988,2020-11-18T16:21:13.0347252Z,2019,87,33,75,41,0,6to,1,0,46,0,0,54,12,0,86,0,0,0
70417,4989,2020-11-18T16:21:13.0347252Z,2019,61,22,43,30,0,7mo,0,0,31,0,0,39,18,0,61,0,0,0
70417,4990,2020-11-18T16:21:13.0347252Z,2019,63,29,45,32,0,8vo,1,1,31,0,0,34,18,0,62,0,0,0
70417,4991,2020-11-18T16:21:13.0347252Z,2019,32,8,21,25,0,K,1,0,7,0,0,24,11,0,31,0,0,0
70417,4992,2020-11-18T16:21:13.0347252Z,2019,46,43,32,9,0,Sin Grado,1,0,37,0,0,3,14,0,45,0,1,0
61762,10371,2020-11-18T16:22:03.7235237Z,2020,67,17,49,39,0,10mo,6,0,28,0,0,50,18,0,61,0,0,0
61762,10372,2020-11-18T16:22:03.7235237Z,2020,74,16,47,39,0,11mo,2,0,35,0,0,58,27,0,71,0,0,1
61762,10373,2020-11-18T16:22:03.7235237Z,2020,58,12,44,42,0,12mo,2,0,16,0,0,46,14,0,56,0,0,0
61762,10374,2020-11-18T16:22:03.7235237Z,2020,37,2,33,22,0,9no,1,0,15,0,0,35,4,0,36,0,0,0
61762,34386,2021-06-24T13:18:38.6401636Z,2021,37,1,29,21,0,10mo,1,0,16,0,0,36,8,0,36,0,0,0
61762,34387,2021-06-24T13:18:38.6401636Z,2021,64,14,46,37,0,11mo,7,1,27,0,0,50,18,0,57,0,0,0
61762,34388,2021-06-24T13:18:38.6401636Z,2021,69,14,49,37,0,12mo,2,0,32,0,0,55,20,0,66,0,0,1
61762,34389,2021-06-24T13:18:38.6401636Z,2021,19,6,12,7,0,9no,1,0,12,0,0,13,7,0,18,0,0,0
61762,4358,2020-11-18T16:21:09.6994984Z,2019,80,18,57,41,0,10mo,2,0,39,0,0,62,23,1,76,0,0,1
61762,4359,2020-11-18T16:21:09.6994984Z,2019,60,12,45,43,0,11mo,3,0,17,0,0,48,15,0,57,0,0,0
61762,4360,2020-11-18T16:21:09.7004984Z,2019,51,0,37,34,0,12mo,4,0,17,0,0,51,14,0,47,0,0,0
61762,4361,2020-11-18T16:21:09.7004984Z,2019,61,14,46,32,0,9no,5,0,29,0,0,47,15,0,56,0,0,0
70763,11130,2020-11-18T16:22:08.3215892Z,2020,100,26,94,74,0,1ro,2,0,26,0,0,74,6,0,98,0,0,0
70763,11131,2020-11-18T16:22:08.3215892Z,2020,85,26,81,44,0,2do,5,0,41,0,0,59,4,0,80,0,0,0
70763,11132,2020-11-18T16:22:08.3225897Z,2020,73,28,69,34,0,3ro,2,0,39,0,0,45,4,0,71,0,0,0
70763,11133,2020-11-18T16:22:08.3225897Z,2020,93,30,89,44,0,4to,3,0,49,0,0,63,4,0,90,0,0,0
70763,11134,2020-11-18T16:22:08.3225897Z,2020,71,19,70,44,0,5to,2,0,27,0,0,52,1,0,69,0,0,0
70763,11135,2020-11-18T16:22:08.3235906Z,2020,73,17,71,33,0,K,0,0,40,0,0,56,2,0,73,0,0,0
70763,11136,2020-11-18T16:22:08.3235906Z,2020,27,27,26,6,0,Sin Grado,1,0,21,0,0,0,1,0,26,0,0,0
70763,35151,2021-06-24T13:18:44.4983642Z,2021,71,22,68,33,0,1ro,0,0,38,0,0,49,3,0,71,0,0,0
70763,35152,2021-06-24T13:18:44.4993643Z,2021,91,30,87,51,0,2do,1,0,40,0,0,61,4,0,90,0,0,0
70763,35153,2021-06-24T13:18:44.4993643Z,2021,81,26,76,41,0,3ro,4,0,40,0,0,55,5,1,76,0,0,0
70763,35154,2021-06-24T13:18:44.4993643Z,2021,68,25,65,30,0,4to,2,0,38,0,0,43,3,0,66,0,0,0
70763,35155,2021-06-24T13:18:44.4993643Z,2021,86,28,83,38,0,5to,3,0,48,0,0,58,3,0,83,0,0,0
70763,35156,2021-06-24T13:18:44.5003648Z,2021,57,10,53,30,0,K,0,0,27,0,0,47,4,0,57,0,0,0
70763,35157,2021-06-24T13:18:44.5003648Z,2021,21,20,19,4,0,Sin Grado,0,0,17,0,0,1,2,0,21,0,0,0
70763,5124,2020-11-18T16:21:14.0263863Z,2019,86,33,82,45,0,1ro,3,0,41,0,0,53,4,0,83,0,0,0
70763,5125,2020-11-18T16:21:14.0263863Z,2019,86,34,78,36,0,2do,2,0,50,0,0,52,8,0,84,0,0,0
70763,5126,2020-11-18T16:21:14.0263863Z,2019,88,30,82,40,0,3ro,2,0,48,0,0,58,6,0,86,0,0,0
70763,5127,2020-11-18T16:21:14.0273868Z,2019,80,21,77,45,0,4to,1,0,35,0,0,59,3,0,79,0,0,0
70763,5128,2020-11-18T16:21:14.0273868Z,2019,95,27,84,48,0,5to,3,0,47,0,0,68,11,0,92,0,0,0
70763,5129,2020-11-18T16:21:14.0273868Z,2019,88,21,84,66,0,K,0,0,22,0,0,67,4,0,88,0,0,0
70763,5130,2020-11-18T16:21:14.0283881Z,2019,25,23,22,7,0,Sin Grado,1,0,18,0,0,2,3,0,24,0,0,0
32243,2005,2020-11-18T16:20:53.8889547Z,2019,46,8,43,24,0,1ro,1,0,22,0,0,38,3,0,45,0,0,0
32243,2006,2020-11-18T16:20:53.8889547Z,2019,50,17,46,18,1,2do,0,0,32,0,0,33,4,0,49,0,1,1
32243,2007,2020-11-18T16:20:53.8889547Z,2019,49,18,44,26,0,3ro,0,0,23,0,0,31,5,0,49,0,1,0
32243,2008,2020-11-18T16:20:53.8889547Z,2019,59,18,57,27,0,4to,0,0,32,0,0,41,2,0,59,0,0,0
32243,2009,2020-11-18T16:20:53.8889547Z,2019,54,10,46,26,0,5to,0,0,28,0,0,44,8,0,54,0,0,0
32243,2010,2020-11-18T16:20:53.889956Z,2019,45,12,42,26,0,K,0,0,19,0,0,33,3,0,44,0,0,1
32243,2011,2020-11-18T16:20:53.889956Z,2019,14,11,13,5,0,Sin Grado,0,0,9,0,0,3,1,0,14,0,0,0
32243,32012,2021-06-24T13:18:20.0728435Z,2021,34,5,31,17,0,1ro,0,0,17,0,0,29,3,0,34,0,0,0
32243,32013,2021-06-24T13:18:20.0748449Z,2021,44,18,39,25,0,2do,0,0,19,0,0,26,5,0,42,0,0,2
32243,32014,2021-06-24T13:18:20.0748449Z,2021,48,12,46,26,0,3ro,0,0,22,0,0,36,2,0,48,0,0,0
32243,32015,2021-06-24T13:18:20.0758463Z,2021,37,12,30,12,0,4to,0,0,25,0,0,25,7,0,35,0,1,2
32243,32016,2021-06-24T13:18:20.0758463Z,2021,45,15,38,21,0,5to,0,0,24,0,0,30,7,0,45,0,1,0
32243,32017,2021-06-24T13:18:20.0758463Z,2021,24,6,21,9,0,K,0,0,15,0,0,18,3,0,24,0,0,0
32243,32018,2021-06-24T13:18:20.0768468Z,2021,6,6,5,2,0,Sin Grado,0,0,4,0,0,0,1,0,6,0,0,0
32243,8016,2020-11-18T16:21:49.5520763Z,2020,49,17,44,27,0,1ro,0,0,22,0,0,32,5,0,48,0,0,1
32243,8017,2020-11-18T16:21:49.5520763Z,2020,47,13,45,27,0,2do,0,0,20,0,0,34,2,0,47,0,0,0
32243,8018,2020-11-18T16:21:49.5530768Z,2020,41,12,37,17,0,3ro,0,0,24,0,0,29,4,0,40,0,1,1
32243,8019,2020-11-18T16:21:49.5530768Z,2020,47,17,44,23,0,4to,0,0,24,0,0,30,3,0,47,0,1,0
32243,8020,2020-11-18T16:21:49.5530768Z,2020,54,15,51,26,0,5to,0,0,28,0,0,39,3,0,54,0,0,0
32243,8021,2020-11-18T16:21:49.5530768Z,2020,40,5,38,18,0,K,0,1,22,0,0,35,2,0,40,0,0,0
32243,8022,2020-11-18T16:21:49.5540768Z,2020,20,19,17,9,0,Sin Grado,0,0,11,0,0,1,3,0,20,0,0,0
62612,10459,2020-11-18T16:22:04.1448054Z,2020,35,8,31,23,0,1ro,0,1,12,0,0,27,4,0,35,0,0,0
62612,10460,2020-11-18T16:22:04.1448054Z,2020,44,10,41,21,0,2do,4,1,23,0,0,34,3,0,40,0,0,0
62612,10461,2020-11-18T16:22:04.1458072Z,2020,43,13,39,25,0,3ro,2,0,18,0,0,30,4,0,41,0,0,0
62612,10462,2020-11-18T16:22:04.1458072Z,2020,44,12,42,19,0,4to,1,2,25,0,0,32,2,0,42,0,0,1
62612,10463,2020-11-18T16:22:04.1458072Z,2020,44,16,43,21,0,5to,1,0,23,0,0,28,1,0,43,0,0,0
62612,10464,2020-11-18T16:22:04.1468067Z,2020,47,16,30,18,0,K,2,1,29,0,0,31,17,0,45,0,0,0
62612,10465,2020-11-18T16:22:04.1468067Z,2020,23,21,21,10,0,Sin Grado,2,0,13,0,0,2,2,0,21,0,0,0
62612,34472,2021-06-24T13:18:39.4897721Z,2021,44,14,39,16,0,1ro,2,0,28,0,0,30,5,0,42,0,0,0
62612,34473,2021-06-24T13:18:39.4907735Z,2021,43,12,37,29,0,2do,0,0,14,0,0,31,6,0,43,0,0,0
62612,34474,2021-06-24T13:18:39.4907735Z,2021,42,12,37,20,0,3ro,4,0,22,0,0,30,5,0,38,0,0,0
62612,34475,2021-06-24T13:18:39.4907735Z,2021,39,10,36,23,0,4to,2,0,16,0,0,29,3,0,36,0,0,1
62612,34476,2021-06-24T13:18:39.4907735Z,2021,50,13,47,25,0,5to,2,1,25,0,0,37,3,0,47,0,0,1
62612,34477,2021-06-24T13:18:39.4917736Z,2021,47,15,38,24,0,K,0,0,23,0,0,32,9,1,46,0,0,0
62612,34478,2021-06-24T13:18:39.4917736Z,2021,19,17,16,7,0,Sin Grado,1,0,12,0,0,2,3,0,18,0,0,0
62612,4447,2020-11-18T16:21:10.1387911Z,2019,46,11,44,26,0,1ro,1,1,20,0,0,35,2,0,45,0,0,0
62612,4448,2020-11-18T16:21:10.1387911Z,2019,49,12,48,27,0,2do,2,0,22,0,0,37,1,0,47,0,0,0
62612,4449,2020-11-18T16:21:10.1387911Z,2019,52,18,50,26,0,3ro,1,0,26,0,0,34,2,0,50,0,0,1
62612,4450,2020-11-18T16:21:10.139792Z,2019,49,16,47,24,0,4to,1,0,25,0,0,33,2,0,48,0,0,0
62612,4451,2020-11-18T16:21:10.139792Z,2019,59,25,54,27,0,5to,6,0,32,0,0,34,5,0,53,0,0,0
62612,4452,2020-11-18T16:21:10.139792Z,2019,1,0,1,0,0,6to,0,0,1,0,0,1,0,0,1,0,0,0
62612,4453,2020-11-18T16:21:10.140792Z,2019,33,10,29,25,0,K,0,1,8,0,0,23,4,0,33,0,0,0
62612,4454,2020-11-18T16:21:10.140792Z,2019,26,24,25,5,0,Sin Grado,2,0,21,0,0,2,1,0,24,0,0,0
71746,11423,2020-11-18T16:22:10.5680892Z,2020,46,21,37,24,0,1ro,0,0,22,0,0,25,9,0,46,0,0,0
71746,11424,2020-11-18T16:22:10.5680892Z,2020,57,25,49,34,0,2do,0,0,23,0,0,32,8,0,56,0,0,1
71746,11425,2020-11-18T16:22:10.5680892Z,2020,43,21,39,22,0,3ro,2,0,21,0,0,22,4,0,41,0,0,0
71746,11426,2020-11-18T16:22:10.5680892Z,2020,40,12,30,22,0,4to,0,0,18,0,0,28,10,0,40,0,1,0
71746,11427,2020-11-18T16:22:10.5690897Z,2020,57,27,44,29,0,5to,0,0,28,0,0,30,13,0,57,0,0,0
71746,11428,2020-11-18T16:22:10.5690897Z,2020,38,7,30,15,0,K,0,0,23,0,0,31,8,0,38,0,0,0
71746,35445,2021-06-24T13:18:46.2416138Z,2021,41,10,36,16,0,1ro,0,0,25,0,0,31,5,0,41,0,0,0
71746,35446,2021-06-24T13:18:46.2416138Z,2021,46,24,39,25,0,2do,0,0,21,0,0,22,7,0,46,0,0,0
71746,35447,2021-06-24T13:18:46.2416138Z,2021,51,24,46,29,0,3ro,0,0,22,0,0,27,5,0,50,0,2,1
71746,35448,2021-06-24T13:18:46.2426147Z,2021,39,23,35,21,0,4to,1,0,18,0,0,16,4,0,38,0,0,0
71746,35449,2021-06-24T13:18:46.2426147Z,2021,43,12,33,25,0,5to,0,0,18,0,0,31,10,0,43,0,1,0
71746,35450,2021-06-24T13:18:46.2426147Z,2021,49,12,45,23,0,K,0,0,26,0,0,37,4,0,49,0,0,0
71746,5414,2020-11-18T16:21:15.4753491Z,2019,59,24,49,35,0,1ro,0,1,24,0,0,35,10,0,58,0,0,1
71746,5415,2020-11-18T16:21:15.4753491Z,2019,40,20,36,19,0,2do,1,0,21,0,0,20,4,0,39,0,0,0
71746,5416,2020-11-18T16:21:15.4753491Z,2019,42,10,29,24,0,3ro,1,0,18,0,0,32,13,0,41,0,1,0
71746,5417,2020-11-18T16:21:15.4753491Z,2019,53,24,41,25,0,4to,0,0,28,0,0,29,12,0,53,0,0,0
71746,5418,2020-11-18T16:21:15.47635Z,2019,38,14,34,17,0,5to,0,0,21,0,0,24,4,0,38,0,0,0
71746,5419,2020-11-18T16:21:15.47635Z,2019,45,18,35,25,0,K,0,0,20,0,0,27,10,0,45,0,0,0
72058,11464,2020-11-18T16:22:10.5800973Z,2020,47,22,40,20,0,1ro,0,0,27,0,0,25,7,0,47,0,0,0
72058,11465,2020-11-18T16:22:10.5800973Z,2020,48,17,42,26,0,2do,1,0,22,0,0,31,6,0,45,0,0,2
72058,11466,2020-11-18T16:22:10.5810977Z,2020,46,18,39,19,0,3ro,1,0,27,0,0,28,7,0,45,0,0,0
72058,11467,2020-11-18T16:22:10.5810977Z,2020,44,14,37,22,0,4to,1,0,22,0,0,30,7,0,43,0,0,0
72058,11468,2020-11-18T16:22:10.5810977Z,2020,68,21,61,37,0,5to,2,0,31,0,0,47,7,0,66,0,0,0
72058,11469,2020-11-18T16:22:10.5810977Z,2020,51,10,47,21,0,K,1,0,30,0,0,41,4,0,50,0,0,0
72058,11470,2020-11-18T16:22:10.5810977Z,2020,7,6,7,4,0,Sin Grado,1,0,3,0,0,1,0,0,6,0,0,0
72058,35485,2021-06-24T13:18:46.2556243Z,2021,45,10,39,18,0,1ro,0,0,27,0,0,35,6,0,45,0,0,0
72058,35486,2021-06-24T13:18:46.2566248Z,2021,45,19,44,17,0,2do,0,0,28,0,0,26,1,0,43,0,0,2
72058,35487,2021-06-24T13:18:46.2566248Z,2021,41,16,36,22,0,3ro,1,0,19,0,0,25,5,0,40,0,0,0
72058,35488,2021-06-24T13:18:46.2566248Z,2021,41,13,33,16,0,4to,2,0,25,0,0,28,8,0,39,0,0,0
72058,35489,2021-06-24T13:18:46.2576257Z,2021,33,8,26,16,0,5to,0,0,17,0,0,25,7,0,33,0,0,0
72058,35490,2021-06-24T13:18:46.2576257Z,2021,31,5,25,20,0,K,2,0,11,0,0,26,6,0,29,0,0,0
72058,35491,2021-06-24T13:18:46.2576257Z,2021,8,8,8,4,0,Sin Grado,1,0,4,0,0,0,0,0,7,0,0,0
72058,5454,2020-11-18T16:21:15.4873571Z,2019,42,14,35,20,0,1ro,2,0,22,0,0,28,7,0,38,0,0,2
72058,5455,2020-11-18T16:21:15.4873571Z,2019,44,12,36,16,0,2do,1,0,28,0,0,32,8,0,43,0,0,0
72058,5456,2020-11-18T16:21:15.4873571Z,2019,47,15,38,22,0,3ro,0,0,25,0,0,32,9,0,47,0,0,0
72058,5457,2020-11-18T16:21:15.4873571Z,2019,68,18,59,33,0,4to,0,1,35,0,0,50,9,0,68,0,0,0
72058,5458,2020-11-18T16:21:15.488358Z,2019,68,19,59,40,0,5to,0,0,28,0,0,49,9,0,68,0,0,0
72058,5459,2020-11-18T16:21:15.488358Z,2019,51,18,45,24,0,K,0,0,27,0,0,33,6,0,51,0,0,0
72058,5460,2020-11-18T16:21:15.488358Z,2019,6,5,6,2,0,Sin Grado,1,0,4,0,0,1,0,0,5,0,0,0
61549,10279,2020-11-18T16:22:03.1351302Z,2020,30,10,22,17,0,1ro,1,0,13,0,0,20,8,0,29,0,0,0
61549,10280,2020-11-18T16:22:03.1351302Z,2020,34,13,29,20,0,2do,1,1,14,0,0,21,5,0,33,0,0,0
61549,10281,2020-11-18T16:22:03.1351302Z,2020,36,14,28,17,0,3ro,1,0,19,0,0,22,8,0,35,0,0,0
61549,10282,2020-11-18T16:22:03.1361311Z,2020,43,12,33,20,0,4to,2,2,23,0,0,31,10,0,41,0,0,0
61549,10283,2020-11-18T16:22:03.1361311Z,2020,34,13,25,16,0,5to,0,1,18,0,0,21,9,0,34,0,0,0
61549,10284,2020-11-18T16:22:03.1361311Z,2020,45,21,37,17,0,K,1,1,28,0,0,24,8,0,44,0,0,0
61549,10285,2020-11-18T16:22:03.1361311Z,2020,4,4,1,0,0,Sin Grado,0,0,4,0,0,0,3,0,4,0,0,0
61549,34294,2021-06-24T13:18:38.1217914Z,2021,43,17,37,18,0,1ro,1,0,25,0,0,26,6,0,42,0,0,0
61549,34295,2021-06-24T13:18:38.1217914Z,2021,32,12,27,16,0,2do,1,0,16,0,0,20,5,0,31,0,0,0
61549,34296,2021-06-24T13:18:38.1227919Z,2021,36,11,32,21,0,3ro,1,0,15,0,0,25,4,0,35,0,0,0
61549,34297,2021-06-24T13:18:38.1227919Z,2021,41,15,34,20,0,4to,0,0,21,0,0,26,7,0,41,0,0,0
61549,34298,2021-06-24T13:18:38.1227919Z,2021,43,12,34,21,0,5to,1,2,22,0,0,31,9,0,42,0,0,0
61549,34299,2021-06-24T13:18:38.1227919Z,2021,29,9,24,14,0,K,0,0,15,0,0,20,5,0,29,0,0,0
61549,34300,2021-06-24T13:18:38.5841234Z,2021,3,3,1,0,0,Sin Grado,1,0,3,0,0,0,2,0,2,0,0,0
61549,4265,2020-11-18T16:21:09.0290539Z,2019,44,17,34,25,0,1ro,1,0,19,0,0,27,10,0,43,0,0,0
61549,4266,2020-11-18T16:21:09.0290539Z,2019,35,12,28,15,0,2do,1,0,20,0,0,23,7,0,33,0,0,1
61549,4267,2020-11-18T16:21:09.0290539Z,2019,48,15,41,22,0,3ro,1,0,26,0,0,33,7,0,47,0,0,0
61549,4268,2020-11-18T16:21:09.0290539Z,2019,37,13,27,19,0,4to,0,0,18,0,0,24,10,0,37,0,0,0
61549,4269,2020-11-18T16:21:09.0290539Z,2019,42,11,37,24,0,5to,3,0,18,0,0,31,5,0,39,2,1,0
61549,4270,2020-11-18T16:21:09.0300547Z,2019,30,12,21,15,0,K,1,0,15,0,0,18,9,0,29,0,0,0
61549,4271,2020-11-18T16:21:09.0300547Z,2019,4,4,2,0,0,Sin Grado,0,0,4,0,0,0,2,0,4,0,0,0
51870,33493,2021-06-24T13:18:32.4907539Z,2021,87,19,76,45,0,6to,1,0,42,0,0,68,11,0,86,0,0,0
51870,33494,2021-06-24T13:18:32.4907539Z,2021,86,14,72,46,0,7mo,1,0,40,0,0,72,14,0,85,0,0,0
51870,33495,2021-06-24T13:18:32.4907539Z,2021,91,29,73,35,0,8vo,1,0,56,0,0,62,18,0,90,0,0,0
51870,33496,2021-06-24T13:18:32.4917539Z,2021,36,33,33,15,0,Sin Grado,0,0,21,0,0,3,3,0,36,0,0,0
51870,3467,2020-11-18T16:21:02.5627426Z,2019,88,29,64,36,0,6to,2,0,52,0,0,59,24,0,86,0,0,0
51870,3468,2020-11-18T16:21:02.563743Z,2019,119,36,98,61,0,7mo,1,1,58,0,0,83,21,0,118,0,0,0
51870,3469,2020-11-18T16:21:02.563743Z,2019,125,36,91,63,0,8vo,1,1,62,0,0,89,34,0,124,0,0,0
51870,3470,2020-11-18T16:21:02.563743Z,2019,40,31,38,11,0,Sin Grado,0,0,29,0,0,9,2,0,40,0,0,0
51870,9488,2020-11-18T16:21:58.4500068Z,2020,82,17,68,42,0,6to,0,1,40,0,0,65,14,0,82,0,0,0
51870,9489,2020-11-18T16:21:58.4500068Z,2020,92,31,69,37,0,7mo,1,3,55,0,0,61,23,0,91,0,0,0
51870,9490,2020-11-18T16:21:58.4500068Z,2020,110,28,89,60,0,8vo,1,5,50,0,0,82,21,0,109,0,0,0
51870,9491,2020-11-18T16:21:58.4510068Z,2020,42,37,42,9,0,Sin Grado,0,1,33,0,0,5,0,0,42,0,0,0
61705,10358,2020-11-18T16:22:03.7205211Z,2020,26,11,21,15,0,10mo,6,0,11,0,0,15,5,0,20,0,0,0
61705,10359,2020-11-18T16:22:03.7205211Z,2020,38,11,34,23,0,11mo,11,0,15,0,0,27,4,0,27,0,0,0
61705,10360,2020-11-18T16:22:03.7205211Z,2020,40,10,37,18,0,12mo,18,0,22,0,0,30,3,1,21,0,0,0
61705,10361,2020-11-18T16:22:03.7205211Z,2020,46,17,40,19,0,7mo,5,0,27,0,0,29,6,0,41,0,0,0
61705,10362,2020-11-18T16:22:03.7215224Z,2020,61,20,47,36,0,8vo,6,1,25,0,0,41,14,0,55,0,0,0
61705,10363,2020-11-18T16:22:03.7215224Z,2020,64,19,58,24,0,9no,8,0,40,0,0,45,6,0,56,0,0,0
61705,34373,2021-06-24T13:18:38.629155Z,2021,53,16,50,19,0,10mo,5,0,34,0,0,37,3,0,48,0,0,0
61705,34374,2021-06-24T13:18:38.6301555Z,2021,25,7,19,14,0,11mo,4,0,11,0,0,18,6,0,21,0,0,0
61705,34375,2021-06-24T13:18:38.6301555Z,2021,29,8,23,19,0,12mo,11,0,10,0,0,21,6,0,18,0,0,0
61705,34376,2021-06-24T13:18:38.6301555Z,2021,29,13,27,15,0,7mo,4,0,14,0,0,16,2,0,25,0,0,0
61705,34377,2021-06-24T13:18:38.6301555Z,2021,48,20,41,19,0,8vo,5,0,29,0,0,28,7,0,43,0,0,0
61705,34378,2021-06-24T13:18:38.631156Z,2021,60,20,49,33,0,9no,6,0,27,0,0,40,11,0,53,0,0,1
61705,4345,2020-11-18T16:21:09.6974967Z,2019,35,11,32,16,0,10mo,11,0,19,0,0,24,3,0,24,0,0,0
61705,4346,2020-11-18T16:21:09.6984967Z,2019,40,10,36,17,0,11mo,17,0,23,0,0,30,4,1,22,0,0,0
61705,4347,2020-11-18T16:21:09.6984967Z,2019,43,0,35,28,0,12mo,7,0,15,0,0,43,8,0,36,0,0,0
61705,4348,2020-11-18T16:21:09.6984967Z,2019,61,23,46,31,0,7mo,4,0,30,0,0,38,15,0,57,0,0,0
61705,4349,2020-11-18T16:21:09.6994984Z,2019,80,22,73,37,0,8vo,10,0,43,0,0,58,7,0,70,0,0,0
61705,4350,2020-11-18T16:21:09.6994984Z,2019,30,14,24,17,0,9no,7,0,13,0,0,16,6,0,23,0,0,0
42390,2772,2020-11-18T16:20:58.7582016Z,2019,50,14,47,30,0,1ro,0,0,20,0,0,36,3,0,50,0,0,0
42390,2773,2020-11-18T16:20:58.7582016Z,2019,45,13,37,25,0,2do,1,0,20,0,0,32,8,0,44,0,0,0
42390,2774,2020-11-18T16:20:58.7582016Z,2019,34,15,26,13,0,3ro,0,0,21,0,0,19,8,0,34,0,1,0
42390,2775,2020-11-18T16:20:58.7582016Z,2019,34,13,26,18,0,4to,2,0,16,0,1,21,8,0,32,0,0,0
42390,2776,2020-11-18T16:20:58.7592011Z,2019,40,13,34,26,0,5to,0,0,14,0,1,27,6,0,40,1,1,0
42390,2777,2020-11-18T16:20:58.7592011Z,2019,48,15,41,29,0,K,0,0,19,0,0,33,7,0,48,0,0,0
42390,2778,2020-11-18T16:20:58.7592011Z,2019,9,9,4,2,0,Sin Grado,0,1,7,0,0,0,5,0,9,0,0,0
42390,32778,2021-06-24T13:18:27.1909532Z,2021,35,14,27,15,0,1ro,1,0,20,0,0,21,8,0,34,0,0,0
42390,32779,2021-06-24T13:18:27.1909532Z,2021,46,12,40,25,0,2do,0,0,21,0,0,34,6,0,46,0,0,0
42390,32780,2021-06-24T13:18:27.1909532Z,2021,47,14,44,26,0,3ro,1,0,21,0,0,33,3,0,46,0,0,0
42390,32781,2021-06-24T13:18:27.1919546Z,2021,38,9,31,23,0,4to,0,0,15,0,0,29,7,0,38,0,0,0
42390,32782,2021-06-24T13:18:27.1919546Z,2021,29,14,26,9,0,5to,0,0,20,0,0,15,3,0,29,0,0,0
42390,32783,2021-06-24T13:18:27.1919546Z,2021,40,15,31,21,0,K,0,0,19,0,0,25,9,0,39,0,0,1
42390,32784,2021-06-24T13:18:27.1929546Z,2021,5,5,2,1,0,Sin Grado,0,0,4,0,0,0,3,0,5,0,0,0
42390,8782,2020-11-18T16:21:53.8189199Z,2020,43,13,38,23,0,1ro,0,0,20,0,0,30,5,0,43,0,0,0
42390,8783,2020-11-18T16:21:53.8189199Z,2020,49,9,46,28,0,2do,0,0,21,0,0,40,3,0,49,0,0,0
42390,8784,2020-11-18T16:21:53.8199204Z,2020,43,11,35,25,0,3ro,1,0,18,0,0,32,8,0,42,0,0,0
42390,8785,2020-11-18T16:21:53.8199204Z,2020,31,15,26,11,0,4to,0,0,20,0,0,16,5,0,31,0,0,0
42390,8786,2020-11-18T16:21:53.8199204Z,2020,35,14,31,16,0,5to,3,0,19,0,0,21,4,0,32,0,0,0
42390,8787,2020-11-18T16:21:53.8199204Z,2020,32,12,28,14,0,K,1,0,18,0,0,20,4,0,31,0,0,0
42390,8788,2020-11-18T16:21:53.8209208Z,2020,12,12,12,3,0,Sin Grado,0,0,9,0,0,0,0,0,12,0,0,0
75705,11563,2020-11-18T16:22:11.3205919Z,2020,59,17,49,27,0,6to,1,14,32,0,0,42,10,0,58,1,0,0
75705,11564,2020-11-18T16:22:11.3205919Z,2020,69,26,61,36,0,7mo,0,13,33,0,0,43,8,0,69,1,0,0
75705,11565,2020-11-18T16:22:11.3215937Z,2020,115,45,97,56,0,8vo,3,21,59,0,0,70,18,1,111,0,0,0
75705,11566,2020-11-18T16:22:11.3215937Z,2020,12,11,11,5,0,Sin Grado,0,3,7,0,0,1,1,0,12,0,0,0
75705,35586,2021-06-24T13:18:46.5978688Z,2021,64,23,57,32,0,6to,0,0,32,0,0,41,7,0,64,0,0,0
75705,35587,2021-06-24T13:18:46.5978688Z,2021,62,19,56,31,0,7mo,1,0,31,0,0,43,6,0,61,1,0,0
75705,35588,2021-06-24T13:18:46.5978688Z,2021,75,26,72,39,0,8vo,2,0,36,0,0,49,3,0,73,1,0,0
75705,35589,2021-06-24T13:18:46.5978688Z,2021,22,20,21,7,0,Sin Grado,0,0,15,0,0,2,1,0,22,0,0,0
75705,5555,2020-11-18T16:21:16.1858246Z,2019,79,31,67,39,0,6to,0,3,40,0,0,48,12,0,79,1,0,0
75705,5556,2020-11-18T16:21:16.1858246Z,2019,105,43,85,55,0,7mo,3,3,50,0,0,62,20,1,101,0,0,0
75705,5557,2020-11-18T16:21:16.1868255Z,2019,120,42,107,60,0,8vo,1,2,60,0,0,78,13,1,118,8,0,0
75705,5558,2020-11-18T16:21:16.1868255Z,2019,10,8,10,5,0,Sin Grado,0,1,5,0,0,2,0,0,10,0,0,0
31302,1945,2020-11-18T16:20:53.3976282Z,2019,112,28,97,59,0,6to,2,0,53,0,0,84,15,0,110,2,0,0
31302,1946,2020-11-18T16:20:53.3976282Z,2019,125,34,94,64,0,7mo,3,0,61,0,0,91,31,0,121,0,0,1
31302,1947,2020-11-18T16:20:53.3976282Z,2019,131,18,104,70,0,8vo,2,1,61,0,0,113,27,0,129,1,2,0
31302,1948,2020-11-18T16:20:53.3976282Z,2019,17,16,14,6,0,Sin Grado,0,0,11,0,0,1,3,0,17,0,0,0
31302,31954,2021-06-24T13:18:18.6818452Z,2021,86,14,73,43,0,6to,1,0,43,0,0,72,13,1,84,0,0,0
31302,31955,2021-06-24T13:18:18.6818452Z,2021,103,22,81,55,0,7mo,4,0,48,0,0,81,22,0,98,0,1,1
31302,31956,2021-06-24T13:18:18.6818452Z,2021,103,22,92,56,0,8vo,2,0,47,0,0,81,11,0,101,2,0,0
31302,31957,2021-06-24T13:18:18.6818452Z,2021,11,11,11,2,0,Sin Grado,0,0,9,0,0,0,0,0,11,0,0,0
31302,7957,2020-11-18T16:21:49.1327951Z,2020,101,21,86,57,0,6to,3,1,44,0,0,80,15,0,98,0,1,0
31302,7958,2020-11-18T16:21:49.1327951Z,2020,104,23,92,58,0,7mo,1,0,46,0,0,81,12,0,103,2,0,0
31302,7959,2020-11-18T16:21:49.133796Z,2020,111,25,86,57,0,8vo,3,0,54,0,0,86,25,0,108,0,0,0
31302,7960,2020-11-18T16:21:49.133796Z,2020,11,11,8,4,0,Sin Grado,0,0,7,0,0,0,3,0,11,0,0,0
20255,30906,2021-06-24T13:18:11.8109192Z,2021,38,3,16,25,0,10mo,0,1,13,0,0,35,22,0,38,0,1,0
20255,30907,2021-06-24T13:18:11.8109192Z,2021,19,3,7,7,0,11mo,0,0,12,0,0,16,12,0,19,0,0,0
20255,30908,2021-06-24T13:18:11.8119193Z,2021,20,1,5,9,0,12mo,1,0,11,0,0,19,15,0,19,2,2,0
20255,30909,2021-06-24T13:18:11.8119193Z,2021,23,3,13,14,0,1ro,0,0,9,0,0,20,10,0,22,0,0,1
20255,30910,2021-06-24T13:18:11.8119193Z,2021,24,1,9,15,0,2do,1,0,9,0,0,23,15,0,23,1,0,0
20255,30911,2021-06-24T13:18:11.8129198Z,2021,24,2,12,13,0,3ro,1,0,11,0,0,22,12,0,23,0,0,0
20255,30912,2021-06-24T13:18:11.8129198Z,2021,24,0,12,16,0,4to,0,0,8,0,0,24,12,0,24,1,0,0
20255,30913,2021-06-24T13:18:11.8129198Z,2021,23,0,14,12,0,5to,0,0,11,0,0,23,9,0,23,1,0,0
20255,30914,2021-06-24T13:18:11.8139207Z,2021,97,23,65,52,0,6to,1,5,45,0,0,74,32,0,96,2,0,0
20255,30915,2021-06-24T13:18:11.8139207Z,2021,97,29,64,47,0,7mo,2,5,50,0,0,68,33,0,95,3,0,0
20255,30916,2021-06-24T13:18:11.8139207Z,2021,93,25,66,59,0,8vo,2,2,34,0,0,68,27,0,91,2,1,0
20255,30917,2021-06-24T13:18:11.8149221Z,2021,19,0,9,10,0,9no,0,0,9,0,0,19,10,0,19,0,0,0
20255,30918,2021-06-24T13:18:11.8149221Z,2021,22,1,13,14,0,K,0,0,8,0,0,21,9,0,22,0,0,0
20255,30919,2021-06-24T13:18:11.8149221Z,2021,15,15,13,6,0,Sin Grado,0,0,9,0,0,0,2,0,15,0,0,0
20255,6910,2020-11-18T16:21:42.5824257Z,2020,20,4,8,8,0,10mo,0,0,12,0,0,16,12,0,20,0,0,0
20255,6911,2020-11-18T16:21:42.5824257Z,2020,19,1,4,9,0,11mo,1,0,10,0,0,18,15,0,18,2,1,0
20255,6912,2020-11-18T16:21:42.5824257Z,2020,9,0,4,5,0,12mo,0,0,4,0,0,9,5,0,9,0,0,0
20255,6913,2020-11-18T16:21:42.5834293Z,2020,24,4,7,15,0,1ro,1,0,9,0,0,20,17,0,23,1,0,0
20255,6914,2020-11-18T16:21:42.5834293Z,2020,22,2,6,12,0,2do,1,0,10,0,0,20,16,0,21,0,0,0
20255,6915,2020-11-18T16:21:42.5834293Z,2020,23,0,5,15,0,3ro,0,0,8,0,0,23,18,0,23,1,0,0
20255,6916,2020-11-18T16:21:42.5834293Z,2020,24,0,9,13,0,4to,0,0,11,0,0,24,15,0,24,1,0,0
20255,6917,2020-11-18T16:21:42.5834293Z,2020,23,3,5,8,0,5to,0,0,15,0,0,20,18,0,23,1,0,0
20255,6918,2020-11-18T16:21:42.5844275Z,2020,105,32,69,50,0,6to,2,6,55,0,0,73,36,0,103,3,0,0
20255,6919,2020-11-18T16:21:42.5844275Z,2020,89,25,51,55,0,7mo,3,2,34,0,0,64,38,0,86,2,0,0
20255,6920,2020-11-18T16:21:42.5844275Z,2020,86,20,38,39,0,8vo,0,4,47,0,0,66,48,0,86,1,0,0
20255,6921,2020-11-18T16:21:42.5844275Z,2020,42,3,12,27,0,9no,0,1,15,0,0,39,30,0,42,0,1,0
20255,6922,2020-11-18T16:21:42.5844275Z,2020,19,2,4,11,0,K,0,0,8,0,0,17,15,0,18,0,0,1
20255,6923,2020-11-18T16:21:42.5854275Z,2020,17,17,14,5,0,Sin Grado,0,0,12,0,0,0,3,0,17,0,0,0
20255,909,2020-11-18T16:20:43.36894Z,2019,30,1,7,14,0,10mo,1,0,16,0,0,29,23,0,29,2,1,0
20255,910,2020-11-18T16:20:43.36894Z,2019,11,0,4,7,0,11mo,0,0,4,0,0,11,7,0,11,1,0,0
20255,911,2020-11-18T16:20:43.3699404Z,2019,5,0,1,3,0,12mo,0,0,2,0,0,5,4,0,5,0,0,0
20255,912,2020-11-18T16:20:43.3699404Z,2019,22,1,7,11,0,1ro,1,0,11,0,0,21,15,0,21,0,0,0
20255,913,2020-11-18T16:20:43.3699404Z,2019,24,2,9,16,0,2do,0,0,8,0,0,22,15,0,24,1,0,0
20255,914,2020-11-18T16:20:43.3699404Z,2019,23,1,13,12,0,3ro,0,0,11,0,0,22,10,0,23,1,0,0
20255,915,2020-11-18T16:20:43.3699404Z,2019,25,3,9,8,0,4to,1,0,17,0,0,22,16,0,24,1,0,0
20255,916,2020-11-18T16:20:43.3709409Z,2019,24,2,9,15,0,5to,0,0,9,0,1,22,15,0,24,1,0,0
20255,917,2020-11-18T16:20:43.3709409Z,2019,24,2,10,13,0,6to,0,0,11,0,0,22,14,0,24,0,0,0
20255,918,2020-11-18T16:20:43.3709409Z,2019,91,23,49,48,0,7mo,1,0,43,0,0,68,42,0,90,2,0,0
20255,919,2020-11-18T16:20:43.3719418Z,2019,121,25,78,68,0,8vo,1,0,53,0,1,96,43,0,120,0,1,0
20255,920,2020-11-18T16:20:43.3719418Z,2019,23,4,9,11,0,9no,0,0,12,0,0,19,14,0,23,0,0,0
20255,921,2020-11-18T16:20:43.3719418Z,2019,20,3,10,14,0,K,1,0,6,0,0,17,10,0,19,1,0,0
20255,922,2020-11-18T16:20:43.3719418Z,2019,17,15,12,8,0,Sin Grado,0,0,9,0,0,2,5,0,17,0,0,0
32268,2019,2020-11-18T16:20:53.8889547Z,2019,48,11,45,20,0,1ro,1,0,28,0,0,37,3,0,47,0,0,0
32268,2020,2020-11-18T16:20:53.889956Z,2019,41,9,38,21,0,2do,0,0,20,0,0,32,3,0,41,0,0,0
32268,2021,2020-11-18T16:20:53.889956Z,2019,40,6,36,21,0,3ro,1,0,19,0,0,34,4,0,39,0,0,0
32268,2022,2020-11-18T16:20:53.889956Z,2019,43,12,42,22,0,4to,2,0,21,0,0,31,1,0,41,0,0,0
32268,2023,2020-11-18T16:20:53.8909565Z,2019,53,14,48,28,0,5to,1,0,25,0,0,39,5,0,52,1,0,0
32268,2024,2020-11-18T16:20:53.8909565Z,2019,46,8,42,21,0,K,0,0,25,0,0,38,4,0,46,0,0,0
32268,32026,2021-06-24T13:18:20.0768468Z,2021,34,8,32,16,0,1ro,0,0,18,0,0,26,2,0,34,0,0,0
32268,32027,2021-06-24T13:18:20.0768468Z,2021,47,6,44,18,0,2do,0,0,29,0,0,41,3,0,47,0,0,0
32268,32028,2021-06-24T13:18:20.0778473Z,2021,43,6,41,20,0,3ro,0,0,23,0,0,37,2,0,43,0,0,0
32268,32029,2021-06-24T13:18:20.0798488Z,2021,46,10,42,28,0,4to,0,0,18,0,0,36,4,0,46,0,0,0
32268,32030,2021-06-24T13:18:20.0798488Z,2021,45,10,41,23,0,5to,1,0,22,0,0,35,4,0,44,0,0,0
32268,32031,2021-06-24T13:18:20.0808484Z,2021,24,5,21,10,0,K,1,0,14,0,0,19,3,0,23,0,0,0
32268,8030,2020-11-18T16:21:49.5570786Z,2020,50,6,44,21,0,1ro,0,0,29,0,0,44,6,0,50,0,0,0
32268,8031,2020-11-18T16:21:49.5570786Z,2020,48,10,45,20,0,2do,1,0,28,0,0,38,3,0,47,0,0,0
32268,8032,2020-11-18T16:21:49.5580803Z,2020,41,9,37,24,0,3ro,0,0,17,0,0,32,4,0,41,0,0,0
32268,8033,2020-11-18T16:21:49.5580803Z,2020,42,8,40,23,0,4to,2,1,19,0,0,34,2,0,40,0,0,0
32268,8034,2020-11-18T16:21:49.5590799Z,2020,43,11,42,19,0,5to,3,0,24,0,0,32,1,0,40,0,1,0
32268,8035,2020-11-18T16:21:49.5590799Z,2020,40,9,36,21,0,K,0,0,19,0,0,31,4,0,40,0,0,0
61499,10262,2020-11-18T16:22:03.1301267Z,2020,43,12,38,15,0,1ro,2,0,28,0,0,31,5,0,40,0,0,1
61499,10263,2020-11-18T16:22:03.1301267Z,2020,29,6,26,12,0,2do,3,0,17,0,0,23,3,0,26,0,0,0
61499,10264,2020-11-18T16:22:03.1311285Z,2020,34,7,32,23,0,3ro,3,0,11,0,0,27,2,0,31,0,0,0
61499,10265,2020-11-18T16:22:03.1311285Z,2020,34,10,31,21,0,4to,2,0,13,0,0,24,3,0,32,0,0,0
61499,10266,2020-11-18T16:22:03.1311285Z,2020,42,19,41,14,0,5to,1,0,28,0,0,23,1,0,41,0,0,0
61499,10267,2020-11-18T16:22:03.1311285Z,2020,50,14,40,27,0,K,1,0,23,0,0,36,10,0,49,0,0,0
61499,10268,2020-11-18T16:22:03.1311285Z,2020,6,6,6,2,0,Sin Grado,1,0,4,0,0,0,0,0,5,0,0,0
61499,34277,2021-06-24T13:18:38.1147866Z,2021,44,13,40,25,0,1ro,1,0,19,0,0,31,4,0,43,0,0,0
61499,34278,2021-06-24T13:18:38.1147866Z,2021,43,14,42,15,0,2do,2,1,28,0,0,29,1,0,41,0,0,0
61499,34279,2021-06-24T13:18:38.1147866Z,2021,30,9,28,16,0,3ro,3,0,14,0,0,21,2,0,27,0,0,0
61499,34280,2021-06-24T13:18:38.1157871Z,2021,32,9,30,21,0,4to,4,1,11,0,0,23,2,0,28,0,0,0
61499,34281,2021-06-24T13:18:38.1157871Z,2021,30,10,30,16,0,5to,2,0,14,0,0,20,0,0,28,0,0,0
61499,34282,2021-06-24T13:18:38.1157871Z,2021,35,7,31,15,0,K,2,0,20,0,0,28,4,0,33,0,0,0
61499,34283,2021-06-24T13:18:38.1157871Z,2021,4,4,4,1,0,Sin Grado,1,0,3,0,0,0,0,0,3,0,0,0
61499,4247,2020-11-18T16:21:09.0250508Z,2019,42,9,40,18,0,1ro,2,0,24,0,0,33,2,0,40,0,0,0
61499,4248,2020-11-18T16:21:09.0250508Z,2019,44,8,42,24,0,2do,3,0,20,0,0,36,2,0,40,0,0,1
61499,4249,2020-11-18T16:21:09.0250508Z,2019,38,15,38,20,0,3ro,2,0,18,0,0,23,0,0,36,0,0,0
61499,4250,2020-11-18T16:21:09.0250508Z,2019,50,18,48,22,0,4to,1,0,28,0,0,32,2,0,49,0,0,0
61499,4251,2020-11-18T16:21:09.0260525Z,2019,35,7,34,13,0,5to,2,0,22,0,0,28,1,0,33,0,0,0
61499,4252,2020-11-18T16:21:09.0260525Z,2019,47,12,45,25,0,K,1,0,22,0,0,35,2,0,45,0,0,1
61499,4253,2020-11-18T16:21:09.0260525Z,2019,11,10,11,2,0,Sin Grado,1,0,9,0,0,1,0,0,10,0,0,0
35816,2376,2020-11-18T16:20:55.7391913Z,2019,83,25,72,44,0,10mo,3,0,39,0,0,58,11,0,80,0,1,0
35816,2377,2020-11-18T16:20:55.7391913Z,2019,104,18,84,52,0,11mo,2,1,52,0,0,86,20,0,102,0,2,0
35816,2378,2020-11-18T16:20:55.7401913Z,2019,108,0,77,57,0,12mo,0,0,51,0,0,108,31,0,108,0,0,0
35816,2379,2020-11-18T16:20:55.7401913Z,2019,63,13,53,23,0,9no,0,0,40,0,0,50,10,0,63,0,0,0
35816,32383,2021-06-24T13:18:23.3511938Z,2021,87,29,75,30,0,10mo,5,0,57,0,0,58,12,0,82,0,0,0
35816,32384,2021-06-24T13:18:23.3511938Z,2021,36,9,31,14,0,11mo,0,0,22,0,0,27,5,0,36,0,0,0
35816,32385,2021-06-24T13:18:23.3511938Z,2021,75,20,59,42,0,12mo,2,0,33,0,0,55,16,0,73,0,1,0
35816,32386,2021-06-24T13:18:23.3511938Z,2021,66,24,56,35,0,9no,0,0,31,0,0,42,10,0,66,0,0,0
35816,8388,2020-11-18T16:21:51.413315Z,2020,41,9,35,16,0,10mo,0,0,25,0,0,32,6,0,41,0,0,0
35816,8389,2020-11-18T16:21:51.4143163Z,2020,75,22,63,39,0,11mo,1,0,36,0,0,53,12,0,74,0,1,0
35816,8390,2020-11-18T16:21:51.4143163Z,2020,93,16,76,50,0,12mo,1,0,43,0,0,77,17,0,92,0,2,0
35816,8391,2020-11-18T16:21:51.4143163Z,2020,86,29,71,31,0,9no,1,0,55,0,0,57,15,0,84,0,0,1
10967,111,2020-11-18T16:20:37.5540625Z,2019,59,16,47,32,0,1ro,2,0,27,0,0,43,12,0,57,0,0,0
10967,112,2020-11-18T16:20:37.5540625Z,2019,65,28,44,33,0,2do,2,0,32,0,0,37,21,0,63,0,0,0
10967,113,2020-11-18T16:20:37.5540625Z,2019,73,22,47,41,0,3ro,3,0,32,0,0,51,26,0,70,0,0,0
10967,114,2020-11-18T16:20:37.5550634Z,2019,58,20,35,25,0,4to,3,0,33,0,0,38,23,0,55,0,1,0
10967,115,2020-11-18T16:20:37.5550634Z,2019,56,13,35,26,0,5to,2,0,30,0,0,43,21,0,54,2,0,0
10967,116,2020-11-18T16:20:37.5550634Z,2019,63,21,43,33,0,K,0,0,30,0,0,42,20,0,63,0,0,0
10967,117,2020-11-18T16:20:37.5560647Z,2019,3,3,2,1,0,Sin Grado,0,0,2,0,0,0,1,0,3,0,0,0
10967,30111,2021-06-24T13:18:06.2889588Z,2021,69,14,55,30,0,1ro,2,0,39,0,0,55,14,0,66,0,0,1
10967,30112,2021-06-24T13:18:06.2899593Z,2021,72,21,56,38,0,2do,2,0,34,0,0,51,16,0,70,0,1,0
10967,30113,2021-06-24T13:18:06.2899593Z,2021,60,16,50,31,0,3ro,2,0,29,0,0,44,10,0,58,0,0,0
10967,30114,2021-06-24T13:18:06.2899593Z,2021,67,27,52,35,0,4to,1,0,32,0,0,40,15,0,66,0,0,0
10967,30115,2021-06-24T13:18:06.2909607Z,2021,68,19,49,38,0,5to,3,0,30,0,0,49,19,0,65,0,0,0
10967,30116,2021-06-24T13:18:06.2909607Z,2021,68,15,57,32,0,K,2,0,36,0,0,53,11,0,66,0,0,0
10967,30117,2021-06-24T13:18:06.2909607Z,2021,5,5,3,2,0,Sin Grado,0,0,3,0,0,0,2,0,5,0,0,0
10967,6112,2020-11-18T16:21:38.2395304Z,2020,68,20,47,37,0,1ro,1,0,31,0,0,48,21,0,67,0,0,0
10967,6113,2020-11-18T16:21:38.2405318Z,2020,67,18,53,33,0,2do,2,0,34,0,0,49,14,0,65,0,0,0
10967,6114,2020-11-18T16:21:38.2405318Z,2020,67,26,48,34,0,3ro,2,0,33,0,0,41,19,0,65,0,0,0
10967,6115,2020-11-18T16:21:38.2405318Z,2020,73,22,46,41,0,4to,3,0,32,0,0,51,27,0,70,0,0,0
10967,6116,2020-11-18T16:21:38.2405318Z,2020,55,21,37,24,0,5to,2,0,31,0,0,34,18,0,53,0,1,0
10967,6117,2020-11-18T16:21:38.2405318Z,2020,74,16,60,35,0,K,1,0,39,0,0,58,14,0,73,0,0,0
10967,6118,2020-11-18T16:21:38.2415327Z,2020,3,3,2,1,0,Sin Grado,0,0,2,0,0,0,1,0,3,0,0,0
15917,30653,2021-06-24T13:18:10.6480845Z,2021,124,28,99,67,0,6to,6,0,57,0,0,96,25,0,118,1,0,0
15917,30654,2021-06-24T13:18:10.6490855Z,2021,153,49,131,66,0,7mo,3,0,87,0,0,104,22,0,149,4,0,1
15917,30655,2021-06-24T13:18:10.6490855Z,2021,174,55,139,93,0,8vo,8,0,81,0,0,119,35,0,165,2,1,1
15917,655,2020-11-18T16:20:41.1844868Z,2019,161,47,123,81,0,6to,10,0,80,0,0,114,38,0,151,2,0,0
15917,656,2020-11-18T16:20:41.1854877Z,2019,182,69,138,89,0,7mo,6,5,93,0,0,113,44,0,176,6,2,0
15917,657,2020-11-18T16:20:41.1854877Z,2019,167,43,124,92,0,8vo,8,5,75,0,0,124,43,0,159,0,2,0
15917,6655,2020-11-18T16:21:40.7532108Z,2020,156,46,118,70,0,6to,3,0,86,0,0,110,38,0,153,5,1,0
15917,6656,2020-11-18T16:21:40.7532108Z,2020,170,51,130,89,0,7mo,9,0,81,0,0,119,40,0,161,2,1,0
15917,6657,2020-11-18T16:21:40.7532108Z,2020,184,67,149,86,0,8vo,5,0,98,0,0,117,35,0,179,6,2,0
46052,3042,2020-11-18T16:21:00.3362551Z,2019,23,11,22,12,0,1ro,1,0,11,0,0,12,1,0,22,0,0,0
46052,3043,2020-11-18T16:21:00.3372555Z,2019,26,10,22,16,0,2do,1,0,10,0,0,16,4,0,25,0,0,0
46052,3044,2020-11-18T16:21:00.3372555Z,2019,40,11,33,18,0,3ro,0,0,22,0,0,29,7,0,40,1,0,0
46052,3045,2020-11-18T16:21:00.3372555Z,2019,27,7,19,15,0,4to,1,0,12,0,0,20,8,0,26,0,0,0
46052,3046,2020-11-18T16:21:00.3382568Z,2019,55,20,47,33,0,5to,1,0,22,0,0,35,8,0,54,1,1,0
46052,3047,2020-11-18T16:21:00.3382568Z,2019,114,34,84,51,0,6to,2,0,63,0,1,80,30,0,112,0,0,0
46052,3048,2020-11-18T16:21:00.3382568Z,2019,134,50,97,61,0,7mo,7,2,73,0,0,84,37,0,127,0,1,0
46052,3049,2020-11-18T16:21:00.3392573Z,2019,143,42,90,69,0,8vo,3,4,74,0,0,101,53,0,140,1,0,0
46052,3050,2020-11-18T16:21:00.3392573Z,2019,18,8,13,13,0,K,0,1,5,0,0,10,5,0,18,0,0,0
46052,3051,2020-11-18T16:21:00.3402582Z,2019,2,2,2,1,0,Sin Grado,0,0,1,0,0,0,0,0,2,0,0,0
46052,33052,2021-06-24T13:18:29.8278438Z,2021,18,6,18,10,0,1ro,1,0,8,0,0,12,0,0,17,0,0,0
46052,33053,2021-06-24T13:18:29.8288447Z,2021,21,3,15,13,0,2do,2,0,8,0,0,18,6,0,19,0,0,0
46052,33054,2021-06-24T13:18:29.8288447Z,2021,27,11,25,12,0,3ro,1,0,15,0,0,16,2,0,26,0,0,0
46052,33055,2021-06-24T13:18:29.8288447Z,2021,30,9,27,19,0,4to,1,0,11,0,0,21,3,0,29,0,0,0
46052,33056,2021-06-24T13:18:29.8298452Z,2021,31,11,27,15,0,5to,0,0,16,0,0,20,4,1,30,1,0,0
46052,33057,2021-06-24T13:18:29.8298452Z,2021,104,37,83,55,0,6to,2,1,49,0,0,67,21,0,102,0,0,0
46052,33058,2021-06-24T13:18:29.8298452Z,2021,130,43,117,69,0,7mo,4,0,61,0,0,87,13,0,126,1,0,0
46052,33059,2021-06-24T13:18:29.8298452Z,2021,131,37,110,61,0,8vo,6,0,70,0,0,94,21,0,125,0,0,0
46052,33060,2021-06-24T13:18:29.8308461Z,2021,12,2,11,8,0,K,0,0,4,0,0,10,1,0,12,0,0,0
46052,33061,2021-06-24T13:18:29.8308461Z,2021,2,2,2,1,0,Sin Grado,0,0,1,0,0,0,0,0,2,0,0,0
46052,9056,2020-11-18T16:21:55.4360001Z,2020,17,4,14,13,0,1ro,1,0,4,0,0,13,3,0,16,0,0,0
46052,9057,2020-11-18T16:21:55.4360001Z,2020,25,11,23,13,0,2do,1,2,12,0,0,14,2,0,24,0,0,0
46052,9058,2020-11-18T16:21:55.4360001Z,2020,32,9,25,21,0,3ro,1,2,11,0,0,23,7,0,31,0,0,0
46052,9059,2020-11-18T16:21:55.4370001Z,2020,36,12,30,18,0,4to,1,1,18,0,0,24,6,0,35,1,0,0
46052,9060,2020-11-18T16:21:55.4370001Z,2020,30,8,21,17,0,5to,0,0,13,0,0,22,9,0,30,0,0,0
46052,9061,2020-11-18T16:21:55.4370001Z,2020,124,40,101,67,0,6to,3,7,57,0,0,84,23,0,121,1,2,0
46052,9062,2020-11-18T16:21:55.438001Z,2020,132,38,99,60,0,7mo,6,2,72,0,0,94,33,0,126,0,0,0
46052,9063,2020-11-18T16:21:55.438001Z,2020,135,50,99,62,0,8vo,7,2,73,0,0,85,36,0,128,1,0,0
46052,9064,2020-11-18T16:21:55.438001Z,2020,24,6,21,12,0,K,2,0,12,0,0,18,3,0,22,0,0,0
46052,9065,2020-11-18T16:21:55.4390019Z,2020,2,2,2,1,0,Sin Grado,0,0,1,0,0,0,0,0,2,0,0,0
12799,30436,2021-06-24T13:18:09.4942578Z,2021,30,9,24,14,0,1ro,0,0,16,0,0,21,6,0,30,0,0,0
12799,30437,2021-06-24T13:18:09.4942578Z,2021,39,12,36,21,0,2do,1,0,18,0,0,27,3,0,38,0,0,0
12799,30438,2021-06-24T13:18:09.4942578Z,2021,49,16,43,30,0,3ro,2,0,19,0,0,33,6,0,47,0,0,0
12799,30439,2021-06-24T13:18:09.4942578Z,2021,42,13,38,21,0,4to,1,0,21,0,0,29,4,0,41,0,0,0
12799,30440,2021-06-24T13:18:09.4952583Z,2021,42,13,36,18,0,5to,3,0,24,0,0,29,6,0,39,0,1,0
12799,30441,2021-06-24T13:18:09.4952583Z,2021,34,10,30,16,0,K,1,0,18,0,0,24,4,0,33,0,1,0
12799,30442,2021-06-24T13:18:09.4952583Z,2021,23,4,16,7,0,PK,0,0,16,0,0,19,7,0,23,0,0,0
12799,30443,2021-06-24T13:18:09.4952583Z,2021,21,21,20,8,0,Sin Grado,0,0,13,0,0,0,1,0,21,0,0,0
12799,438,2020-11-18T16:20:40.065739Z,2019,69,27,64,42,0,1ro,3,2,27,0,0,42,5,0,66,0,1,0
12799,439,2020-11-18T16:20:40.0667395Z,2019,47,19,41,20,0,2do,2,3,27,0,0,28,6,0,44,0,0,1
12799,440,2020-11-18T16:20:40.0667395Z,2019,61,24,57,28,0,3ro,2,1,33,0,0,37,4,0,58,0,0,1
12799,441,2020-11-18T16:20:40.0667395Z,2019,55,26,49,30,0,4to,2,0,25,0,0,29,6,0,53,0,0,0
12799,442,2020-11-18T16:20:40.0667395Z,2019,43,20,32,17,0,5to,0,0,26,0,0,23,11,0,42,2,0,1
12799,443,2020-11-18T16:20:40.0677404Z,2019,37,10,32,19,0,K,0,0,18,0,0,27,5,0,37,0,0,0
12799,444,2020-11-18T16:20:40.0677404Z,2019,30,6,27,15,0,PK,0,0,15,0,0,24,3,0,30,0,0,0
12799,445,2020-11-18T16:20:40.0677404Z,2019,31,24,27,11,0,Sin Grado,0,0,20,0,0,7,4,0,31,0,0,0
12799,6439,2020-11-18T16:21:39.6664845Z,2020,37,12,34,18,0,1ro,1,0,19,0,0,25,3,0,36,0,0,0
12799,6440,2020-11-18T16:21:39.6664845Z,2020,51,18,45,32,0,2do,3,0,19,0,0,33,6,0,48,0,0,0
12799,6441,2020-11-18T16:21:39.6664845Z,2020,42,16,36,20,0,3ro,1,0,22,0,0,26,6,0,41,0,0,0
12799,6442,2020-11-18T16:21:39.6664845Z,2020,44,18,40,20,0,4to,2,0,24,0,0,26,4,0,42,0,0,0
12799,6443,2020-11-18T16:21:39.6674845Z,2020,52,26,47,29,0,5to,2,0,23,0,0,26,5,0,50,1,0,0
12799,6444,2020-11-18T16:21:39.6674845Z,2020,34,10,31,14,0,K,0,0,20,0,0,24,3,0,34,0,0,0
12799,6445,2020-11-18T16:21:39.6674845Z,2020,24,4,22,11,0,PK,0,0,13,0,0,20,2,0,24,0,0,0
12799,6446,2020-11-18T16:21:39.6674845Z,2020,20,20,19,8,0,Sin Grado,0,0,12,0,0,0,1,0,20,0,0,0
50468,3263,2020-11-18T16:21:01.4590059Z,2019,175,32,127,88,0,10mo,3,0,87,0,0,143,48,0,172,0,1,0
50468,3264,2020-11-18T16:21:01.4600068Z,2019,164,37,105,77,0,11mo,3,2,87,0,1,127,59,0,161,1,0,0
50468,3265,2020-11-18T16:21:01.4600068Z,2019,166,0,93,93,0,12mo,1,1,73,0,0,166,73,0,165,0,0,0
50468,3266,2020-11-18T16:21:01.4600068Z,2019,216,53,133,110,0,9no,7,0,106,0,0,163,83,0,209,0,0,0
50468,3267,2020-11-18T16:21:01.4600068Z,2019,8,7,6,3,0,Sin Grado,0,0,5,0,0,1,2,0,8,0,0,0
50468,33289,2021-06-24T13:18:30.9006134Z,2021,176,46,116,85,0,10mo,5,0,91,0,0,130,60,1,170,0,1,0
50468,33290,2021-06-24T13:18:30.9016135Z,2021,205,45,151,114,0,11mo,6,0,91,0,0,160,54,0,199,0,0,0
50468,33291,2021-06-24T13:18:30.9016135Z,2021,152,24,96,87,0,12mo,2,0,65,0,0,128,56,0,150,0,0,0
50468,33292,2021-06-24T13:18:30.9016135Z,2021,183,47,129,100,0,9no,3,0,83,0,0,136,54,0,180,3,0,0
50468,33293,2021-06-24T13:18:30.9016135Z,2021,18,18,13,5,0,Sin Grado,0,0,13,0,0,0,5,0,18,0,0,0
50468,9283,2020-11-18T16:21:57.3372665Z,2020,227,51,143,118,0,10mo,6,0,109,0,0,176,84,0,221,0,0,0
50468,9284,2020-11-18T16:21:57.3372665Z,2020,152,27,101,86,0,11mo,2,0,66,0,0,125,51,0,150,0,0,0
50468,9285,2020-11-18T16:21:57.3382669Z,2020,156,37,104,74,0,12mo,3,0,82,0,0,119,52,0,153,0,0,0
50468,9286,2020-11-18T16:21:57.3382669Z,2020,190,51,124,90,0,9no,5,0,100,0,0,139,66,1,184,0,1,0
50468,9287,2020-11-18T16:21:57.3382669Z,2020,10,10,8,2,0,Sin Grado,0,0,8,0,0,0,2,0,10,0,0,0
58495,10087,2020-11-18T16:22:01.9593491Z,2020,16,2,11,8,0,1ro,0,0,8,0,0,14,5,0,16,0,0,0
58495,10088,2020-11-18T16:22:01.9593491Z,2020,10,6,8,6,0,2do,0,0,4,0,0,4,2,0,10,0,0,0
58495,10089,2020-11-18T16:22:01.9603499Z,2020,9,4,6,2,0,3ro,0,0,7,0,0,5,3,0,9,0,0,0
58495,10090,2020-11-18T16:22:01.9603499Z,2020,10,1,6,7,0,4to,0,0,3,0,0,9,4,0,10,0,1,0
58495,10091,2020-11-18T16:22:01.9603499Z,2020,11,5,7,2,0,5to,0,0,9,0,0,6,4,0,11,0,0,0
58495,10092,2020-11-18T16:22:01.9603499Z,2020,15,2,12,10,0,K,0,0,5,0,0,13,3,0,15,0,0,0
58495,10093,2020-11-18T16:22:01.9603499Z,2020,23,23,19,7,0,Sin Grado,0,0,16,0,0,0,4,0,23,0,0,0
58495,34095,2021-06-24T13:18:36.9969844Z,2021,16,3,12,11,0,1ro,0,0,5,0,0,13,4,0,16,0,0,0
58495,34096,2021-06-24T13:18:36.9979854Z,2021,18,2,12,8,0,2do,0,0,10,0,0,16,6,0,18,0,0,0
58495,34097,2021-06-24T13:18:36.9979854Z,2021,11,6,9,7,0,3ro,0,0,4,0,0,5,2,0,11,0,0,0
58495,34098,2021-06-24T13:18:36.9979854Z,2021,11,3,9,3,0,4to,0,0,8,0,0,8,2,0,11,0,0,0
58495,34099,2021-06-24T13:18:36.9979854Z,2021,9,1,8,6,0,5to,0,0,3,0,0,8,1,0,9,0,0,0
58495,34100,2021-06-24T13:18:37.4182868Z,2021,13,2,10,8,0,K,0,0,5,0,0,11,3,0,13,0,0,0
58495,34101,2021-06-24T13:18:37.4182868Z,2021,20,20,15,6,0,Sin Grado,0,0,14,0,0,0,5,0,20,0,0,0
58495,4069,2020-11-18T16:21:07.3109079Z,2019,12,7,4,5,0,1ro,0,1,7,0,0,5,8,0,12,0,0,0
58495,4070,2020-11-18T16:21:07.3119083Z,2019,9,4,7,4,0,2do,0,0,5,0,0,5,2,0,9,0,0,0
58495,4071,2020-11-18T16:21:07.3119083Z,2019,9,0,6,5,0,3ro,0,0,4,0,0,9,3,0,9,0,1,0
58495,4072,2020-11-18T16:21:07.3119083Z,2019,11,5,7,3,0,4to,0,0,8,0,0,6,4,0,11,0,0,0
58495,4073,2020-11-18T16:21:07.3119083Z,2019,10,2,5,5,0,5to,0,0,5,0,0,8,5,0,10,0,0,0
58495,4074,2020-11-18T16:21:07.3119083Z,2019,17,3,0,9,0,K,0,0,8,0,0,14,17,0,17,0,0,0
58495,4075,2020-11-18T16:21:07.3119083Z,2019,21,20,15,6,0,Sin Grado,0,0,15,0,0,1,6,0,21,0,0,0
43794,2952,2020-11-18T16:20:59.9109716Z,2019,50,12,47,22,0,1ro,1,0,28,0,0,38,3,0,49,0,0,0
43794,2953,2020-11-18T16:20:59.9109716Z,2019,63,21,56,27,0,2do,0,1,36,0,0,42,7,0,63,0,1,0
43794,2954,2020-11-18T16:20:59.9109716Z,2019,77,25,71,38,0,3ro,0,1,39,0,0,52,6,0,77,2,0,0
43794,2955,2020-11-18T16:20:59.9119721Z,2019,63,14,58,30,0,4to,0,0,33,0,0,49,5,0,63,1,1,0
43794,2956,2020-11-18T16:20:59.9119721Z,2019,82,24,66,37,0,5to,0,1,45,0,0,58,16,0,82,0,1,0
43794,2957,2020-11-18T16:20:59.9119721Z,2019,40,13,38,20,0,K,1,2,20,0,0,27,2,0,39,0,0,0
43794,2958,2020-11-18T16:20:59.912973Z,2019,13,9,12,1,0,Sin Grado,0,1,12,0,0,4,1,0,13,0,0,0
43794,32961,2021-06-24T13:18:28.9021807Z,2021,49,16,48,20,0,1ro,2,0,29,0,0,33,1,0,47,0,0,0
43794,32962,2021-06-24T13:18:28.9021807Z,2021,31,8,29,15,0,2do,0,0,16,0,0,23,2,0,31,0,0,0
43794,32963,2021-06-24T13:18:28.9021807Z,2021,49,17,48,20,0,3ro,1,0,29,0,0,32,1,0,48,0,1,0
43794,32964,2021-06-24T13:18:28.9021807Z,2021,66,23,61,31,0,4to,0,0,35,0,0,43,5,0,66,0,0,0
43794,32965,2021-06-24T13:18:28.9031812Z,2021,68,20,64,31,0,5to,0,0,37,0,0,48,4,0,68,1,0,0
43794,32966,2021-06-24T13:18:28.9031812Z,2021,43,5,40,18,0,K,0,0,25,0,0,38,3,0,43,0,0,0
43794,32967,2021-06-24T13:18:28.9031812Z,2021,9,9,7,3,0,Sin Grado,0,0,6,0,0,0,2,0,9,0,0,0
43794,8965,2020-11-18T16:21:54.9967065Z,2020,37,10,34,16,0,1ro,0,0,21,0,0,27,3,0,37,0,0,0
43794,8966,2020-11-18T16:21:54.9967065Z,2020,49,17,45,18,0,2do,0,0,31,0,0,32,4,0,49,0,1,0
43794,8967,2020-11-18T16:21:54.9977069Z,2020,65,22,58,32,0,3ro,1,0,33,0,0,43,7,0,64,0,0,0
43794,8968,2020-11-18T16:21:54.9977069Z,2020,78,25,70,37,0,4to,1,0,41,0,0,53,8,0,77,2,0,0
43794,8969,2020-11-18T16:21:54.9977069Z,2020,66,16,55,35,0,5to,1,0,31,0,0,50,11,0,65,1,1,0
43794,8970,2020-11-18T16:21:54.9977069Z,2020,53,14,50,21,0,K,1,0,32,0,0,39,3,0,52,0,0,0
43794,8971,2020-11-18T16:21:54.9977069Z,2020,9,9,7,3,0,Sin Grado,0,0,6,0,0,0,2,0,9,0,0,0
52555,33590,2021-06-24T13:18:33.4124141Z,2021,166,164,135,58,0,Sin Grado,0,5,108,0,0,2,31,0,166,1,0,0
52555,3565,2020-11-18T16:21:03.2682141Z,2019,173,165,139,59,0,Sin Grado,0,8,114,0,1,8,34,0,173,2,0,0
52555,9584,2020-11-18T16:21:59.0954377Z,2020,169,168,135,58,0,Sin Grado,0,9,111,0,0,1,34,0,169,1,0,0
75713,11567,2020-11-18T16:22:11.3235937Z,2020,69,29,57,30,0,1ro,1,1,39,0,0,40,12,0,68,1,0,0
75713,11568,2020-11-18T16:22:11.3245941Z,2020,46,14,41,24,0,2do,2,1,22,0,0,32,5,0,44,1,0,0
75713,11569,2020-11-18T16:22:11.3245941Z,2020,47,23,34,22,0,3ro,0,2,25,0,0,24,13,0,47,0,0,0
75713,11570,2020-11-18T16:22:11.3245941Z,2020,65,20,48,36,0,4to,2,1,29,0,0,45,17,0,63,1,0,0
75713,11571,2020-11-18T16:22:11.3245941Z,2020,57,12,47,28,0,5to,2,3,29,0,0,45,10,0,55,1,0,0
75713,11572,2020-11-18T16:22:11.3245941Z,2020,63,17,55,35,0,K,0,3,28,0,0,46,8,0,63,0,0,0
75713,11573,2020-11-18T16:22:11.3255955Z,2020,30,30,23,7,0,Sin Grado,2,1,23,0,0,0,7,0,28,0,0,0
75713,35590,2021-06-24T13:18:46.5978688Z,2021,65,23,55,31,0,1ro,2,0,34,0,0,42,10,0,63,0,0,0
75713,35591,2021-06-24T13:18:46.5978688Z,2021,70,26,60,32,0,2do,3,0,38,0,0,44,10,0,67,1,0,0
75713,35592,2021-06-24T13:18:46.5988698Z,2021,50,14,35,27,0,3ro,2,0,23,0,0,36,15,0,48,1,0,0
75713,35593,2021-06-24T13:18:46.5988698Z,2021,47,24,37,22,0,4to,1,0,25,0,0,23,10,0,46,0,0,0
75713,35594,2021-06-24T13:18:46.5988698Z,2021,64,19,51,37,0,5to,3,1,27,0,0,45,13,0,61,0,0,0
75713,35595,2021-06-24T13:18:46.5998707Z,2021,68,13,50,30,0,K,2,0,38,0,0,55,18,0,66,0,0,0
75713,35596,2021-06-24T13:18:46.5998707Z,2021,32,32,28,10,0,Sin Grado,1,1,22,0,0,0,4,0,31,0,0,0
75713,5559,2020-11-18T16:21:16.1928286Z,2019,55,21,49,27,0,1ro,2,0,28,0,0,34,6,0,53,1,0,0
75713,5560,2020-11-18T16:21:16.1928286Z,2019,46,21,36,23,0,2do,0,0,23,0,0,25,10,0,46,0,0,0
75713,5561,2020-11-18T16:21:16.1928286Z,2019,62,15,49,39,0,3ro,2,0,23,0,0,47,13,0,60,1,0,0
75713,5562,2020-11-18T16:21:16.1928286Z,2019,55,14,44,24,0,4to,1,0,31,0,0,41,11,0,54,1,0,0
75713,5563,2020-11-18T16:21:16.1938295Z,2019,52,17,41,27,0,5to,3,0,25,0,0,35,11,0,49,0,0,0
75713,5564,2020-11-18T16:21:16.1938295Z,2019,60,22,51,29,0,K,0,0,31,0,0,38,9,0,60,1,0,0
75713,5565,2020-11-18T16:21:16.1938295Z,2019,30,28,25,8,0,Sin Grado,2,0,22,0,0,2,5,0,28,0,0,0
70045,10882,2020-11-18T16:22:06.549411Z,2020,76,27,58,36,0,1ro,2,0,40,0,0,49,18,0,74,0,0,0
70045,10883,2020-11-18T16:22:06.549411Z,2020,72,25,55,39,0,2do,1,0,33,0,0,47,17,0,70,0,1,1
70045,10884,2020-11-18T16:22:06.549411Z,2020,73,28,56,39,0,3ro,4,0,34,0,0,45,17,0,69,0,1,0
70045,10885,2020-11-18T16:22:06.5504132Z,2020,57,19,42,30,0,4to,1,1,27,0,0,38,15,0,55,0,0,1
70045,10886,2020-11-18T16:22:06.5504132Z,2020,75,23,55,36,0,5to,4,0,39,0,0,52,20,0,71,0,0,0
70045,10887,2020-11-18T16:22:06.5504132Z,2020,73,31,62,35,0,K,0,0,38,0,0,42,11,0,73,0,0,0
70045,10888,2020-11-18T16:22:06.5504132Z,2020,21,21,19,3,0,Sin Grado,0,0,18,0,0,0,2,0,21,0,0,0
70045,34904,2021-06-24T13:18:43.3165161Z,2021,74,34,64,34,0,1ro,0,0,40,0,0,40,10,0,74,0,0,0
70045,34905,2021-06-24T13:18:43.3165161Z,2021,68,28,59,30,0,2do,1,0,38,0,0,40,9,0,67,0,0,0
70045,34906,2021-06-24T13:18:43.3165161Z,2021,67,26,53,35,0,3ro,1,0,32,0,0,41,14,0,66,0,0,0
70045,34907,2021-06-24T13:18:43.3175166Z,2021,71,31,58,37,0,4to,4,0,34,0,0,40,13,0,67,0,0,0
70045,34908,2021-06-24T13:18:43.3175166Z,2021,49,17,39,25,0,5to,1,0,24,0,0,32,10,0,48,0,0,0
70045,34909,2021-06-24T13:18:43.3175166Z,2021,65,16,55,35,0,K,2,0,30,0,0,49,10,1,62,0,0,0
70045,34910,2021-06-24T13:18:43.3175166Z,2021,15,15,15,2,0,Sin Grado,0,0,13,0,0,0,0,0,15,0,0,0
70045,4874,2020-11-18T16:21:12.4063059Z,2019,85,39,65,41,0,1ro,1,1,44,0,0,46,20,0,84,0,1,0
70045,4875,2020-11-18T16:21:12.4063059Z,2019,82,32,62,45,0,2do,3,0,37,0,0,50,20,0,79,0,2,0
70045,4876,2020-11-18T16:21:12.4063059Z,2019,73,33,62,37,0,3ro,2,0,36,0,0,40,11,0,71,0,0,0
70045,4877,2020-11-18T16:21:12.4063059Z,2019,92,28,73,41,0,4to,3,1,51,0,0,64,19,0,89,0,0,0
70045,4878,2020-11-18T16:21:12.4073063Z,2019,81,19,63,40,0,5to,0,0,41,0,0,62,18,0,81,0,0,0
70045,4879,2020-11-18T16:21:12.4073063Z,2019,74,25,56,34,0,K,4,0,40,0,0,49,18,0,70,0,0,0
70045,4880,2020-11-18T16:21:12.4073063Z,2019,22,19,20,1,0,Sin Grado,0,3,21,0,0,3,2,0,22,0,0,0
44529,2965,2020-11-18T16:20:59.9159747Z,2019,29,10,27,9,0,1ro,2,0,20,0,0,19,2,0,27,1,0,0
44529,2966,2020-11-18T16:20:59.9159747Z,2019,35,21,31,10,0,2do,0,0,25,0,0,14,4,0,35,0,0,0
44529,2967,2020-11-18T16:20:59.9159747Z,2019,25,10,19,10,0,3ro,0,0,15,0,0,15,6,0,25,0,0,0
44529,2968,2020-11-18T16:20:59.9169752Z,2019,23,9,18,11,0,4to,1,0,12,0,0,14,5,0,22,0,0,0
44529,2969,2020-11-18T16:20:59.9169752Z,2019,32,21,28,10,0,5to,1,0,22,0,0,11,4,0,31,0,0,0
44529,2970,2020-11-18T16:20:59.9169752Z,2019,31,17,27,12,0,K,0,0,19,0,0,14,4,0,31,0,0,0
44529,2971,2020-11-18T16:20:59.9179756Z,2019,21,20,20,10,0,Sin Grado,0,0,11,0,0,1,1,0,21,0,0,0
44529,32974,2021-06-24T13:18:28.9031812Z,2021,34,13,31,14,0,1ro,0,0,20,0,0,21,3,0,34,0,0,0
44529,32975,2021-06-24T13:18:28.9031812Z,2021,42,20,34,16,0,2do,0,0,26,0,0,22,8,0,42,0,0,0
44529,32976,2021-06-24T13:18:28.9031812Z,2021,30,15,29,9,0,3ro,0,0,21,0,0,15,1,0,30,1,0,0
44529,32977,2021-06-24T13:18:28.9031812Z,2021,31,16,29,9,0,4to,0,0,22,0,0,15,2,0,31,0,0,0
44529,32978,2021-06-24T13:18:28.9041821Z,2021,24,10,19,9,0,5to,0,0,15,0,0,14,5,0,24,0,0,0
44529,32979,2021-06-24T13:18:28.9041821Z,2021,34,21,28,16,0,K,0,0,18,0,0,13,6,0,34,0,0,0
44529,32980,2021-06-24T13:18:28.9041821Z,2021,17,17,16,4,0,Sin Grado,0,0,13,0,0,0,1,0,17,0,0,0
44529,8978,2020-11-18T16:21:55.0017096Z,2020,34,17,29,13,0,1ro,0,0,21,0,0,17,5,0,34,0,0,0
44529,8979,2020-11-18T16:21:55.0017096Z,2020,31,15,29,9,0,2do,1,0,22,0,0,16,2,0,30,1,0,0
44529,8980,2020-11-18T16:21:55.0017096Z,2020,32,15,32,8,0,3ro,0,0,24,0,0,17,0,0,32,0,0,0
44529,8981,2020-11-18T16:21:55.00271Z,2020,25,9,21,9,0,4to,1,0,16,0,0,16,4,0,24,0,0,0
44529,8982,2020-11-18T16:21:55.00271Z,2020,24,12,21,11,0,5to,0,0,13,0,0,12,3,0,24,0,0,0
44529,8983,2020-11-18T16:21:55.00271Z,2020,7,7,6,0,0,6to,1,0,7,0,0,0,1,0,6,0,0,0
44529,8984,2020-11-18T16:21:55.0037105Z,2020,32,12,30,12,0,K,0,0,20,0,0,20,2,0,32,0,0,0
44529,8985,2020-11-18T16:21:55.0037105Z,2020,22,21,20,7,0,Sin Grado,0,0,15,0,0,1,2,0,22,0,0,0
51946,33507,2021-06-24T13:18:33.3723854Z,2021,41,8,38,14,0,1ro,0,0,27,0,0,33,3,0,41,0,0,0
51946,33508,2021-06-24T13:18:33.3723854Z,2021,43,15,37,17,0,2do,0,0,26,0,0,28,6,0,43,0,0,0
51946,33509,2021-06-24T13:18:33.3733863Z,2021,23,5,20,12,0,3ro,1,0,11,0,0,18,3,0,22,0,0,0
51946,33510,2021-06-24T13:18:33.3733863Z,2021,38,14,32,14,0,4to,0,0,24,0,0,24,6,0,38,0,0,0
51946,33511,2021-06-24T13:18:33.3733863Z,2021,53,17,46,25,0,5to,2,0,28,0,0,36,7,0,50,0,0,1
51946,33512,2021-06-24T13:18:33.3743868Z,2021,34,9,32,15,0,6to,2,0,19,0,0,25,2,0,32,0,0,0
51946,33513,2021-06-24T13:18:33.3743868Z,2021,47,18,40,31,0,7mo,3,0,16,0,0,29,7,0,44,0,0,0
51946,33514,2021-06-24T13:18:33.3743868Z,2021,32,8,29,15,0,8vo,1,0,17,0,0,24,3,0,31,0,0,0
51946,33515,2021-06-24T13:18:33.3753882Z,2021,23,2,14,7,0,K,0,0,16,0,0,21,9,1,22,0,0,0
51946,33516,2021-06-24T13:18:33.3753882Z,2021,7,7,7,1,0,Sin Grado,0,0,6,0,0,0,0,0,7,0,0,0
51946,3481,2020-11-18T16:21:02.5707475Z,2019,40,15,37,19,1,1ro,1,1,21,0,0,25,3,0,39,0,0,0
51946,3482,2020-11-18T16:21:02.5707475Z,2019,36,12,33,12,0,2do,0,0,24,0,0,24,3,0,36,0,0,0
51946,3483,2020-11-18T16:21:02.5717484Z,2019,46,15,45,22,0,3ro,1,1,24,0,0,31,1,0,45,0,0,0
51946,3484,2020-11-18T16:21:02.5717484Z,2019,43,14,37,19,0,4to,1,3,24,0,0,29,6,0,42,0,0,0
51946,3485,2020-11-18T16:21:02.5717484Z,2019,56,20,51,36,0,5to,2,2,20,0,0,36,5,0,54,0,0,0
51946,3486,2020-11-18T16:21:02.5717484Z,2019,43,9,38,19,0,6to,2,1,24,0,0,34,5,0,41,0,0,0
51946,3487,2020-11-18T16:21:02.5717484Z,2019,31,10,28,19,0,7mo,2,1,12,0,0,21,3,0,29,0,0,0
51946,3488,2020-11-18T16:21:02.5727493Z,2019,43,17,37,20,0,8vo,0,0,23,0,0,26,6,0,43,0,0,0
51946,3489,2020-11-18T16:21:02.5727493Z,2019,31,5,28,16,0,K,0,1,15,0,0,26,3,0,31,0,0,0
51946,3490,2020-11-18T16:21:02.5727493Z,2019,7,7,7,1,0,Sin Grado,0,0,6,0,0,0,0,0,7,0,0,0
51946,9502,2020-11-18T16:21:59.0724226Z,2020,41,14,39,15,0,1ro,0,0,26,0,0,27,2,0,41,0,0,0
51946,9503,2020-11-18T16:21:59.0724226Z,2020,24,7,22,13,0,2do,1,0,11,0,0,17,2,0,23,0,0,0
51946,9504,2020-11-18T16:21:59.0724226Z,2020,36,14,33,11,0,3ro,0,1,25,0,0,22,3,0,36,0,0,0
51946,9505,2020-11-18T16:21:59.0724226Z,2020,53,19,52,25,0,4to,1,0,28,0,0,34,1,0,51,0,0,1
51946,9506,2020-11-18T16:21:59.0734235Z,2020,40,11,35,19,0,5to,2,1,21,0,0,29,5,0,38,0,0,0
51946,9507,2020-11-18T16:21:59.0734235Z,2020,52,19,49,33,0,6to,3,2,19,0,0,33,3,0,49,0,0,0
51946,9508,2020-11-18T16:21:59.0734235Z,2020,36,8,31,17,0,7mo,2,1,19,0,0,28,5,0,34,0,0,0
51946,9509,2020-11-18T16:21:59.0734235Z,2020,34,9,31,22,0,8vo,3,0,12,0,0,25,3,0,31,0,0,0
51946,9510,2020-11-18T16:21:59.0744253Z,2020,43,3,39,17,0,K,0,0,26,0,0,40,4,0,42,0,0,1
51946,9511,2020-11-18T16:21:59.0744253Z,2020,8,8,8,1,0,Sin Grado,0,0,7,0,0,0,0,0,8,0,0,0
30973,1893,2020-11-18T16:20:52.4880242Z,2019,184,24,111,88,0,10mo,2,0,96,0,0,160,73,0,181,0,0,1
30973,1894,2020-11-18T16:20:52.4880242Z,2019,148,17,84,88,0,11mo,1,0,60,0,0,131,64,1,146,0,0,0
30973,1895,2020-11-18T16:20:52.4880242Z,2019,163,0,89,96,0,12mo,2,0,67,0,0,163,74,0,161,0,0,0
30973,1896,2020-11-18T16:20:52.4890256Z,2019,149,27,90,84,0,9no,0,0,65,0,0,122,59,0,149,0,1,0
30973,1897,2020-11-18T16:20:52.4890256Z,2019,42,35,34,14,0,Sin Grado,0,0,28,0,0,7,8,0,42,0,0,0
30973,31898,2021-06-24T13:18:17.7862032Z,2021,185,30,129,92,0,10mo,3,0,93,0,0,155,56,0,182,0,0,0
30973,31899,2021-06-24T13:18:17.7872041Z,2021,185,23,126,101,0,11mo,0,0,84,0,0,162,59,0,185,0,1,0
30973,31900,2021-06-24T13:18:18.6438179Z,2021,187,20,120,88,0,12mo,2,0,99,0,0,167,67,0,184,0,0,1
30973,31901,2021-06-24T13:18:18.6438179Z,2021,159,18,101,91,0,9no,0,0,68,0,0,141,58,0,159,0,0,0
30973,31902,2021-06-24T13:18:18.6438179Z,2021,53,50,37,13,0,Sin Grado,1,0,40,0,0,3,16,1,51,0,1,0
30973,7901,2020-11-18T16:21:49.1187871Z,2020,196,30,111,108,0,10mo,0,0,88,0,0,166,85,0,196,0,1,0
30973,7902,2020-11-18T16:21:49.1197876Z,2020,198,24,105,95,0,11mo,2,0,103,0,0,174,93,0,195,0,0,1
30973,7903,2020-11-18T16:21:49.1197876Z,2020,144,17,96,86,0,12mo,1,0,58,0,0,127,48,1,142,0,0,0
30973,7904,2020-11-18T16:21:49.1197876Z,2020,178,35,116,85,0,9no,2,0,93,0,0,143,62,0,176,0,0,0
30973,7905,2020-11-18T16:21:49.1197876Z,2020,42,39,32,9,0,Sin Grado,0,0,33,0,0,3,10,0,42,0,0,0
63123,10616,2020-11-18T16:22:05.3295959Z,2020,52,20,48,33,0,10mo,1,0,19,0,0,32,4,0,51,0,0,0
63123,10617,2020-11-18T16:22:05.3295959Z,2020,70,30,69,44,0,11mo,2,0,26,0,0,40,1,0,68,0,0,0
63123,10618,2020-11-18T16:22:05.3305964Z,2020,45,13,42,28,0,12mo,4,0,17,0,0,32,3,0,41,0,0,0
63123,10619,2020-11-18T16:22:05.3305964Z,2020,22,6,20,10,0,9no,2,0,12,0,0,16,2,0,19,0,0,1
63123,10620,2020-11-18T16:22:05.3305964Z,2020,48,46,45,15,0,Sin Grado,0,1,33,0,0,2,3,0,48,0,0,0
63123,34631,2021-06-24T13:18:41.0869174Z,2021,48,16,44,26,0,10mo,3,0,22,0,0,32,4,0,44,0,0,1
63123,34632,2021-06-24T13:18:41.0869174Z,2021,50,20,46,34,0,11mo,1,0,16,0,0,30,4,0,49,1,0,0
63123,34633,2021-06-24T13:18:41.0879183Z,2021,62,27,58,39,0,12mo,2,0,23,0,0,35,4,0,60,0,0,0
63123,34634,2021-06-24T13:18:41.0879183Z,2021,18,7,18,11,0,9no,1,0,7,0,0,11,0,0,17,0,0,0
63123,34635,2021-06-24T13:18:41.0879183Z,2021,41,39,36,18,0,Sin Grado,0,1,23,0,0,2,5,0,41,0,0,0
63123,4605,2020-11-18T16:21:11.2455304Z,2019,75,28,70,47,0,10mo,2,0,28,0,0,47,5,0,73,0,0,0
63123,4606,2020-11-18T16:21:11.2455304Z,2019,57,13,53,34,0,11mo,5,0,23,0,0,44,4,0,52,0,0,0
63123,4607,2020-11-18T16:21:11.2455304Z,2019,60,0,54,30,0,12mo,4,0,30,0,0,60,6,0,56,0,0,0
63123,4608,2020-11-18T16:21:11.2465309Z,2019,28,8,24,17,0,9no,1,0,11,0,0,20,4,0,27,0,0,0
63123,4609,2020-11-18T16:21:11.2465309Z,2019,52,29,49,17,0,Sin Grado,2,0,35,0,0,23,3,0,50,0,0,0
35782,2371,2020-11-18T16:20:55.7381895Z,2019,139,13,100,80,0,10mo,0,0,59,0,0,126,39,0,139,0,0,0
35782,2372,2020-11-18T16:20:55.7391913Z,2019,146,6,100,87,0,11mo,2,0,59,0,0,140,46,0,144,1,0,0
35782,2373,2020-11-18T16:20:55.7391913Z,2019,150,0,119,89,0,12mo,1,0,61,0,0,150,31,1,148,0,1,0
35782,2374,2020-11-18T16:20:55.7391913Z,2019,85,11,62,39,0,9no,3,0,46,0,0,74,23,0,82,0,0,0
35782,2375,2020-11-18T16:20:55.7401913Z,2019,13,12,12,3,0,Sin Grado,0,0,10,0,0,1,1,0,13,0,0,0
35782,32378,2021-06-24T13:18:23.3501929Z,2021,109,13,69,49,0,10mo,1,0,60,0,0,96,40,0,108,0,0,0
35782,32379,2021-06-24T13:18:23.3501929Z,2021,84,13,59,40,0,11mo,1,0,44,0,0,71,25,0,83,0,0,0
35782,32380,2021-06-24T13:18:23.3511938Z,2021,131,12,95,77,0,12mo,1,0,54,0,0,119,36,0,130,0,0,0
35782,32381,2021-06-24T13:18:23.3511938Z,2021,78,11,56,39,0,9no,0,0,39,0,0,67,22,0,78,2,0,0
35782,32382,2021-06-24T13:18:23.3511938Z,2021,19,19,16,7,0,Sin Grado,0,0,12,0,0,0,3,0,19,0,0,0
35782,8383,2020-11-18T16:21:51.4123145Z,2020,84,12,63,41,0,10mo,1,0,43,0,0,72,21,0,83,0,0,0
35782,8384,2020-11-18T16:21:51.4123145Z,2020,128,12,87,73,0,11mo,0,0,55,0,0,116,41,0,128,0,0,0
35782,8385,2020-11-18T16:21:51.413315Z,2020,145,8,105,85,0,12mo,2,0,60,0,0,137,40,0,143,0,0,0
35782,8386,2020-11-18T16:21:51.413315Z,2020,104,12,66,46,0,9no,1,0,58,0,0,92,38,0,103,0,0,0
35782,8387,2020-11-18T16:21:51.413315Z,2020,16,16,14,4,0,Sin Grado,0,0,12,0,0,0,2,0,16,0,0,0
30239,1784,2020-11-18T16:20:48.8746111Z,2019,51,18,47,28,0,1ro,3,0,23,0,0,33,4,0,47,0,0,1
30239,1785,2020-11-18T16:20:48.8746111Z,2019,52,19,49,28,0,2do,2,0,24,0,0,33,3,0,50,0,0,0
30239,1786,2020-11-18T16:20:48.8746111Z,2019,63,18,56,31,0,3ro,1,0,32,0,0,45,7,0,62,0,0,0
30239,1787,2020-11-18T16:20:48.8746111Z,2019,40,5,34,21,0,4to,0,0,19,0,0,35,6,0,39,0,0,1
30239,1788,2020-11-18T16:20:48.8756116Z,2019,68,16,57,33,0,5to,1,0,35,0,0,52,11,0,67,0,0,0
30239,1789,2020-11-18T16:20:48.8756116Z,2019,45,11,41,25,0,K,0,0,20,0,0,34,4,0,44,0,0,1
30239,1790,2020-11-18T16:20:48.8756116Z,2019,5,1,3,4,0,Sin Grado,0,0,1,0,0,4,2,0,5,0,0,0
30239,31788,2021-06-24T13:18:17.2488185Z,2021,44,15,42,18,0,1ro,1,0,26,0,0,29,2,1,42,0,0,0
30239,31789,2021-06-24T13:18:17.2498181Z,2021,40,9,35,21,0,2do,1,0,19,0,0,31,5,0,39,0,0,0
30239,31790,2021-06-24T13:18:17.2498181Z,2021,48,20,46,26,0,3ro,3,0,22,0,0,28,2,0,44,0,0,1
30239,31791,2021-06-24T13:18:17.2498181Z,2021,48,18,47,31,0,4to,2,0,17,0,0,30,1,0,46,1,0,0
30239,31792,2021-06-24T13:18:17.2498181Z,2021,52,14,48,24,0,5to,1,0,28,0,0,38,4,0,51,0,0,0
30239,31793,2021-06-24T13:18:17.2498181Z,2021,43,13,42,18,0,K,1,0,25,0,0,30,1,0,41,0,0,1
30239,7791,2020-11-18T16:21:47.9249881Z,2020,42,10,37,23,0,1ro,0,0,19,0,0,32,5,0,41,0,0,1
30239,7792,2020-11-18T16:21:47.9259894Z,2020,49,16,41,26,0,2do,3,0,23,0,0,33,8,0,45,0,0,1
30239,7793,2020-11-18T16:21:47.9259894Z,2020,50,17,47,31,0,3ro,2,0,19,0,0,33,3,0,48,1,0,0
30239,7794,2020-11-18T16:21:47.9259894Z,2020,60,20,54,28,0,4to,1,0,32,0,0,40,6,0,59,0,0,0
30239,7795,2020-11-18T16:21:47.9259894Z,2020,38,6,31,19,0,5to,0,0,19,0,0,32,7,0,37,0,0,1
30239,7796,2020-11-18T16:21:47.9259894Z,2020,52,16,51,18,0,K,0,0,34,0,0,36,1,1,51,0,0,0
12336,30333,2021-06-24T13:18:08.8537986Z,2021,8,3,7,4,0,1ro,1,0,4,0,0,5,1,0,7,0,0,0
12336,30334,2021-06-24T13:18:08.8537986Z,2021,16,5,14,9,0,2do,0,0,7,0,0,11,2,2,14,0,0,0
12336,30335,2021-06-24T13:18:08.8537986Z,2021,8,3,8,6,0,3ro,0,0,2,0,0,5,0,3,5,0,0,0
12336,30336,2021-06-24T13:18:08.8547982Z,2021,17,6,16,10,0,4to,0,0,7,0,0,11,1,0,17,0,0,0
12336,30337,2021-06-24T13:18:08.8547982Z,2021,15,3,14,8,0,5to,0,0,7,0,0,12,1,0,15,0,0,0
12336,30338,2021-06-24T13:18:08.8547982Z,2021,10,8,10,3,0,6to,0,0,7,0,0,2,0,0,10,0,0,0
12336,30339,2021-06-24T13:18:08.8547982Z,2021,11,3,11,4,0,7mo,0,0,7,0,0,8,0,0,11,0,0,0
12336,30340,2021-06-24T13:18:08.8557991Z,2021,14,1,13,10,0,8vo,0,0,4,0,0,13,1,0,14,0,0,0
12336,30341,2021-06-24T13:18:08.8557991Z,2021,11,3,11,5,0,K,0,0,6,0,0,8,0,3,8,0,0,0
12336,335,2020-11-18T16:20:39.6364534Z,2019,8,2,7,5,0,1ro,0,0,3,0,0,6,1,6,2,0,0,0
12336,336,2020-11-18T16:20:39.6364534Z,2019,14,6,14,9,0,2do,0,0,5,0,0,8,0,0,14,0,0,0
12336,337,2020-11-18T16:20:39.6364534Z,2019,13,3,12,6,0,3ro,0,0,7,0,0,10,1,0,13,0,0,0
12336,338,2020-11-18T16:20:39.6374534Z,2019,10,6,9,2,0,4to,0,0,8,0,0,4,1,0,10,0,0,0
12336,339,2020-11-18T16:20:39.6374534Z,2019,11,4,9,4,0,5to,0,0,7,0,0,7,2,0,11,0,0,0
12336,340,2020-11-18T16:20:39.6374534Z,2019,16,1,14,10,0,6to,0,0,6,0,0,15,2,0,16,0,0,0
12336,341,2020-11-18T16:20:39.6384547Z,2019,12,3,9,4,0,7mo,0,0,8,0,0,9,3,0,12,0,0,0
12336,342,2020-11-18T16:20:39.6384547Z,2019,16,5,15,4,0,8vo,0,0,12,0,0,11,1,0,16,0,0,0
12336,343,2020-11-18T16:20:39.6384547Z,2019,14,3,9,7,0,K,0,0,7,0,0,11,5,2,12,0,0,0
12336,6336,2020-11-18T16:21:39.2411998Z,2020,15,4,11,8,0,1ro,0,0,7,0,0,11,4,2,13,0,0,0
12336,6337,2020-11-18T16:21:39.2411998Z,2020,7,3,6,5,0,2do,0,0,2,0,0,4,1,3,4,0,0,0
12336,6338,2020-11-18T16:21:39.2411998Z,2020,16,6,16,10,0,3ro,0,0,6,0,0,10,0,0,16,0,0,0
12336,6339,2020-11-18T16:21:39.2422007Z,2020,12,3,12,5,0,4to,0,0,7,0,0,9,0,0,12,0,0,0
12336,6340,2020-11-18T16:21:39.2422007Z,2020,12,8,12,3,0,5to,0,0,9,0,0,4,0,0,12,0,0,0
12336,6341,2020-11-18T16:21:39.2422007Z,2020,12,4,10,5,0,6to,0,0,7,0,0,8,2,0,12,0,0,0
12336,6342,2020-11-18T16:21:39.2432011Z,2020,15,1,13,9,0,7mo,0,0,6,0,0,14,2,0,15,0,0,0
12336,6343,2020-11-18T16:21:39.2432011Z,2020,11,2,8,4,0,8vo,0,0,7,0,0,9,3,0,11,0,0,0
12336,6344,2020-11-18T16:21:39.2432011Z,2020,10,1,7,6,0,K,0,0,4,0,0,9,3,0,10,0,0,0
62950,10552,2020-11-18T16:22:04.9233245Z,2020,62,13,53,30,0,10mo,12,0,32,0,0,49,9,0,50,0,0,0
62950,10553,2020-11-18T16:22:04.9233245Z,2020,63,16,52,33,0,11mo,10,4,30,0,0,47,11,0,53,0,0,0
62950,10554,2020-11-18T16:22:04.9233245Z,2020,61,12,47,33,0,12mo,12,1,28,0,0,49,14,0,49,0,0,0
62950,10555,2020-11-18T16:22:04.9233245Z,2020,46,16,42,21,0,6to,4,0,25,0,0,30,4,3,39,0,0,0
62950,10556,2020-11-18T16:22:04.9233245Z,2020,63,30,59,34,0,7mo,4,1,29,0,0,33,4,0,59,0,0,0
62950,10557,2020-11-18T16:22:04.9243254Z,2020,55,23,48,29,0,8vo,4,1,26,0,0,32,7,0,51,1,0,0
62950,10558,2020-11-18T16:22:04.9243254Z,2020,70,22,64,37,0,9no,14,1,33,0,0,48,6,0,56,0,0,0
62950,34566,2021-06-24T13:18:40.2343064Z,2021,59,19,57,33,0,10mo,13,1,26,0,0,40,2,0,46,0,0,0
62950,34567,2021-06-24T13:18:40.2343064Z,2021,55,11,51,26,0,11mo,11,0,29,0,0,44,4,0,44,0,0,0
62950,34568,2021-06-24T13:18:40.2343064Z,2021,57,14,48,31,0,12mo,9,3,26,0,0,43,9,0,48,0,0,0
62950,34569,2021-06-24T13:18:40.2353069Z,2021,30,10,29,18,0,6to,4,0,12,0,0,20,1,0,26,0,0,0
62950,34570,2021-06-24T13:18:40.2353069Z,2021,38,17,36,22,0,7mo,2,0,16,0,0,21,2,2,34,0,0,0
62950,34571,2021-06-24T13:18:40.2353069Z,2021,50,26,47,27,0,8vo,3,1,23,0,0,24,3,0,47,0,0,0
62950,34572,2021-06-24T13:18:40.2353069Z,2021,52,20,48,29,0,9no,5,1,23,0,0,32,4,0,47,1,0,0
62950,4540,2020-11-18T16:21:10.8422608Z,2019,104,26,78,47,0,10mo,16,0,57,0,0,78,26,0,88,0,0,0
62950,4541,2020-11-18T16:21:10.8422608Z,2019,79,16,59,47,0,11mo,11,0,32,0,0,63,20,0,68,0,0,0
62950,4542,2020-11-18T16:21:10.8422608Z,2019,77,1,57,46,0,12mo,6,0,31,0,0,76,20,2,68,0,0,1
62950,4543,2020-11-18T16:21:10.8422608Z,2019,58,30,52,31,0,6to,2,0,27,0,0,28,6,0,56,0,0,0
62950,4544,2020-11-18T16:21:10.8432617Z,2019,66,25,58,32,0,7mo,4,0,34,0,0,41,8,0,62,1,0,0
62950,4545,2020-11-18T16:21:10.8432617Z,2019,61,18,53,35,0,8vo,12,0,26,0,0,43,8,0,49,0,0,0
62950,4546,2020-11-18T16:21:10.8432617Z,2019,90,24,68,34,0,9no,12,1,56,0,0,66,22,1,75,1,0,2
62950,4547,2020-11-18T16:21:10.8442626Z,2019,33,28,30,7,0,Sin Grado,4,0,26,0,0,5,3,0,29,0,0,0
41921,2712,2020-11-18T16:20:58.7451918Z,2019,25,7,21,10,0,1ro,0,0,15,0,0,18,4,0,25,0,0,0
41921,2713,2020-11-18T16:20:58.7451918Z,2019,14,5,12,6,0,2do,0,0,8,0,0,9,2,0,14,0,0,0
41921,2714,2020-11-18T16:20:58.7451918Z,2019,16,7,15,9,0,3ro,1,0,7,0,0,9,1,0,15,0,0,0
41921,2715,2020-11-18T16:20:58.7451918Z,2019,22,9,16,9,0,4to,0,0,13,0,0,13,6,0,22,1,0,0
41921,2716,2020-11-18T16:20:58.7451918Z,2019,19,7,19,8,0,5to,0,0,11,0,0,12,0,0,19,0,0,0
41921,2717,2020-11-18T16:20:58.7461927Z,2019,34,12,32,16,0,6to,1,0,18,0,0,22,2,0,33,1,0,0
41921,2718,2020-11-18T16:20:58.7461927Z,2019,38,10,34,15,0,7mo,0,0,23,0,0,28,4,0,38,0,0,0
41921,2719,2020-11-18T16:20:58.7461927Z,2019,45,11,33,21,0,8vo,2,0,24,0,0,34,12,0,43,0,0,0
41921,2720,2020-11-18T16:20:58.7471944Z,2019,16,5,16,10,0,K,0,0,6,0,0,11,0,0,16,1,0,0
41921,2721,2020-11-18T16:20:58.7471944Z,2019,12,12,12,5,0,Sin Grado,1,0,7,0,0,0,0,0,11,0,0,0
41921,32719,2021-06-24T13:18:27.1309101Z,2021,15,2,15,7,0,1ro,0,0,8,0,0,13,0,0,15,0,0,0
41921,32720,2021-06-24T13:18:27.1309101Z,2021,20,10,19,9,0,2do,0,0,11,0,0,10,1,0,20,1,0,0
41921,32721,2021-06-24T13:18:27.1309101Z,2021,20,3,19,8,0,3ro,0,0,12,0,0,17,1,0,20,0,0,0
41921,32722,2021-06-24T13:18:27.1319111Z,2021,17,7,15,6,0,4to,1,0,11,0,0,10,2,0,16,0,0,0
41921,32723,2021-06-24T13:18:27.1319111Z,2021,13,7,12,5,0,5to,1,0,8,0,0,6,1,0,12,0,1,0
41921,32724,2021-06-24T13:18:27.1319111Z,2021,46,17,38,26,0,6to,2,0,20,0,0,29,8,0,44,1,0,0
41921,32725,2021-06-24T13:18:27.132912Z,2021,30,10,28,11,0,7mo,0,0,19,0,0,20,2,0,30,0,0,0
41921,32726,2021-06-24T13:18:27.132912Z,2021,28,8,28,15,0,8vo,0,0,13,0,0,20,0,0,28,1,0,0
41921,32727,2021-06-24T13:18:27.132912Z,2021,7,1,7,3,0,K,0,0,4,0,0,6,0,0,7,0,0,0
41921,32728,2021-06-24T13:18:27.132912Z,2021,8,8,8,4,0,Sin Grado,0,0,4,0,0,0,0,0,8,0,0,0
41921,8723,2020-11-18T16:21:53.7999065Z,2020,18,9,18,9,0,1ro,0,0,9,0,0,9,0,0,18,1,0,0
41921,8724,2020-11-18T16:21:53.7999065Z,2020,22,4,17,9,0,2do,0,0,13,0,0,18,5,0,22,0,0,0
41921,8725,2020-11-18T16:21:53.7999065Z,2020,16,5,14,6,0,3ro,1,0,10,0,0,11,2,0,15,0,0,0
41921,8726,2020-11-18T16:21:53.7999065Z,2020,17,8,16,8,0,4to,1,0,9,0,0,9,1,0,16,0,0,0
41921,8727,2020-11-18T16:21:53.8009083Z,2020,28,13,21,13,0,5to,0,0,15,0,0,15,7,0,28,1,0,0
41921,8728,2020-11-18T16:21:53.8009083Z,2020,32,9,28,12,0,6to,0,0,20,0,0,23,4,0,32,0,0,0
41921,8729,2020-11-18T16:21:53.8009083Z,2020,28,8,23,18,0,7mo,1,0,10,0,0,20,5,0,27,1,0,0
41921,8730,2020-11-18T16:21:53.8019083Z,2020,35,8,31,16,0,8vo,1,0,19,0,0,27,4,0,34,0,0,0
41921,8731,2020-11-18T16:21:53.8019083Z,2020,15,2,13,8,0,K,0,0,7,0,0,13,2,0,15,0,0,0
41921,8732,2020-11-18T16:21:53.8019083Z,2020,13,13,12,6,0,Sin Grado,0,0,7,0,0,0,1,0,13,0,0,0
28365,1692,2020-11-18T16:20:48.2742127Z,2019,49,19,41,28,0,1ro,0,5,21,0,0,30,8,0,49,0,0,0
28365,1693,2020-11-18T16:20:48.2752136Z,2019,52,19,42,27,0,2do,0,7,25,0,0,33,10,0,52,0,0,0
28365,1694,2020-11-18T16:20:48.2752136Z,2019,57,21,45,30,0,3ro,1,4,27,0,0,36,12,0,56,0,0,0
28365,1695,2020-11-18T16:20:48.2752136Z,2019,49,17,38,19,0,4to,0,3,30,0,0,32,11,0,49,0,0,0
28365,1696,2020-11-18T16:20:48.2752136Z,2019,63,29,45,28,0,5to,4,4,35,0,0,34,18,0,59,0,0,0
28365,1697,2020-11-18T16:20:48.2752136Z,2019,50,24,41,23,0,K,1,2,27,0,0,26,9,0,49,0,0,0
28365,1698,2020-11-18T16:20:48.276214Z,2019,15,5,8,9,0,PK,1,1,6,0,0,10,7,0,14,0,0,0
28365,1699,2020-11-18T16:20:48.276214Z,2019,5,5,5,0,1,Sin Grado,0,0,5,0,0,0,0,0,5,0,0,0
28365,31694,2021-06-24T13:18:16.127013Z,2021,33,8,29,14,0,1ro,0,0,19,0,0,25,4,0,33,0,0,0
28365,31695,2021-06-24T13:18:16.1280135Z,2021,44,11,38,18,0,2do,1,0,26,0,0,33,6,0,43,0,0,0
28365,31696,2021-06-24T13:18:16.1290144Z,2021,57,14,51,34,0,3ro,0,2,23,0,0,43,6,0,57,0,0,0
28365,31697,2021-06-24T13:18:16.1290144Z,2021,51,18,43,25,0,4to,0,0,26,0,0,33,8,0,51,0,0,0
28365,31698,2021-06-24T13:18:16.1300154Z,2021,46,18,40,27,0,5to,1,0,19,0,0,28,6,0,45,0,0,0
28365,31699,2021-06-24T13:18:16.1300154Z,2021,49,10,40,14,0,K,1,0,35,0,0,39,9,0,48,0,0,0
28365,31700,2021-06-24T13:18:17.1117204Z,2021,16,2,15,8,0,PK,0,0,8,0,0,14,1,0,16,0,0,0
28365,31701,2021-06-24T13:18:17.1127209Z,2021,5,5,5,1,0,Sin Grado,0,0,4,0,0,0,0,0,5,0,0,0
28365,7697,2020-11-18T16:21:47.2065099Z,2020,41,13,35,18,0,1ro,0,0,23,0,0,28,6,0,41,0,0,0
28365,7698,2020-11-18T16:21:47.2065099Z,2020,54,15,48,28,0,2do,0,0,26,0,0,39,6,0,54,0,0,0
28365,7699,2020-11-18T16:21:47.2065099Z,2020,55,21,44,25,0,3ro,0,0,30,0,0,34,11,0,55,0,0,0
28365,7700,2020-11-18T16:21:47.2075104Z,2020,49,18,34,27,0,4to,1,0,22,0,0,31,15,0,48,0,0,0
28365,7701,2020-11-18T16:21:47.8989712Z,2020,41,16,30,16,0,5to,0,0,25,0,0,25,11,0,41,0,0,0
28365,7702,2020-11-18T16:21:47.8989712Z,2020,43,13,36,18,0,K,0,0,25,0,0,30,7,0,43,0,0,0
28365,7703,2020-11-18T16:21:47.8989712Z,2020,15,0,7,5,0,PK,0,0,10,0,0,15,8,0,15,0,0,0
28365,7704,2020-11-18T16:21:47.8989712Z,2020,9,9,9,1,0,Sin Grado,0,0,8,0,0,0,0,0,9,0,0,0
65995,10739,2020-11-18T16:22:06.0190567Z,2020,98,21,85,67,0,6to,10,0,31,0,0,77,13,0,88,0,1,0
65995,10740,2020-11-18T16:22:06.0190567Z,2020,107,27,83,54,0,7mo,7,2,53,0,0,80,24,0,99,0,0,1
65995,10741,2020-11-18T16:22:06.0190567Z,2020,96,18,74,39,0,8vo,8,1,57,0,0,78,22,0,88,0,0,0
65995,34756,2021-06-24T13:18:41.4761967Z,2021,88,25,76,43,0,6to,6,0,45,0,0,63,12,0,82,0,0,0
65995,34757,2021-06-24T13:18:41.4761967Z,2021,95,22,82,61,0,7mo,8,0,34,0,0,73,13,0,87,0,0,0
65995,34758,2021-06-24T13:18:41.4771972Z,2021,102,25,84,50,0,8vo,7,0,52,0,0,77,18,0,95,0,0,0
65995,4730,2020-11-18T16:21:11.9169796Z,2019,114,30,89,57,0,6to,6,1,57,0,0,84,25,0,108,0,0,0
65995,4731,2020-11-18T16:21:11.9169796Z,2019,99,21,77,43,0,7mo,8,0,56,0,0,78,22,0,91,0,0,0
65995,4732,2020-11-18T16:21:11.9169796Z,2019,148,35,106,79,0,8vo,10,0,69,0,0,113,42,0,138,0,1,0
61515,10269,2020-11-18T16:22:03.1301267Z,2020,51,12,33,31,0,1ro,2,0,20,0,0,39,18,0,49,0,0,0
61515,10270,2020-11-18T16:22:03.1311285Z,2020,41,8,34,21,0,2do,3,0,20,0,0,33,7,0,38,0,0,0
61515,10271,2020-11-18T16:22:03.1311285Z,2020,38,16,32,19,0,3ro,2,0,19,0,0,22,6,0,36,0,0,0
61515,10272,2020-11-18T16:22:03.1311285Z,2020,44,10,35,18,0,4to,3,0,26,0,0,34,9,0,41,0,0,0
61515,10273,2020-11-18T16:22:03.1311285Z,2020,51,21,45,24,0,5to,6,0,27,0,0,30,6,0,43,0,0,2
61515,10274,2020-11-18T16:22:03.1311285Z,2020,34,8,30,18,0,K,0,0,16,0,0,26,4,0,34,0,0,0
61515,34284,2021-06-24T13:18:38.1187891Z,2021,34,7,29,19,0,1ro,0,0,15,0,0,27,5,0,34,0,0,0
61515,34285,2021-06-24T13:18:38.1187891Z,2021,45,14,42,28,0,2do,2,0,17,0,0,31,3,0,43,0,0,0
61515,34286,2021-06-24T13:18:38.1197896Z,2021,36,10,27,19,0,3ro,3,0,17,0,0,26,9,0,33,0,0,0
61515,34287,2021-06-24T13:18:38.1197896Z,2021,39,15,35,20,0,4to,1,0,19,0,0,24,4,0,38,0,0,0
61515,34288,2021-06-24T13:18:38.12079Z,2021,46,11,41,23,0,5to,3,0,23,0,0,35,5,0,43,0,0,0
61515,34289,2021-06-24T13:18:38.12079Z,2021,23,6,12,10,0,K,1,0,13,0,0,17,11,0,22,0,0,0
61515,4254,2020-11-18T16:21:09.0200481Z,2019,45,13,39,25,0,1ro,4,0,20,0,0,32,6,0,41,0,0,0
61515,4255,2020-11-18T16:21:09.021049Z,2019,37,16,34,18,0,2do,1,0,19,0,0,21,3,0,36,0,0,0
61515,4256,2020-11-18T16:21:09.021049Z,2019,37,8,34,18,0,3ro,3,0,19,0,0,29,3,0,34,0,0,0
61515,4257,2020-11-18T16:21:09.021049Z,2019,57,22,50,28,0,4to,7,0,29,0,0,35,7,0,49,0,0,1
61515,4258,2020-11-18T16:21:09.021049Z,2019,38,15,31,21,0,5to,2,0,17,0,0,23,7,0,36,0,0,0
61515,4259,2020-11-18T16:21:09.021049Z,2019,1,0,1,0,0,6to,0,0,1,0,0,1,0,0,1,0,0,0
61515,4260,2020-11-18T16:21:09.0220495Z,2019,30,6,1,18,0,K,2,0,12,0,0,24,29,0,28,0,0,0
62877,10500,2020-11-18T16:22:04.1528107Z,2020,32,7,31,14,0,10mo,4,0,18,0,0,25,1,0,28,0,0,0
62877,10501,2020-11-18T16:22:04.9063129Z,2020,49,11,45,26,0,11mo,12,1,23,0,0,38,4,0,37,0,0,0
62877,10502,2020-11-18T16:22:04.9063129Z,2020,53,13,42,31,0,12mo,10,0,22,0,0,40,11,0,43,0,0,0
62877,10503,2020-11-18T16:22:04.9073143Z,2020,59,14,57,33,0,9no,2,1,26,0,0,45,2,0,57,0,0,0
62877,10504,2020-11-18T16:22:04.9073143Z,2020,60,58,59,14,0,Sin Grado,0,0,46,0,0,2,1,0,60,0,0,0
62877,34513,2021-06-24T13:18:40.1992807Z,2021,59,15,58,30,0,10mo,3,0,29,0,0,44,1,0,56,0,0,0
62877,34514,2021-06-24T13:18:40.1992807Z,2021,37,8,37,19,0,11mo,7,0,18,0,0,29,0,0,30,0,0,0
62877,34515,2021-06-24T13:18:40.2002816Z,2021,43,8,39,23,0,12mo,11,0,20,0,0,35,4,0,32,0,0,0
62877,34516,2021-06-24T13:18:40.2002816Z,2021,52,17,49,34,0,9no,5,0,18,0,0,35,3,0,47,0,0,0
62877,34517,2021-06-24T13:18:40.2002816Z,2021,63,62,59,16,0,Sin Grado,0,1,47,0,0,1,4,0,63,0,0,0
62877,4490,2020-11-18T16:21:10.1487978Z,2019,49,9,44,27,0,10mo,8,0,22,0,0,40,5,0,41,0,0,0
62877,4491,2020-11-18T16:21:10.1487978Z,2019,61,13,47,41,0,11mo,9,2,20,0,0,48,14,1,51,0,0,0
62877,4492,2020-11-18T16:21:10.1487978Z,2019,60,0,54,32,0,12mo,6,0,28,0,0,60,6,0,54,0,0,0
62877,4493,2020-11-18T16:21:10.1487978Z,2019,62,12,58,33,0,9no,7,0,29,0,0,50,4,0,55,0,0,0
62877,4494,2020-11-18T16:21:10.1497987Z,2019,59,23,56,14,0,Sin Grado,0,0,45,0,0,36,3,0,59,0,0,0
20982,1116,2020-11-18T16:20:44.6247778Z,2019,186,28,135,97,0,10mo,1,4,89,0,0,158,51,0,185,0,2,0
20982,1117,2020-11-18T16:20:44.6247778Z,2019,136,25,101,81,0,11mo,2,1,55,0,0,111,35,0,134,0,0,0
20982,1118,2020-11-18T16:20:44.6247778Z,2019,180,1,117,81,0,12mo,3,2,99,0,0,179,63,0,176,0,0,1
20982,1119,2020-11-18T16:20:44.6247778Z,2019,214,57,152,113,0,9no,2,1,101,0,0,157,62,0,212,0,1,0
20982,1120,2020-11-18T16:20:44.6247778Z,2019,13,8,9,0,0,Sin Grado,0,0,13,0,0,5,4,0,13,0,0,0
20982,31117,2021-06-24T13:18:13.0588143Z,2021,212,55,165,114,0,10mo,1,1,98,0,0,157,47,0,211,1,0,0
20982,31118,2021-06-24T13:18:13.0598139Z,2021,204,49,144,111,0,11mo,2,1,93,0,0,155,60,0,202,0,1,0
20982,31119,2021-06-24T13:18:13.0598139Z,2021,170,26,122,91,0,12mo,0,0,79,0,0,144,48,0,170,0,1,0
20982,31120,2021-06-24T13:18:13.0598139Z,2021,205,40,161,106,0,9no,1,0,99,0,0,165,44,0,204,2,2,0
20982,31121,2021-06-24T13:18:13.0608153Z,2021,11,11,7,1,0,Sin Grado,0,0,10,0,0,0,4,0,11,0,0,0
20982,7121,2020-11-18T16:21:44.191501Z,2020,217,53,143,121,0,10mo,2,5,96,0,0,164,74,0,215,0,1,0
20982,7122,2020-11-18T16:21:44.191501Z,2020,173,26,122,92,0,11mo,0,1,81,0,0,147,51,0,173,0,1,0
20982,7123,2020-11-18T16:21:44.191501Z,2020,133,25,73,81,0,12mo,2,1,52,0,0,108,60,0,131,0,0,0
20982,7124,2020-11-18T16:21:44.1925015Z,2020,214,57,165,111,0,9no,1,0,103,0,0,157,49,0,213,1,0,0
20982,7125,2020-11-18T16:21:44.1925015Z,2020,12,12,7,1,0,Sin Grado,0,0,11,0,0,0,5,0,12,0,0,0
63149,10625,2020-11-18T16:22:05.3335986Z,2020,5,2,5,3,0,10mo,0,1,2,0,0,3,0,0,5,1,0,0
63149,10626,2020-11-18T16:22:05.3345995Z,2020,56,25,51,24,0,6to,7,0,32,0,0,31,5,0,49,0,0,0
63149,10627,2020-11-18T16:22:05.3345995Z,2020,77,34,74,35,0,7mo,3,0,42,0,0,43,3,0,74,0,0,0
63149,10628,2020-11-18T16:22:05.3345995Z,2020,60,17,56,35,0,8vo,2,0,25,0,0,43,4,0,58,0,0,0
63149,10629,2020-11-18T16:22:05.3345995Z,2020,45,22,40,23,0,9no,1,0,22,0,0,23,5,0,44,0,0,0
63149,34640,2021-06-24T13:18:41.0879183Z,2021,16,7,15,5,0,10mo,1,0,11,0,0,9,1,0,15,0,0,0
63149,34641,2021-06-24T13:18:41.0889184Z,2021,42,22,42,21,0,6to,0,0,21,0,0,20,0,0,41,0,0,1
63149,34642,2021-06-24T13:18:41.0889184Z,2021,71,34,69,35,0,7mo,3,0,36,0,0,37,2,0,68,0,0,0
63149,34643,2021-06-24T13:18:41.0889184Z,2021,71,32,68,34,0,8vo,3,1,37,0,0,39,3,0,68,0,0,0
63149,34644,2021-06-24T13:18:41.0889184Z,2021,38,12,36,21,0,9no,1,0,17,0,0,26,2,0,37,0,0,0
63149,34645,2021-06-24T13:18:41.0889184Z,2021,11,11,10,7,0,Sin Grado,0,0,4,0,0,0,1,0,11,0,0,0
63149,4614,2020-11-18T16:21:11.2465309Z,2019,5,4,5,2,0,10mo,0,0,3,0,0,1,0,0,5,0,0,0
63149,4615,2020-11-18T16:21:11.2465309Z,2019,43,18,41,20,0,6to,2,1,23,0,0,25,2,0,41,0,0,0
63149,4616,2020-11-18T16:21:11.2465309Z,2019,62,16,60,32,0,7mo,1,1,30,0,0,46,2,0,61,0,0,0
63149,4617,2020-11-18T16:21:11.2465309Z,2019,50,20,45,23,0,8vo,1,0,27,0,0,30,5,0,49,0,0,0
63149,4618,2020-11-18T16:21:11.2465309Z,2019,33,11,31,22,0,9no,0,0,11,0,0,22,2,0,33,0,0,0
70243,10931,2020-11-18T16:22:07.2038449Z,2020,45,12,44,30,0,1ro,1,5,15,0,0,33,1,0,44,0,0,0
70243,10932,2020-11-18T16:22:07.2038449Z,2020,61,37,57,27,0,2do,0,4,34,0,0,24,4,0,61,0,0,0
70243,10933,2020-11-18T16:22:07.2038449Z,2020,43,18,35,16,0,3ro,2,2,27,0,0,25,8,0,41,0,0,0
70243,10934,2020-11-18T16:22:07.2038449Z,2020,51,17,46,27,0,4to,2,7,24,0,0,34,5,0,49,0,0,0
70243,10935,2020-11-18T16:22:07.2048466Z,2020,55,22,46,28,0,5to,1,3,27,0,0,33,9,0,54,0,0,0
70243,10936,2020-11-18T16:22:07.2048466Z,2020,66,15,54,40,0,K,1,2,26,0,0,51,12,0,65,0,0,0
70243,10937,2020-11-18T16:22:07.2048466Z,2020,74,71,69,16,0,Sin Grado,2,5,58,0,0,3,5,0,72,0,0,0
70243,34952,2021-06-24T13:18:43.3455372Z,2021,65,15,59,35,0,1ro,2,0,30,0,0,50,6,0,63,0,0,0
70243,34953,2021-06-24T13:18:43.3455372Z,2021,44,19,42,31,0,2do,0,0,13,0,0,25,2,0,44,0,0,0
70243,34954,2021-06-24T13:18:43.3465372Z,2021,68,36,61,31,0,3ro,0,0,37,0,0,32,7,0,68,0,0,0
70243,34955,2021-06-24T13:18:43.3465372Z,2021,48,22,46,20,0,4to,2,0,28,0,0,26,2,0,46,0,0,0
70243,34956,2021-06-24T13:18:43.3465372Z,2021,58,17,54,32,0,5to,4,0,26,0,0,41,4,0,54,0,0,0
70243,34957,2021-06-24T13:18:43.3465372Z,2021,70,18,52,28,0,K,1,0,42,0,0,52,18,0,69,0,0,0
70243,34958,2021-06-24T13:18:43.3475381Z,2021,64,61,58,16,0,Sin Grado,1,0,48,0,0,3,6,0,63,0,0,0
70243,4923,2020-11-18T16:21:12.9966998Z,2019,74,41,69,34,0,1ro,1,0,40,0,0,33,5,0,73,0,0,0
70243,4924,2020-11-18T16:21:12.9966998Z,2019,46,22,38,18,0,2do,2,0,28,0,0,24,8,0,44,0,0,0
70243,4925,2020-11-18T16:21:12.9966998Z,2019,50,20,44,25,0,3ro,1,0,25,0,0,30,6,0,49,0,0,0
70243,4926,2020-11-18T16:21:12.9966998Z,2019,60,24,47,34,0,4to,2,0,26,0,0,36,13,0,58,0,0,0
70243,4927,2020-11-18T16:21:12.9977007Z,2019,62,26,55,30,0,5to,1,0,32,0,0,36,7,0,61,0,0,0
70243,4928,2020-11-18T16:21:12.9977007Z,2019,50,12,46,35,0,K,1,0,15,0,0,38,4,0,49,0,0,0
70243,4929,2020-11-18T16:21:12.9977007Z,2019,72,71,66,17,0,Sin Grado,1,0,55,0,0,1,6,0,71,0,1,0
71084,11225,2020-11-18T16:22:09.5634177Z,2020,95,40,87,41,0,6to,1,0,54,0,0,55,8,0,94,0,0,0
71084,11226,2020-11-18T16:22:09.5644186Z,2020,73,23,66,37,0,7mo,1,0,36,0,0,50,7,1,71,0,0,0
71084,11227,2020-11-18T16:22:09.5644186Z,2020,91,34,76,45,0,8vo,1,0,46,0,0,57,15,0,88,0,0,2
71084,11228,2020-11-18T16:22:09.5644186Z,2020,47,47,43,17,0,Sin Grado,1,7,30,0,0,0,4,0,46,0,0,0
71084,35246,2021-06-24T13:18:44.8085862Z,2021,81,32,68,43,0,6to,0,0,38,0,0,49,13,0,81,0,0,0
71084,35247,2021-06-24T13:18:44.8085862Z,2021,93,39,79,41,0,7mo,1,0,52,0,0,54,14,0,92,0,0,0
71084,35248,2021-06-24T13:18:44.8085862Z,2021,68,20,54,36,0,8vo,1,0,32,0,0,48,14,0,66,0,0,1
71084,35249,2021-06-24T13:18:44.8085862Z,2021,34,34,33,10,0,Sin Grado,0,0,24,0,0,0,1,0,34,0,0,0
71084,5220,2020-11-18T16:21:14.4376587Z,2019,85,34,76,43,0,6to,3,4,42,0,0,51,9,0,82,0,0,0
71084,5221,2020-11-18T16:21:14.4386592Z,2019,85,29,70,41,0,7mo,1,3,44,0,0,56,15,1,81,0,0,2
71084,5222,2020-11-18T16:21:14.4386592Z,2019,137,45,119,76,1,8vo,1,6,61,0,0,92,18,0,136,1,0,0
71084,5223,2020-11-18T16:21:14.4386592Z,2019,47,45,43,15,0,Sin Grado,5,9,32,0,0,2,4,0,42,0,0,0
17459,30710,2021-06-24T13:18:11.174462Z,2021,42,9,39,26,0,1ro,0,0,16,0,0,33,3,0,41,0,0,1
17459,30711,2021-06-24T13:18:11.174462Z,2021,48,12,45,30,0,2do,0,0,18,0,0,36,3,0,48,0,0,0
17459,30712,2021-06-24T13:18:11.1754625Z,2021,36,9,35,21,0,3ro,0,0,15,0,0,27,1,0,36,0,0,0
17459,30713,2021-06-24T13:18:11.1754625Z,2021,37,12,33,14,0,4to,1,0,23,0,0,25,4,0,36,0,0,0
17459,30714,2021-06-24T13:18:11.1754625Z,2021,39,14,36,14,0,5to,0,0,25,0,0,25,3,0,39,0,0,0
17459,30715,2021-06-24T13:18:11.1764634Z,2021,32,8,30,15,0,K,0,0,17,0,0,24,2,0,32,0,0,0
17459,30716,2021-06-24T13:18:11.1764634Z,2021,10,1,10,5,0,PK,0,0,5,0,0,9,0,0,10,0,0,0
17459,30717,2021-06-24T13:18:11.1774643Z,2021,4,4,4,1,0,Sin Grado,0,0,3,0,0,0,0,0,4,0,0,0
17459,6712,2020-11-18T16:21:41.4336624Z,2020,47,12,41,29,0,1ro,0,0,18,0,0,35,6,0,46,0,0,1
17459,6713,2020-11-18T16:21:41.434662Z,2020,30,4,29,18,0,2do,0,0,12,0,0,26,1,0,30,0,0,0
17459,6714,2020-11-18T16:21:41.434662Z,2020,39,13,33,15,0,3ro,1,0,24,0,0,26,6,0,38,0,0,0
17459,6715,2020-11-18T16:21:41.434662Z,2020,40,16,36,17,0,4to,0,0,23,0,0,24,4,0,40,0,0,0
17459,6716,2020-11-18T16:21:41.434662Z,2020,49,27,48,20,0,5to,2,0,29,0,0,22,1,0,47,0,0,0
17459,6717,2020-11-18T16:21:41.4356628Z,2020,42,6,38,28,0,K,0,0,14,0,0,36,4,0,42,0,0,0
17459,6718,2020-11-18T16:21:41.4356628Z,2020,13,0,10,8,0,PK,0,0,5,0,0,13,3,0,13,0,0,0
17459,6719,2020-11-18T16:21:41.4356628Z,2020,7,5,7,1,0,Sin Grado,0,0,6,0,0,2,0,0,7,0,0,0
17459,711,2020-11-18T16:20:42.1040988Z,2019,38,8,36,23,0,1ro,0,0,15,0,0,30,2,0,38,0,0,0
17459,712,2020-11-18T16:20:42.1040988Z,2019,36,11,31,13,0,2do,0,0,23,0,0,25,5,0,36,0,0,0
17459,713,2020-11-18T16:20:42.1050987Z,2019,40,15,36,18,0,3ro,0,0,22,0,0,25,4,0,40,0,0,0
17459,714,2020-11-18T16:20:42.1050987Z,2019,41,20,37,18,0,4to,0,0,23,0,0,21,4,0,41,0,0,0
17459,715,2020-11-18T16:20:42.1050987Z,2019,36,17,31,16,0,5to,2,0,20,0,0,19,5,0,34,0,0,0
17459,716,2020-11-18T16:20:42.1050987Z,2019,49,14,43,34,0,K,0,0,15,0,0,35,6,0,49,0,0,0
17459,717,2020-11-18T16:20:42.1050987Z,2019,19,0,16,11,0,PK,0,0,8,0,0,19,3,0,19,0,0,0
17459,718,2020-11-18T16:20:42.1060992Z,2019,11,6,10,3,0,Sin Grado,0,0,8,0,0,5,1,0,11,0,0,0
47571,3134,2020-11-18T16:21:01.0237149Z,2019,24,14,21,11,0,1ro,0,0,13,0,0,10,3,0,24,0,0,0
47571,3135,2020-11-18T16:21:01.0237149Z,2019,26,12,23,17,0,2do,1,0,9,0,0,14,3,0,25,0,0,0
47571,3136,2020-11-18T16:21:01.0247154Z,2019,28,13,25,11,0,3ro,0,0,17,0,0,15,3,0,28,0,0,0
47571,3137,2020-11-18T16:21:01.0247154Z,2019,30,13,29,12,0,4to,0,0,18,0,0,17,1,0,30,0,0,0
47571,3138,2020-11-18T16:21:01.0247154Z,2019,32,17,27,7,0,5to,0,0,25,0,0,15,5,0,32,1,0,0
47571,3139,2020-11-18T16:21:01.0247154Z,2019,46,14,39,22,0,6to,1,0,24,0,0,32,7,0,45,0,1,0
47571,3140,2020-11-18T16:21:01.0247154Z,2019,40,19,32,21,0,7mo,2,0,19,0,0,21,8,0,38,0,0,0
47571,3141,2020-11-18T16:21:01.0257163Z,2019,42,13,36,20,0,8vo,0,1,22,0,0,29,6,0,42,0,0,0
47571,3142,2020-11-18T16:21:01.0257163Z,2019,18,5,15,4,0,K,1,0,14,0,0,13,3,0,17,0,0,0
47571,3143,2020-11-18T16:21:01.0257163Z,2019,7,2,6,5,0,PK,0,0,2,0,0,5,1,0,7,0,0,0
47571,33150,2021-06-24T13:18:30.3352078Z,2021,18,5,14,11,0,1ro,0,0,7,0,0,13,4,0,18,0,0,0
47571,33151,2021-06-24T13:18:30.3352078Z,2021,13,6,12,6,0,2do,0,0,7,0,0,7,1,0,13,0,0,0
47571,33152,2021-06-24T13:18:30.3352078Z,2021,20,11,17,6,0,3ro,0,0,14,0,0,9,3,0,20,0,0,0
47571,33153,2021-06-24T13:18:30.3362087Z,2021,19,10,19,9,0,4to,1,0,10,0,0,9,0,0,18,0,0,0
47571,33154,2021-06-24T13:18:30.3362087Z,2021,32,13,31,13,0,5to,0,0,19,0,0,19,1,0,31,0,0,1
47571,33155,2021-06-24T13:18:30.3362087Z,2021,31,16,27,12,0,6to,0,0,19,0,0,15,4,0,30,0,0,1
47571,33156,2021-06-24T13:18:30.3362087Z,2021,48,24,42,11,0,7mo,1,0,37,0,0,24,6,0,47,1,0,0
47571,33157,2021-06-24T13:18:30.3372097Z,2021,37,10,32,18,0,8vo,2,0,19,0,0,27,5,0,35,0,0,0
47571,33158,2021-06-24T13:18:30.3372097Z,2021,21,5,15,5,0,K,0,0,16,0,0,16,6,0,21,0,0,0
47571,33159,2021-06-24T13:18:30.3372097Z,2021,7,1,4,3,0,PK,0,0,4,0,0,6,3,0,7,0,0,0
47571,9148,2020-11-18T16:21:56.1444725Z,2020,13,6,10,6,0,1ro,0,0,7,0,0,7,3,0,13,0,0,0
47571,9149,2020-11-18T16:21:56.1454734Z,2020,20,11,18,6,0,2do,0,0,14,0,0,9,2,0,20,0,0,0
47571,9150,2020-11-18T16:21:56.1454734Z,2020,22,11,21,11,0,3ro,1,0,11,0,0,11,1,0,21,0,0,0
47571,9151,2020-11-18T16:21:56.1454734Z,2020,29,11,28,12,0,4to,0,0,17,0,0,18,1,0,29,0,0,0
47571,9152,2020-11-18T16:21:56.1454734Z,2020,27,12,23,11,0,5to,0,0,16,0,0,15,4,0,27,0,0,0
47571,9153,2020-11-18T16:21:56.1464738Z,2020,45,22,40,10,0,6to,1,0,35,0,0,23,5,0,44,1,0,0
47571,9154,2020-11-18T16:21:56.1464738Z,2020,38,14,31,18,0,7mo,1,0,20,0,0,24,7,0,37,0,0,0
47571,9155,2020-11-18T16:21:56.1464738Z,2020,30,10,21,16,0,8vo,2,0,14,0,0,20,9,0,28,0,0,0
47571,9156,2020-11-18T16:21:56.1464738Z,2020,16,2,13,11,0,K,0,0,5,0,0,14,3,0,16,0,0,0
47571,9157,2020-11-18T16:21:56.1464738Z,2020,13,2,10,4,0,PK,1,0,9,0,0,11,3,0,12,0,0,0
64949,10671,2020-11-18T16:22:05.3556146Z,2020,43,11,40,24,0,1ro,1,0,19,0,0,32,3,0,42,0,0,0
64949,10672,2020-11-18T16:22:05.3566151Z,2020,47,14,44,25,0,2do,2,0,22,0,0,33,3,0,45,0,0,0
64949,10673,2020-11-18T16:22:05.3566151Z,2020,45,18,42,19,0,3ro,1,0,26,0,0,27,3,0,44,0,0,0
64949,10674,2020-11-18T16:22:05.3566151Z,2020,37,16,31,20,0,4to,2,0,17,0,0,21,6,0,35,0,1,0
64949,10675,2020-11-18T16:22:05.3576146Z,2020,40,10,33,20,0,5to,1,0,20,0,0,30,7,0,37,0,0,2
64949,10676,2020-11-18T16:22:05.3576146Z,2020,53,5,49,27,0,K,2,0,26,0,0,48,4,0,51,0,0,0
64949,10677,2020-11-18T16:22:05.3576146Z,2020,9,9,7,4,0,Sin Grado,0,0,5,0,0,0,2,0,9,0,0,0
64949,34688,2021-06-24T13:18:41.1089332Z,2021,50,5,45,24,0,1ro,2,1,26,0,0,45,5,0,48,0,0,0
64949,34689,2021-06-24T13:18:41.1089332Z,2021,41,14,39,22,0,2do,1,0,19,0,0,27,2,0,40,0,0,0
64949,34690,2021-06-24T13:18:41.1089332Z,2021,49,14,44,24,0,3ro,2,0,25,0,0,35,5,0,47,0,0,0
64949,34691,2021-06-24T13:18:41.1099337Z,2021,43,19,38,19,0,4to,0,0,24,0,0,24,5,0,43,0,0,0
64949,34692,2021-06-24T13:18:41.1099337Z,2021,35,14,32,18,0,5to,2,0,17,0,0,21,3,0,33,0,0,0
64949,34693,2021-06-24T13:18:41.1099337Z,2021,26,3,22,17,0,K,1,0,9,0,0,23,4,1,24,0,0,0
64949,34694,2021-06-24T13:18:41.1099337Z,2021,4,4,4,1,0,Sin Grado,0,0,3,0,0,0,0,0,4,0,0,0
64949,4659,2020-11-18T16:21:11.2615407Z,2019,46,8,45,26,0,1ro,0,1,20,0,0,38,1,0,46,0,0,0
64949,4660,2020-11-18T16:21:11.2615407Z,2019,53,24,51,25,0,2do,3,0,28,0,0,29,2,0,50,0,0,0
64949,4661,2020-11-18T16:21:11.2615407Z,2019,39,16,38,22,1,3ro,2,0,17,0,0,23,1,0,37,0,1,0
64949,4662,2020-11-18T16:21:11.2615407Z,2019,36,11,33,20,1,4to,2,0,16,0,0,25,3,0,34,0,0,0
64949,4663,2020-11-18T16:21:11.2615407Z,2019,35,12,31,15,0,5to,0,1,20,0,0,23,4,0,35,0,0,0
64949,4664,2020-11-18T16:21:11.2625411Z,2019,44,5,40,24,0,K,2,0,20,0,0,39,4,0,42,0,0,0
64949,4665,2020-11-18T16:21:11.2625411Z,2019,12,12,12,5,0,Sin Grado,0,0,7,0,0,0,0,0,12,0,0,0
36327,2452,2020-11-18T16:20:56.2615398Z,2019,66,24,55,27,0,1ro,0,0,39,0,0,42,11,0,66,0,0,0
36327,2453,2020-11-18T16:20:56.2625403Z,2019,64,19,52,30,0,2do,0,0,34,0,0,45,12,0,64,0,0,0
36327,2454,2020-11-18T16:20:56.2625403Z,2019,55,18,43,31,0,3ro,3,0,24,0,0,37,12,0,52,0,0,0
36327,2455,2020-11-18T16:20:56.2635416Z,2019,36,9,28,18,0,4to,1,0,18,0,0,27,8,0,35,0,1,0
36327,2456,2020-11-18T16:20:56.2635416Z,2019,61,19,51,28,0,5to,1,1,33,0,0,42,10,0,60,0,0,0
36327,2457,2020-11-18T16:20:56.2635416Z,2019,70,18,56,40,0,K,3,0,30,0,0,52,14,0,67,0,0,0
36327,2458,2020-11-18T16:20:56.264542Z,2019,19,18,15,11,0,Sin Grado,0,0,8,0,0,1,4,0,19,0,1,0
36327,32459,2021-06-24T13:18:24.7211809Z,2021,54,8,50,28,0,1ro,0,0,26,0,0,46,4,0,54,0,0,0
36327,32460,2021-06-24T13:18:24.7211809Z,2021,55,25,47,25,0,2do,1,0,30,0,0,30,8,0,54,0,0,0
36327,32461,2021-06-24T13:18:24.7221818Z,2021,45,19,38,18,0,3ro,0,0,27,0,0,26,7,0,45,0,0,0
36327,32462,2021-06-24T13:18:24.7221818Z,2021,45,15,38,24,0,4to,0,0,21,0,0,30,7,0,45,0,0,0
36327,32463,2021-06-24T13:18:24.7221818Z,2021,38,13,31,22,0,5to,3,0,16,0,0,25,7,0,35,0,0,0
36327,32464,2021-06-24T13:18:24.7221818Z,2021,45,6,30,26,0,K,0,0,19,0,0,39,15,0,45,0,0,0
36327,32465,2021-06-24T13:18:24.7231823Z,2021,17,17,13,3,0,Sin Grado,0,1,14,0,0,0,4,0,17,0,0,0
36327,8464,2020-11-18T16:21:51.8045732Z,2020,67,20,55,31,0,1ro,3,0,36,0,0,47,12,0,64,0,0,0
36327,8465,2020-11-18T16:21:51.8055754Z,2020,60,22,44,27,0,2do,0,0,33,0,0,38,16,0,60,0,0,0
36327,8466,2020-11-18T16:21:51.8055754Z,2020,64,22,46,30,0,3ro,1,0,34,0,0,42,18,0,63,0,0,0
36327,8467,2020-11-18T16:21:51.8055754Z,2020,53,21,42,28,0,4to,2,0,25,0,0,32,11,0,51,0,0,0
36327,8468,2020-11-18T16:21:51.8065754Z,2020,40,11,31,22,0,5to,1,0,18,0,0,29,9,0,39,0,0,0
36327,8469,2020-11-18T16:21:51.8065754Z,2020,62,4,58,32,0,K,0,0,30,0,0,58,4,0,62,0,0,0
36327,8470,2020-11-18T16:21:51.8065754Z,2020,12,12,7,5,0,Sin Grado,0,0,7,0,0,0,5,0,12,0,0,0
52571,33591,2021-06-24T13:18:33.4224222Z,2021,38,8,37,13,0,1ro,0,0,25,0,0,30,1,0,38,0,0,0
52571,33592,2021-06-24T13:18:33.4234222Z,2021,38,14,37,17,0,2do,0,1,21,0,0,24,1,0,37,0,0,1
52571,33593,2021-06-24T13:18:33.4234222Z,2021,49,21,47,29,0,3ro,3,1,20,0,0,28,2,0,45,0,0,1
52571,33594,2021-06-24T13:18:33.4244254Z,2021,41,18,40,20,0,4to,3,1,21,0,0,23,1,0,38,0,0,0
52571,33595,2021-06-24T13:18:33.4244254Z,2021,39,13,39,21,0,5to,0,0,18,0,0,26,0,0,38,0,0,1
52571,33596,2021-06-24T13:18:33.4244254Z,2021,23,2,23,14,0,K,0,0,9,0,0,21,0,0,23,0,0,0
52571,33597,2021-06-24T13:18:33.4254236Z,2021,17,17,15,0,0,Sin Grado,0,1,17,0,0,0,2,0,17,0,0,0
52571,3566,2020-11-18T16:21:03.2732172Z,2019,76,26,70,41,0,1ro,3,0,35,0,0,50,6,0,72,0,0,1
52571,3567,2020-11-18T16:21:03.2742176Z,2019,62,27,56,30,0,2do,4,0,32,0,0,35,6,0,58,0,0,0
52571,3568,2020-11-18T16:21:03.2742176Z,2019,63,24,60,25,0,3ro,0,1,38,0,0,39,3,0,62,0,0,1
52571,3569,2020-11-18T16:21:03.2742176Z,2019,71,19,63,37,0,4to,2,1,34,0,0,52,8,0,69,0,0,0
52571,3570,2020-11-18T16:21:03.2742176Z,2019,44,18,41,18,0,5to,0,0,26,0,0,26,3,0,44,0,0,0
52571,3571,2020-11-18T16:21:03.2752181Z,2019,52,10,52,29,0,K,1,0,23,0,0,42,0,0,50,0,0,1
52571,3572,2020-11-18T16:21:03.2752181Z,2019,38,34,34,10,0,Sin Grado,0,1,28,0,0,4,4,0,38,0,0,0
52571,9585,2020-11-18T16:21:59.1024422Z,2020,45,15,44,23,0,1ro,1,0,22,0,0,30,1,0,43,0,0,1
52571,9586,2020-11-18T16:21:59.1024422Z,2020,67,26,62,43,0,2do,4,0,24,0,0,41,5,0,62,0,0,1
52571,9587,2020-11-18T16:21:59.1024422Z,2020,52,21,46,24,0,3ro,3,0,28,0,0,31,6,0,49,0,0,0
52571,9588,2020-11-18T16:21:59.1024422Z,2020,42,15,41,22,0,4to,0,0,20,0,0,27,1,0,41,0,0,1
52571,9589,2020-11-18T16:21:59.1024422Z,2020,55,17,48,29,0,5to,1,0,26,0,0,38,7,0,54,0,0,0
52571,9590,2020-11-18T16:21:59.1034431Z,2020,63,11,59,30,0,K,0,0,33,0,0,52,4,0,63,0,0,0
52571,9591,2020-11-18T16:21:59.1034431Z,2020,38,36,37,4,0,Sin Grado,0,0,34,0,0,2,1,0,38,0,0,0
50609,3286,2020-11-18T16:21:01.4700135Z,2019,20,11,14,5,0,1ro,0,0,15,0,0,9,6,0,20,0,0,0
50609,3287,2020-11-18T16:21:01.4710135Z,2019,22,8,20,13,0,2do,0,0,9,0,0,14,2,0,22,0,0,0
50609,3288,2020-11-18T16:21:01.4710135Z,2019,22,7,14,12,0,3ro,0,0,10,0,0,15,8,0,22,0,1,0
50609,3289,2020-11-18T16:21:01.4710135Z,2019,35,12,26,16,0,4to,0,0,19,0,0,23,9,0,35,0,0,0
50609,3290,2020-11-18T16:21:01.4720135Z,2019,33,10,24,11,0,5to,0,1,22,0,0,23,9,0,33,0,0,0
50609,3291,2020-11-18T16:21:01.4720135Z,2019,26,10,17,10,0,6to,0,0,16,0,0,16,9,0,26,0,2,0
50609,3292,2020-11-18T16:21:01.4730144Z,2019,23,6,19,12,0,7mo,0,0,11,0,0,17,4,0,23,0,0,0
50609,3293,2020-11-18T16:21:01.4730144Z,2019,36,15,28,18,0,8vo,0,0,18,0,0,21,8,0,36,0,0,0
50609,3294,2020-11-18T16:21:01.4740153Z,2019,29,16,22,15,0,K,0,0,14,0,0,13,7,0,29,0,0,0
50609,3295,2020-11-18T16:21:01.4740153Z,2019,27,27,17,6,0,Sin Grado,0,0,21,0,0,0,10,0,27,0,0,0
50609,33312,2021-06-24T13:18:31.5520808Z,2021,35,11,26,20,0,1ro,0,0,15,0,0,24,9,0,35,0,0,0
50609,33313,2021-06-24T13:18:31.5530817Z,2021,24,10,21,12,0,2do,0,0,12,0,0,14,3,0,24,0,0,0
50609,33314,2021-06-24T13:18:31.5530817Z,2021,23,12,17,5,0,3ro,0,0,18,0,0,11,6,0,23,0,0,0
50609,33315,2021-06-24T13:18:31.5530817Z,2021,23,8,15,14,0,4to,0,0,9,0,0,15,8,0,23,0,0,0
50609,33316,2021-06-24T13:18:31.5530817Z,2021,29,9,25,14,0,5to,0,0,15,0,0,20,4,0,29,0,2,0
50609,33317,2021-06-24T13:18:31.5540818Z,2021,32,6,25,14,0,6to,0,0,18,0,0,26,7,0,32,0,0,0
50609,33318,2021-06-24T13:18:31.5540818Z,2021,29,11,24,12,0,7mo,0,0,17,0,0,18,5,0,29,0,0,0
50609,33319,2021-06-24T13:18:31.5540818Z,2021,22,8,16,7,0,8vo,0,0,15,0,0,14,6,0,22,0,2,0
50609,33320,2021-06-24T13:18:31.5540818Z,2021,18,4,13,11,0,K,0,0,7,0,0,14,5,0,18,0,0,0
50609,33321,2021-06-24T13:18:31.5540818Z,2021,19,19,16,5,0,Sin Grado,0,0,14,0,0,0,3,0,19,0,0,0
50609,9306,2020-11-18T16:21:57.9906998Z,2020,22,13,18,11,0,1ro,0,0,11,0,0,9,4,0,22,0,0,0
50609,9307,2020-11-18T16:21:57.9906998Z,2020,22,12,14,4,0,2do,0,0,18,0,0,10,8,0,22,0,0,0
50609,9308,2020-11-18T16:21:57.9906998Z,2020,21,7,20,12,0,3ro,0,0,9,0,0,14,1,0,21,0,0,0
50609,9309,2020-11-18T16:21:57.9906998Z,2020,22,6,15,12,0,4to,0,0,10,0,0,16,7,0,22,0,1,0
50609,9310,2020-11-18T16:21:57.9917007Z,2020,33,8,25,13,0,5to,0,0,20,0,0,25,8,0,33,0,0,0
50609,9311,2020-11-18T16:21:57.9917007Z,2020,30,12,24,12,0,6to,0,1,18,0,0,18,6,0,30,0,0,0
50609,9312,2020-11-18T16:21:57.9917007Z,2020,23,8,17,7,0,7mo,0,0,16,0,0,15,6,0,23,0,2,0
50609,9313,2020-11-18T16:21:57.9917007Z,2020,21,5,17,11,0,8vo,0,0,10,0,0,16,4,0,21,0,0,0
50609,9314,2020-11-18T16:21:57.9917007Z,2020,32,9,21,16,0,K,0,0,16,0,0,23,11,0,32,0,0,0
50609,9315,2020-11-18T16:21:57.992702Z,2020,23,23,15,5,0,Sin Grado,0,0,18,0,0,0,8,0,23,0,0,0
20990,1121,2020-11-18T16:20:44.6287814Z,2019,75,38,55,34,0,1ro,0,0,41,0,0,37,20,0,75,0,0,0
20990,1122,2020-11-18T16:20:44.6287814Z,2019,56,25,36,28,0,2do,0,0,28,0,0,31,20,0,56,0,0,0
20990,1123,2020-11-18T16:20:44.6297818Z,2019,51,17,35,25,0,3ro,0,0,26,0,0,34,16,0,51,0,0,0
20990,1124,2020-11-18T16:20:44.6297818Z,2019,60,21,39,25,0,4to,0,0,35,0,0,39,21,0,60,0,0,0
20990,1125,2020-11-18T16:20:44.6297818Z,2019,61,25,50,33,0,5to,0,0,28,0,0,36,11,0,61,0,0,0
20990,1126,2020-11-18T16:20:44.6297818Z,2019,50,20,33,15,0,K,1,0,35,0,0,30,17,0,49,0,0,0
20990,1127,2020-11-18T16:20:44.6297818Z,2019,20,20,16,2,0,Sin Grado,0,0,18,0,0,0,4,0,20,0,0,0
20990,31122,2021-06-24T13:18:13.0668191Z,2021,54,18,51,24,0,1ro,0,0,30,0,0,36,3,0,54,0,0,0
20990,31123,2021-06-24T13:18:13.0678201Z,2021,46,26,32,17,0,2do,1,0,29,0,0,20,14,0,45,0,0,0
20990,31124,2021-06-24T13:18:13.0678201Z,2021,67,30,56,30,0,3ro,1,1,37,0,0,37,11,0,66,0,0,0
20990,31125,2021-06-24T13:18:13.068821Z,2021,47,19,40,22,0,4to,0,3,25,0,0,28,7,0,47,0,0,0
20990,31126,2021-06-24T13:18:13.068821Z,2021,47,16,39,22,0,5to,1,0,25,0,0,31,8,0,46,0,0,0
20990,31127,2021-06-24T13:18:13.068821Z,2021,32,7,29,14,0,K,1,0,18,0,0,25,3,0,31,0,0,0
20990,31128,2021-06-24T13:18:13.070822Z,2021,7,7,6,2,0,Sin Grado,0,0,5,0,0,0,1,0,7,0,0,0
20990,7126,2020-11-18T16:21:44.1955037Z,2020,53,27,39,19,0,1ro,2,0,34,0,0,26,14,0,51,0,0,0
20990,7127,2020-11-18T16:21:44.1955037Z,2020,68,31,51,31,0,2do,1,0,37,0,0,37,17,0,67,0,0,0
20990,7128,2020-11-18T16:21:44.1955037Z,2020,54,23,38,25,0,3ro,0,0,29,0,0,31,16,0,54,0,0,0
20990,7129,2020-11-18T16:21:44.1955037Z,2020,48,16,37,25,0,4to,0,0,23,0,0,32,11,0,48,0,0,0
20990,7130,2020-11-18T16:21:44.1955037Z,2020,57,20,41,23,0,5to,0,0,34,0,0,37,16,0,57,0,0,0
20990,7131,2020-11-18T16:21:44.1965041Z,2020,56,16,40,25,0,K,0,0,31,0,0,40,16,0,56,0,0,0
20990,7132,2020-11-18T16:21:44.1965041Z,2020,17,17,13,3,0,Sin Grado,0,0,14,0,0,0,4,0,17,0,0,0
32532,2074,2020-11-18T16:20:53.9099685Z,2019,58,17,43,20,0,6to,0,0,38,0,0,41,15,0,58,0,0,0
32532,2075,2020-11-18T16:20:53.9109694Z,2019,89,29,72,51,0,7mo,1,0,38,0,0,60,17,0,88,0,1,0
32532,2076,2020-11-18T16:20:53.9109694Z,2019,68,9,56,36,0,8vo,0,0,32,0,0,59,12,0,68,0,0,0
32532,2077,2020-11-18T16:20:53.9109694Z,2019,29,29,25,14,0,Sin Grado,0,0,15,0,0,0,4,0,29,0,0,0
32532,32080,2021-06-24T13:18:20.0988622Z,2021,19,10,17,8,0,6to,0,1,11,0,0,9,2,0,19,0,0,0
32532,32081,2021-06-24T13:18:20.0998622Z,2021,51,11,44,23,0,7mo,1,3,28,0,0,40,7,1,49,0,0,0
32532,32082,2021-06-24T13:18:20.0998622Z,2021,54,18,44,24,0,8vo,0,0,30,0,0,36,10,0,54,0,1,0
32532,32083,2021-06-24T13:18:20.0998622Z,2021,12,12,9,7,0,Sin Grado,0,1,5,0,0,0,3,0,12,0,0,0
32532,8086,2020-11-18T16:21:49.5690866Z,2020,40,9,35,20,0,6to,1,0,20,0,0,31,5,1,38,0,0,0
32532,8087,2020-11-18T16:21:49.5690866Z,2020,54,16,40,24,0,7mo,0,0,30,0,0,38,14,0,54,0,1,0
32532,8088,2020-11-18T16:21:49.5700879Z,2020,81,26,66,48,0,8vo,1,0,33,0,0,55,15,0,80,0,0,0
32532,8089,2020-11-18T16:21:49.5700879Z,2020,23,22,18,12,0,Sin Grado,0,0,11,0,0,1,5,0,23,0,0,0
71308,11256,2020-11-18T16:22:09.5784284Z,2020,26,10,19,8,0,1ro,0,0,18,0,0,16,7,0,26,0,0,0
71308,11257,2020-11-18T16:22:09.5784284Z,2020,35,13,28,17,0,2do,0,4,18,0,0,22,7,0,35,0,0,0
71308,11258,2020-11-18T16:22:09.5784284Z,2020,47,14,33,26,0,3ro,0,2,21,0,0,33,14,0,47,2,0,0
71308,11259,2020-11-18T16:22:09.5784284Z,2020,32,12,27,19,0,4to,0,2,13,0,0,20,5,0,32,1,0,0
71308,11260,2020-11-18T16:22:09.5794301Z,2020,24,4,18,14,0,5to,0,1,10,0,0,20,6,0,24,4,0,0
71308,11261,2020-11-18T16:22:09.5794301Z,2020,31,11,25,17,0,K,0,2,14,0,0,20,6,0,31,0,0,0
71308,35277,2021-06-24T13:18:44.8426097Z,2021,30,13,27,17,0,1ro,0,2,13,0,0,17,3,0,30,0,0,0
71308,35278,2021-06-24T13:18:44.8426097Z,2021,23,9,19,8,0,2do,0,0,15,0,0,14,4,0,23,0,0,0
71308,35279,2021-06-24T13:18:44.8426097Z,2021,33,13,28,17,0,3ro,0,3,16,0,0,20,5,0,33,0,0,0
71308,35280,2021-06-24T13:18:44.8436111Z,2021,33,9,27,20,0,4to,0,1,13,0,0,24,6,0,33,1,0,0
71308,35281,2021-06-24T13:18:44.8436111Z,2021,24,7,21,13,0,5to,0,1,11,0,0,17,3,0,24,1,0,0
71308,35282,2021-06-24T13:18:44.8436111Z,2021,30,5,24,15,0,K,0,0,15,0,0,25,6,0,30,0,0,0
71308,5251,2020-11-18T16:21:14.4676777Z,2019,36,14,28,17,0,1ro,0,1,19,0,0,22,8,0,36,0,0,0
71308,5252,2020-11-18T16:21:14.4686786Z,2019,48,16,32,27,0,2do,0,2,21,0,0,32,16,0,48,2,0,0
71308,5253,2020-11-18T16:21:14.4686786Z,2019,36,13,30,24,0,3ro,0,0,12,0,0,23,6,0,36,1,0,0
71308,5254,2020-11-18T16:21:14.4686786Z,2019,26,5,20,16,0,4to,0,1,10,0,0,21,6,0,26,3,0,0
71308,5255,2020-11-18T16:21:14.4686786Z,2019,19,3,15,8,0,5to,0,0,11,0,0,16,4,0,19,0,0,0
71308,5256,2020-11-18T16:21:14.469679Z,2019,44,20,35,20,0,K,1,0,24,0,0,24,9,0,43,0,0,0
34769,2254,2020-11-18T16:20:55.0117043Z,2019,39,9,34,17,0,1ro,1,0,22,0,0,30,5,0,37,0,0,1
34769,2255,2020-11-18T16:20:55.0117043Z,2019,41,15,33,18,0,2do,0,0,23,0,0,26,8,0,41,0,0,0
34769,2256,2020-11-18T16:20:55.0127051Z,2019,33,14,28,12,0,3ro,0,0,21,0,0,19,5,0,33,0,0,0
34769,2257,2020-11-18T16:20:55.0127051Z,2019,38,6,32,22,0,4to,2,0,16,0,1,32,6,0,36,0,0,0
34769,2258,2020-11-18T16:20:55.0127051Z,2019,34,4,29,14,0,5to,0,0,20,0,1,30,5,0,34,0,0,0
34769,2259,2020-11-18T16:20:55.0127051Z,2019,28,7,23,12,0,K,0,0,16,0,0,21,5,0,28,0,0,0
34769,2260,2020-11-18T16:20:55.0127051Z,2019,13,13,11,4,0,Sin Grado,0,0,9,0,0,0,2,0,13,0,0,0
34769,32261,2021-06-24T13:18:21.7640558Z,2021,26,8,23,14,0,1ro,0,0,12,0,0,18,3,0,26,0,0,0
34769,32262,2021-06-24T13:18:21.7640558Z,2021,37,12,31,18,0,2do,0,0,19,0,0,25,6,0,37,0,0,0
34769,32263,2021-06-24T13:18:21.7640558Z,2021,35,9,32,17,0,3ro,0,0,18,0,0,26,3,0,35,0,0,0
34769,32264,2021-06-24T13:18:21.7640558Z,2021,42,14,38,18,0,4to,0,0,24,0,0,28,4,0,42,0,0,0
34769,32265,2021-06-24T13:18:21.7650558Z,2021,30,12,25,11,0,5to,0,0,19,0,0,18,5,0,30,0,0,0
34769,32266,2021-06-24T13:18:21.7650558Z,2021,22,7,20,13,0,K,0,0,9,0,0,15,2,0,22,0,0,0
34769,32267,2021-06-24T13:18:21.7650558Z,2021,12,11,12,3,0,Sin Grado,0,0,9,0,0,1,0,0,12,0,0,0
34769,8266,2020-11-18T16:21:50.6898357Z,2020,37,9,29,16,0,1ro,0,0,21,0,0,28,8,0,37,0,0,0
34769,8267,2020-11-18T16:21:50.6898357Z,2020,36,10,32,15,0,2do,0,0,21,0,0,26,4,0,36,0,0,0
34769,8268,2020-11-18T16:21:50.6898357Z,2020,47,17,39,21,0,3ro,1,0,26,0,0,30,8,0,46,0,0,0
34769,8269,2020-11-18T16:21:50.6908361Z,2020,33,11,27,13,0,4to,0,0,20,0,0,22,6,0,32,0,0,1
34769,8270,2020-11-18T16:21:50.6908361Z,2020,40,9,31,23,0,5to,1,0,17,0,0,31,9,0,39,0,0,0
34769,8271,2020-11-18T16:21:50.6908361Z,2020,27,7,24,18,0,K,0,0,9,0,0,20,3,0,27,0,0,0
34769,8272,2020-11-18T16:21:50.6908361Z,2020,16,16,14,4,0,Sin Grado,0,1,12,0,0,0,2,0,16,0,0,0
75739,11574,2020-11-18T16:22:11.3275964Z,2020,47,13,40,24,0,10mo,1,0,23,0,0,34,7,0,46,0,0,0
75739,11575,2020-11-18T16:22:11.3275964Z,2020,31,7,30,9,0,11mo,0,0,22,0,0,24,1,0,31,1,0,0
75739,11576,2020-11-18T16:22:11.3275964Z,2020,48,7,42,26,0,12mo,4,0,22,0,0,41,6,0,44,0,0,0
75739,11577,2020-11-18T16:22:11.3285968Z,2020,33,14,31,16,0,6to,1,0,17,0,0,19,2,0,32,0,0,0
75739,11578,2020-11-18T16:22:11.3285968Z,2020,40,14,38,11,0,7mo,1,0,29,0,0,26,2,0,39,0,0,0
75739,11579,2020-11-18T16:22:11.3285968Z,2020,44,17,33,19,0,8vo,0,0,25,0,0,27,11,0,44,0,0,0
75739,11580,2020-11-18T16:22:11.3285968Z,2020,41,13,36,15,0,9no,0,0,26,0,0,28,5,0,41,0,0,0
75739,11581,2020-11-18T16:22:11.3285968Z,2020,6,6,5,1,0,Sin Grado,0,0,5,0,0,0,1,0,6,0,1,0
75739,35597,2021-06-24T13:18:46.6018721Z,2021,38,12,33,13,0,10mo,1,0,25,0,0,26,5,0,37,0,0,0
75739,35598,2021-06-24T13:18:46.6018721Z,2021,44,12,36,22,0,11mo,0,0,22,0,0,32,8,0,44,0,0,0
75739,35599,2021-06-24T13:18:46.6018721Z,2021,28,8,28,8,0,12mo,1,0,20,0,0,20,0,0,27,0,0,0
75739,35600,2021-06-24T13:18:47.3554122Z,2021,43,12,40,19,0,6to,2,1,24,0,0,31,3,0,41,0,0,0
75739,35601,2021-06-24T13:18:47.3554122Z,2021,39,15,33,19,0,7mo,2,0,20,0,0,24,6,0,37,0,0,0
75739,35602,2021-06-24T13:18:47.3554122Z,2021,40,16,39,12,0,8vo,0,2,28,0,0,24,1,0,40,0,0,0
75739,35603,2021-06-24T13:18:47.3564136Z,2021,46,16,38,20,0,9no,1,0,26,0,0,30,8,0,45,0,0,0
75739,35604,2021-06-24T13:18:47.3564136Z,2021,7,7,7,2,0,Sin Grado,0,0,5,0,0,0,0,0,7,0,0,0
75739,5566,2020-11-18T16:21:16.1958304Z,2019,38,9,36,12,0,10mo,0,0,26,0,0,29,2,0,38,1,0,0
75739,5567,2020-11-18T16:21:16.1968317Z,2019,63,10,55,33,0,11mo,4,0,30,0,0,53,8,0,59,0,0,0
75739,5568,2020-11-18T16:21:16.1968317Z,2019,52,0,47,22,0,12mo,4,0,30,0,0,52,5,0,48,0,0,0
75739,5569,2020-11-18T16:21:16.1978321Z,2019,43,15,42,11,0,6to,1,0,32,0,0,28,1,0,42,0,0,0
75739,5570,2020-11-18T16:21:16.1978321Z,2019,46,18,36,21,0,7mo,0,0,25,0,0,28,10,0,46,0,0,0
75739,5571,2020-11-18T16:21:16.1978321Z,2019,39,13,36,16,0,8vo,1,0,23,0,0,26,3,0,38,0,1,0
75739,5572,2020-11-18T16:21:16.198833Z,2019,59,16,53,28,0,9no,1,0,31,0,0,43,6,0,58,0,0,0
75739,5573,2020-11-18T16:21:16.198833Z,2019,13,13,11,3,0,Sin Grado,0,0,10,0,0,0,2,0,13,0,1,0
41566,2666,2020-11-18T16:20:58.0687439Z,2019,33,12,28,15,0,1ro,0,0,18,0,0,21,5,0,33,0,0,0
41566,2667,2020-11-18T16:20:58.0687439Z,2019,33,11,29,18,0,2do,0,0,15,0,0,22,4,0,33,0,0,0
41566,2668,2020-11-18T16:20:58.0697447Z,2019,39,9,34,18,0,3ro,0,0,21,0,0,30,5,1,37,0,0,1
41566,2669,2020-11-18T16:20:58.0697447Z,2019,25,8,20,11,0,4to,0,0,14,0,0,17,5,0,25,0,0,0
41566,2670,2020-11-18T16:20:58.0697447Z,2019,47,20,38,21,0,5to,0,0,26,0,0,27,9,0,47,0,0,0
41566,2671,2020-11-18T16:20:58.0697447Z,2019,15,3,13,8,0,K,0,0,7,0,0,12,2,0,15,0,0,0
41566,2672,2020-11-18T16:20:58.0707456Z,2019,8,8,8,0,0,Sin Grado,0,0,8,0,0,0,0,0,8,0,0,0
41566,32673,2021-06-24T13:18:26.2873054Z,2021,26,6,23,13,0,1ro,0,0,13,0,0,20,3,0,26,0,0,0
41566,32674,2021-06-24T13:18:26.2873054Z,2021,20,6,20,9,0,2do,0,0,11,0,0,14,0,0,20,0,0,0
41566,32675,2021-06-24T13:18:26.2883064Z,2021,35,13,31,15,0,3ro,0,0,20,0,0,22,4,0,35,0,0,0
41566,32676,2021-06-24T13:18:26.2883064Z,2021,23,9,21,9,0,4to,0,0,14,0,0,14,2,0,23,0,0,0
41566,32677,2021-06-24T13:18:26.2883064Z,2021,40,8,38,19,0,5to,1,0,21,0,0,32,2,0,39,0,0,0
41566,32678,2021-06-24T13:18:26.2883064Z,2021,25,4,19,13,0,K,1,0,12,0,0,21,6,0,24,0,0,0
41566,32679,2021-06-24T13:18:26.2893069Z,2021,9,9,9,4,0,Sin Grado,0,0,5,0,0,0,0,0,9,0,0,0
41566,8677,2020-11-18T16:21:53.068419Z,2020,17,4,15,9,0,1ro,0,4,8,0,0,13,2,0,17,0,0,0
41566,8678,2020-11-18T16:21:53.068419Z,2020,36,13,32,16,0,2do,0,2,20,0,0,23,4,0,36,0,0,0
41566,8679,2020-11-18T16:21:53.0694195Z,2020,27,8,25,14,0,3ro,0,1,13,0,0,19,2,0,27,0,0,0
41566,8680,2020-11-18T16:21:53.0694195Z,2020,38,8,32,16,0,4to,0,4,22,0,0,30,6,0,38,0,0,0
41566,8681,2020-11-18T16:21:53.0694195Z,2020,23,8,19,11,0,5to,0,2,12,0,0,15,4,0,23,0,0,0
41566,8682,2020-11-18T16:21:53.0704199Z,2020,32,8,28,15,0,K,0,5,17,0,0,24,4,0,32,0,0,0
41566,8683,2020-11-18T16:21:53.0704199Z,2020,9,9,9,4,0,Sin Grado,0,3,5,0,0,0,0,0,9,0,0,0
78857,11737,2020-11-18T16:22:12.3192586Z,2020,233,44,157,118,0,10mo,1,3,115,0,0,189,76,0,231,9,0,1
78857,11738,2020-11-18T16:22:12.3192586Z,2020,188,30,124,100,0,11mo,4,0,88,0,0,158,64,0,184,4,0,0
78857,11739,2020-11-18T16:22:12.3192586Z,2020,175,33,116,89,0,12mo,2,6,86,0,0,142,59,0,173,7,0,0
78857,11740,2020-11-18T16:22:12.3192586Z,2020,244,55,174,128,0,9no,4,3,116,0,0,189,70,0,240,9,0,0
78857,11741,2020-11-18T16:22:12.3202604Z,2020,8,8,7,1,0,Sin Grado,0,0,7,0,0,0,1,0,8,0,0,0
78857,35759,2021-06-24T13:18:47.761704Z,2021,230,50,181,123,0,10mo,4,0,107,0,0,180,49,0,226,8,0,0
78857,35760,2021-06-24T13:18:47.7627041Z,2021,234,41,173,119,0,11mo,1,0,115,0,0,193,61,0,232,9,0,1
78857,35761,2021-06-24T13:18:47.7627041Z,2021,184,30,129,97,0,12mo,4,0,87,0,0,154,55,0,180,4,0,0
78857,35762,2021-06-24T13:18:47.7627041Z,2021,206,46,156,102,0,9no,3,0,104,0,0,160,50,0,203,1,0,0
78857,35763,2021-06-24T13:18:47.7627041Z,2021,6,6,5,1,0,Sin Grado,0,0,5,0,0,0,1,0,6,0,0,0
78857,5731,2020-11-18T16:21:17.1494676Z,2019,189,31,127,105,0,10mo,4,0,84,0,0,158,62,0,185,4,0,0
78857,5732,2020-11-18T16:21:17.1494676Z,2019,169,33,116,80,0,11mo,2,4,89,0,0,136,53,0,167,6,0,0
78857,5733,2020-11-18T16:21:17.1494676Z,2019,111,0,65,56,0,12mo,0,0,55,0,0,111,46,0,111,0,0,0
78857,5734,2020-11-18T16:21:17.1504685Z,2019,293,73,206,144,0,9no,1,1,149,0,0,220,87,0,291,9,0,1
78857,5735,2020-11-18T16:21:17.1504685Z,2019,9,6,8,1,0,Sin Grado,0,0,8,0,0,3,1,0,9,0,0,0
33308,2157,2020-11-18T16:20:54.6024324Z,2019,48,11,48,28,0,1ro,2,2,20,0,0,37,0,0,46,0,0,0
33308,2158,2020-11-18T16:20:54.603432Z,2019,51,22,49,27,0,2do,2,4,24,0,0,29,2,0,49,0,0,0
33308,2159,2020-11-18T16:20:54.603432Z,2019,50,21,43,21,0,3ro,4,2,29,0,0,29,7,0,46,0,1,0
33308,2160,2020-11-18T16:20:54.603432Z,2019,49,24,47,28,0,4to,0,1,21,0,0,25,2,0,49,0,0,0
33308,2161,2020-11-18T16:20:54.603432Z,2019,31,11,30,13,0,5to,0,1,18,0,0,20,1,0,31,0,0,0
33308,2162,2020-11-18T16:20:54.603432Z,2019,38,6,35,24,0,K,1,1,14,0,0,32,3,0,37,0,0,0
33308,2163,2020-11-18T16:20:54.6044342Z,2019,19,18,14,6,0,Sin Grado,2,0,13,0,0,1,5,0,17,0,0,0
33308,32163,2021-06-24T13:18:20.9164478Z,2021,38,4,36,21,0,1ro,3,0,17,0,0,34,2,0,35,0,0,0
33308,32164,2021-06-24T13:18:20.9174482Z,2021,27,8,25,15,0,2do,1,0,12,0,0,19,2,0,26,0,0,0
33308,32165,2021-06-24T13:18:20.9174482Z,2021,47,17,41,22,0,3ro,4,0,25,0,0,30,6,0,43,0,0,0
33308,32166,2021-06-24T13:18:20.9174482Z,2021,27,12,27,13,0,4to,1,0,14,0,0,15,0,0,26,0,0,0
33308,32167,2021-06-24T13:18:20.9174482Z,2021,39,19,34,15,0,5to,3,0,24,0,0,20,5,0,36,0,1,0
33308,32168,2021-06-24T13:18:20.9184496Z,2021,25,4,21,16,0,K,0,0,9,0,0,21,4,0,25,0,0,0
33308,32169,2021-06-24T13:18:20.9184496Z,2021,17,17,16,3,0,Sin Grado,1,0,14,0,0,0,1,0,16,0,0,0
33308,8169,2020-11-18T16:21:50.2335318Z,2020,28,8,27,15,0,1ro,1,0,13,0,0,20,1,0,27,0,0,0
33308,8170,2020-11-18T16:21:50.2345309Z,2020,56,17,55,30,0,2do,4,0,26,0,0,39,1,0,52,0,0,0
33308,8171,2020-11-18T16:21:50.2345309Z,2020,39,12,38,21,0,3ro,0,0,18,0,0,27,1,0,39,0,0,0
33308,8172,2020-11-18T16:21:50.2345309Z,2020,42,16,36,16,0,4to,4,0,26,0,0,26,6,0,38,0,1,0
33308,8173,2020-11-18T16:21:50.2345309Z,2020,42,20,39,21,0,5to,0,0,21,0,0,22,3,0,42,0,0,0
33308,8174,2020-11-18T16:21:50.2345309Z,2020,42,3,40,26,0,K,2,0,16,0,0,39,2,0,40,0,0,0
33308,8175,2020-11-18T16:21:50.2355331Z,2020,23,23,19,5,0,Sin Grado,1,0,18,0,0,0,4,0,22,0,0,0
27557,1633,2020-11-18T16:20:48.2521995Z,2019,173,43,117,99,0,10mo,1,3,74,0,0,130,56,0,172,0,0,0
27557,1634,2020-11-18T16:20:48.2521995Z,2019,180,39,107,99,0,11mo,0,5,81,0,0,141,73,0,180,0,0,0
27557,1635,2020-11-18T16:20:48.2531999Z,2019,148,0,110,83,0,12mo,1,1,65,0,0,148,38,0,147,0,0,0
27557,1636,2020-11-18T16:20:48.2531999Z,2019,165,50,127,79,0,9no,2,2,86,0,0,115,38,0,163,0,0,0
27557,1637,2020-11-18T16:20:48.2531999Z,2019,12,0,6,6,0,PK,1,0,6,0,0,12,6,0,11,0,0,0
27557,31636,2021-06-24T13:18:16.1120038Z,2021,188,43,150,97,0,10mo,3,1,91,0,0,145,38,0,185,1,0,0
27557,31637,2021-06-24T13:18:16.1120038Z,2021,147,46,104,75,0,11mo,1,0,72,0,0,101,43,0,146,0,0,0
27557,31638,2021-06-24T13:18:16.1120038Z,2021,159,39,116,91,0,12mo,2,0,68,0,0,120,43,0,157,0,0,0
27557,31639,2021-06-24T13:18:16.1130034Z,2021,177,57,139,81,0,9no,0,0,96,0,0,120,38,0,177,0,0,0
27557,31640,2021-06-24T13:18:16.1130034Z,2021,6,1,4,3,0,PK,0,0,3,0,0,5,2,0,6,0,0,0
27557,7639,2020-11-18T16:21:47.1874966Z,2020,153,47,117,76,0,10mo,1,2,77,0,0,106,36,0,152,0,0,0
27557,7640,2020-11-18T16:21:47.1874966Z,2020,167,41,117,93,0,11mo,1,5,74,0,0,126,50,0,166,0,0,0
27557,7641,2020-11-18T16:21:47.1874966Z,2020,172,39,103,93,0,12mo,0,6,79,0,0,133,69,0,172,0,0,0
27557,7642,2020-11-18T16:21:47.188497Z,2020,191,47,154,97,0,9no,3,5,94,0,0,144,37,0,188,1,0,0
27557,7643,2020-11-18T16:21:47.188497Z,2020,10,1,4,5,0,PK,0,0,5,0,0,9,6,0,10,0,0,0
51656,33450,2021-06-24T13:18:32.4787453Z,2021,49,15,43,24,0,1ro,0,1,25,0,0,34,6,0,49,0,0,0
51656,33451,2021-06-24T13:18:32.4797462Z,2021,54,18,48,30,0,2do,1,0,24,0,0,36,6,0,52,1,1,1
51656,33452,2021-06-24T13:18:32.4797462Z,2021,69,31,59,37,0,3ro,2,2,32,0,0,38,10,0,67,0,0,0
51656,33453,2021-06-24T13:18:32.4797462Z,2021,68,29,58,30,0,4to,1,2,38,0,0,39,10,0,67,0,0,0
51656,33454,2021-06-24T13:18:32.4807467Z,2021,122,42,101,56,0,5to,4,1,66,0,0,80,21,0,116,2,2,2
51656,33455,2021-06-24T13:18:32.4807467Z,2021,46,11,32,21,0,K,0,0,25,0,0,35,14,1,45,0,0,0
51656,33456,2021-06-24T13:18:32.4807467Z,2021,15,14,13,7,0,Sin Grado,0,0,8,0,0,1,2,0,15,0,0,0
51656,3426,2020-11-18T16:21:02.5547377Z,2019,44,22,31,25,0,1ro,1,2,19,0,0,22,13,0,43,0,0,0
51656,3427,2020-11-18T16:21:02.5547377Z,2019,40,17,29,20,0,2do,0,1,20,0,0,23,11,0,40,0,0,0
51656,3428,2020-11-18T16:21:02.5547377Z,2019,69,25,54,34,0,3ro,3,0,35,0,0,44,15,0,66,1,1,0
51656,3429,2020-11-18T16:21:02.5557377Z,2019,122,40,87,64,0,4to,2,2,58,0,0,82,35,0,120,1,1,0
51656,3430,2020-11-18T16:21:02.5557377Z,2019,116,47,80,59,0,5to,6,1,57,0,0,69,36,0,110,0,1,0
51656,3431,2020-11-18T16:21:02.5557377Z,2019,35,12,33,15,0,K,0,0,20,0,0,23,2,0,34,1,0,1
51656,3432,2020-11-18T16:21:02.5567381Z,2019,21,20,18,9,0,Sin Grado,1,0,12,0,0,1,3,0,20,0,0,0
51656,9446,2020-11-18T16:21:58.4179854Z,2020,38,12,33,22,0,1ro,0,0,16,0,0,26,5,0,37,1,0,1
51656,9447,2020-11-18T16:21:58.4179854Z,2020,63,32,42,31,0,2do,2,5,32,0,0,31,21,0,61,0,0,0
51656,9448,2020-11-18T16:21:58.4189859Z,2020,53,25,40,20,0,3ro,0,0,33,0,0,28,13,0,53,0,0,0
51656,9449,2020-11-18T16:21:58.4189859Z,2020,98,37,67,41,0,4to,4,0,57,0,0,61,31,0,93,2,2,1
51656,9450,2020-11-18T16:21:58.4189859Z,2020,117,39,79,60,0,5to,2,3,57,0,0,78,38,0,115,1,1,0
51656,9451,2020-11-18T16:21:58.4189859Z,2020,48,10,39,25,0,K,0,2,23,0,0,38,9,0,48,0,0,0
51656,9452,2020-11-18T16:21:58.4189859Z,2020,24,24,22,11,0,Sin Grado,0,0,13,0,0,0,2,0,24,0,0,0
62174,10387,2020-11-18T16:22:03.7245251Z,2020,112,25,82,65,0,6to,1,1,47,0,0,87,30,0,111,0,0,0
62174,10388,2020-11-18T16:22:03.7255246Z,2020,81,13,51,42,0,7mo,0,0,39,0,0,68,30,0,81,1,0,0
62174,10389,2020-11-18T16:22:03.7255246Z,2020,99,15,64,55,0,8vo,0,0,44,0,0,84,35,0,99,0,0,0
62174,34402,2021-06-24T13:18:39.4217238Z,2021,85,27,74,37,0,6to,2,0,48,0,0,58,11,0,83,0,0,0
62174,34403,2021-06-24T13:18:39.4217238Z,2021,110,28,77,61,0,7mo,2,0,49,0,0,82,33,0,108,0,0,0
62174,34404,2021-06-24T13:18:39.4217238Z,2021,79,14,54,40,0,8vo,0,0,39,0,0,65,25,0,79,1,0,0
62174,4374,2020-11-18T16:21:09.7034997Z,2019,100,24,67,42,0,6to,1,0,58,0,0,76,33,0,99,0,0,0
62174,4375,2020-11-18T16:21:09.7034997Z,2019,106,18,66,61,0,7mo,0,0,45,0,0,88,40,1,105,0,0,0
62174,4376,2020-11-18T16:21:09.7034997Z,2019,109,24,64,56,0,8vo,3,0,53,0,0,85,45,0,106,0,0,0
51797,33476,2021-06-24T13:18:32.4877515Z,2021,25,9,20,13,0,1ro,0,0,12,0,0,16,5,0,25,0,0,0
51797,33477,2021-06-24T13:18:32.488752Z,2021,20,8,16,10,0,2do,0,0,10,0,0,12,4,0,20,0,0,0
51797,33478,2021-06-24T13:18:32.488752Z,2021,22,7,18,12,0,3ro,0,0,10,0,0,15,4,0,22,0,0,0
51797,33479,2021-06-24T13:18:32.488752Z,2021,26,7,23,16,0,4to,0,0,10,0,0,19,3,0,26,0,0,0
51797,33480,2021-06-24T13:18:32.4897525Z,2021,30,13,25,19,0,5to,0,0,11,0,0,17,5,0,30,0,0,0
51797,33481,2021-06-24T13:18:32.4897525Z,2021,28,10,23,15,0,6to,1,0,13,0,0,18,5,0,27,0,0,0
51797,33482,2021-06-24T13:18:32.4897525Z,2021,30,7,27,17,0,7mo,1,0,13,0,0,23,3,0,29,0,0,0
51797,33483,2021-06-24T13:18:32.4897525Z,2021,26,9,24,11,0,8vo,1,0,15,0,0,17,2,0,25,0,0,0
51797,33484,2021-06-24T13:18:32.4907539Z,2021,23,4,22,12,0,K,0,0,11,0,0,19,1,0,23,0,0,0
51797,33485,2021-06-24T13:18:32.4907539Z,2021,5,5,4,2,0,Sin Grado,0,0,3,0,0,0,1,1,4,0,0,0
51797,3451,2020-11-18T16:21:02.563743Z,2019,17,4,15,8,0,1ro,0,0,9,0,0,13,2,0,17,0,0,0
51797,3452,2020-11-18T16:21:02.563743Z,2019,14,7,11,7,0,2do,0,0,7,0,0,7,3,0,14,0,0,0
51797,3453,2020-11-18T16:21:02.5647448Z,2019,14,4,11,10,0,3ro,0,0,4,0,0,10,3,0,14,0,0,0
51797,3454,2020-11-18T16:21:02.5647448Z,2019,12,3,10,8,0,4to,0,0,4,0,0,9,2,0,12,1,0,0
51797,3455,2020-11-18T16:21:02.5647448Z,2019,18,7,17,11,0,5to,1,0,7,0,0,11,1,0,17,0,0,0
51797,3456,2020-11-18T16:21:02.5657448Z,2019,17,2,12,12,0,6to,1,0,5,0,0,15,5,0,16,0,0,0
51797,3457,2020-11-18T16:21:02.5657448Z,2019,19,6,12,10,0,7mo,1,0,9,0,0,13,7,0,18,0,0,0
51797,3458,2020-11-18T16:21:02.5657448Z,2019,22,6,19,10,0,8vo,0,0,12,0,0,16,3,0,22,0,0,0
51797,3459,2020-11-18T16:21:02.5657448Z,2019,13,3,10,7,0,K,0,0,6,0,0,10,3,0,13,0,0,0
51797,9472,2020-11-18T16:21:58.4410006Z,2020,14,3,11,8,0,1ro,0,0,6,0,0,11,3,0,14,0,0,0
51797,9473,2020-11-18T16:21:58.442001Z,2020,19,3,16,9,0,2do,0,0,10,0,0,16,3,0,19,0,0,0
51797,9474,2020-11-18T16:21:58.442001Z,2020,15,7,12,8,0,3ro,0,0,7,0,0,8,3,0,15,0,0,0
51797,9475,2020-11-18T16:21:58.442001Z,2020,14,4,10,11,0,4to,0,0,3,0,0,10,4,0,14,0,0,0
51797,9476,2020-11-18T16:21:58.442001Z,2020,14,3,10,9,0,5to,0,0,5,0,0,11,4,0,13,1,0,1
51797,9477,2020-11-18T16:21:58.442001Z,2020,16,8,15,9,0,6to,1,0,7,0,0,8,1,0,15,0,0,0
51797,9478,2020-11-18T16:21:58.4430019Z,2020,16,3,11,10,0,7mo,1,0,6,0,0,13,5,0,15,0,0,0
51797,9479,2020-11-18T16:21:58.4430019Z,2020,18,6,11,8,0,8vo,0,0,10,0,0,12,7,0,18,0,0,0
51797,9480,2020-11-18T16:21:58.4430019Z,2020,16,5,15,9,0,K,0,0,7,0,0,11,1,0,16,0,0,0
71340,11262,2020-11-18T16:22:09.5834315Z,2020,36,16,34,18,0,1ro,0,1,18,0,0,20,2,0,36,1,0,0
71340,11263,2020-11-18T16:22:09.5834315Z,2020,38,17,33,19,0,2do,1,2,19,0,0,21,5,0,37,3,0,0
71340,11264,2020-11-18T16:22:09.5834315Z,2020,32,9,28,16,0,3ro,0,1,16,0,0,23,4,0,32,0,0,0
71340,11265,2020-11-18T16:22:09.5834315Z,2020,23,9,21,8,0,4to,0,1,15,0,0,14,2,0,23,1,0,0
71340,11266,2020-11-18T16:22:09.5844328Z,2020,40,12,35,19,0,5to,0,2,21,0,0,28,5,0,40,1,0,0
71340,11267,2020-11-18T16:22:09.5844328Z,2020,41,11,33,25,0,6to,2,0,16,0,0,30,8,0,39,3,0,0
71340,11268,2020-11-18T16:22:09.5844328Z,2020,23,9,21,11,0,7mo,0,1,12,0,0,14,2,0,23,2,0,0
71340,11269,2020-11-18T16:22:09.5844328Z,2020,45,17,37,20,0,8vo,0,1,25,0,0,28,8,0,45,1,0,0
71340,11270,2020-11-18T16:22:09.5844328Z,2020,41,8,36,20,0,K,0,0,21,0,0,33,5,0,41,0,0,0
71340,11271,2020-11-18T16:22:09.5854333Z,2020,10,10,10,3,0,Sin Grado,0,0,7,0,0,0,0,0,10,1,0,0
71340,35283,2021-06-24T13:18:44.8466166Z,2021,38,8,33,19,0,1ro,0,0,19,0,0,30,5,0,38,0,0,0
71340,35284,2021-06-24T13:18:44.8466166Z,2021,38,16,36,22,0,2do,0,0,16,0,0,22,2,0,38,1,0,0
71340,35285,2021-06-24T13:18:44.8466166Z,2021,35,12,32,19,0,3ro,0,0,16,0,0,23,3,0,35,2,0,0
71340,35286,2021-06-24T13:18:44.847614Z,2021,34,11,32,17,0,4to,0,0,17,0,0,23,2,0,34,0,0,0
71340,35287,2021-06-24T13:18:44.847614Z,2021,25,8,22,8,0,5to,0,0,17,0,0,17,3,0,25,1,0,0
71340,35288,2021-06-24T13:18:44.847614Z,2021,42,12,40,24,0,6to,1,0,18,0,0,30,2,0,41,1,0,0
71340,35289,2021-06-24T13:18:44.847614Z,2021,44,12,37,27,0,7mo,2,0,17,0,0,32,7,0,42,3,0,0
71340,35290,2021-06-24T13:18:44.8486145Z,2021,21,9,20,9,0,8vo,0,0,12,0,0,12,1,0,21,2,0,0
71340,35291,2021-06-24T13:18:44.8486145Z,2021,30,10,27,10,0,K,1,0,20,0,0,20,3,0,29,0,0,0
71340,35292,2021-06-24T13:18:44.8486145Z,2021,6,6,6,3,0,Sin Grado,0,0,3,0,0,0,0,0,6,1,0,0
71340,5257,2020-11-18T16:21:14.4766852Z,2019,43,18,37,22,0,1ro,0,3,21,0,0,25,6,0,43,4,0,0
71340,5258,2020-11-18T16:21:14.4766852Z,2019,32,8,28,15,0,2do,0,1,17,0,0,24,4,0,32,0,0,0
71340,5259,2020-11-18T16:21:14.4766852Z,2019,24,9,21,10,0,3ro,0,0,14,0,0,15,3,0,24,2,0,0
71340,5260,2020-11-18T16:21:14.4766852Z,2019,36,11,33,17,0,4to,0,1,19,0,0,25,3,0,36,1,0,0
71340,5261,2020-11-18T16:21:14.4776857Z,2019,38,11,32,24,0,5to,2,0,14,0,0,27,6,0,36,3,0,0
71340,5262,2020-11-18T16:21:14.4776857Z,2019,22,8,18,12,0,6to,0,1,10,0,0,14,4,0,22,3,0,0
71340,5263,2020-11-18T16:21:14.4776857Z,2019,40,17,35,18,0,7mo,0,1,22,0,0,23,5,0,40,1,0,0
71340,5264,2020-11-18T16:21:14.4776857Z,2019,33,5,30,15,0,8vo,0,1,18,0,0,28,3,0,33,0,0,0
71340,5265,2020-11-18T16:21:14.4786861Z,2019,39,17,33,15,0,K,0,0,24,0,0,22,6,0,39,0,0,0
71340,5266,2020-11-18T16:21:14.4786861Z,2019,9,9,8,3,0,Sin Grado,0,0,6,0,0,0,1,0,9,1,0,0
34199,2201,2020-11-18T16:20:55.0016985Z,2019,36,10,33,21,0,1ro,1,1,15,0,0,26,3,0,35,0,0,0
34199,2202,2020-11-18T16:20:55.0026985Z,2019,45,14,35,15,0,2do,0,0,30,0,0,31,10,0,45,1,0,0
34199,2203,2020-11-18T16:20:55.0026985Z,2019,36,10,32,24,0,3ro,1,0,12,0,0,26,4,0,35,1,0,0
34199,2204,2020-11-18T16:20:55.0026985Z,2019,44,14,33,19,0,4to,0,0,25,0,0,30,11,0,44,1,0,0
34199,2205,2020-11-18T16:20:55.0026985Z,2019,48,15,40,25,0,5to,0,1,23,0,0,33,8,0,48,0,0,0
34199,2206,2020-11-18T16:20:55.0026985Z,2019,65,20,52,32,0,6to,0,1,33,0,0,45,13,0,65,2,1,0
34199,2207,2020-11-18T16:20:55.0026985Z,2019,79,18,62,26,0,7mo,2,1,53,0,0,61,17,0,77,2,2,0
34199,2208,2020-11-18T16:20:55.0037007Z,2019,70,17,47,34,0,8vo,0,0,36,0,0,53,23,1,69,1,0,0
34199,2209,2020-11-18T16:20:55.0037007Z,2019,25,6,21,21,0,K,0,0,4,0,0,19,4,0,25,0,0,0
34199,32208,2021-06-24T13:18:21.7430405Z,2021,16,1,14,6,0,1ro,0,0,10,0,0,15,2,0,16,0,0,0
34199,32209,2021-06-24T13:18:21.7430405Z,2021,31,7,26,18,0,2do,2,0,13,0,0,24,5,0,28,0,1,1
34199,32210,2021-06-24T13:18:21.7440419Z,2021,23,6,20,12,0,3ro,0,0,11,0,0,17,3,0,22,0,0,1
34199,32211,2021-06-24T13:18:21.7440419Z,2021,33,9,29,12,0,4to,3,0,21,0,0,24,4,0,30,0,0,0
34199,32212,2021-06-24T13:18:21.7440419Z,2021,38,11,35,22,0,5to,1,0,16,0,0,27,3,0,37,1,0,0
34199,32213,2021-06-24T13:18:21.7450419Z,2021,59,17,52,30,0,6to,0,0,29,0,0,42,7,1,56,1,3,2
34199,32214,2021-06-24T13:18:21.7450419Z,2021,79,17,68,38,0,7mo,1,0,41,0,0,62,11,0,77,0,0,1
34199,32215,2021-06-24T13:18:21.7450419Z,2021,68,19,62,29,0,8vo,0,0,39,0,0,49,6,0,68,4,1,0
34199,32216,2021-06-24T13:18:21.7460428Z,2021,24,7,17,8,0,K,1,0,16,0,0,17,7,0,22,0,0,1
34199,8213,2020-11-18T16:21:50.6768263Z,2020,27,9,22,16,0,1ro,1,0,11,0,0,18,5,0,26,0,0,0
34199,8214,2020-11-18T16:21:50.6768263Z,2020,28,7,23,17,0,2do,0,0,11,0,0,21,5,0,27,0,0,1
34199,8215,2020-11-18T16:21:50.6768263Z,2020,38,10,32,11,0,3ro,1,0,27,0,0,28,6,0,37,0,0,0
34199,8216,2020-11-18T16:21:50.6778272Z,2020,36,11,31,21,0,4to,1,0,15,0,0,25,5,0,35,1,0,0
34199,8217,2020-11-18T16:21:50.6778272Z,2020,43,12,35,20,0,5to,0,0,23,0,0,31,8,0,43,1,0,0
34199,8218,2020-11-18T16:21:50.6778272Z,2020,75,20,62,36,0,6to,0,1,39,0,0,55,13,0,75,0,0,0
34199,8219,2020-11-18T16:21:50.6778272Z,2020,64,17,51,29,0,7mo,0,0,35,0,0,47,13,0,64,4,0,0
34199,8220,2020-11-18T16:21:50.6778272Z,2020,69,15,54,20,0,8vo,2,0,49,0,0,54,15,0,67,2,1,0
34199,8221,2020-11-18T16:21:50.6788281Z,2020,19,0,18,9,0,K,0,0,10,0,0,19,1,0,19,0,0,0
44891,2992,2020-11-18T16:20:59.928985Z,2019,48,19,36,27,0,1ro,0,0,21,0,0,29,12,0,48,0,0,0
44891,2993,2020-11-18T16:20:59.928985Z,2019,35,10,24,16,0,2do,3,0,19,0,0,25,11,0,32,0,0,0
44891,2994,2020-11-18T16:20:59.928985Z,2019,52,18,45,19,0,3ro,3,0,33,0,0,34,7,0,49,0,0,0
44891,2995,2020-11-18T16:20:59.9299846Z,2019,61,17,52,27,0,4to,2,0,34,0,0,44,9,0,59,0,0,0
44891,2996,2020-11-18T16:20:59.9299846Z,2019,56,12,46,30,0,5to,3,0,26,0,0,44,10,0,53,1,0,0
44891,2997,2020-11-18T16:20:59.9299846Z,2019,77,22,58,35,0,6to,5,0,42,0,0,55,19,0,71,2,0,1
44891,2998,2020-11-18T16:20:59.930985Z,2019,72,26,48,29,0,7mo,1,0,43,0,0,46,24,0,71,0,0,0
44891,2999,2020-11-18T16:20:59.930985Z,2019,54,18,38,21,0,8vo,0,0,33,0,0,36,16,0,54,0,0,0
44891,3000,2020-11-18T16:20:59.930985Z,2019,45,17,18,18,0,K,0,0,27,0,0,28,27,0,45,0,0,0
44891,3001,2020-11-18T16:21:00.3142408Z,2019,4,4,4,2,0,Sin Grado,0,0,2,0,0,0,0,0,4,0,0,0
44891,33001,2021-06-24T13:18:29.8028269Z,2021,35,10,29,23,0,1ro,1,0,12,0,0,25,6,0,34,0,0,0
44891,33002,2021-06-24T13:18:29.8038261Z,2021,45,17,36,20,0,2do,0,1,25,0,0,28,9,0,45,0,0,0
44891,33003,2021-06-24T13:18:29.8038261Z,2021,48,16,41,26,0,3ro,1,0,22,0,0,32,7,0,47,0,0,0
44891,33004,2021-06-24T13:18:29.8038261Z,2021,43,10,37,21,0,4to,3,1,22,0,0,33,6,0,40,0,0,0
44891,33005,2021-06-24T13:18:29.8038261Z,2021,54,17,49,22,0,5to,1,0,32,0,0,37,5,0,53,0,0,0
44891,33006,2021-06-24T13:18:29.8048275Z,2021,78,22,67,38,0,6to,2,0,40,0,0,56,11,0,76,0,0,0
44891,33007,2021-06-24T13:18:29.8048275Z,2021,71,15,55,36,0,7mo,4,0,35,0,0,56,16,0,67,1,1,0
44891,33008,2021-06-24T13:18:29.8048275Z,2021,73,21,59,32,0,8vo,6,0,41,0,0,52,14,0,66,2,0,1
44891,33009,2021-06-24T13:18:29.8048275Z,2021,42,13,36,23,0,K,1,0,19,0,0,29,6,0,41,0,0,0
44891,33010,2021-06-24T13:18:29.8048275Z,2021,5,4,5,0,0,Sin Grado,0,0,5,0,0,1,0,0,5,0,0,0
44891,9006,2020-11-18T16:21:55.4169876Z,2020,40,14,32,17,0,1ro,0,1,23,0,0,26,8,0,40,0,0,0
44891,9007,2020-11-18T16:21:55.4169876Z,2020,45,18,34,22,0,2do,1,0,23,0,0,27,11,0,44,0,0,0
44891,9008,2020-11-18T16:21:55.4169876Z,2020,35,9,25,17,0,3ro,4,0,18,0,0,26,10,0,31,0,0,0
44891,9009,2020-11-18T16:21:55.4169876Z,2020,56,19,49,23,0,4to,1,0,33,0,0,37,7,0,55,0,0,0
44891,9010,2020-11-18T16:21:55.4179885Z,2020,60,17,50,24,0,5to,2,0,36,0,0,43,10,0,58,0,0,0
44891,9011,2020-11-18T16:21:55.4179885Z,2020,67,13,55,35,0,6to,4,0,32,0,0,54,12,0,63,1,0,0
44891,9012,2020-11-18T16:21:55.4179885Z,2020,76,21,59,32,0,7mo,6,0,44,0,0,55,17,0,69,2,0,1
44891,9013,2020-11-18T16:21:55.4189881Z,2020,65,22,44,29,0,8vo,1,0,36,0,0,43,21,0,64,0,0,0
44891,9014,2020-11-18T16:21:55.4189881Z,2020,35,9,28,21,0,K,0,0,14,0,0,26,7,0,35,0,0,0
44891,9015,2020-11-18T16:21:55.4189881Z,2020,6,6,4,1,0,Sin Grado,0,0,5,0,0,0,2,0,6,0,0,0
72090,11481,2020-11-18T16:22:10.5941071Z,2020,36,7,33,17,0,1ro,0,0,19,0,0,29,3,0,36,0,0,0
72090,11482,2020-11-18T16:22:10.5941071Z,2020,44,13,41,21,0,2do,0,0,23,0,0,31,3,0,43,0,0,1
72090,11483,2020-11-18T16:22:10.5941071Z,2020,55,13,52,28,0,3ro,0,0,27,0,0,42,3,0,55,0,0,0
72090,11484,2020-11-18T16:22:10.5951066Z,2020,52,22,47,23,0,4to,0,0,29,0,0,30,5,0,51,0,0,1
72090,11485,2020-11-18T16:22:10.5951066Z,2020,47,15,40,24,0,5to,0,0,23,0,0,32,7,0,47,0,0,0
72090,11486,2020-11-18T16:22:10.5951066Z,2020,77,29,68,32,0,6to,1,0,45,0,0,48,9,0,76,0,0,0
72090,11487,2020-11-18T16:22:10.5951066Z,2020,73,22,64,40,0,7mo,0,0,33,0,0,51,9,0,73,0,0,0
72090,11488,2020-11-18T16:22:10.5951066Z,2020,63,17,49,32,0,8vo,1,0,31,0,0,46,14,0,62,0,1,0
72090,11489,2020-11-18T16:22:10.5951066Z,2020,27,5,25,15,0,K,0,0,12,0,0,22,2,0,27,0,0,0
72090,11490,2020-11-18T16:22:10.5961084Z,2020,16,5,12,7,0,PK,0,0,9,0,0,11,4,0,16,0,0,0
72090,11491,2020-11-18T16:22:10.5961084Z,2020,17,17,15,4,0,Sin Grado,0,0,13,0,0,0,2,0,17,0,0,0
72090,35502,2021-06-24T13:18:46.5638449Z,2021,33,9,26,16,0,1ro,0,0,17,0,0,24,7,0,33,0,0,0
72090,35503,2021-06-24T13:18:46.5638449Z,2021,41,8,37,19,0,2do,0,0,22,0,0,33,4,0,41,0,0,0
72090,35504,2021-06-24T13:18:46.5638449Z,2021,46,16,45,23,0,3ro,0,0,23,0,0,30,1,0,45,0,0,1
72090,35505,2021-06-24T13:18:46.5638449Z,2021,53,15,52,26,0,4to,0,0,27,0,0,38,1,0,53,0,0,0
72090,35506,2021-06-24T13:18:46.5648449Z,2021,49,24,48,23,0,5to,0,0,26,0,0,25,1,0,49,0,0,0
72090,35507,2021-06-24T13:18:46.5648449Z,2021,60,20,53,34,0,6to,0,0,26,0,0,40,7,0,60,0,0,0
72090,35508,2021-06-24T13:18:46.5648449Z,2021,74,27,69,31,0,7mo,0,0,43,0,0,47,5,0,74,0,0,0
72090,35509,2021-06-24T13:18:46.5658463Z,2021,67,19,59,35,0,8vo,0,0,32,0,0,48,8,0,67,0,0,0
72090,35510,2021-06-24T13:18:46.5658463Z,2021,23,4,21,10,0,K,0,0,13,0,0,19,2,0,23,0,0,0
72090,35511,2021-06-24T13:18:46.5658463Z,2021,13,2,12,5,0,PK,0,0,8,0,0,11,1,0,13,0,0,0
72090,35512,2021-06-24T13:18:46.5668468Z,2021,12,12,11,4,0,Sin Grado,0,0,8,0,0,0,1,0,12,0,0,0
72090,5471,2020-11-18T16:21:15.4963629Z,2019,42,13,39,19,0,1ro,0,0,23,0,0,29,3,0,42,0,0,0
72090,5472,2020-11-18T16:21:15.4963629Z,2019,49,12,44,25,0,2do,0,0,24,0,0,37,5,0,49,0,0,0
72090,5473,2020-11-18T16:21:15.4963629Z,2019,46,18,41,24,0,3ro,1,0,22,0,0,28,5,0,44,0,0,1
72090,5474,2020-11-18T16:21:15.4963629Z,2019,46,16,40,25,0,4to,0,0,21,0,0,30,6,0,46,0,0,0
72090,5475,2020-11-18T16:21:15.4963629Z,2019,59,21,51,29,0,5to,1,0,30,0,0,38,8,0,58,0,0,0
72090,5476,2020-11-18T16:21:15.4973656Z,2019,61,17,54,31,0,6to,0,0,30,0,0,44,7,0,61,0,0,0
72090,5477,2020-11-18T16:21:15.4973656Z,2019,66,18,52,35,0,7mo,1,0,31,0,0,48,14,0,65,0,1,0
72090,5478,2020-11-18T16:21:15.4973656Z,2019,77,21,67,49,0,8vo,0,0,28,0,0,56,10,0,77,0,0,0
72090,5479,2020-11-18T16:21:15.4973656Z,2019,32,5,27,15,0,K,0,0,17,0,0,27,5,0,32,0,0,0
72090,5480,2020-11-18T16:21:15.4973656Z,2019,14,1,12,10,0,PK,0,0,4,0,0,13,2,0,14,0,0,0
72090,5481,2020-11-18T16:21:15.4983651Z,2019,19,18,16,6,0,Sin Grado,0,0,13,0,0,1,3,0,19,0,0,0
12724,30407,2021-06-24T13:18:09.4842498Z,2021,13,2,12,7,0,1ro,0,0,6,0,0,11,1,0,13,0,0,0
12724,30408,2021-06-24T13:18:09.4842498Z,2021,14,7,13,7,0,2do,0,1,7,0,0,7,1,0,14,0,0,0
12724,30409,2021-06-24T13:18:09.4842498Z,2021,22,11,21,10,0,3ro,0,0,12,0,0,11,1,0,22,0,0,0
12724,30410,2021-06-24T13:18:09.4852512Z,2021,16,5,14,9,0,4to,0,0,7,0,0,11,2,0,16,0,0,0
12724,30411,2021-06-24T13:18:09.4852512Z,2021,13,5,11,9,0,5to,0,0,4,0,0,8,2,0,13,0,0,0
12724,30412,2021-06-24T13:18:09.4852512Z,2021,24,12,21,12,0,6to,0,0,12,0,0,12,3,0,24,0,0,0
12724,30413,2021-06-24T13:18:09.4852512Z,2021,14,6,11,5,0,7mo,0,0,9,0,0,8,3,0,14,0,0,0
12724,30414,2021-06-24T13:18:09.4852512Z,2021,25,9,18,8,0,8vo,0,0,17,0,0,16,7,0,25,0,0,0
12724,30415,2021-06-24T13:18:09.4862512Z,2021,17,2,16,12,0,K,1,0,5,0,0,15,1,0,16,0,0,0
12724,30416,2021-06-24T13:18:09.4862512Z,2021,6,6,6,4,0,Sin Grado,0,0,2,0,0,0,0,0,6,0,0,0
12724,409,2020-11-18T16:20:40.052731Z,2019,28,15,25,11,0,1ro,0,0,17,0,0,13,3,0,28,0,0,0
12724,410,2020-11-18T16:20:40.052731Z,2019,15,5,13,8,0,2do,0,0,7,0,0,10,2,0,15,0,0,0
12724,411,2020-11-18T16:20:40.052731Z,2019,12,7,10,6,0,3ro,0,0,6,0,0,5,2,0,12,0,0,0
12724,412,2020-11-18T16:20:40.052731Z,2019,22,12,17,10,0,4to,0,0,12,0,0,10,5,0,22,0,0,0
12724,413,2020-11-18T16:20:40.053731Z,2019,9,4,8,4,0,5to,0,0,5,0,0,5,1,0,9,0,0,0
12724,414,2020-11-18T16:20:40.053731Z,2019,18,6,11,6,0,6to,0,0,12,0,0,12,7,0,18,0,0,0
12724,415,2020-11-18T16:20:40.053731Z,2019,14,7,12,6,0,7mo,0,0,8,0,0,7,2,0,14,2,0,0
12724,416,2020-11-18T16:20:40.053731Z,2019,26,9,19,8,0,8vo,0,0,18,0,0,17,7,0,26,1,0,0
12724,417,2020-11-18T16:20:40.053731Z,2019,13,3,10,5,0,K,0,0,8,0,0,10,3,0,13,0,0,0
12724,418,2020-11-18T16:20:40.053731Z,2019,8,4,8,4,0,Sin Grado,1,0,4,0,0,4,0,0,7,0,0,0
12724,6410,2020-11-18T16:21:39.661481Z,2020,16,5,14,6,0,1ro,0,0,10,0,0,11,2,0,16,0,0,0
12724,6411,2020-11-18T16:21:39.661481Z,2020,25,13,19,10,0,2do,0,0,15,0,0,12,6,0,25,0,0,0
12724,6412,2020-11-18T16:21:39.661481Z,2020,15,5,13,8,0,3ro,0,0,7,0,0,10,2,0,15,0,0,0
12724,6413,2020-11-18T16:21:39.661481Z,2020,11,5,8,7,0,4to,0,0,4,0,0,6,3,0,11,0,0,0
12724,6414,2020-11-18T16:21:39.6624814Z,2020,25,12,21,13,0,5to,0,0,12,0,0,13,4,0,25,0,0,0
12724,6415,2020-11-18T16:21:39.6624814Z,2020,14,6,11,4,0,6to,0,0,10,0,0,8,3,0,14,0,0,0
12724,6416,2020-11-18T16:21:39.6624814Z,2020,22,7,14,8,0,7mo,0,0,14,0,0,15,8,0,22,0,0,0
12724,6417,2020-11-18T16:21:39.6624814Z,2020,14,6,12,7,0,8vo,0,0,7,0,0,8,2,0,14,2,0,0
12724,6418,2020-11-18T16:21:39.6634836Z,2020,16,5,14,8,0,K,0,0,8,0,0,11,2,0,16,0,0,0
12724,6419,2020-11-18T16:21:39.6634836Z,2020,3,3,3,3,0,Sin Grado,0,0,0,0,0,0,0,0,3,0,0,0
32680,2094,2020-11-18T16:20:53.9159725Z,2019,29,5,23,18,0,1ro,0,0,11,0,0,24,6,0,29,0,0,0
32680,2095,2020-11-18T16:20:53.9169734Z,2019,37,13,34,13,0,2do,1,0,24,0,0,24,3,0,36,0,0,0
32680,2096,2020-11-18T16:20:53.9169734Z,2019,35,10,27,18,0,3ro,0,0,17,0,0,25,8,0,35,0,0,0
32680,2097,2020-11-18T16:20:53.9169734Z,2019,48,8,33,24,0,4to,1,1,24,0,0,40,15,0,47,0,0,0
32680,2098,2020-11-18T16:20:53.9179734Z,2019,47,10,36,29,0,5to,1,0,18,0,0,37,11,0,46,1,0,0
32680,2099,2020-11-18T16:20:53.9179734Z,2019,116,30,82,56,0,6to,0,0,60,0,0,86,34,0,116,0,0,0
32680,2100,2020-11-18T16:20:53.9179734Z,2019,93,22,75,45,0,7mo,0,0,48,0,0,71,18,0,93,0,0,0
32680,2101,2020-11-18T16:20:54.5574012Z,2019,117,25,81,57,0,8vo,0,0,60,0,0,92,36,0,117,2,0,0
32680,2102,2020-11-18T16:20:54.5574012Z,2019,23,6,15,15,0,K,0,0,8,0,0,17,8,0,23,0,0,0
32680,2103,2020-11-18T16:20:54.5584021Z,2019,2,2,1,2,0,Sin Grado,0,0,0,0,0,0,1,0,2,0,0,0
32680,32100,2021-06-24T13:18:20.8884277Z,2021,36,7,30,12,0,1ro,0,0,24,0,0,29,6,0,36,0,0,0
32680,32101,2021-06-24T13:18:20.8884277Z,2021,24,8,19,11,0,2do,0,0,13,0,0,16,5,0,24,1,0,0
32680,32102,2021-06-24T13:18:20.8894282Z,2021,32,9,28,21,0,3ro,1,0,11,0,0,23,4,0,31,0,0,0
32680,32103,2021-06-24T13:18:20.8894282Z,2021,41,12,33,16,0,4to,0,0,25,0,0,29,8,0,41,0,0,0
32680,32104,2021-06-24T13:18:20.8894282Z,2021,44,9,37,26,0,5to,0,0,18,0,0,35,7,0,44,0,0,0
32680,32105,2021-06-24T13:18:20.8894282Z,2021,115,26,97,52,0,6to,2,0,63,0,0,89,18,0,113,2,0,0
32680,32106,2021-06-24T13:18:20.8894282Z,2021,102,25,76,62,0,7mo,1,0,40,0,0,77,26,0,101,1,0,0
32680,32107,2021-06-24T13:18:20.8904295Z,2021,113,22,83,46,0,8vo,2,0,67,0,0,91,30,0,111,0,0,0
32680,32108,2021-06-24T13:18:20.8904295Z,2021,34,5,24,14,0,K,0,0,20,0,0,29,10,0,34,0,0,0
32680,32109,2021-06-24T13:18:20.8904295Z,2021,3,3,2,3,0,Sin Grado,0,0,0,0,0,0,1,0,3,0,0,0
32680,8106,2020-11-18T16:21:50.2165188Z,2020,21,6,16,11,0,1ro,0,0,10,0,0,15,5,0,21,0,0,0
32680,8107,2020-11-18T16:21:50.2175193Z,2020,32,9,27,20,0,2do,1,0,12,0,0,23,5,0,31,0,0,0
32680,8108,2020-11-18T16:21:50.2175193Z,2020,32,8,24,9,0,3ro,0,0,23,0,0,24,8,0,32,0,0,0
32680,8109,2020-11-18T16:21:50.2175193Z,2020,40,9,28,22,0,4to,0,0,18,0,0,31,12,0,40,0,0,0
32680,8110,2020-11-18T16:21:50.2175193Z,2020,48,4,39,26,0,5to,1,0,22,0,0,44,9,0,47,0,0,0
32680,8111,2020-11-18T16:21:50.2175193Z,2020,96,21,69,59,0,6to,1,0,37,0,0,75,27,0,95,1,0,0
32680,8112,2020-11-18T16:21:50.2185202Z,2020,120,23,83,50,0,7mo,1,0,70,0,0,97,37,0,119,0,0,0
32680,8113,2020-11-18T16:21:50.2185202Z,2020,95,22,72,47,0,8vo,0,0,48,0,0,73,23,0,95,0,0,0
32680,8114,2020-11-18T16:21:50.2185202Z,2020,28,5,19,9,0,K,0,0,19,0,0,23,9,0,28,0,0,0
32680,8115,2020-11-18T16:21:50.2185202Z,2020,2,2,2,2,0,Sin Grado,0,0,0,0,0,0,0,0,2,0,0,0
11932,245,2020-11-18T16:20:38.7908883Z,2019,43,20,35,17,0,1ro,0,2,26,0,0,23,8,0,43,1,0,0
11932,246,2020-11-18T16:20:38.7908883Z,2019,35,17,29,14,0,2do,0,1,21,0,0,18,6,0,35,3,0,0
11932,247,2020-11-18T16:20:38.7908883Z,2019,35,8,32,17,0,3ro,2,0,18,0,0,27,3,0,33,1,0,0
11932,248,2020-11-18T16:20:38.7908883Z,2019,49,21,43,21,0,4to,1,2,28,0,0,28,6,0,48,3,1,0
11932,249,2020-11-18T16:20:38.7918896Z,2019,51,19,43,22,0,5to,0,0,29,0,0,32,8,0,51,2,0,0
11932,250,2020-11-18T16:20:38.7918896Z,2019,46,16,36,21,0,6to,1,3,25,0,0,30,10,0,45,2,1,0
11932,251,2020-11-18T16:20:38.7918896Z,2019,51,18,39,25,0,7mo,0,0,26,0,0,33,12,0,51,2,1,0
11932,252,2020-11-18T16:20:38.7918896Z,2019,39,9,30,16,0,8vo,0,2,23,0,0,30,9,0,39,0,0,0
11932,253,2020-11-18T16:20:38.7918896Z,2019,40,14,37,18,0,K,0,0,22,0,0,26,3,0,40,0,0,0
11932,254,2020-11-18T16:20:38.7928901Z,2019,29,12,24,15,0,PK,0,2,14,0,0,17,5,0,29,0,0,0
11932,255,2020-11-18T16:20:38.7928901Z,2019,20,19,14,8,0,Sin Grado,1,0,12,0,0,1,6,0,19,0,0,0
11932,30245,2021-06-24T13:18:07.1235581Z,2021,27,12,25,12,0,1ro,0,3,15,0,0,15,2,0,27,0,0,0
11932,30246,2021-06-24T13:18:07.1235581Z,2021,39,12,37,12,0,2do,0,1,27,0,0,27,2,0,39,0,0,0
11932,30247,2021-06-24T13:18:07.1245586Z,2021,41,17,33,17,0,3ro,1,2,24,0,0,24,8,0,40,1,0,0
11932,30248,2021-06-24T13:18:07.1245586Z,2021,36,16,31,17,0,4to,1,3,19,0,0,20,5,0,35,3,0,0
11932,30249,2021-06-24T13:18:07.1245586Z,2021,40,10,33,19,0,5to,2,2,21,0,0,30,7,0,38,1,0,0
11932,30250,2021-06-24T13:18:07.1245586Z,2021,40,19,37,13,0,6to,1,1,27,0,0,21,3,0,39,1,0,0
11932,30251,2021-06-24T13:18:07.1255591Z,2021,47,13,38,21,0,7mo,0,1,26,0,0,34,9,0,47,2,0,0
11932,30252,2021-06-24T13:18:07.1255591Z,2021,43,15,34,23,0,8vo,1,5,20,0,0,28,9,0,42,1,0,0
11932,30253,2021-06-24T13:18:07.1255591Z,2021,45,13,42,19,0,K,0,1,26,0,0,32,3,1,44,0,0,0
11932,30254,2021-06-24T13:18:07.1255591Z,2021,21,3,18,11,0,PK,0,1,10,0,0,18,3,0,21,0,0,0
11932,30255,2021-06-24T13:18:07.1255591Z,2021,22,22,20,8,0,Sin Grado,0,0,14,0,0,0,2,0,22,0,0,0
11932,6247,2020-11-18T16:21:38.6377974Z,2020,39,13,36,12,0,1ro,0,0,27,0,0,26,3,0,39,0,0,0
11932,6248,2020-11-18T16:21:38.6377974Z,2020,43,18,34,17,0,2do,1,0,26,0,0,25,9,0,42,1,0,0
11932,6249,2020-11-18T16:21:38.6377974Z,2020,35,17,28,15,0,3ro,0,0,20,0,0,18,7,0,35,3,0,0
11932,6250,2020-11-18T16:21:38.6387992Z,2020,37,10,31,18,0,4to,2,0,19,0,0,27,6,0,35,1,0,0
11932,6251,2020-11-18T16:21:38.6387992Z,2020,50,20,44,18,0,5to,1,0,32,0,0,30,6,0,49,2,0,0
11932,6252,2020-11-18T16:21:38.6387992Z,2020,53,18,45,24,0,6to,0,0,29,0,0,35,8,0,53,2,0,0
11932,6253,2020-11-18T16:21:38.6387992Z,2020,42,15,30,20,0,7mo,1,0,22,0,0,27,12,0,41,1,0,0
11932,6254,2020-11-18T16:21:38.6387992Z,2020,46,15,36,24,0,8vo,0,0,22,0,0,31,10,0,46,2,1,0
11932,6255,2020-11-18T16:21:38.6397992Z,2020,41,17,36,23,0,K,0,0,18,0,0,24,5,0,41,0,0,0
11932,6256,2020-11-18T16:21:38.6397992Z,2020,29,3,26,14,0,PK,0,0,15,0,0,26,3,0,29,0,0,0
11932,6257,2020-11-18T16:21:38.6397992Z,2020,22,22,18,7,0,Sin Grado,1,1,15,0,0,0,4,0,21,0,0,0
51458,33429,2021-06-24T13:18:32.4707395Z,2021,18,3,16,7,0,1ro,1,0,11,0,0,15,2,0,17,0,0,0
51458,33430,2021-06-24T13:18:32.4717396Z,2021,12,1,9,10,0,2do,0,1,2,0,0,11,3,0,12,0,0,0
51458,33431,2021-06-24T13:18:32.4717396Z,2021,16,3,14,8,0,3ro,0,1,8,0,0,13,2,0,15,0,0,1
51458,33432,2021-06-24T13:18:32.4717396Z,2021,19,6,14,8,0,4to,0,1,11,0,0,13,5,0,19,0,0,0
51458,33433,2021-06-24T13:18:32.4727405Z,2021,17,5,14,8,0,5to,0,0,9,0,0,12,3,0,17,0,0,0
51458,33434,2021-06-24T13:18:32.4727405Z,2021,18,7,17,8,0,6to,0,1,10,0,0,11,1,0,18,0,1,0
51458,33435,2021-06-24T13:18:32.4727405Z,2021,21,5,18,7,0,7mo,0,0,14,0,0,16,3,0,21,1,0,0
51458,33436,2021-06-24T13:18:32.4737419Z,2021,14,4,12,4,0,8vo,0,0,10,0,0,10,2,0,14,0,0,0
51458,33437,2021-06-24T13:18:32.4737419Z,2021,13,1,10,9,0,K,0,0,4,0,0,12,3,0,13,0,0,0
51458,33438,2021-06-24T13:18:32.4737419Z,2021,5,1,3,4,0,PK,0,0,1,0,0,4,2,0,5,0,0,0
51458,33439,2021-06-24T13:18:32.474742Z,2021,1,1,0,1,0,Sin Grado,0,0,0,0,0,0,1,0,1,0,0,0
51458,3405,2020-11-18T16:21:02.550735Z,2019,17,3,14,9,0,1ro,0,1,8,0,0,14,3,0,17,0,0,0
51458,3406,2020-11-18T16:21:02.550735Z,2019,22,6,18,8,0,2do,0,3,14,0,0,16,4,0,22,0,0,0
51458,3407,2020-11-18T16:21:02.550735Z,2019,12,3,10,9,0,3ro,0,1,3,0,0,9,2,0,12,0,0,0
51458,3408,2020-11-18T16:21:02.550735Z,2019,21,8,18,10,0,4to,0,2,11,0,0,13,3,0,21,0,1,0
51458,3409,2020-11-18T16:21:02.5517354Z,2019,19,6,17,6,0,5to,0,0,13,0,0,13,2,0,19,1,0,0
51458,3410,2020-11-18T16:21:02.5517354Z,2019,14,5,13,5,0,6to,0,0,9,0,0,9,1,0,14,0,0,0
51458,3411,2020-11-18T16:21:02.5517354Z,2019,23,7,18,4,0,7mo,0,1,19,0,0,16,5,0,23,0,0,0
51458,3412,2020-11-18T16:21:02.5527363Z,2019,21,7,18,15,0,8vo,0,0,6,0,0,14,3,0,21,1,0,0
51458,3413,2020-11-18T16:21:02.5527363Z,2019,12,1,10,9,0,K,0,0,3,0,0,11,2,0,12,0,0,0
51458,3414,2020-11-18T16:21:02.5527363Z,2019,8,1,6,4,0,PK,0,0,4,0,0,7,2,0,8,0,0,0
51458,3415,2020-11-18T16:21:02.5537372Z,2019,3,3,2,1,0,Sin Grado,0,1,2,0,0,0,1,0,3,0,0,0
51458,9425,2020-11-18T16:21:58.4179854Z,2020,12,1,9,8,0,1ro,1,0,4,0,0,11,3,0,11,0,0,0
51458,9426,2020-11-18T16:21:58.4189859Z,2020,18,3,13,8,0,2do,0,0,10,0,0,15,5,0,17,0,0,1
51458,9427,2020-11-18T16:21:58.4189859Z,2020,21,8,19,8,0,3ro,1,0,13,0,0,13,2,0,20,0,0,0
51458,9428,2020-11-18T16:21:58.4189859Z,2020,15,4,11,9,0,4to,0,0,6,0,0,11,4,0,15,0,0,0
51458,9429,2020-11-18T16:21:58.4189859Z,2020,21,8,19,10,0,5to,0,1,11,0,0,13,2,0,21,0,1,0
51458,9430,2020-11-18T16:21:58.4189859Z,2020,21,7,19,6,0,6to,0,0,15,0,0,14,2,0,21,1,0,0
51458,9431,2020-11-18T16:21:58.4199863Z,2020,15,5,14,5,0,7mo,0,0,10,0,0,10,1,0,15,0,0,0
51458,9432,2020-11-18T16:21:58.4199863Z,2020,23,7,18,6,0,8vo,0,0,17,0,0,16,5,0,23,0,0,0
51458,9433,2020-11-18T16:21:58.4199863Z,2020,16,2,14,7,0,K,1,0,9,0,0,14,2,0,15,0,0,0
51458,9434,2020-11-18T16:21:58.4199863Z,2020,7,0,6,4,0,PK,0,0,3,0,0,7,1,0,7,0,0,0
51458,9435,2020-11-18T16:21:58.4199863Z,2020,3,3,2,1,0,Sin Grado,0,0,2,0,0,0,1,0,3,0,0,0
41020,2648,2020-11-18T16:20:58.065743Z,2019,26,8,19,10,0,1ro,1,0,16,0,0,18,7,0,25,0,0,0
41020,2649,2020-11-18T16:20:58.066743Z,2019,25,5,13,9,0,2do,1,0,16,0,0,20,12,0,23,0,0,1
41020,2650,2020-11-18T16:20:58.066743Z,2019,25,3,13,13,0,3ro,0,0,12,0,0,22,12,0,25,0,0,0
41020,2651,2020-11-18T16:20:58.066743Z,2019,28,4,13,13,0,4to,0,0,15,0,0,24,15,0,28,0,0,0
41020,2652,2020-11-18T16:20:58.0677439Z,2019,49,12,33,23,0,5to,3,0,26,0,0,37,16,0,46,0,0,0
41020,2653,2020-11-18T16:20:58.0677439Z,2019,53,15,35,20,0,6to,1,0,33,0,0,38,18,0,52,0,1,0
41020,2654,2020-11-18T16:20:58.0687439Z,2019,65,18,40,31,0,7mo,2,0,34,0,0,47,25,0,63,0,1,0
41020,2655,2020-11-18T16:20:58.0687439Z,2019,48,17,29,20,0,8vo,1,0,28,0,0,31,19,0,47,0,2,0
41020,2656,2020-11-18T16:20:58.0687439Z,2019,24,10,15,11,0,K,0,0,13,0,0,14,9,0,24,0,0,0
41020,32655,2021-06-24T13:18:26.2732949Z,2021,29,10,25,19,0,1ro,0,0,10,0,0,19,4,0,29,0,0,0
41020,32656,2021-06-24T13:18:26.2732949Z,2021,25,10,21,10,0,2do,0,0,15,0,0,15,4,0,25,0,0,0
41020,32657,2021-06-24T13:18:26.2742959Z,2021,26,7,21,8,0,3ro,1,0,18,0,0,19,5,0,25,0,0,0
41020,32658,2021-06-24T13:18:26.2742959Z,2021,26,6,16,9,0,4to,1,0,17,0,0,20,10,0,24,0,0,1
41020,32659,2021-06-24T13:18:26.2742959Z,2021,39,9,28,19,0,5to,1,0,20,0,0,30,11,0,38,0,0,0
41020,32660,2021-06-24T13:18:26.2742959Z,2021,51,10,32,24,0,6to,1,0,27,0,0,41,19,0,50,0,0,0
41020,32661,2021-06-24T13:18:26.2742959Z,2021,60,15,40,28,0,7mo,4,0,32,0,0,45,20,0,56,0,0,0
41020,32662,2021-06-24T13:18:26.2752959Z,2021,51,13,37,18,0,8vo,1,0,33,0,0,38,14,0,50,0,1,0
41020,32663,2021-06-24T13:18:26.2752959Z,2021,24,7,19,11,0,K,0,0,13,0,0,17,5,0,24,0,0,0
41020,8659,2020-11-18T16:21:53.0644168Z,2020,27,11,20,13,0,1ro,0,0,14,0,0,16,7,0,27,0,0,0
41020,8660,2020-11-18T16:21:53.0654159Z,2020,26,8,15,10,0,2do,1,0,16,0,0,18,11,0,25,0,0,0
41020,8661,2020-11-18T16:21:53.0654159Z,2020,24,6,15,9,0,3ro,1,0,15,0,0,18,9,0,23,0,0,0
41020,8662,2020-11-18T16:21:53.0654159Z,2020,28,3,16,17,0,4to,1,0,11,0,0,25,12,0,27,0,0,0
41020,8663,2020-11-18T16:21:53.0664172Z,2020,42,6,21,22,0,5to,1,0,20,0,0,36,21,0,41,0,0,0
41020,8664,2020-11-18T16:21:53.0664172Z,2020,54,15,33,26,0,6to,4,0,28,0,0,39,21,0,50,0,0,0
41020,8665,2020-11-18T16:21:53.0664172Z,2020,53,14,36,18,0,7mo,1,0,35,0,0,39,17,0,52,0,1,0
41020,8666,2020-11-18T16:21:53.0664172Z,2020,61,15,39,30,0,8vo,1,0,31,0,0,46,22,0,60,0,1,0
41020,8667,2020-11-18T16:21:53.0664172Z,2020,22,6,19,13,0,K,0,0,9,0,0,16,3,0,22,0,0,0
51441,33420,2021-06-24T13:18:32.4637343Z,2021,13,2,12,8,0,1ro,0,0,5,0,0,11,1,0,13,0,0,0
51441,33421,2021-06-24T13:18:32.4647348Z,2021,15,3,15,4,0,2do,1,0,11,0,0,12,0,0,14,0,0,0
51441,33422,2021-06-24T13:18:32.4647348Z,2021,10,5,3,5,0,3ro,0,0,5,0,0,5,7,0,10,0,0,0
51441,33423,2021-06-24T13:18:32.4647348Z,2021,16,2,14,12,0,4to,0,0,4,0,0,14,2,0,16,0,0,0
51441,33424,2021-06-24T13:18:32.4657353Z,2021,22,10,16,10,0,5to,0,0,12,0,0,12,6,0,22,0,0,0
51441,33425,2021-06-24T13:18:32.4657353Z,2021,31,12,28,9,0,6to,0,0,22,0,0,19,3,0,31,0,0,0
51441,33426,2021-06-24T13:18:32.4657353Z,2021,31,11,26,14,0,7mo,0,0,17,0,0,20,5,0,31,0,0,0
51441,33427,2021-06-24T13:18:32.4657353Z,2021,33,10,29,16,0,8vo,1,0,17,0,0,23,4,0,32,0,0,0
51441,33428,2021-06-24T13:18:32.4667362Z,2021,17,5,9,6,0,K,2,0,11,0,0,12,8,0,15,0,0,0
51441,3396,2020-11-18T16:21:02.1554707Z,2019,13,6,7,7,0,1ro,0,1,6,0,0,7,6,0,13,0,0,0
51441,3397,2020-11-18T16:21:02.1554707Z,2019,18,3,16,15,0,2do,0,4,3,0,0,15,2,0,18,0,0,0
51441,3398,2020-11-18T16:21:02.1554707Z,2019,27,11,20,13,0,3ro,0,4,14,0,0,16,7,0,27,0,0,0
51441,3399,2020-11-18T16:21:02.1554707Z,2019,28,12,24,8,0,4to,0,7,20,0,0,16,4,0,28,0,0,0
51441,3400,2020-11-18T16:21:02.1554707Z,2019,25,9,21,10,0,5to,0,1,15,0,0,16,4,0,25,0,0,0
51441,3401,2020-11-18T16:21:02.5407288Z,2019,45,15,42,19,0,6to,1,3,26,0,0,30,3,0,44,0,0,0
51441,3402,2020-11-18T16:21:02.5407288Z,2019,31,11,27,17,0,7mo,1,9,14,0,0,20,4,1,29,0,0,0
51441,3403,2020-11-18T16:21:02.5407288Z,2019,43,14,36,18,0,8vo,0,6,25,0,0,29,7,0,43,0,0,0
51441,3404,2020-11-18T16:21:02.5407288Z,2019,18,2,1,7,0,K,1,1,11,0,0,16,17,0,17,0,0,0
51441,9416,2020-11-18T16:21:58.4139823Z,2020,15,2,13,4,0,1ro,1,0,11,0,0,13,2,0,14,0,0,0
51441,9417,2020-11-18T16:21:58.4139823Z,2020,15,7,8,8,0,2do,0,1,7,0,0,8,7,0,15,0,0,0
51441,9418,2020-11-18T16:21:58.4139823Z,2020,17,3,16,14,0,3ro,0,2,3,0,0,14,1,0,17,0,0,0
51441,9419,2020-11-18T16:21:58.4139823Z,2020,24,10,17,12,0,4to,0,2,12,0,0,14,7,0,24,0,0,0
51441,9420,2020-11-18T16:21:58.4149836Z,2020,28,12,23,7,0,5to,0,2,21,0,0,16,5,0,28,0,0,0
51441,9421,2020-11-18T16:21:58.4149836Z,2020,32,11,25,14,0,6to,0,0,18,0,0,21,7,0,32,0,0,0
51441,9422,2020-11-18T16:21:58.4149836Z,2020,39,12,38,17,0,7mo,1,4,22,0,0,27,1,0,38,0,0,0
51441,9423,2020-11-18T16:21:58.4149836Z,2020,34,12,30,17,0,8vo,1,4,17,0,0,22,4,1,32,0,0,0
51441,9424,2020-11-18T16:21:58.4149836Z,2020,15,2,5,8,0,K,0,0,7,0,0,13,10,0,15,0,0,0
32433,2047,2020-11-18T16:20:53.9009627Z,2019,25,6,22,12,0,1ro,0,0,13,0,0,19,3,0,25,0,0,0
32433,2048,2020-11-18T16:20:53.9019636Z,2019,25,8,21,13,0,2do,1,0,12,0,0,17,4,0,24,0,0,0
32433,2049,2020-11-18T16:20:53.9019636Z,2019,25,7,23,13,0,3ro,1,0,12,0,0,18,2,0,24,0,0,0
32433,2050,2020-11-18T16:20:53.9019636Z,2019,31,4,27,16,0,4to,1,0,15,0,0,27,4,0,30,0,0,0
32433,2051,2020-11-18T16:20:53.9019636Z,2019,36,5,32,18,0,5to,0,0,18,0,0,31,4,0,36,0,0,0
32433,2052,2020-11-18T16:20:53.9029636Z,2019,13,1,12,7,0,6to,0,0,6,0,0,12,1,0,13,0,0,0
32433,2053,2020-11-18T16:20:53.9029636Z,2019,18,3,15,11,0,7mo,0,0,7,0,0,15,3,0,18,0,0,0
32433,2054,2020-11-18T16:20:53.9029636Z,2019,24,4,16,11,0,8vo,0,2,13,0,0,20,8,0,24,0,0,0
32433,2055,2020-11-18T16:20:53.9039645Z,2019,21,7,19,13,0,K,0,0,8,0,0,14,2,0,21,0,0,0
32433,2056,2020-11-18T16:20:53.9039645Z,2019,4,3,4,2,0,Sin Grado,1,0,2,0,0,1,0,0,3,0,0,0
32433,32053,2021-06-24T13:18:20.0978612Z,2021,16,6,15,7,0,1ro,0,0,9,0,0,10,1,0,16,0,0,0
32433,32054,2021-06-24T13:18:20.0978612Z,2021,21,5,16,10,0,2do,0,0,11,0,0,16,5,0,21,0,0,0
32433,32055,2021-06-24T13:18:20.0978612Z,2021,26,9,21,14,0,3ro,0,0,12,0,0,17,5,0,26,0,0,0
32433,32056,2021-06-24T13:18:20.0988622Z,2021,20,6,16,11,0,4to,1,1,9,0,0,14,4,0,19,0,0,0
32433,32057,2021-06-24T13:18:20.0988622Z,2021,23,6,21,12,0,5to,1,0,11,0,0,17,2,0,22,0,0,0
32433,32058,2021-06-24T13:18:20.0988622Z,2021,35,4,26,17,0,6to,1,0,18,0,0,31,9,0,34,0,0,0
32433,32059,2021-06-24T13:18:20.0998622Z,2021,37,5,35,18,0,7mo,0,0,19,0,0,32,2,0,37,0,0,0
32433,32060,2021-06-24T13:18:20.0998622Z,2021,20,4,16,11,0,8vo,0,1,9,0,0,16,4,0,20,0,0,0
32433,32061,2021-06-24T13:18:20.0998622Z,2021,21,3,11,11,0,K,0,0,10,0,0,18,10,0,21,0,0,0
32433,32062,2021-06-24T13:18:20.0998622Z,2021,4,4,3,1,0,Sin Grado,1,0,3,0,0,0,1,0,3,0,0,0
32433,8059,2020-11-18T16:21:49.5680857Z,2020,22,6,21,13,0,1ro,0,0,9,0,0,16,1,0,22,0,0,0
32433,8060,2020-11-18T16:21:49.5680857Z,2020,25,7,24,11,0,2do,1,0,14,0,0,18,1,0,24,0,0,0
32433,8061,2020-11-18T16:21:49.5690866Z,2020,23,9,20,12,0,3ro,1,0,11,0,0,14,3,0,22,0,0,0
32433,8062,2020-11-18T16:21:49.5690866Z,2020,22,6,21,11,0,4to,1,0,11,0,0,16,1,0,21,0,0,0
32433,8063,2020-11-18T16:21:49.5690866Z,2020,31,5,25,15,0,5to,1,0,16,0,0,26,6,0,30,0,0,0
32433,8064,2020-11-18T16:21:49.5700879Z,2020,36,5,32,19,0,6to,0,0,17,0,0,31,4,0,36,0,0,0
32433,8065,2020-11-18T16:21:49.5700879Z,2020,18,3,13,11,0,7mo,0,0,7,0,0,15,5,0,18,0,0,0
32433,8066,2020-11-18T16:21:49.5700879Z,2020,19,1,14,13,0,8vo,0,0,6,0,0,18,5,0,19,0,0,0
32433,8067,2020-11-18T16:21:49.5700879Z,2020,16,4,16,9,0,K,0,0,7,0,0,12,0,0,16,0,0,0
32433,8068,2020-11-18T16:21:49.5710884Z,2020,3,3,3,1,0,Sin Grado,1,0,2,0,0,0,0,0,2,0,0,0
17749,30753,2021-06-24T13:18:11.1944768Z,2021,53,19,43,22,0,1ro,0,0,31,0,0,34,10,0,53,0,0,0
17749,30754,2021-06-24T13:18:11.1944768Z,2021,48,9,36,29,0,2do,1,0,19,0,0,39,12,0,46,0,0,1
17749,30755,2021-06-24T13:18:11.1954768Z,2021,67,33,55,32,0,3ro,0,0,35,0,0,34,12,0,66,0,0,1
17749,30756,2021-06-24T13:18:11.1954768Z,2021,57,20,48,31,0,4to,0,0,26,0,0,37,9,0,55,0,0,2
17749,30757,2021-06-24T13:18:11.1964778Z,2021,61,21,50,33,0,5to,0,0,28,0,0,40,11,0,60,0,0,1
17749,30758,2021-06-24T13:18:11.1964778Z,2021,84,38,71,49,0,6to,0,0,35,0,0,46,13,0,84,0,0,0
17749,30759,2021-06-24T13:18:11.1974787Z,2021,90,25,80,39,0,7mo,1,0,51,0,0,65,10,0,89,0,0,0
17749,30760,2021-06-24T13:18:11.1974787Z,2021,78,31,65,39,0,8vo,1,0,39,0,0,47,13,0,77,0,0,0
17749,30761,2021-06-24T13:18:11.1984792Z,2021,36,9,25,15,0,K,0,0,21,0,0,27,11,1,33,0,0,2
17749,30762,2021-06-24T13:18:11.1984792Z,2021,21,21,18,4,0,Sin Grado,0,0,17,0,0,0,3,0,21,0,0,0
17749,6756,2020-11-18T16:21:41.4466699Z,2020,45,10,36,30,0,1ro,0,0,15,0,0,35,9,0,45,0,0,0
17749,6757,2020-11-18T16:21:41.4466699Z,2020,75,34,62,38,0,2do,0,0,37,0,0,41,13,0,75,0,0,0
17749,6758,2020-11-18T16:21:41.4466699Z,2020,66,24,54,34,0,3ro,0,0,32,0,0,42,12,0,66,0,0,0
17749,6759,2020-11-18T16:21:41.4466699Z,2020,67,24,55,37,0,4to,0,0,30,0,0,43,12,0,65,0,0,2
17749,6760,2020-11-18T16:21:41.4476695Z,2020,82,37,61,46,0,5to,0,0,36,0,0,45,21,0,82,0,1,0
17749,6761,2020-11-18T16:21:41.4476695Z,2020,97,27,76,43,0,6to,1,0,54,0,0,70,21,0,96,0,0,0
17749,6762,2020-11-18T16:21:41.4476695Z,2020,83,31,69,41,0,7mo,1,0,42,0,0,52,14,0,82,0,0,0
17749,6763,2020-11-18T16:21:41.4476695Z,2020,91,38,72,36,0,8vo,2,0,55,0,0,53,19,0,88,0,1,1
17749,6764,2020-11-18T16:21:41.4486703Z,2020,59,15,52,28,0,K,0,0,31,0,0,44,7,0,59,0,0,0
17749,6765,2020-11-18T16:21:41.4486703Z,2020,23,23,22,5,0,Sin Grado,0,0,18,0,0,0,1,0,23,0,0,0
17749,755,2020-11-18T16:20:42.1161063Z,2019,67,29,52,35,0,1ro,0,0,32,0,0,38,15,0,67,0,0,0
17749,756,2020-11-18T16:20:42.1161063Z,2019,59,24,50,30,0,2do,0,0,29,0,0,35,9,0,59,0,0,0
17749,757,2020-11-18T16:20:42.1171067Z,2019,67,24,54,36,0,3ro,0,0,31,0,0,43,13,0,67,0,0,0
17749,758,2020-11-18T16:20:42.1171067Z,2019,74,33,56,41,0,4to,0,0,33,0,0,41,18,0,74,0,1,0
17749,759,2020-11-18T16:20:42.1171067Z,2019,85,22,68,42,0,5to,1,0,43,0,0,63,17,0,84,0,0,0
17749,760,2020-11-18T16:20:42.1171067Z,2019,89,36,76,44,0,6to,0,1,45,0,0,53,13,0,89,0,0,0
17749,761,2020-11-18T16:20:42.1171067Z,2019,83,35,62,32,0,7mo,2,0,51,0,0,48,21,0,80,0,1,1
17749,762,2020-11-18T16:20:42.1181071Z,2019,83,30,65,36,0,8vo,1,1,47,0,0,53,18,0,82,0,1,0
17749,763,2020-11-18T16:20:42.1181071Z,2019,49,15,0,26,0,K,0,0,23,0,0,34,49,0,49,0,0,0
17749,764,2020-11-18T16:20:42.1181071Z,2019,19,18,18,5,0,Sin Grado,1,0,14,0,0,1,1,0,18,1,0,0
20172,30875,2021-06-24T13:18:11.4666728Z,2021,23,9,23,11,0,1ro,1,0,12,0,0,14,0,0,22,0,0,0
20172,30876,2021-06-24T13:18:11.4676724Z,2021,18,6,16,8,0,2do,0,2,10,0,0,12,2,0,18,0,0,0
20172,30877,2021-06-24T13:18:11.4676724Z,2021,25,7,22,7,0,3ro,0,0,18,0,0,18,3,0,25,0,0,0
20172,30878,2021-06-24T13:18:11.4676724Z,2021,35,11,32,20,0,4to,1,0,15,0,0,24,3,0,34,0,0,0
20172,30879,2021-06-24T13:18:11.4676724Z,2021,36,14,32,17,0,5to,0,2,19,0,0,22,4,0,36,0,0,0
20172,30880,2021-06-24T13:18:11.4686734Z,2021,27,11,25,15,0,6to,0,0,12,0,0,16,2,0,27,0,0,0
20172,30881,2021-06-24T13:18:11.4686734Z,2021,37,17,33,15,0,7mo,0,2,22,0,0,20,4,0,37,0,0,0
20172,30882,2021-06-24T13:18:11.4686734Z,2021,40,16,34,17,0,8vo,0,1,23,0,0,24,6,0,40,0,0,0
20172,30883,2021-06-24T13:18:11.4686734Z,2021,15,3,13,7,0,K,0,0,8,0,0,12,2,0,15,0,0,0
20172,30884,2021-06-24T13:18:11.4696743Z,2021,8,8,6,3,0,Sin Grado,0,0,5,0,0,0,2,0,8,0,0,0
20172,6879,2020-11-18T16:21:42.057075Z,2020,17,6,13,7,0,1ro,0,2,10,0,0,11,4,0,17,0,0,0
20172,6880,2020-11-18T16:21:42.057075Z,2020,22,7,20,6,0,2do,0,1,16,0,0,15,2,0,22,0,0,0
20172,6881,2020-11-18T16:21:42.0580754Z,2020,34,11,29,19,0,3ro,1,1,15,0,0,23,5,0,33,0,0,0
20172,6882,2020-11-18T16:21:42.0580754Z,2020,35,14,32,16,0,4to,0,1,19,0,0,21,3,0,35,0,0,0
20172,6883,2020-11-18T16:21:42.0580754Z,2020,27,9,21,15,0,5to,1,4,12,0,0,18,6,0,26,0,0,0
20172,6884,2020-11-18T16:21:42.0580754Z,2020,35,15,31,15,0,6to,0,3,20,0,0,20,4,0,35,0,0,0
20172,6885,2020-11-18T16:21:42.0580754Z,2020,39,17,35,17,0,7mo,0,1,22,0,0,22,4,0,39,0,0,0
20172,6886,2020-11-18T16:21:42.0590768Z,2020,48,27,41,22,0,8vo,0,4,26,0,0,21,7,0,48,0,0,0
20172,6887,2020-11-18T16:21:42.0590768Z,2020,22,6,22,11,0,K,1,0,11,0,0,16,0,0,21,0,0,0
20172,6888,2020-11-18T16:21:42.0590768Z,2020,12,12,11,1,0,Sin Grado,1,4,11,0,0,0,1,0,11,0,0,0
20172,878,2020-11-18T16:20:42.6554643Z,2019,26,8,20,10,0,1ro,0,1,16,0,0,18,6,0,26,0,0,0
20172,879,2020-11-18T16:20:42.6564638Z,2019,33,9,29,19,0,2do,1,2,14,0,0,24,4,0,32,0,0,0
20172,880,2020-11-18T16:20:42.6564638Z,2019,37,15,32,16,0,3ro,0,0,21,0,0,22,5,0,37,0,0,0
20172,881,2020-11-18T16:20:42.6564638Z,2019,31,10,25,16,0,4to,2,1,15,0,0,21,6,0,29,0,0,0
20172,882,2020-11-18T16:20:42.6564638Z,2019,37,17,33,14,0,5to,0,3,23,0,0,20,4,0,37,0,0,0
20172,883,2020-11-18T16:20:42.6564638Z,2019,41,16,34,19,0,6to,0,0,22,0,0,25,7,0,41,0,0,0
20172,884,2020-11-18T16:20:42.6574647Z,2019,45,26,37,21,0,7mo,0,4,24,0,0,19,8,0,45,0,0,0
20172,885,2020-11-18T16:20:42.6574647Z,2019,45,19,35,18,0,8vo,1,2,27,0,0,26,10,0,44,0,0,0
20172,886,2020-11-18T16:20:42.6574647Z,2019,13,5,0,4,0,K,0,0,9,0,0,8,13,0,13,0,0,0
20172,887,2020-11-18T16:20:42.6574647Z,2019,9,9,8,2,0,Sin Grado,1,3,7,0,0,0,1,0,8,0,0,0
43729,2925,2020-11-18T16:20:59.9059685Z,2019,18,8,14,5,0,1ro,0,0,13,0,0,10,4,0,18,1,0,0
43729,2926,2020-11-18T16:20:59.9059685Z,2019,26,4,23,15,0,2do,0,0,11,0,0,22,3,0,26,1,0,0
43729,2927,2020-11-18T16:20:59.9059685Z,2019,24,7,20,10,0,3ro,0,0,14,0,0,17,4,0,24,0,0,0
43729,2928,2020-11-18T16:20:59.9069694Z,2019,34,11,28,18,0,4to,0,0,16,0,0,23,6,0,34,0,0,0
43729,2929,2020-11-18T16:20:59.9069694Z,2019,35,10,30,12,0,5to,0,0,23,0,0,25,5,0,35,1,0,0
43729,2930,2020-11-18T16:20:59.9069694Z,2019,66,18,54,32,0,6to,1,0,34,0,0,48,12,0,65,1,0,0
43729,2931,2020-11-18T16:20:59.9079694Z,2019,67,17,54,29,0,7mo,2,0,38,0,0,50,13,0,65,2,0,0
43729,2932,2020-11-18T16:20:59.9079694Z,2019,48,13,34,23,0,8vo,1,0,25,0,0,35,14,0,47,1,0,0
43729,2933,2020-11-18T16:20:59.9079694Z,2019,11,2,10,6,0,K,0,0,5,0,0,9,1,0,11,0,0,0
43729,32934,2021-06-24T13:18:28.8831664Z,2021,15,3,15,10,0,1ro,0,0,5,0,0,12,0,0,15,0,0,0
43729,32935,2021-06-24T13:18:28.8841682Z,2021,15,5,14,8,0,2do,0,0,7,0,0,10,1,0,15,0,0,0
43729,32936,2021-06-24T13:18:28.8841682Z,2021,17,8,15,5,0,3ro,0,0,12,0,0,9,2,0,17,1,0,0
43729,32937,2021-06-24T13:18:28.8841682Z,2021,30,7,28,18,0,4to,0,0,12,0,0,23,2,0,30,1,0,0
43729,32938,2021-06-24T13:18:28.8841682Z,2021,26,2,23,13,0,5to,0,0,13,0,0,24,3,0,26,0,0,0
43729,32939,2021-06-24T13:18:28.8841682Z,2021,58,23,55,26,0,6to,1,0,32,0,0,35,3,0,57,0,1,0
43729,32940,2021-06-24T13:18:28.8851682Z,2021,50,15,44,21,0,7mo,0,0,29,0,0,35,6,0,50,1,0,0
43729,32941,2021-06-24T13:18:28.8851682Z,2021,69,22,59,31,0,8vo,1,0,38,0,0,47,10,0,68,1,1,0
43729,32942,2021-06-24T13:18:28.8851682Z,2021,12,3,11,7,0,K,1,0,5,0,0,9,1,0,11,0,0,0
43729,8938,2020-11-18T16:21:54.9927033Z,2020,13,2,13,6,0,1ro,0,0,7,0,0,11,0,0,13,0,0,0
43729,8939,2020-11-18T16:21:54.9927033Z,2020,15,6,11,4,0,2do,0,0,11,0,0,9,4,0,15,1,0,0
43729,8940,2020-11-18T16:21:54.9927033Z,2020,30,5,28,19,0,3ro,0,0,11,0,0,25,2,0,30,1,0,0
43729,8941,2020-11-18T16:21:54.9927033Z,2020,24,3,20,14,0,4to,0,0,10,0,0,21,4,0,24,0,0,0
43729,8942,2020-11-18T16:21:54.9937047Z,2020,37,12,32,19,0,5to,0,0,18,0,0,25,5,0,37,1,1,0
43729,8943,2020-11-18T16:21:54.9937047Z,2020,43,12,38,19,0,6to,0,0,24,0,0,31,5,0,43,1,0,0
43729,8944,2020-11-18T16:21:54.9937047Z,2020,58,22,49,25,0,7mo,1,0,33,0,0,36,9,0,57,1,0,0
43729,8945,2020-11-18T16:21:54.9937047Z,2020,67,17,55,30,0,8vo,1,0,37,0,0,50,12,0,66,2,0,0
43729,8946,2020-11-18T16:21:54.9937047Z,2020,16,6,13,8,0,K,0,0,8,0,0,10,3,0,16,0,0,0
48306,3212,2020-11-18T16:21:01.4449961Z,2019,39,13,32,23,0,1ro,0,0,16,0,0,26,7,0,39,0,0,0
48306,3213,2020-11-18T16:21:01.4449961Z,2019,35,9,31,17,0,2do,0,0,18,0,0,26,4,0,34,0,0,1
48306,3214,2020-11-18T16:21:01.4449961Z,2019,35,13,30,11,0,3ro,0,0,24,0,0,22,5,0,35,0,1,0
48306,3215,2020-11-18T16:21:01.4449961Z,2019,37,16,34,21,0,4to,1,0,16,0,0,21,3,0,36,0,1,0
48306,3216,2020-11-18T16:21:01.4459966Z,2019,29,9,24,14,0,5to,0,0,15,0,0,20,5,0,29,0,0,0
48306,3217,2020-11-18T16:21:01.4459966Z,2019,40,16,35,16,0,6to,3,0,24,0,0,24,5,0,37,0,0,0
48306,3218,2020-11-18T16:21:01.4459966Z,2019,47,18,37,22,0,7mo,0,2,25,0,0,29,10,0,47,0,0,0
48306,3219,2020-11-18T16:21:01.4459966Z,2019,48,17,42,24,0,8vo,1,0,24,0,0,31,6,0,47,0,0,0
48306,3220,2020-11-18T16:21:01.4459966Z,2019,23,6,23,18,0,K,0,1,5,0,0,17,0,0,23,0,0,0
48306,3221,2020-11-18T16:21:01.446997Z,2019,25,22,23,6,0,Sin Grado,0,3,19,0,0,3,2,0,25,0,0,0
48306,33237,2021-06-24T13:18:30.8805986Z,2021,35,11,32,16,0,1ro,0,1,19,0,0,24,3,0,35,0,0,0
48306,33238,2021-06-24T13:18:30.8805986Z,2021,21,7,21,14,0,2do,0,0,7,0,0,14,0,0,21,0,0,0
48306,33239,2021-06-24T13:18:30.8805986Z,2021,35,9,30,22,0,3ro,0,0,13,0,0,26,5,0,35,0,0,0
48306,33240,2021-06-24T13:18:30.8805986Z,2021,30,9,27,13,0,4to,0,0,17,0,0,21,3,0,29,0,0,1
48306,33241,2021-06-24T13:18:30.8805986Z,2021,26,7,24,12,0,5to,0,0,14,0,0,19,2,0,26,0,0,0
48306,33242,2021-06-24T13:18:30.8815996Z,2021,36,13,33,25,0,6to,1,0,11,0,0,23,3,0,35,0,0,0
48306,33243,2021-06-24T13:18:30.8815996Z,2021,25,12,24,10,0,7mo,0,0,15,0,0,13,1,0,25,0,0,0
48306,33244,2021-06-24T13:18:30.8815996Z,2021,31,11,27,13,0,8vo,1,0,18,0,0,20,4,0,30,0,0,0
48306,33245,2021-06-24T13:18:30.8815996Z,2021,21,5,19,8,0,K,0,0,13,0,0,16,2,0,20,0,0,1
48306,33246,2021-06-24T13:18:30.8826001Z,2021,10,10,9,2,0,Sin Grado,0,0,8,0,0,0,1,0,10,0,0,0
48306,9232,2020-11-18T16:21:57.3242567Z,2020,22,6,21,15,0,1ro,0,0,7,0,0,16,1,0,22,0,0,0
48306,9233,2020-11-18T16:21:57.3242567Z,2020,39,12,30,24,0,2do,0,0,15,0,0,27,9,0,39,0,0,0
48306,9234,2020-11-18T16:21:57.3242567Z,2020,36,11,32,19,0,3ro,0,0,17,0,0,25,4,0,35,0,0,1
48306,9235,2020-11-18T16:21:57.3252576Z,2020,37,13,27,15,0,4to,0,1,22,0,0,24,10,0,37,0,1,0
48306,9236,2020-11-18T16:21:57.3252576Z,2020,40,19,35,25,0,5to,1,1,15,0,0,21,5,0,39,0,1,0
48306,9237,2020-11-18T16:21:57.3252576Z,2020,35,11,31,18,0,6to,1,2,17,0,0,24,4,0,34,0,0,0
48306,9238,2020-11-18T16:21:57.3252576Z,2020,35,14,29,14,0,7mo,2,0,21,0,0,21,6,0,33,0,0,0
48306,9239,2020-11-18T16:21:57.3262585Z,2020,50,16,40,25,0,8vo,1,0,25,0,0,34,10,0,49,0,0,0
48306,9240,2020-11-18T16:21:57.3262585Z,2020,39,11,36,18,0,K,0,0,21,0,0,28,3,0,39,0,0,0
48306,9241,2020-11-18T16:21:57.3262585Z,2020,21,20,16,4,0,Sin Grado,0,0,17,0,0,1,5,0,21,0,0,0
12518,30371,2021-06-24T13:18:08.8457924Z,2021,15,9,11,7,0,1ro,0,0,8,0,0,6,4,0,15,0,0,0
12518,30372,2021-06-24T13:18:08.8457924Z,2021,22,9,21,7,0,2do,0,0,15,0,0,13,1,0,22,0,0,0
12518,30373,2021-06-24T13:18:08.8467938Z,2021,23,8,20,11,0,3ro,0,0,12,0,0,15,3,0,23,0,0,0
12518,30374,2021-06-24T13:18:08.8467938Z,2021,19,10,17,11,0,4to,0,0,8,0,0,9,2,0,19,0,0,0
12518,30375,2021-06-24T13:18:08.8467938Z,2021,21,8,19,8,0,5to,0,0,13,0,0,13,2,0,21,0,0,0
12518,30376,2021-06-24T13:18:08.8467938Z,2021,23,10,21,10,0,6to,0,0,13,0,0,13,2,0,23,0,0,0
12518,30377,2021-06-24T13:18:08.8477943Z,2021,20,8,14,6,0,7mo,0,0,14,0,0,12,6,0,20,0,0,0
12518,30378,2021-06-24T13:18:08.8477943Z,2021,19,4,16,9,0,8vo,0,0,10,0,0,15,3,0,19,2,0,0
12518,30379,2021-06-24T13:18:08.8477943Z,2021,13,3,12,5,0,K,0,0,8,0,0,10,1,0,13,0,0,0
12518,373,2020-11-18T16:20:39.6474601Z,2019,23,8,20,11,0,1ro,0,0,12,0,0,15,3,0,23,0,0,0
12518,374,2020-11-18T16:20:39.6484618Z,2019,21,8,15,12,0,2do,0,0,9,0,0,13,6,0,21,0,0,0
12518,375,2020-11-18T16:20:39.6484618Z,2019,17,6,15,7,0,3ro,0,0,10,0,0,11,2,0,17,0,0,0
12518,376,2020-11-18T16:20:39.6484618Z,2019,21,7,17,10,0,4to,0,0,11,0,0,14,4,0,21,0,0,0
12518,377,2020-11-18T16:20:39.6494623Z,2019,20,6,15,6,0,5to,0,0,14,0,0,14,5,0,20,0,0,0
12518,378,2020-11-18T16:20:39.6494623Z,2019,22,6,14,9,0,6to,0,0,13,0,0,16,8,0,22,2,0,0
12518,379,2020-11-18T16:20:39.6494623Z,2019,19,3,11,11,0,7mo,0,0,8,0,0,16,8,0,19,0,0,0
12518,380,2020-11-18T16:20:39.6504618Z,2019,23,5,19,11,0,8vo,0,0,12,0,0,18,4,0,23,0,0,0
12518,381,2020-11-18T16:20:39.6504618Z,2019,20,10,16,7,0,K,0,0,13,0,0,10,4,0,20,0,0,0
12518,6374,2020-11-18T16:21:39.2552096Z,2020,24,9,18,7,0,1ro,0,0,17,0,0,15,6,0,24,0,0,0
12518,6375,2020-11-18T16:21:39.2562105Z,2020,23,8,19,11,0,2do,0,0,12,0,0,15,4,0,23,0,0,0
12518,6376,2020-11-18T16:21:39.2562105Z,2020,24,10,16,14,0,3ro,0,0,10,0,0,14,8,0,24,0,0,0
12518,6377,2020-11-18T16:21:39.2562105Z,2020,20,8,17,7,0,4to,0,0,13,0,0,12,3,0,20,0,0,0
12518,6378,2020-11-18T16:21:39.2572114Z,2020,22,9,19,9,0,5to,0,0,13,0,0,13,3,0,22,0,0,0
12518,6379,2020-11-18T16:21:39.2572114Z,2020,22,8,16,7,0,6to,0,0,15,0,0,14,6,0,22,0,0,0
12518,6380,2020-11-18T16:21:39.2572114Z,2020,21,4,15,10,0,7mo,0,0,11,0,0,17,6,0,21,2,0,0
12518,6381,2020-11-18T16:21:39.2582118Z,2020,20,3,12,12,0,8vo,0,0,8,0,0,17,8,0,20,0,0,0
12518,6382,2020-11-18T16:21:39.2582118Z,2020,19,4,14,9,0,K,0,0,10,0,0,15,5,0,19,0,0,0
12716,30397,2021-06-24T13:18:08.8517963Z,2021,16,3,15,8,0,1ro,0,0,8,0,0,13,1,0,16,0,0,0
12716,30398,2021-06-24T13:18:08.8527972Z,2021,12,5,11,5,0,2do,0,0,7,0,0,7,1,0,12,0,0,0
12716,30399,2021-06-24T13:18:08.8527972Z,2021,19,2,17,7,0,3ro,1,0,12,0,0,17,2,0,18,0,0,0
12716,30400,2021-06-24T13:18:09.4752435Z,2021,21,8,20,10,0,4to,1,0,11,0,0,13,1,0,20,0,0,0
12716,30401,2021-06-24T13:18:09.4752435Z,2021,14,4,12,8,0,5to,0,0,6,0,0,10,2,0,14,0,0,0
12716,30402,2021-06-24T13:18:09.4752435Z,2021,19,7,17,5,0,6to,0,0,14,0,0,12,2,0,19,0,0,0
12716,30403,2021-06-24T13:18:09.4752435Z,2021,22,5,20,9,0,7mo,1,0,13,0,0,17,2,0,21,1,0,0
12716,30404,2021-06-24T13:18:09.4762445Z,2021,16,4,15,4,0,8vo,1,0,12,0,0,12,1,0,15,0,0,0
12716,30405,2021-06-24T13:18:09.4762445Z,2021,15,1,15,3,0,K,0,0,12,0,0,14,0,0,15,0,0,0
12716,30406,2021-06-24T13:18:09.4762445Z,2021,15,15,14,1,0,Sin Grado,0,0,14,0,0,0,1,0,15,0,0,0
12716,399,2020-11-18T16:20:39.6494623Z,2019,21,5,18,10,0,1ro,0,0,11,0,0,16,3,0,21,0,0,0
12716,400,2020-11-18T16:20:39.6504618Z,2019,23,10,19,10,0,2do,0,0,13,0,0,13,4,0,23,0,0,0
12716,401,2020-11-18T16:20:40.0797488Z,2019,16,4,13,9,0,3ro,0,0,7,0,0,12,3,0,16,0,0,0
12716,402,2020-11-18T16:20:40.0797488Z,2019,20,8,20,6,0,4to,0,0,14,0,0,12,0,0,20,0,0,0
12716,403,2020-11-18T16:20:40.0807497Z,2019,21,5,20,10,0,5to,0,0,11,0,0,16,1,0,21,1,0,0
12716,404,2020-11-18T16:20:40.0807497Z,2019,12,4,11,6,0,6to,0,0,6,0,0,8,1,0,12,0,0,0
12716,405,2020-11-18T16:20:40.0807497Z,2019,22,6,20,10,0,7mo,0,0,12,0,0,16,2,0,22,1,0,0
12716,406,2020-11-18T16:20:40.0807497Z,2019,12,5,11,7,0,8vo,0,0,5,0,0,7,1,0,12,1,0,0
12716,407,2020-11-18T16:20:40.0817506Z,2019,13,3,12,3,0,K,0,0,10,0,0,10,1,0,13,0,0,0
12716,408,2020-11-18T16:20:40.0817506Z,2019,19,18,16,3,0,Sin Grado,0,0,16,0,0,1,3,0,19,0,0,0
12716,6400,2020-11-18T16:21:39.2512078Z,2020,13,5,12,5,0,1ro,0,0,8,0,0,8,1,0,13,0,0,0
12716,6401,2020-11-18T16:21:39.6594796Z,2020,21,3,18,8,0,2do,1,0,13,0,0,18,3,0,20,0,0,0
12716,6402,2020-11-18T16:21:39.6594796Z,2020,22,8,17,10,0,3ro,1,0,12,0,0,14,5,0,21,0,0,0
12716,6403,2020-11-18T16:21:39.6604805Z,2020,16,5,13,8,0,4to,0,0,8,0,0,11,3,0,16,0,0,0
12716,6404,2020-11-18T16:21:39.6604805Z,2020,19,7,17,5,0,5to,0,0,14,0,0,12,2,0,19,0,0,0
12716,6405,2020-11-18T16:21:39.6604805Z,2020,25,6,20,10,0,6to,1,0,15,0,0,19,5,0,24,1,0,0
12716,6406,2020-11-18T16:21:39.6604805Z,2020,17,4,15,5,0,7mo,1,0,12,0,0,13,2,0,16,0,0,0
12716,6407,2020-11-18T16:21:39.661481Z,2020,20,7,17,11,0,8vo,0,0,9,0,0,13,3,0,20,1,0,0
12716,6408,2020-11-18T16:21:39.661481Z,2020,19,5,17,9,0,K,0,0,10,0,0,14,2,0,19,0,0,0
12716,6409,2020-11-18T16:21:39.661481Z,2020,17,17,16,1,0,Sin Grado,0,0,16,0,0,0,1,0,17,0,0,0
70334,10965,2020-11-18T16:22:07.2158533Z,2020,16,4,15,11,0,1ro,0,0,5,0,0,12,1,0,16,0,0,0
70334,10966,2020-11-18T16:22:07.2158533Z,2020,19,5,18,12,0,2do,1,1,7,0,0,14,1,0,18,0,0,0
70334,10967,2020-11-18T16:22:07.2158533Z,2020,21,11,16,15,0,3ro,0,1,6,0,0,10,5,0,21,0,0,0
70334,10968,2020-11-18T16:22:07.2168541Z,2020,30,10,25,15,0,4to,1,2,15,0,0,20,5,0,29,0,0,0
70334,10969,2020-11-18T16:22:07.2168541Z,2020,33,13,29,16,0,5to,1,3,17,0,0,20,4,0,32,0,0,0
70334,10970,2020-11-18T16:22:07.2168541Z,2020,27,9,20,11,0,6to,1,1,16,0,0,18,7,0,26,0,0,0
70334,10971,2020-11-18T16:22:07.2168541Z,2020,24,7,16,14,0,7mo,1,1,10,0,0,17,8,0,23,0,0,0
70334,10972,2020-11-18T16:22:07.2168541Z,2020,28,12,22,11,0,8vo,0,2,17,0,0,16,6,0,28,0,0,0
70334,10973,2020-11-18T16:22:07.2178541Z,2020,22,5,22,9,0,K,0,0,13,0,0,17,0,0,22,0,0,0
70334,34986,2021-06-24T13:18:43.4476103Z,2021,21,6,20,8,0,1ro,0,0,13,0,0,15,1,0,21,0,0,0
70334,34987,2021-06-24T13:18:43.4476103Z,2021,10,2,9,7,0,2do,0,1,3,0,0,8,1,0,10,0,0,0
70334,34988,2021-06-24T13:18:43.4486113Z,2021,21,8,18,13,0,3ro,1,1,8,0,0,13,3,0,20,0,0,0
70334,34989,2021-06-24T13:18:43.4486113Z,2021,18,8,16,14,0,4to,0,1,4,0,0,10,2,0,18,0,0,0
70334,34990,2021-06-24T13:18:43.4486113Z,2021,26,11,23,10,0,5to,1,1,16,0,0,15,3,0,25,0,0,0
70334,34991,2021-06-24T13:18:43.4486113Z,2021,33,12,28,12,0,6to,1,1,21,0,0,21,5,0,32,0,0,0
70334,34992,2021-06-24T13:18:43.4486113Z,2021,26,13,23,9,0,7mo,1,1,17,0,0,13,3,0,25,0,0,0
70334,34993,2021-06-24T13:18:43.4496122Z,2021,22,6,17,12,0,8vo,2,0,10,0,0,16,5,0,20,0,0,0
70334,34994,2021-06-24T13:18:43.4496122Z,2021,6,0,5,2,0,K,0,0,4,0,0,6,1,0,6,0,0,0
70334,4957,2020-11-18T16:21:13.0237181Z,2019,10,6,9,6,0,1ro,1,0,4,0,0,4,1,0,9,0,0,0
70334,4958,2020-11-18T16:21:13.0247181Z,2019,24,14,20,16,0,2do,0,1,8,0,0,10,4,0,24,0,0,0
70334,4959,2020-11-18T16:21:13.0247181Z,2019,24,7,18,13,0,3ro,1,2,11,0,0,17,6,0,23,0,0,0
70334,4960,2020-11-18T16:21:13.0247181Z,2019,30,9,26,15,0,4to,1,2,15,0,0,21,4,0,29,0,0,0
70334,4961,2020-11-18T16:21:13.0247181Z,2019,27,10,21,11,0,5to,1,1,16,0,0,17,6,0,26,0,0,0
70334,4962,2020-11-18T16:21:13.0247181Z,2019,25,9,18,13,0,6to,1,3,12,0,0,16,7,0,23,0,0,1
70334,4963,2020-11-18T16:21:13.025719Z,2019,35,20,27,15,0,7mo,0,5,20,0,0,15,8,0,35,0,0,0
70334,4964,2020-11-18T16:21:13.025719Z,2019,33,14,28,14,0,8vo,1,2,19,0,0,19,5,0,32,0,0,0
70334,4965,2020-11-18T16:21:13.025719Z,2019,17,5,15,11,0,K,0,0,6,0,0,12,2,0,17,0,0,0
22566,1323,2020-11-18T16:20:45.8896249Z,2019,27,11,21,14,0,1ro,0,0,13,0,0,16,6,0,27,0,0,0
22566,1324,2020-11-18T16:20:45.8896249Z,2019,36,13,30,14,0,2do,0,0,22,0,0,23,6,0,35,0,0,1
22566,1325,2020-11-18T16:20:45.8906254Z,2019,35,9,31,15,0,3ro,1,1,20,0,0,26,4,0,34,0,0,0
22566,1326,2020-11-18T16:20:45.8906254Z,2019,28,7,21,12,0,4to,1,0,16,0,0,21,7,0,27,0,0,0
22566,1327,2020-11-18T16:20:45.8906254Z,2019,30,9,22,13,0,5to,0,0,17,0,0,21,8,0,30,0,0,0
22566,1328,2020-11-18T16:20:45.8906254Z,2019,34,11,26,16,0,6to,0,1,18,0,0,23,8,0,34,0,0,0
22566,1329,2020-11-18T16:20:45.8916254Z,2019,40,11,28,11,0,7mo,0,0,29,0,0,29,12,0,40,0,0,0
22566,1330,2020-11-18T16:20:45.8916254Z,2019,25,3,13,16,0,8vo,0,0,9,0,0,22,12,0,25,0,0,0
22566,1331,2020-11-18T16:20:45.8916254Z,2019,25,6,23,10,0,K,1,1,15,0,0,19,2,0,24,0,0,0
22566,31324,2021-06-24T13:18:14.5688964Z,2021,21,0,15,12,0,1ro,0,0,9,0,0,21,6,0,21,0,0,0
22566,31325,2021-06-24T13:18:14.5698969Z,2021,26,5,24,13,0,2do,0,1,13,0,0,21,2,0,26,0,0,0
22566,31326,2021-06-24T13:18:14.5698969Z,2021,31,10,25,15,0,3ro,0,0,16,0,0,21,6,0,31,0,0,0
22566,31327,2021-06-24T13:18:14.5698969Z,2021,31,13,27,14,0,4to,1,0,17,0,0,18,4,0,30,0,0,0
22566,31328,2021-06-24T13:18:14.5698969Z,2021,30,7,25,12,0,5to,1,0,18,0,0,23,5,0,29,0,0,0
22566,31329,2021-06-24T13:18:14.5708979Z,2021,27,5,22,13,0,6to,2,0,14,0,0,22,5,0,25,0,0,0
22566,31330,2021-06-24T13:18:14.5708979Z,2021,32,12,25,11,0,7mo,0,0,21,0,0,20,7,0,32,0,0,0
22566,31331,2021-06-24T13:18:14.5708979Z,2021,38,9,32,21,0,8vo,0,0,17,0,0,29,6,0,38,0,0,0
22566,31332,2021-06-24T13:18:14.5718983Z,2021,23,2,22,8,0,K,0,0,15,0,0,21,1,0,23,0,0,0
22566,7328,2020-11-18T16:21:45.3272599Z,2020,22,6,18,10,0,1ro,0,0,12,0,0,16,4,0,22,0,0,0
22566,7329,2020-11-18T16:21:45.3282599Z,2020,27,8,21,12,0,2do,0,0,15,0,0,19,6,0,27,0,0,0
22566,7330,2020-11-18T16:21:45.3282599Z,2020,35,14,26,15,0,3ro,1,0,20,0,0,21,9,0,34,0,0,0
22566,7331,2020-11-18T16:21:45.3282599Z,2020,31,8,26,12,0,4to,1,0,19,0,0,23,5,0,30,0,0,0
22566,7332,2020-11-18T16:21:45.3292599Z,2020,26,6,19,12,0,5to,1,0,14,0,0,20,7,0,25,0,0,0
22566,7333,2020-11-18T16:21:45.3292599Z,2020,32,12,23,12,0,6to,0,0,20,0,0,20,9,0,32,0,0,0
22566,7334,2020-11-18T16:21:45.3302613Z,2020,39,9,31,20,0,7mo,1,0,19,0,0,30,8,0,38,0,0,0
22566,7335,2020-11-18T16:21:45.3302613Z,2020,40,10,31,12,0,8vo,1,0,28,0,0,30,9,0,39,0,0,0
22566,7336,2020-11-18T16:21:45.3302613Z,2020,21,0,18,11,0,K,0,0,10,0,0,21,3,0,21,0,0,0
43752,2943,2020-11-18T16:20:59.9099707Z,2019,41,10,35,17,0,1ro,0,0,24,0,0,31,6,0,41,0,0,0
43752,2944,2020-11-18T16:20:59.9099707Z,2019,31,7,25,16,0,2do,0,0,15,0,0,24,6,0,30,0,0,1
43752,2945,2020-11-18T16:20:59.9109716Z,2019,32,10,26,11,0,3ro,0,0,21,0,0,22,6,0,32,0,1,0
43752,2946,2020-11-18T16:20:59.9109716Z,2019,41,9,30,15,0,4to,0,0,26,0,0,32,11,0,41,0,0,0
43752,2947,2020-11-18T16:20:59.9109716Z,2019,49,8,33,26,0,5to,0,0,23,0,0,41,16,0,48,0,0,1
43752,2948,2020-11-18T16:20:59.9119721Z,2019,51,15,41,24,0,6to,0,0,27,0,0,36,10,0,51,0,0,0
43752,2949,2020-11-18T16:20:59.9119721Z,2019,51,17,34,26,0,7mo,10,0,25,0,0,34,17,0,41,0,0,0
43752,2950,2020-11-18T16:20:59.9119721Z,2019,73,19,53,35,0,8vo,0,0,38,0,0,54,20,0,73,0,1,0
43752,2951,2020-11-18T16:20:59.9119721Z,2019,26,7,20,10,0,K,0,0,16,0,0,19,6,0,25,0,0,1
43752,32952,2021-06-24T13:18:28.8951754Z,2021,32,9,25,15,0,1ro,0,2,17,0,0,23,7,0,32,0,0,0
43752,32953,2021-06-24T13:18:28.8951754Z,2021,30,11,21,16,0,2do,0,2,14,0,0,19,9,0,30,0,0,0
43752,32954,2021-06-24T13:18:28.8951754Z,2021,45,9,37,18,0,3ro,0,0,27,0,0,36,8,0,45,0,1,0
43752,32955,2021-06-24T13:18:28.8961768Z,2021,40,12,35,21,0,4to,0,1,19,0,0,28,5,0,40,0,0,0
43752,32956,2021-06-24T13:18:28.8961768Z,2021,35,11,30,13,0,5to,0,0,22,0,0,24,5,0,35,0,0,0
43752,32957,2021-06-24T13:18:28.8961768Z,2021,73,19,54,35,0,6to,0,1,38,0,0,54,19,0,72,0,1,1
43752,32958,2021-06-24T13:18:28.8961768Z,2021,53,7,42,28,0,7mo,0,0,25,0,0,46,11,0,53,0,0,0
43752,32959,2021-06-24T13:18:28.8961768Z,2021,59,17,47,28,0,8vo,0,1,31,0,0,42,12,0,59,0,0,0
43752,32960,2021-06-24T13:18:28.8971791Z,2021,39,7,30,16,0,K,1,2,23,0,0,32,9,0,37,0,0,1
43752,8956,2020-11-18T16:21:54.9957056Z,2020,28,11,22,15,0,1ro,0,0,13,0,0,17,6,0,28,0,0,0
43752,8957,2020-11-18T16:21:54.9967065Z,2020,41,7,35,16,0,2do,0,0,25,0,0,34,6,0,41,0,0,0
43752,8958,2020-11-18T16:21:54.9967065Z,2020,39,11,30,19,0,3ro,0,0,20,0,0,28,9,0,39,0,0,0
43752,8959,2020-11-18T16:21:54.9967065Z,2020,34,10,26,11,0,4to,0,0,23,0,0,24,8,0,34,0,0,0
43752,8960,2020-11-18T16:21:54.9967065Z,2020,45,9,35,16,0,5to,0,0,29,0,0,36,10,0,45,0,0,0
43752,8961,2020-11-18T16:21:54.9967065Z,2020,51,9,34,28,0,6to,0,0,23,0,0,42,17,0,51,0,1,0
43752,8962,2020-11-18T16:21:54.9977069Z,2020,53,16,42,25,0,7mo,0,0,28,0,0,37,11,0,53,0,0,0
43752,8963,2020-11-18T16:21:54.9977069Z,2020,54,17,38,28,0,8vo,10,0,26,0,0,37,16,0,44,0,0,0
43752,8964,2020-11-18T16:21:54.9977069Z,2020,30,6,24,13,0,K,0,0,17,0,0,24,6,0,30,0,0,0
41004,2629,2020-11-18T16:20:58.0627403Z,2019,28,7,24,11,0,1ro,1,0,17,0,0,21,4,0,27,0,0,0
41004,2630,2020-11-18T16:20:58.0637408Z,2019,24,6,19,11,0,2do,1,0,13,0,0,18,5,0,23,0,1,0
41004,2631,2020-11-18T16:20:58.0637408Z,2019,20,7,19,13,0,3ro,0,0,7,0,0,13,1,0,20,0,0,0
41004,2632,2020-11-18T16:20:58.0647417Z,2019,25,7,18,12,0,4to,1,0,13,0,0,18,7,0,24,0,0,0
41004,2633,2020-11-18T16:20:58.0647417Z,2019,21,4,17,8,0,5to,1,0,13,0,0,17,4,0,20,0,0,0
41004,2634,2020-11-18T16:20:58.0647417Z,2019,66,27,60,32,0,6to,2,0,34,0,0,39,6,0,64,0,0,0
41004,2635,2020-11-18T16:20:58.065743Z,2019,58,19,44,29,0,7mo,0,0,29,0,0,39,14,0,58,0,0,0
41004,2636,2020-11-18T16:20:58.065743Z,2019,52,11,42,31,0,8vo,0,0,21,0,0,41,10,0,52,0,1,0
41004,2637,2020-11-18T16:20:58.065743Z,2019,19,4,15,8,0,K,0,0,11,0,0,15,4,0,19,0,0,0
41004,2638,2020-11-18T16:20:58.066743Z,2019,32,30,27,6,0,Sin Grado,0,0,26,0,0,2,5,0,32,0,1,0
41004,32636,2021-06-24T13:18:26.270293Z,2021,17,8,15,6,0,1ro,0,0,11,0,0,9,2,0,17,0,0,0
41004,32637,2021-06-24T13:18:26.2712935Z,2021,14,3,13,7,0,2do,0,0,7,0,0,11,1,0,14,0,0,0
41004,32638,2021-06-24T13:18:26.2712935Z,2021,22,9,20,8,0,3ro,0,0,14,0,0,13,2,0,22,1,0,0
41004,32639,2021-06-24T13:18:26.2712935Z,2021,23,6,20,10,0,4to,0,0,13,0,0,17,3,0,23,0,1,0
41004,32640,2021-06-24T13:18:26.2722949Z,2021,20,8,19,13,0,5to,1,0,7,0,0,12,1,0,19,0,0,0
41004,32641,2021-06-24T13:18:26.2722949Z,2021,43,18,32,24,0,6to,2,0,19,0,0,25,11,0,41,0,1,0
41004,32642,2021-06-24T13:18:26.2722949Z,2021,39,9,33,16,0,7mo,1,0,23,0,0,30,6,0,38,0,0,0
41004,32643,2021-06-24T13:18:26.2722949Z,2021,60,28,52,28,0,8vo,3,0,32,0,0,32,8,0,57,0,0,0
41004,32644,2021-06-24T13:18:26.2732949Z,2021,12,5,10,7,0,K,1,0,5,0,0,7,2,0,11,0,0,0
41004,32645,2021-06-24T13:18:26.2732949Z,2021,4,4,4,1,0,Sin Grado,0,0,3,0,0,0,0,0,4,0,0,0
41004,8640,2020-11-18T16:21:53.0584119Z,2020,17,3,14,7,0,1ro,0,0,10,0,0,14,3,0,17,0,0,0
41004,8641,2020-11-18T16:21:53.0584119Z,2020,25,7,21,11,0,2do,1,0,14,0,0,18,4,0,24,0,0,0
41004,8642,2020-11-18T16:21:53.0594119Z,2020,24,7,19,11,0,3ro,0,0,13,0,0,17,5,0,24,0,1,0
41004,8643,2020-11-18T16:21:53.0594119Z,2020,20,7,18,13,0,4to,1,0,7,0,0,13,2,0,19,0,0,0
41004,8644,2020-11-18T16:21:53.0594119Z,2020,25,8,17,14,0,5to,0,0,11,0,0,17,8,0,25,0,0,0
41004,8645,2020-11-18T16:21:53.0594119Z,2020,43,9,34,18,0,6to,1,0,25,0,0,34,9,0,42,0,0,0
41004,8646,2020-11-18T16:21:53.0604137Z,2020,57,25,51,27,0,7mo,3,0,30,0,0,32,6,0,54,0,0,0
41004,8647,2020-11-18T16:21:53.0604137Z,2020,54,18,40,29,0,8vo,0,0,25,0,0,36,14,0,54,0,0,0
41004,8648,2020-11-18T16:21:53.0604137Z,2020,21,8,19,7,0,K,0,0,14,0,0,13,2,0,21,0,0,0
41004,8649,2020-11-18T16:21:53.0614137Z,2020,25,25,22,7,0,Sin Grado,0,0,18,0,0,0,3,0,25,0,1,0
20339,30937,2021-06-24T13:18:11.8109192Z,2021,15,7,14,10,0,1ro,1,3,5,0,0,8,1,0,14,0,0,0
20339,30938,2021-06-24T13:18:11.8119193Z,2021,15,3,13,10,0,2do,0,3,5,0,0,12,2,0,15,0,0,0
20339,30939,2021-06-24T13:18:11.8119193Z,2021,12,5,11,3,0,3ro,1,2,9,0,0,7,1,0,11,0,0,0
20339,30940,2021-06-24T13:18:11.8129198Z,2021,11,4,7,8,0,4to,0,1,3,0,0,7,4,0,11,0,0,0
20339,30941,2021-06-24T13:18:11.8129198Z,2021,22,7,18,14,0,5to,1,2,8,0,0,15,4,0,21,1,0,0
20339,30942,2021-06-24T13:18:11.8129198Z,2021,15,7,12,5,0,6to,0,1,10,0,0,8,3,0,15,0,0,0
20339,30943,2021-06-24T13:18:11.8139207Z,2021,15,7,14,6,0,7mo,1,0,9,0,0,8,1,0,14,0,0,0
20339,30944,2021-06-24T13:18:11.8139207Z,2021,15,4,15,8,0,8vo,0,1,7,0,0,11,0,0,15,0,0,0
20339,30945,2021-06-24T13:18:11.8139207Z,2021,6,2,4,3,0,K,0,1,3,0,0,4,2,0,6,0,0,0
20339,6941,2020-11-18T16:21:42.5854275Z,2020,14,0,11,9,0,1ro,0,2,5,0,0,14,3,0,14,0,0,0
20339,6942,2020-11-18T16:21:42.5864284Z,2020,11,4,10,3,0,2do,1,1,8,0,0,7,1,0,10,0,0,0
20339,6943,2020-11-18T16:21:42.5864284Z,2020,11,4,6,7,0,3ro,0,0,4,0,0,7,5,0,11,0,0,0
20339,6944,2020-11-18T16:21:42.5864284Z,2020,23,7,21,15,0,4to,1,3,8,0,0,16,2,0,22,1,0,0
20339,6945,2020-11-18T16:21:42.5864284Z,2020,15,8,14,5,0,5to,0,0,10,0,0,7,1,0,15,0,0,0
20339,6946,2020-11-18T16:21:42.5874288Z,2020,14,5,11,7,0,6to,1,0,7,0,0,9,3,0,13,0,0,0
20339,6947,2020-11-18T16:21:42.5874288Z,2020,15,4,15,8,0,7mo,0,1,7,0,0,11,0,0,15,0,0,0
20339,6948,2020-11-18T16:21:42.5874288Z,2020,21,10,16,8,0,8vo,0,0,13,0,0,11,5,0,21,0,0,0
20339,6949,2020-11-18T16:21:42.5874288Z,2020,13,5,13,8,0,K,0,0,5,0,0,8,0,0,13,0,0,0
20339,941,2020-11-18T16:20:43.3759445Z,2019,12,5,11,4,0,1ro,2,0,8,0,0,7,1,0,10,0,0,0
20339,942,2020-11-18T16:20:43.3759445Z,2019,13,3,9,8,0,2do,0,0,5,0,0,10,4,0,13,0,0,0
20339,943,2020-11-18T16:20:43.3759445Z,2019,21,7,16,13,0,3ro,1,0,8,0,0,14,5,0,20,1,0,0
20339,944,2020-11-18T16:20:43.3759445Z,2019,14,8,13,5,0,4to,0,0,9,0,0,6,1,0,14,0,0,0
20339,945,2020-11-18T16:20:43.3769458Z,2019,16,7,15,8,0,5to,1,0,8,0,0,9,1,0,15,0,0,0
20339,946,2020-11-18T16:20:43.3769458Z,2019,17,4,15,10,0,6to,0,0,7,0,0,13,2,0,17,0,0,0
20339,947,2020-11-18T16:20:43.3769458Z,2019,20,10,13,7,0,7mo,0,0,13,0,0,10,7,0,20,0,0,0
20339,948,2020-11-18T16:20:43.3769458Z,2019,22,8,16,10,0,8vo,0,0,12,0,0,14,6,0,22,0,0,0
20339,949,2020-11-18T16:20:43.3769458Z,2019,13,1,9,8,0,K,0,0,5,0,0,12,4,0,13,0,0,0
21543,1208,2020-11-18T16:20:45.0800826Z,2019,53,13,44,26,0,1ro,0,0,27,0,0,40,9,0,53,0,1,0
21543,1209,2020-11-18T16:20:45.0800826Z,2019,43,14,34,21,0,2do,1,0,22,0,0,29,9,0,42,0,0,0
21543,1210,2020-11-18T16:20:45.0800826Z,2019,50,22,42,22,0,3ro,3,2,28,0,0,28,8,0,47,1,1,0
21543,1211,2020-11-18T16:20:45.0800826Z,2019,56,18,43,26,0,4to,0,0,30,0,0,38,13,0,56,0,0,0
21543,1212,2020-11-18T16:20:45.081083Z,2019,53,15,36,30,0,5to,1,0,23,0,0,38,17,0,52,0,0,0
21543,1213,2020-11-18T16:20:45.081083Z,2019,54,14,46,30,0,6to,3,0,24,0,0,40,8,0,51,1,0,0
21543,1214,2020-11-18T16:20:45.081083Z,2019,52,21,38,32,0,7mo,0,0,20,0,0,31,14,0,52,0,1,0
21543,1215,2020-11-18T16:20:45.081083Z,2019,71,18,42,31,0,8vo,3,2,40,0,0,53,29,0,68,1,0,0
21543,1216,2020-11-18T16:20:45.0820839Z,2019,46,17,35,24,0,K,2,0,22,0,0,29,11,0,43,0,0,1
21543,1217,2020-11-18T16:20:45.0820839Z,2019,2,2,2,0,0,Sin Grado,0,0,2,0,0,0,0,0,2,0,0,0
21543,31209,2021-06-24T13:18:13.996486Z,2021,33,15,31,13,0,1ro,1,0,20,0,0,18,2,0,32,0,0,0
21543,31210,2021-06-24T13:18:13.996486Z,2021,48,10,44,26,0,2do,3,0,22,0,0,38,4,0,44,0,0,1
21543,31211,2021-06-24T13:18:13.9974882Z,2021,48,14,47,22,0,3ro,0,0,26,0,0,34,1,0,48,0,0,0
21543,31212,2021-06-24T13:18:13.9974882Z,2021,43,11,38,22,0,4to,1,0,21,0,0,32,5,0,42,0,0,0
21543,31213,2021-06-24T13:18:13.9974882Z,2021,52,19,45,23,0,5to,3,0,29,0,0,33,7,0,49,0,0,0
21543,31214,2021-06-24T13:18:13.9974882Z,2021,59,20,51,22,0,6to,0,0,37,0,0,39,8,0,59,1,0,0
21543,31215,2021-06-24T13:18:13.9984874Z,2021,61,21,51,33,0,7mo,2,0,28,0,0,40,10,0,59,1,0,0
21543,31216,2021-06-24T13:18:13.9984874Z,2021,48,13,41,25,0,8vo,2,0,23,0,0,35,7,0,46,1,0,0
21543,31217,2021-06-24T13:18:13.9984874Z,2021,46,14,41,19,0,K,0,0,27,0,0,32,5,0,46,0,0,0
21543,7213,2020-11-18T16:21:44.5877662Z,2020,47,11,38,27,0,1ro,4,0,20,0,0,36,9,0,42,0,0,1
21543,7214,2020-11-18T16:21:44.5877662Z,2020,50,14,41,21,0,2do,1,0,29,0,0,36,9,0,49,0,0,0
21543,7215,2020-11-18T16:21:44.5887662Z,2020,46,11,30,25,0,3ro,2,0,21,0,0,35,16,0,44,0,0,0
21543,7216,2020-11-18T16:21:44.5887662Z,2020,52,23,44,23,0,4to,3,0,29,0,0,29,8,0,49,0,1,0
21543,7217,2020-11-18T16:21:44.5887662Z,2020,51,17,36,20,0,5to,0,0,31,0,0,34,15,0,51,1,0,0
21543,7218,2020-11-18T16:21:44.5897671Z,2020,61,19,45,33,0,6to,2,0,28,0,0,42,16,0,59,1,0,0
21543,7219,2020-11-18T16:21:44.5897671Z,2020,50,13,40,27,0,7mo,1,0,23,0,0,37,10,0,49,1,0,0
21543,7220,2020-11-18T16:21:44.5897671Z,2020,45,15,32,28,0,8vo,0,0,17,0,0,30,13,0,45,0,1,0
21543,7221,2020-11-18T16:21:44.5907671Z,2020,42,18,35,16,0,K,1,0,26,0,0,24,7,0,41,0,0,0
30742,1838,2020-11-18T16:20:52.4810202Z,2019,42,10,37,22,0,1ro,0,3,20,0,0,32,5,0,42,0,0,0
30742,1839,2020-11-18T16:20:52.4810202Z,2019,39,7,30,21,0,2do,2,0,18,0,0,32,9,0,37,1,0,0
30742,1840,2020-11-18T16:20:52.4810202Z,2019,39,9,32,21,0,3ro,0,0,18,0,0,30,7,0,39,0,0,0
30742,1841,2020-11-18T16:20:52.4810202Z,2019,44,10,33,30,0,4to,0,0,14,0,1,34,11,0,44,1,0,0
30742,1842,2020-11-18T16:20:52.4820216Z,2019,39,8,32,23,0,5to,0,0,16,0,0,31,7,0,39,0,0,0
30742,1843,2020-11-18T16:20:52.4820216Z,2019,69,20,52,27,0,6to,2,0,42,0,1,49,17,0,67,1,0,0
30742,1844,2020-11-18T16:20:52.4820216Z,2019,88,20,67,46,0,7mo,1,0,42,0,0,68,21,0,87,1,0,0
30742,1845,2020-11-18T16:20:52.4820216Z,2019,103,28,77,44,0,8vo,1,0,59,0,0,75,26,0,102,0,0,0
30742,1846,2020-11-18T16:20:52.4820216Z,2019,20,4,18,10,0,K,0,0,10,0,0,16,2,0,20,0,0,0
30742,1847,2020-11-18T16:20:52.483022Z,2019,20,20,15,4,0,Sin Grado,0,0,16,0,0,0,5,0,20,0,0,0
30742,31843,2021-06-24T13:18:17.7621864Z,2021,35,3,33,18,0,1ro,0,0,17,0,0,32,2,0,35,0,0,0
30742,31844,2021-06-24T13:18:17.7621864Z,2021,29,5,20,15,0,2do,0,3,14,0,0,24,9,0,29,0,0,0
30742,31845,2021-06-24T13:18:17.7621864Z,2021,41,12,37,22,0,3ro,0,3,19,0,0,29,4,0,41,0,0,0
30742,31846,2021-06-24T13:18:17.7621864Z,2021,44,7,34,25,0,4to,2,1,19,0,0,37,10,0,42,1,0,0
30742,31847,2021-06-24T13:18:17.7631865Z,2021,37,7,33,19,0,5to,0,0,18,0,0,30,4,0,37,1,0,0
30742,31848,2021-06-24T13:18:17.7631865Z,2021,60,15,44,39,0,6to,1,1,21,0,0,45,16,0,59,1,0,0
30742,31849,2021-06-24T13:18:17.7631865Z,2021,45,12,36,25,0,7mo,0,0,20,0,0,33,9,0,45,0,0,0
30742,31850,2021-06-24T13:18:17.7641878Z,2021,69,21,57,29,0,8vo,3,0,40,0,0,48,12,0,66,2,0,0
30742,31851,2021-06-24T13:18:17.7641878Z,2021,33,7,23,18,0,K,0,2,15,0,0,26,10,0,33,0,0,0
30742,31852,2021-06-24T13:18:17.7641878Z,2021,21,21,15,8,0,Sin Grado,0,0,13,0,0,0,6,0,21,0,0,0
30742,7846,2020-11-18T16:21:48.4793584Z,2020,25,6,22,13,0,1ro,1,3,12,0,0,19,3,0,24,0,0,0
30742,7847,2020-11-18T16:21:48.4793584Z,2020,36,10,31,19,0,2do,0,2,17,0,0,26,5,0,36,0,0,0
30742,7848,2020-11-18T16:21:48.4793584Z,2020,37,6,31,20,0,3ro,2,2,17,0,0,31,6,0,35,1,0,0
30742,7849,2020-11-18T16:21:48.4793584Z,2020,35,7,28,19,0,4to,0,0,16,0,0,28,7,0,35,0,0,0
30742,7850,2020-11-18T16:21:48.4803602Z,2020,44,11,34,28,0,5to,0,0,16,0,0,33,10,0,44,1,0,0
30742,7851,2020-11-18T16:21:48.4803602Z,2020,41,11,34,24,0,6to,2,0,17,0,0,30,7,0,39,0,0,0
30742,7852,2020-11-18T16:21:48.4803602Z,2020,67,20,51,28,0,7mo,3,0,39,0,0,47,16,0,64,2,0,0
30742,7853,2020-11-18T16:21:48.4803602Z,2020,89,20,72,46,0,8vo,1,0,43,0,0,69,17,0,88,1,0,0
30742,7854,2020-11-18T16:21:48.4803602Z,2020,29,3,25,19,0,K,0,2,10,0,0,26,4,0,29,0,0,0
30742,7855,2020-11-18T16:21:48.4813606Z,2020,25,25,20,9,0,Sin Grado,0,0,16,0,0,0,5,0,25,0,0,0
40469,2568,2020-11-18T16:20:57.6424618Z,2019,65,20,56,25,0,1ro,1,0,40,0,0,45,9,0,64,0,0,0
40469,2569,2020-11-18T16:20:57.6424618Z,2019,73,25,64,30,0,2do,2,0,43,0,0,48,9,0,71,0,1,0
40469,2570,2020-11-18T16:20:57.6424618Z,2019,75,31,69,29,0,3ro,1,0,46,0,0,44,6,0,74,0,1,0
40469,2571,2020-11-18T16:20:57.6434623Z,2019,62,16,55,32,0,4to,1,0,30,0,0,46,7,0,59,0,1,2
40469,2572,2020-11-18T16:20:57.6434623Z,2019,87,25,75,43,0,5to,2,0,44,0,0,62,12,1,84,0,0,0
40469,2573,2020-11-18T16:20:57.6434623Z,2019,118,35,99,59,0,6to,2,0,59,0,0,83,19,0,115,0,0,1
40469,2574,2020-11-18T16:20:57.6434623Z,2019,112,29,92,48,0,7mo,4,0,64,0,0,83,20,0,108,0,0,0
40469,2575,2020-11-18T16:20:57.6444627Z,2019,114,33,101,51,0,8vo,2,0,63,0,0,81,13,0,112,0,0,0
40469,2576,2020-11-18T16:20:57.6444627Z,2019,74,23,67,33,0,K,1,0,41,0,0,51,7,0,73,0,0,0
40469,2577,2020-11-18T16:20:57.6444627Z,2019,17,3,13,11,0,PK,0,0,6,0,0,14,4,0,17,0,0,0
40469,2578,2020-11-18T16:20:57.6444627Z,2019,17,15,15,4,0,Sin Grado,0,0,13,0,0,2,2,0,17,1,1,0
40469,32576,2021-06-24T13:18:25.2415553Z,2021,72,23,68,36,0,1ro,3,0,36,0,0,49,4,0,69,0,0,0
40469,32577,2021-06-24T13:18:25.2425563Z,2021,69,20,61,34,0,2do,0,0,35,0,0,49,8,0,69,0,0,0
40469,32578,2021-06-24T13:18:25.2425563Z,2021,76,21,63,36,0,3ro,2,0,40,0,0,55,13,1,73,0,0,0
40469,32579,2021-06-24T13:18:25.2425563Z,2021,81,24,64,38,0,4to,3,0,43,0,0,57,17,0,78,0,1,0
40469,32580,2021-06-24T13:18:25.2435572Z,2021,87,26,77,32,0,5to,1,0,55,0,0,61,10,0,86,0,1,0
40469,32581,2021-06-24T13:18:25.2435572Z,2021,97,26,83,50,0,6to,1,0,47,0,0,71,14,0,94,0,0,2
40469,32582,2021-06-24T13:18:25.2435572Z,2021,108,35,85,56,0,7mo,2,0,52,0,0,73,23,1,105,0,0,0
40469,32583,2021-06-24T13:18:25.2435572Z,2021,122,32,103,60,0,8vo,2,0,62,0,0,90,19,0,119,0,0,1
40469,32584,2021-06-24T13:18:25.2435572Z,2021,76,24,56,35,0,K,2,0,41,0,0,52,20,0,74,0,0,0
40469,32585,2021-06-24T13:18:25.2445577Z,2021,14,1,9,11,0,PK,0,0,3,0,0,13,5,0,14,0,0,0
40469,32586,2021-06-24T13:18:25.2445577Z,2021,17,17,14,2,0,Sin Grado,0,0,15,0,0,0,3,0,17,0,0,0
40469,8580,2020-11-18T16:21:52.6491383Z,2020,69,20,60,32,0,1ro,0,1,37,0,0,49,9,0,69,0,0,0
40469,8581,2020-11-18T16:21:52.6491383Z,2020,69,20,60,30,0,2do,2,2,39,0,0,49,9,1,66,0,0,0
40469,8582,2020-11-18T16:21:52.6491383Z,2020,74,20,62,36,0,3ro,2,1,38,0,0,54,12,0,72,0,1,0
40469,8583,2020-11-18T16:21:52.6501405Z,2020,76,27,63,27,0,4to,1,1,49,0,0,49,13,0,75,0,1,0
40469,8584,2020-11-18T16:21:52.6501405Z,2020,76,18,63,44,0,5to,0,3,32,0,0,58,13,0,74,0,0,2
40469,8585,2020-11-18T16:21:52.6501405Z,2020,110,36,85,57,0,6to,0,3,53,0,0,74,25,1,109,0,0,0
40469,8586,2020-11-18T16:21:52.6501405Z,2020,120,36,101,60,0,7mo,2,1,60,0,0,84,19,0,117,0,0,1
40469,8587,2020-11-18T16:21:52.6511396Z,2020,106,26,78,49,0,8vo,1,3,57,0,0,80,28,0,105,0,0,0
40469,8588,2020-11-18T16:21:52.6511396Z,2020,70,19,62,34,0,K,4,2,36,0,0,51,8,0,66,0,0,0
40469,8589,2020-11-18T16:21:52.6511396Z,2020,16,3,10,9,0,PK,0,0,7,0,0,13,6,0,16,0,0,0
40469,8590,2020-11-18T16:21:52.6511396Z,2020,15,15,15,3,0,Sin Grado,0,0,12,0,0,0,0,0,15,0,0,0
42812,2807,2020-11-18T16:20:59.1684752Z,2019,44,11,42,26,0,1ro,1,0,18,0,0,33,2,0,43,0,0,0
42812,2808,2020-11-18T16:20:59.1684752Z,2019,33,11,32,22,0,2do,1,0,11,0,0,22,1,0,32,0,0,0
42812,2809,2020-11-18T16:20:59.1684752Z,2019,35,12,34,15,0,3ro,0,0,20,0,0,23,1,0,35,0,0,0
42812,2810,2020-11-18T16:20:59.1684752Z,2019,38,16,38,19,0,4to,0,0,19,0,0,22,0,0,38,0,0,0
42812,2811,2020-11-18T16:20:59.1684752Z,2019,37,13,33,20,0,5to,0,0,17,0,0,24,4,0,37,0,0,0
42812,2812,2020-11-18T16:20:59.1684752Z,2019,31,5,28,20,0,K,0,0,11,0,0,26,3,0,31,0,0,0
42812,2813,2020-11-18T16:20:59.1694756Z,2019,31,7,24,17,0,PK,0,0,14,0,0,24,7,0,31,0,0,0
42812,32813,2021-06-24T13:18:28.1876679Z,2021,31,11,28,15,0,1ro,0,0,16,0,0,20,3,0,31,0,0,0
42812,32814,2021-06-24T13:18:28.1876679Z,2021,27,5,22,17,0,2do,0,0,10,0,0,22,5,0,27,0,0,0
42812,32815,2021-06-24T13:18:28.1886684Z,2021,38,9,33,22,0,3ro,0,0,16,0,0,29,5,0,38,0,0,0
42812,32816,2021-06-24T13:18:28.1886684Z,2021,34,13,28,23,0,4to,1,0,11,0,0,21,6,0,33,0,0,0
42812,32817,2021-06-24T13:18:28.1886684Z,2021,37,12,33,19,0,5to,0,0,18,0,0,25,4,0,37,0,0,0
42812,32818,2021-06-24T13:18:28.1896689Z,2021,47,6,34,26,0,K,0,0,21,0,0,41,13,0,47,0,0,0
42812,32819,2021-06-24T13:18:28.1896689Z,2021,19,2,11,7,0,PK,0,0,12,0,0,17,8,0,19,0,0,0
42812,8817,2020-11-18T16:21:54.2171855Z,2020,32,6,30,20,0,1ro,0,0,12,0,0,26,2,0,32,0,0,0
42812,8818,2020-11-18T16:21:54.2171855Z,2020,36,9,34,21,0,2do,0,0,15,0,0,27,2,0,35,0,0,1
42812,8819,2020-11-18T16:21:54.2181859Z,2020,34,12,32,23,0,3ro,1,0,11,0,0,22,2,0,33,0,0,0
42812,8820,2020-11-18T16:21:54.2181859Z,2020,33,13,30,15,0,4to,0,0,18,0,0,20,3,0,33,0,0,0
42812,8821,2020-11-18T16:21:54.2181859Z,2020,38,16,37,19,0,5to,1,0,19,0,0,22,1,0,36,0,0,1
42812,8822,2020-11-18T16:21:54.2181859Z,2020,30,9,26,16,0,K,0,0,14,0,0,21,4,0,29,0,0,1
42812,8823,2020-11-18T16:21:54.2181859Z,2020,32,7,25,23,0,PK,1,0,9,0,0,25,7,0,30,0,0,1
42952,2831,2020-11-18T16:20:59.1774814Z,2019,76,26,66,34,0,1ro,2,0,42,0,0,50,10,0,73,0,0,1
42952,2832,2020-11-18T16:20:59.1774814Z,2019,46,11,36,23,0,2do,0,0,23,0,1,35,10,0,46,0,0,0
42952,2833,2020-11-18T16:20:59.1774814Z,2019,54,16,37,29,0,3ro,1,0,25,0,0,38,17,0,53,0,0,0
42952,2834,2020-11-18T16:20:59.1774814Z,2019,56,18,42,26,0,4to,2,0,30,0,1,38,14,0,54,0,0,0
42952,2835,2020-11-18T16:20:59.1784823Z,2019,64,19,42,31,0,5to,1,0,33,0,0,45,22,0,63,0,0,0
42952,2836,2020-11-18T16:20:59.1784823Z,2019,83,27,53,34,0,6to,1,0,49,0,0,56,30,0,82,0,1,0
42952,2837,2020-11-18T16:20:59.1784823Z,2019,68,20,52,37,0,7mo,3,0,31,0,1,48,16,0,65,0,0,0
42952,2838,2020-11-18T16:20:59.1784823Z,2019,92,30,67,54,0,8vo,1,0,38,0,0,62,25,0,91,0,0,0
42952,2839,2020-11-18T16:20:59.1794828Z,2019,45,7,37,24,0,K,1,0,21,0,0,38,8,0,44,0,1,0
42952,2840,2020-11-18T16:20:59.1794828Z,2019,13,13,10,3,0,Sin Grado,0,0,10,0,0,0,3,0,13,0,0,0
42952,32838,2021-06-24T13:18:28.2026784Z,2021,49,11,41,24,0,1ro,1,0,25,0,0,38,8,0,46,0,0,2
42952,32839,2021-06-24T13:18:28.2026784Z,2021,41,15,33,20,0,2do,1,0,21,0,0,26,8,0,40,0,0,0
42952,32840,2021-06-24T13:18:28.2026784Z,2021,60,22,50,28,0,3ro,1,0,32,0,0,38,10,0,58,0,0,1
42952,32841,2021-06-24T13:18:28.2026784Z,2021,45,14,35,24,0,4to,2,0,21,0,0,31,10,0,43,0,0,0
42952,32842,2021-06-24T13:18:28.2026784Z,2021,48,16,37,24,0,5to,1,0,24,0,0,32,11,0,47,0,0,0
42952,32843,2021-06-24T13:18:28.2026784Z,2021,61,20,41,31,0,6to,2,0,30,0,0,41,20,0,58,0,0,1
42952,32844,2021-06-24T13:18:28.2036794Z,2021,64,22,36,30,0,7mo,0,0,34,0,0,42,28,0,64,0,0,0
42952,32845,2021-06-24T13:18:28.2036794Z,2021,70,20,50,28,0,8vo,1,0,42,0,0,50,20,0,69,0,1,0
42952,32846,2021-06-24T13:18:28.2036794Z,2021,33,10,23,14,0,K,0,0,19,0,0,23,10,0,33,0,0,0
42952,32847,2021-06-24T13:18:28.2036794Z,2021,12,12,11,3,0,Sin Grado,0,0,9,0,0,0,1,0,12,0,0,0
42952,8842,2020-11-18T16:21:54.2281931Z,2020,44,10,37,23,0,1ro,1,1,21,0,0,34,7,0,43,0,0,0
42952,8843,2020-11-18T16:21:54.2291931Z,2020,63,21,51,30,0,2do,1,0,33,0,0,42,12,0,61,0,0,1
42952,8844,2020-11-18T16:21:54.2291931Z,2020,46,6,33,25,0,3ro,2,0,21,0,0,40,13,0,44,0,0,0
42952,8845,2020-11-18T16:21:54.2291931Z,2020,51,16,35,27,0,4to,1,1,24,0,0,35,16,0,50,0,0,0
42952,8846,2020-11-18T16:21:54.2291931Z,2020,55,17,42,26,0,5to,2,1,29,0,0,38,13,0,53,0,0,0
42952,8847,2020-11-18T16:21:54.2291931Z,2020,65,23,43,31,0,6to,0,1,34,0,0,42,22,0,65,0,0,0
42952,8848,2020-11-18T16:21:54.2301944Z,2020,79,23,50,33,0,7mo,1,1,46,0,0,56,29,0,78,0,1,0
42952,8849,2020-11-18T16:21:54.2301944Z,2020,63,18,47,32,0,8vo,2,1,31,0,0,45,16,0,61,0,1,0
42952,8850,2020-11-18T16:21:54.2301944Z,2020,54,11,47,25,0,K,1,1,29,0,0,43,7,0,52,0,0,1
42952,8851,2020-11-18T16:21:54.2301944Z,2020,15,15,12,5,0,Sin Grado,0,2,10,0,0,0,3,0,15,0,0,0
71068,11208,2020-11-18T16:22:09.5624168Z,2020,18,5,17,6,0,1ro,0,0,12,0,0,13,1,0,18,0,0,0
71068,11209,2020-11-18T16:22:09.5624168Z,2020,38,9,35,12,0,2do,0,0,26,0,0,29,3,0,38,1,0,0
71068,11210,2020-11-18T16:22:09.5634177Z,2020,33,9,28,20,0,3ro,0,0,13,0,0,24,5,0,33,1,0,0
71068,11211,2020-11-18T16:22:09.5634177Z,2020,39,12,37,18,0,4to,0,0,21,0,0,27,2,0,39,1,0,0
71068,11212,2020-11-18T16:22:09.5634177Z,2020,38,9,32,19,0,5to,0,0,19,0,0,29,6,0,37,3,0,1
71068,11213,2020-11-18T16:22:09.5634177Z,2020,24,7,20,12,0,6to,0,0,12,0,0,17,4,0,24,0,0,0
71068,11214,2020-11-18T16:22:09.5634177Z,2020,34,5,29,16,0,7mo,0,1,18,0,0,29,5,0,34,0,0,0
71068,11215,2020-11-18T16:22:09.5644186Z,2020,44,18,38,17,0,8vo,0,1,27,0,0,26,6,0,44,1,0,0
71068,11216,2020-11-18T16:22:09.5644186Z,2020,29,5,23,13,0,K,2,0,16,0,0,24,6,0,27,0,0,0
71068,11217,2020-11-18T16:22:09.5644186Z,2020,9,8,9,2,0,Sin Grado,0,4,7,0,0,1,0,0,8,0,0,1
71068,35229,2021-06-24T13:18:44.8035829Z,2021,26,6,25,12,0,1ro,1,0,14,0,0,20,1,0,25,0,0,0
71068,35230,2021-06-24T13:18:44.8035829Z,2021,19,4,16,6,0,2do,0,0,13,0,0,15,3,0,19,0,0,0
71068,35231,2021-06-24T13:18:44.8035829Z,2021,36,10,32,14,0,3ro,1,0,22,0,0,26,4,0,35,0,0,0
71068,35232,2021-06-24T13:18:44.8045834Z,2021,32,9,32,20,0,4to,0,0,12,0,0,23,0,0,32,1,0,0
71068,35233,2021-06-24T13:18:44.8045834Z,2021,40,13,39,18,0,5to,0,0,22,0,0,27,1,0,40,1,0,0
71068,35234,2021-06-24T13:18:44.8045834Z,2021,41,9,38,20,0,6to,0,0,21,0,0,32,3,0,40,4,0,1
71068,35235,2021-06-24T13:18:44.8045834Z,2021,23,7,19,13,0,7mo,0,1,10,0,0,16,4,0,23,0,0,0
71068,35236,2021-06-24T13:18:44.8055848Z,2021,35,6,32,15,0,8vo,0,2,20,0,0,29,3,0,35,0,0,0
71068,35237,2021-06-24T13:18:44.8055848Z,2021,32,7,30,8,0,K,0,0,24,0,0,25,2,1,31,0,0,0
71068,35238,2021-06-24T13:18:44.8055848Z,2021,10,10,10,2,0,Sin Grado,0,5,8,0,0,0,0,0,9,0,0,1
71068,5203,2020-11-18T16:21:14.4386592Z,2019,34,8,31,12,0,1ro,0,4,22,0,0,26,3,0,34,0,0,0
71068,5204,2020-11-18T16:21:14.4396596Z,2019,39,12,38,25,0,2do,0,4,14,0,0,27,1,0,39,1,0,0
71068,5205,2020-11-18T16:21:14.4396596Z,2019,41,11,39,18,0,3ro,0,2,23,0,0,30,2,0,41,1,0,0
71068,5206,2020-11-18T16:21:14.4396596Z,2019,40,12,37,21,0,4to,0,2,19,0,0,28,3,0,40,3,0,0
71068,5207,2020-11-18T16:21:14.4406605Z,2019,29,9,25,13,0,5to,0,5,16,0,0,20,4,0,29,0,0,0
71068,5208,2020-11-18T16:21:14.4406605Z,2019,32,6,29,14,0,6to,0,4,18,0,0,26,3,0,32,0,0,0
71068,5209,2020-11-18T16:21:14.4406605Z,2019,46,19,41,18,0,7mo,0,2,28,0,0,27,5,0,46,1,0,0
71068,5210,2020-11-18T16:21:14.4406605Z,2019,34,13,30,12,0,8vo,2,6,22,0,0,21,4,0,32,0,0,0
71068,5211,2020-11-18T16:21:14.4406605Z,2019,25,10,24,16,0,K,1,2,9,0,0,15,1,0,24,0,0,0
71068,5212,2020-11-18T16:21:14.4416627Z,2019,4,4,4,0,0,Sin Grado,0,3,4,0,0,0,0,0,4,0,0,0
62943,10541,2020-11-18T16:22:04.9253254Z,2020,13,4,12,9,0,1ro,0,0,4,0,0,9,1,0,13,0,0,0
62943,10542,2020-11-18T16:22:04.9253254Z,2020,28,7,26,12,0,2do,0,0,16,0,0,21,2,0,28,0,0,0
62943,10543,2020-11-18T16:22:04.9253254Z,2020,20,6,19,14,0,3ro,0,0,6,0,0,14,1,0,20,0,0,0
62943,10544,2020-11-18T16:22:04.9263268Z,2020,25,12,23,9,0,4to,0,0,16,0,0,13,2,0,25,0,0,0
62943,10545,2020-11-18T16:22:04.9263268Z,2020,28,10,26,13,0,5to,0,0,15,0,0,18,2,0,28,0,0,0
62943,10546,2020-11-18T16:22:04.9263268Z,2020,55,27,50,25,0,6to,1,0,30,0,0,28,5,0,53,0,1,1
62943,10547,2020-11-18T16:22:04.9263268Z,2020,45,17,41,27,0,7mo,0,0,18,0,0,28,4,0,45,0,0,0
62943,10548,2020-11-18T16:22:04.9273272Z,2020,45,20,39,28,0,8vo,0,0,17,0,0,25,6,0,45,0,0,0
62943,10549,2020-11-18T16:22:04.9273272Z,2020,22,8,19,11,0,9no,0,0,11,0,0,14,3,0,22,0,0,0
62943,10550,2020-11-18T16:22:04.9273272Z,2020,15,3,14,8,0,K,0,0,7,0,0,12,1,0,15,0,0,0
62943,10551,2020-11-18T16:22:04.9283285Z,2020,22,22,21,7,0,Sin Grado,1,0,15,0,0,0,1,0,21,2,0,0
62943,34554,2021-06-24T13:18:40.2323041Z,2021,21,6,18,11,0,10mo,0,1,10,0,0,15,3,0,21,0,0,0
62943,34555,2021-06-24T13:18:40.2323041Z,2021,18,4,18,10,0,1ro,0,0,8,0,0,14,0,0,18,0,0,0
62943,34556,2021-06-24T13:18:40.2323041Z,2021,18,6,17,11,0,2do,1,0,7,0,0,12,1,0,17,0,0,0
62943,34557,2021-06-24T13:18:40.2323041Z,2021,24,6,22,10,0,3ro,0,0,14,0,0,18,2,0,24,0,0,0
62943,34558,2021-06-24T13:18:40.2323041Z,2021,21,7,19,16,0,4to,0,0,5,0,0,14,2,0,21,0,0,0
62943,34559,2021-06-24T13:18:40.2333051Z,2021,24,9,24,11,0,5to,0,1,13,0,0,15,0,0,24,0,0,0
62943,34560,2021-06-24T13:18:40.2333051Z,2021,45,18,41,19,0,6to,0,0,26,0,0,27,4,0,45,0,0,0
62943,34561,2021-06-24T13:18:40.2333051Z,2021,59,25,56,27,0,7mo,1,1,32,0,0,34,3,0,57,0,1,1
62943,34562,2021-06-24T13:18:40.2333051Z,2021,45,17,44,24,0,8vo,0,0,21,0,0,28,1,0,45,0,0,0
62943,34563,2021-06-24T13:18:40.2333051Z,2021,29,16,26,14,0,9no,0,0,15,0,0,13,3,0,29,0,0,0
62943,34564,2021-06-24T13:18:40.2343064Z,2021,17,4,17,8,0,K,0,0,9,0,0,13,0,0,17,0,0,0
62943,34565,2021-06-24T13:18:40.2343064Z,2021,19,19,19,7,0,Sin Grado,1,0,12,0,0,0,0,0,18,1,0,0
62943,4530,2020-11-18T16:21:10.8342559Z,2019,30,9,27,15,0,1ro,0,0,15,0,0,21,3,0,30,0,0,0
62943,4531,2020-11-18T16:21:10.8352573Z,2019,30,6,27,19,0,2do,0,1,11,0,0,24,3,0,30,0,0,0
62943,4532,2020-11-18T16:21:10.8352573Z,2019,28,13,24,12,0,3ro,0,0,16,0,0,15,4,0,28,0,0,0
62943,4533,2020-11-18T16:21:10.8352573Z,2019,34,13,31,16,0,4to,0,1,18,0,0,21,3,0,34,0,0,0
62943,4534,2020-11-18T16:21:10.8362577Z,2019,28,17,24,11,0,5to,0,0,17,0,0,11,4,0,28,0,1,0
62943,4535,2020-11-18T16:21:10.8362577Z,2019,48,19,42,22,0,6to,0,4,26,0,0,29,6,0,48,0,0,0
62943,4536,2020-11-18T16:21:10.8362577Z,2019,49,20,41,31,0,7mo,0,1,18,0,0,29,8,0,49,0,0,0
62943,4537,2020-11-18T16:21:10.8372577Z,2019,43,17,39,17,0,8vo,0,1,26,0,0,26,4,0,43,0,0,0
62943,4538,2020-11-18T16:21:10.8372577Z,2019,12,4,11,7,0,K,0,0,5,0,0,8,1,0,12,0,0,0
62943,4539,2020-11-18T16:21:10.8372577Z,2019,27,25,25,10,0,Sin Grado,1,0,17,0,0,2,2,0,26,2,0,0
10322,18,2020-11-18T16:20:36.6844864Z,2019,21,9,21,15,0,1ro,0,4,6,0,0,12,0,0,21,0,0,0
10322,19,2020-11-18T16:20:36.6844864Z,2019,32,11,29,20,0,2do,0,8,12,0,0,21,3,0,32,0,0,0
10322,20,2020-11-18T16:20:36.6844864Z,2019,20,8,18,12,0,3ro,1,0,8,0,0,12,2,0,19,0,0,0
10322,21,2020-11-18T16:20:36.6844864Z,2019,26,11,22,14,0,4to,2,5,12,0,0,15,4,0,24,0,0,0
10322,22,2020-11-18T16:20:36.6854877Z,2019,29,8,28,17,0,5to,0,2,12,0,0,21,1,0,29,0,0,0
10322,23,2020-11-18T16:20:36.6854877Z,2019,30,15,24,11,0,6to,1,6,19,0,0,15,6,0,29,0,0,0
10322,24,2020-11-18T16:20:36.6854877Z,2019,26,12,23,14,0,7mo,1,3,12,0,0,14,3,0,25,0,0,0
10322,25,2020-11-18T16:20:36.6854877Z,2019,21,5,17,8,0,8vo,1,1,13,0,0,16,4,0,20,0,0,0
10322,26,2020-11-18T16:20:36.6854877Z,2019,14,2,13,12,0,K,1,1,2,0,0,12,1,0,13,0,0,0
10322,27,2020-11-18T16:20:36.6864895Z,2019,4,4,3,2,0,Sin Grado,0,0,2,0,0,0,1,0,4,0,0,0
10322,30018,2021-06-24T13:18:05.8936769Z,2021,13,4,13,10,0,1ro,0,0,3,0,0,9,0,0,13,0,0,0
10322,30019,2021-06-24T13:18:05.8936769Z,2021,15,5,14,13,0,2do,0,0,2,0,0,10,1,0,15,0,0,0
10322,30020,2021-06-24T13:18:05.8936769Z,2021,22,9,21,15,0,3ro,0,0,7,0,0,13,1,0,22,0,0,0
10322,30021,2021-06-24T13:18:05.894677Z,2021,26,9,24,16,0,4to,0,0,10,0,0,17,2,0,26,0,0,0
10322,30022,2021-06-24T13:18:05.894677Z,2021,21,7,21,9,0,5to,1,0,12,0,0,14,0,0,20,0,0,0
10322,30023,2021-06-24T13:18:05.894677Z,2021,24,11,24,13,0,6to,0,0,11,0,0,13,0,0,24,0,0,0
10322,30024,2021-06-24T13:18:05.8956779Z,2021,34,11,32,18,0,7mo,1,0,16,0,0,23,2,0,33,0,0,0
10322,30025,2021-06-24T13:18:05.8956779Z,2021,30,16,29,10,0,8vo,1,0,20,0,0,14,1,0,29,0,0,0
10322,30026,2021-06-24T13:18:05.8956779Z,2021,19,4,19,8,0,K,0,0,11,0,0,15,0,0,19,0,0,0
10322,30027,2021-06-24T13:18:05.8956779Z,2021,10,10,6,6,0,Sin Grado,0,0,4,0,0,0,4,0,10,0,0,0
10322,6019,2020-11-18T16:21:37.6841597Z,2020,16,5,14,14,0,1ro,0,0,2,0,0,11,2,0,16,0,0,0
10322,6020,2020-11-18T16:21:37.6841597Z,2020,26,10,25,17,0,2do,0,0,9,0,0,16,1,0,26,0,0,0
10322,6021,2020-11-18T16:21:37.6841597Z,2020,31,12,30,19,0,3ro,0,0,12,0,0,19,1,0,31,0,0,0
10322,6022,2020-11-18T16:21:37.6841597Z,2020,19,8,19,9,0,4to,1,0,10,0,0,11,0,0,18,0,0,0
10322,6023,2020-11-18T16:21:37.6851614Z,2020,26,12,22,14,0,5to,1,0,12,0,0,14,4,0,25,0,0,0
10322,6024,2020-11-18T16:21:37.6851614Z,2020,38,12,36,21,0,6to,0,0,17,0,0,26,2,0,38,0,0,0
10322,6025,2020-11-18T16:21:37.6851614Z,2020,30,17,27,9,0,7mo,1,0,21,0,0,13,3,0,29,0,0,0
10322,6026,2020-11-18T16:21:37.6851614Z,2020,31,14,25,16,0,8vo,2,0,15,0,0,17,6,0,29,0,0,0
10322,6027,2020-11-18T16:21:37.6851614Z,2020,18,5,18,12,0,K,0,0,6,0,0,13,0,0,18,0,0,0
10322,6028,2020-11-18T16:21:37.686161Z,2020,10,10,6,4,0,Sin Grado,1,0,6,0,0,0,4,0,9,0,0,0
40220,2541,2020-11-18T16:20:57.6364583Z,2019,45,16,31,16,0,1ro,5,1,29,0,0,29,14,0,40,0,1,0
40220,2542,2020-11-18T16:20:57.6374587Z,2019,62,15,47,34,0,2do,0,0,28,0,0,47,15,0,61,0,3,1
40220,2543,2020-11-18T16:20:57.6374587Z,2019,61,15,49,19,0,3ro,2,0,42,0,0,46,12,0,59,0,0,0
40220,2544,2020-11-18T16:20:57.6374587Z,2019,79,19,60,32,0,4to,3,0,47,0,0,60,19,0,76,0,0,0
40220,2545,2020-11-18T16:20:57.6374587Z,2019,71,14,42,38,0,5to,2,0,33,0,0,57,29,0,69,0,0,0
40220,2546,2020-11-18T16:20:57.6374587Z,2019,90,22,66,41,0,6to,3,0,49,0,0,68,24,0,87,0,1,0
40220,2547,2020-11-18T16:20:57.6384592Z,2019,94,22,70,57,0,7mo,3,0,37,0,0,72,24,0,91,0,0,0
40220,2548,2020-11-18T16:20:57.6384592Z,2019,93,17,58,56,0,8vo,7,0,37,0,0,76,35,0,86,1,0,0
40220,2549,2020-11-18T16:20:57.6384592Z,2019,64,14,49,44,0,K,3,1,20,0,0,50,15,1,60,0,0,0
40220,2550,2020-11-18T16:20:57.6384592Z,2019,69,14,56,40,0,PK,0,0,29,0,0,55,13,0,69,0,0,0
40220,32549,2021-06-24T13:18:25.2335492Z,2021,55,10,39,23,0,1ro,0,0,32,0,0,45,16,1,54,0,0,0
40220,32550,2021-06-24T13:18:25.2345501Z,2021,50,10,39,28,0,2do,2,0,22,0,0,40,11,1,47,0,0,0
40220,32551,2021-06-24T13:18:25.2345501Z,2021,51,11,38,27,0,3ro,2,0,24,0,0,40,13,0,47,0,0,2
40220,32552,2021-06-24T13:18:25.2345501Z,2021,56,12,45,31,0,4to,0,0,25,0,0,44,11,1,55,0,1,0
40220,32553,2021-06-24T13:18:25.2345501Z,2021,58,12,39,16,0,5to,4,0,42,0,0,46,19,0,54,0,0,0
40220,32554,2021-06-24T13:18:25.2355506Z,2021,61,15,47,28,0,6to,3,0,33,0,0,46,14,1,57,0,0,0
40220,32555,2021-06-24T13:18:25.2355506Z,2021,39,6,26,21,0,7mo,1,0,18,0,0,33,13,0,38,0,0,0
40220,32556,2021-06-24T13:18:25.2355506Z,2021,69,15,59,34,0,8vo,2,0,35,0,0,54,10,0,67,0,1,0
40220,32557,2021-06-24T13:18:25.2355506Z,2021,55,13,44,26,0,K,0,0,29,0,0,42,11,0,55,0,0,0
40220,32558,2021-06-24T13:18:25.236552Z,2021,29,5,19,18,0,PK,2,0,11,0,0,24,10,0,26,0,0,1
40220,32559,2021-06-24T13:18:25.236552Z,2021,6,6,6,2,0,Sin Grado,0,0,4,0,0,0,0,0,6,0,0,0
40220,8554,2020-11-18T16:21:52.6361289Z,2020,48,13,39,29,0,1ro,2,0,19,0,0,35,9,1,45,0,0,0
40220,8555,2020-11-18T16:21:52.6361289Z,2020,37,10,30,18,0,2do,1,0,19,0,0,27,7,0,36,0,0,0
40220,8556,2020-11-18T16:21:52.6361289Z,2020,61,12,53,34,0,3ro,0,1,27,0,0,49,8,1,60,0,1,0
40220,8557,2020-11-18T16:21:52.6361289Z,2020,57,12,36,15,0,4to,2,0,42,0,0,45,21,0,55,0,0,0
40220,8558,2020-11-18T16:21:52.6361289Z,2020,77,19,57,33,0,5to,3,0,44,0,0,58,20,0,74,0,0,0
40220,8559,2020-11-18T16:21:52.6371302Z,2020,71,14,44,36,0,6to,2,0,35,0,0,57,27,0,69,0,0,0
40220,8560,2020-11-18T16:21:52.6371302Z,2020,85,22,60,44,0,7mo,2,0,41,0,0,63,25,0,83,0,1,0
40220,8561,2020-11-18T16:21:52.6371302Z,2020,87,23,62,56,0,8vo,3,0,31,0,0,64,25,0,84,0,0,0
40220,8562,2020-11-18T16:21:52.6371302Z,2020,59,14,49,21,0,K,0,0,38,0,0,45,10,0,59,0,0,0
40220,8563,2020-11-18T16:21:52.6371302Z,2020,45,8,33,21,0,PK,2,0,24,0,0,37,12,0,43,0,0,0
21352,1188,2020-11-18T16:20:44.6467943Z,2019,18,6,17,11,0,1ro,0,0,7,0,0,12,1,0,18,0,0,0
21352,1189,2020-11-18T16:20:44.6467943Z,2019,22,3,20,11,0,2do,1,1,11,0,0,19,2,0,21,0,0,0
21352,1190,2020-11-18T16:20:44.6477943Z,2019,14,5,12,7,0,3ro,0,5,7,0,0,9,2,0,14,0,1,0
21352,1191,2020-11-18T16:20:44.6477943Z,2019,21,5,19,12,0,4to,0,0,9,0,0,16,2,0,21,0,0,0
21352,1192,2020-11-18T16:20:44.6477943Z,2019,20,6,16,10,0,5to,0,1,10,0,0,14,4,0,20,0,0,0
21352,1193,2020-11-18T16:20:44.6477943Z,2019,14,6,12,6,0,6to,0,0,8,0,0,8,2,0,14,0,0,0
21352,1194,2020-11-18T16:20:44.6477943Z,2019,11,8,10,4,0,7mo,0,0,7,0,0,3,1,0,11,0,0,0
21352,1195,2020-11-18T16:20:44.6487947Z,2019,21,10,14,4,0,8vo,0,1,17,0,0,11,7,0,21,0,0,0
21352,1196,2020-11-18T16:20:44.6487947Z,2019,13,3,11,5,0,K,0,1,8,0,0,10,2,0,13,0,0,0
21352,1197,2020-11-18T16:20:44.6487947Z,2019,7,6,5,0,0,Sin Grado,0,0,7,0,0,1,2,0,7,0,0,0
21352,31189,2021-06-24T13:18:13.1308655Z,2021,13,4,13,6,0,1ro,0,0,7,0,0,9,0,0,13,0,0,0
21352,31190,2021-06-24T13:18:13.131866Z,2021,25,6,20,9,0,2do,0,0,16,0,0,19,5,0,25,0,0,0
21352,31191,2021-06-24T13:18:13.131866Z,2021,20,7,18,10,0,3ro,1,0,10,0,0,13,2,0,19,0,0,0
21352,31192,2021-06-24T13:18:13.131866Z,2021,25,6,23,12,0,4to,0,0,13,0,0,19,2,0,25,0,0,0
21352,31193,2021-06-24T13:18:13.131866Z,2021,18,5,15,8,0,5to,0,0,10,0,0,13,3,0,18,0,1,0
21352,31194,2021-06-24T13:18:13.1328665Z,2021,26,10,23,12,0,6to,0,0,14,0,0,16,3,0,26,0,0,0
21352,31195,2021-06-24T13:18:13.1328665Z,2021,31,12,28,14,0,7mo,0,0,17,0,0,19,3,0,31,0,0,0
21352,31196,2021-06-24T13:18:13.1328665Z,2021,25,13,23,12,0,8vo,0,1,13,0,0,12,2,0,25,0,0,0
21352,31197,2021-06-24T13:18:13.1338674Z,2021,15,2,15,6,0,K,0,0,9,0,0,13,0,0,15,0,0,0
21352,31198,2021-06-24T13:18:13.1338674Z,2021,17,17,13,4,0,Sin Grado,0,0,13,0,0,0,4,0,17,0,0,0
21352,7193,2020-11-18T16:21:44.2125144Z,2020,18,4,15,8,0,1ro,0,0,10,0,0,14,3,0,18,0,0,0
21352,7194,2020-11-18T16:21:44.2125144Z,2020,18,6,18,8,0,2do,1,0,10,0,0,12,0,0,17,0,0,0
21352,7195,2020-11-18T16:21:44.2135153Z,2020,25,5,23,12,0,3ro,0,0,13,0,0,20,2,0,25,0,0,0
21352,7196,2020-11-18T16:21:44.2135153Z,2020,18,7,15,7,0,4to,0,0,11,0,0,11,3,0,18,0,1,0
21352,7197,2020-11-18T16:21:44.2135153Z,2020,26,8,24,14,0,5to,0,0,12,0,0,18,2,0,26,0,0,0
21352,7198,2020-11-18T16:21:44.2135153Z,2020,29,11,25,15,0,6to,0,1,14,0,0,18,4,0,29,0,0,0
21352,7199,2020-11-18T16:21:44.2135153Z,2020,21,9,18,11,0,7mo,0,2,10,0,0,12,3,0,21,0,0,0
21352,7200,2020-11-18T16:21:44.2145157Z,2020,14,10,12,6,0,8vo,0,1,8,0,0,4,2,0,14,0,0,0
21352,7201,2020-11-18T16:21:44.5777586Z,2020,16,3,14,6,0,K,0,0,10,0,0,13,2,0,16,0,0,0
21352,7202,2020-11-18T16:21:44.5777586Z,2020,34,34,29,6,0,Sin Grado,0,4,28,0,0,0,5,0,34,0,0,0
50443,3253,2020-11-18T16:21:01.4620073Z,2019,29,8,23,16,0,1ro,0,1,13,0,0,21,6,0,29,0,0,0
50443,3254,2020-11-18T16:21:01.4630086Z,2019,23,10,20,11,0,2do,0,1,12,0,0,13,3,0,23,0,0,0
50443,3255,2020-11-18T16:21:01.4630086Z,2019,24,12,21,10,0,3ro,0,1,14,0,0,12,3,0,24,0,1,0
50443,3256,2020-11-18T16:21:01.4630086Z,2019,33,12,24,16,0,4to,2,1,17,0,0,21,9,0,31,0,0,0
50443,3257,2020-11-18T16:21:01.4630086Z,2019,22,7,15,10,0,5to,1,1,12,0,0,15,7,0,21,0,0,0
50443,3258,2020-11-18T16:21:01.4630086Z,2019,15,10,10,7,0,6to,0,0,8,0,0,5,5,0,15,0,0,0
50443,3259,2020-11-18T16:21:01.4640077Z,2019,24,11,18,11,0,7mo,0,0,13,0,0,13,6,0,24,0,0,0
50443,3260,2020-11-18T16:21:01.4640077Z,2019,23,10,11,12,0,8vo,0,1,11,0,0,13,12,0,23,0,0,0
50443,3261,2020-11-18T16:21:01.4640077Z,2019,20,6,18,9,0,K,0,1,11,0,0,14,2,0,20,0,0,0
50443,3262,2020-11-18T16:21:01.4640077Z,2019,13,13,10,2,0,Sin Grado,0,0,11,0,0,0,3,0,13,0,0,0
50443,33279,2021-06-24T13:18:30.9116216Z,2021,27,8,24,11,0,1ro,2,0,16,0,0,19,3,0,25,0,0,0
50443,33280,2021-06-24T13:18:30.9116216Z,2021,15,7,13,7,0,2do,1,0,8,0,0,8,2,0,14,0,0,0
50443,33281,2021-06-24T13:18:30.9116216Z,2021,28,10,21,18,0,3ro,1,0,10,0,0,18,7,0,27,0,0,0
50443,33282,2021-06-24T13:18:30.9126216Z,2021,18,9,16,9,0,4to,1,0,9,0,0,9,2,0,17,0,0,0
50443,33283,2021-06-24T13:18:30.9126216Z,2021,24,10,16,10,0,5to,0,0,14,0,0,14,8,0,24,0,1,0
50443,33284,2021-06-24T13:18:30.9126216Z,2021,32,13,23,14,0,6to,2,0,18,0,0,19,9,0,30,0,0,0
50443,33285,2021-06-24T13:18:30.9126216Z,2021,18,6,14,9,0,7mo,0,0,9,0,0,12,4,0,18,0,0,0
50443,33286,2021-06-24T13:18:30.9136225Z,2021,19,10,15,8,0,8vo,0,0,11,0,0,9,4,0,19,0,0,0
50443,33287,2021-06-24T13:18:30.9136225Z,2021,19,5,15,8,0,K,0,0,11,0,0,14,4,0,19,0,0,0
50443,33288,2021-06-24T13:18:30.9136225Z,2021,16,16,15,3,0,Sin Grado,0,0,13,0,0,0,1,0,16,0,0,0
50443,9273,2020-11-18T16:21:57.3332643Z,2020,17,6,16,7,0,1ro,1,0,10,0,0,11,1,0,16,0,0,0
50443,9274,2020-11-18T16:21:57.3342647Z,2020,30,6,22,19,0,2do,0,0,11,0,0,24,8,0,30,0,0,0
50443,9275,2020-11-18T16:21:57.3342647Z,2020,18,8,14,8,0,3ro,0,0,10,0,0,10,4,0,18,0,0,0
50443,9276,2020-11-18T16:21:57.3342647Z,2020,23,10,16,10,0,4to,0,0,13,0,0,13,7,0,23,0,1,0
50443,9277,2020-11-18T16:21:57.3342647Z,2020,34,13,25,16,0,5to,2,0,18,0,0,21,9,0,32,0,0,0
50443,9278,2020-11-18T16:21:57.335266Z,2020,22,7,16,10,0,6to,1,0,12,0,0,15,6,0,21,0,0,0
50443,9279,2020-11-18T16:21:57.335266Z,2020,21,10,15,8,0,7mo,0,0,13,0,0,11,6,0,21,0,0,0
50443,9280,2020-11-18T16:21:57.335266Z,2020,27,12,20,12,0,8vo,0,0,15,0,0,15,7,0,27,0,0,0
50443,9281,2020-11-18T16:21:57.3362678Z,2020,32,8,26,14,0,K,2,0,18,0,0,24,6,0,30,0,0,0
50443,9282,2020-11-18T16:21:57.3362678Z,2020,18,18,17,4,0,Sin Grado,0,0,14,0,0,0,1,0,18,0,0,0
10546,30056,2021-06-24T13:18:05.9036832Z,2021,28,15,25,11,0,1ro,0,0,17,0,0,13,3,0,28,0,0,0
10546,30057,2021-06-24T13:18:05.9036832Z,2021,35,13,29,18,0,2do,0,1,17,0,0,22,6,0,35,0,0,0
10546,30058,2021-06-24T13:18:05.9036832Z,2021,28,9,21,14,0,3ro,0,0,14,0,0,19,7,0,28,0,0,0
10546,30059,2021-06-24T13:18:05.9036832Z,2021,47,23,40,26,0,4to,0,1,21,0,0,24,7,0,47,0,0,0
10546,30060,2021-06-24T13:18:05.9046841Z,2021,51,21,40,24,0,5to,1,1,27,0,0,30,11,0,50,0,1,0
10546,30061,2021-06-24T13:18:05.9046841Z,2021,108,42,94,59,0,6to,2,3,49,0,0,66,14,0,106,0,0,0
10546,30062,2021-06-24T13:18:05.9046841Z,2021,117,34,96,64,0,7mo,0,2,53,0,0,83,21,0,117,0,0,0
10546,30063,2021-06-24T13:18:05.9046841Z,2021,106,36,84,60,0,8vo,1,4,46,0,0,70,22,0,105,0,1,0
10546,30064,2021-06-24T13:18:05.9056851Z,2021,15,4,11,5,0,K,0,0,10,0,0,11,4,0,15,0,0,0
10546,30065,2021-06-24T13:18:05.9056851Z,2021,3,3,0,0,0,Sin Grado,0,0,3,0,0,0,3,0,3,0,0,0
10546,55,2020-11-18T16:20:36.6924921Z,2019,31,10,24,13,0,1ro,0,0,18,0,0,21,7,0,31,0,0,0
10546,56,2020-11-18T16:20:36.6924921Z,2019,45,18,39,28,0,2do,0,0,17,0,0,27,6,0,45,0,0,0
10546,57,2020-11-18T16:20:36.6924921Z,2019,51,17,42,24,0,3ro,1,0,27,0,0,34,9,0,50,0,0,0
10546,58,2020-11-18T16:20:36.6924921Z,2019,74,29,66,41,0,4to,4,0,33,0,0,45,8,0,70,0,0,0
10546,59,2020-11-18T16:20:36.6934921Z,2019,68,26,55,36,0,5to,0,0,32,0,0,42,13,0,68,0,0,0
10546,60,2020-11-18T16:20:36.6934921Z,2019,127,43,97,76,0,6to,1,0,51,0,0,84,30,0,126,0,1,0
10546,6057,2020-11-18T16:21:37.6951672Z,2020,35,14,30,20,0,1ro,1,0,15,0,0,21,5,0,34,0,0,0
10546,6058,2020-11-18T16:21:37.6951672Z,2020,27,10,20,12,0,2do,0,0,15,0,0,17,7,0,27,0,0,0
10546,6059,2020-11-18T16:21:37.6951672Z,2020,44,19,34,27,0,3ro,0,0,17,0,0,25,10,0,44,0,0,0
10546,6060,2020-11-18T16:21:37.6951672Z,2020,49,18,39,24,0,4to,1,0,25,0,0,31,10,0,48,0,0,0
10546,6061,2020-11-18T16:21:37.6961686Z,2020,68,27,63,37,0,5to,4,0,31,0,0,41,5,0,64,0,0,0
10546,6062,2020-11-18T16:21:37.6961686Z,2020,109,33,84,60,0,6to,0,0,49,0,0,76,25,0,109,0,0,0
10546,6063,2020-11-18T16:21:37.6961686Z,2020,112,43,81,65,0,7mo,1,0,47,0,0,69,31,0,111,0,1,0
10546,6064,2020-11-18T16:21:37.6961686Z,2020,100,41,71,44,0,8vo,2,0,56,0,0,59,29,0,98,0,2,0
10546,6065,2020-11-18T16:21:37.6961686Z,2020,28,11,26,11,0,K,0,0,17,0,0,17,2,0,28,0,0,0
10546,6066,2020-11-18T16:21:37.6961686Z,2020,4,4,3,1,0,Sin Grado,0,0,3,0,0,0,1,0,4,0,0,0
10546,61,2020-11-18T16:20:36.6934921Z,2019,127,56,97,54,0,7mo,1,0,73,0,0,71,30,0,126,0,2,0
10546,62,2020-11-18T16:20:36.6934921Z,2019,126,43,89,69,0,8vo,3,0,57,0,0,83,37,0,123,0,0,0
10546,63,2020-11-18T16:20:36.6934921Z,2019,35,13,31,19,0,K,0,0,16,0,0,22,4,0,35,0,0,0
10546,64,2020-11-18T16:20:36.6944934Z,2019,8,8,6,3,0,PK,0,0,5,0,0,0,2,0,8,0,0,0
10546,65,2020-11-18T16:20:36.6944934Z,2019,11,11,10,2,0,Sin Grado,1,0,9,0,0,0,1,0,10,0,0,0
41012,2639,2020-11-18T16:20:58.0627403Z,2019,35,8,31,17,0,1ro,1,0,18,0,0,27,4,0,34,0,0,0
41012,2640,2020-11-18T16:20:58.0627403Z,2019,44,17,41,20,0,2do,1,0,24,0,0,27,3,2,41,0,0,0
41012,2641,2020-11-18T16:20:58.0627403Z,2019,30,12,27,15,0,3ro,1,0,15,0,0,18,3,0,29,0,0,0
41012,2642,2020-11-18T16:20:58.0637408Z,2019,32,11,29,17,0,4to,0,0,15,0,0,21,3,0,32,0,0,0
41012,2643,2020-11-18T16:20:58.0637408Z,2019,30,6,27,17,0,5to,0,0,13,0,0,24,3,0,30,0,0,0
41012,2644,2020-11-18T16:20:58.0637408Z,2019,43,15,37,21,0,6to,1,0,22,0,0,28,6,0,42,1,0,0
41012,2645,2020-11-18T16:20:58.0647417Z,2019,34,15,28,18,0,7mo,2,0,16,0,0,19,6,0,32,0,0,0
41012,2646,2020-11-18T16:20:58.0647417Z,2019,52,16,37,20,0,8vo,1,0,32,0,0,36,15,0,51,0,0,0
41012,2647,2020-11-18T16:20:58.0647417Z,2019,27,8,23,16,0,K,0,0,11,0,0,19,4,1,26,0,0,0
41012,32646,2021-06-24T13:18:26.2662906Z,2021,28,10,26,14,0,1ro,0,0,14,0,0,18,2,0,28,0,0,0
41012,32647,2021-06-24T13:18:26.2662906Z,2021,31,8,30,20,0,2do,0,0,11,0,0,23,1,0,31,0,0,0
41012,32648,2021-06-24T13:18:26.2662906Z,2021,27,5,23,16,0,3ro,0,0,11,0,0,22,4,0,27,0,0,0
41012,32649,2021-06-24T13:18:26.2672911Z,2021,44,16,41,21,0,4to,0,0,23,0,0,28,3,1,43,0,0,0
41012,32650,2021-06-24T13:18:26.2672911Z,2021,38,16,35,16,0,5to,1,0,22,0,0,22,3,0,37,0,0,0
41012,32651,2021-06-24T13:18:26.2672911Z,2021,44,13,42,22,0,6to,2,0,22,0,0,31,2,0,42,0,0,0
41012,32652,2021-06-24T13:18:26.2672911Z,2021,53,11,46,28,0,7mo,0,0,25,0,0,42,7,0,53,0,0,0
41012,32653,2021-06-24T13:18:26.2672911Z,2021,43,11,36,19,0,8vo,1,0,24,0,0,32,7,0,42,1,0,0
41012,32654,2021-06-24T13:18:26.2682925Z,2021,28,3,22,12,0,K,1,0,16,0,0,25,6,0,27,0,0,0
41012,8650,2020-11-18T16:21:53.0624146Z,2020,34,9,32,22,0,1ro,0,0,12,0,0,25,2,0,34,0,0,0
41012,8651,2020-11-18T16:21:53.0624146Z,2020,31,7,23,16,0,2do,0,0,15,0,0,24,8,0,31,0,0,0
41012,8652,2020-11-18T16:21:53.0624146Z,2020,46,16,42,21,0,3ro,1,0,25,0,0,30,4,1,44,0,0,0
41012,8653,2020-11-18T16:21:53.0634141Z,2020,39,16,36,17,0,4to,1,0,22,0,0,23,3,0,38,0,0,0
41012,8654,2020-11-18T16:21:53.0634141Z,2020,33,10,29,18,0,5to,1,0,15,0,0,23,4,0,32,0,0,0
41012,8655,2020-11-18T16:21:53.0634141Z,2020,56,13,50,28,0,6to,1,0,28,0,0,43,6,0,55,0,0,0
41012,8656,2020-11-18T16:21:53.0644168Z,2020,48,15,43,24,0,7mo,1,0,24,0,0,33,5,0,47,1,0,0
41012,8657,2020-11-18T16:21:53.0644168Z,2020,32,12,27,16,0,8vo,2,0,16,0,0,20,5,0,30,0,0,0
41012,8658,2020-11-18T16:21:53.0644168Z,2020,30,5,27,15,0,K,0,0,15,0,0,25,3,0,30,0,0,0
76349,11650,2020-11-18T16:22:11.7348687Z,2020,45,17,39,24,0,1ro,0,0,21,0,0,28,6,0,45,0,0,0
76349,11651,2020-11-18T16:22:11.7348687Z,2020,73,26,63,39,0,2do,0,0,34,0,0,47,10,0,72,0,0,1
76349,11652,2020-11-18T16:22:11.7348687Z,2020,70,23,57,39,0,3ro,0,0,31,0,0,47,13,1,68,0,0,1
76349,11653,2020-11-18T16:22:11.73587Z,2020,59,19,47,35,0,4to,0,0,24,0,0,40,12,0,58,0,0,1
76349,11654,2020-11-18T16:22:11.73587Z,2020,52,20,42,22,0,5to,0,0,30,0,0,32,10,0,52,0,0,0
76349,11655,2020-11-18T16:22:11.73587Z,2020,94,32,71,38,0,6to,1,0,56,0,0,62,23,0,92,0,0,1
76349,11656,2020-11-18T16:22:11.7368709Z,2020,84,25,63,43,0,7mo,0,0,41,0,0,59,21,0,84,0,0,0
76349,11657,2020-11-18T16:22:11.7368709Z,2020,68,21,49,31,0,8vo,2,0,37,0,0,47,19,0,66,0,0,0
76349,11658,2020-11-18T16:22:11.7368709Z,2020,43,7,39,18,0,K,0,0,25,0,0,36,4,0,43,0,0,0
76349,11659,2020-11-18T16:22:11.7378709Z,2020,2,2,2,0,0,Sin Grado,0,0,2,0,0,0,0,0,2,0,0,0
76349,35673,2021-06-24T13:18:47.4314668Z,2021,50,12,43,22,0,1ro,0,0,28,0,0,38,7,0,49,0,0,1
76349,35674,2021-06-24T13:18:47.4314668Z,2021,38,13,28,19,0,2do,0,1,19,0,0,25,10,0,38,0,0,0
76349,35675,2021-06-24T13:18:47.4314668Z,2021,62,22,53,33,0,3ro,0,0,29,0,0,40,9,0,62,0,0,0
76349,35676,2021-06-24T13:18:47.4314668Z,2021,65,21,49,38,0,4to,0,0,27,0,0,44,16,1,64,0,0,0
76349,35677,2021-06-24T13:18:47.4324677Z,2021,53,18,41,32,0,5to,0,0,21,0,0,35,12,0,52,0,0,1
76349,35678,2021-06-24T13:18:47.4324677Z,2021,58,19,48,26,0,6to,0,1,32,0,0,39,10,0,58,0,0,0
76349,35679,2021-06-24T13:18:47.4324677Z,2021,79,23,66,33,0,7mo,1,0,46,0,0,56,13,0,78,0,0,0
76349,35680,2021-06-24T13:18:47.4324677Z,2021,82,24,68,40,0,8vo,0,2,42,0,0,58,14,0,82,0,0,0
76349,35681,2021-06-24T13:18:47.4334682Z,2021,34,7,23,18,0,K,0,0,16,0,0,27,11,0,34,0,0,0
76349,35682,2021-06-24T13:18:47.4334682Z,2021,4,3,3,0,0,Sin Grado,0,0,4,0,0,1,1,0,4,0,0,0
76349,5643,2020-11-18T16:21:16.616112Z,2019,67,23,55,37,0,1ro,2,0,30,0,0,44,12,0,65,0,0,0
76349,5644,2020-11-18T16:21:16.616112Z,2019,75,28,59,40,0,2do,0,1,35,0,0,47,16,0,75,0,0,0
76349,5645,2020-11-18T16:21:16.6171124Z,2019,67,20,55,38,0,3ro,1,0,29,0,0,47,12,0,65,0,0,1
76349,5646,2020-11-18T16:21:16.6171124Z,2019,54,21,45,23,0,4to,0,0,31,0,0,33,9,0,54,0,0,0
76349,5647,2020-11-18T16:21:16.6171124Z,2019,81,26,61,32,0,5to,3,0,49,0,0,55,20,0,78,0,0,0
76349,5648,2020-11-18T16:21:16.6181138Z,2019,82,26,61,39,0,6to,0,2,43,0,0,56,21,0,82,0,0,0
76349,5649,2020-11-18T16:21:16.6181138Z,2019,77,25,54,34,0,7mo,2,3,43,0,0,52,23,0,75,0,0,0
76349,5650,2020-11-18T16:21:16.6181138Z,2019,96,26,69,49,0,8vo,2,2,47,0,0,70,27,0,94,0,0,0
76349,5651,2020-11-18T16:21:16.6181138Z,2019,37,11,33,21,0,K,0,0,16,0,0,26,4,0,37,0,0,0
76349,5652,2020-11-18T16:21:16.6191147Z,2019,3,3,3,3,0,Sin Grado,0,2,0,0,0,0,0,0,3,0,0,0
43398,2902,2020-11-18T16:20:59.9019654Z,2019,31,10,28,11,0,1ro,1,0,20,0,0,21,3,0,30,0,0,0
43398,2903,2020-11-18T16:20:59.9019654Z,2019,27,9,25,15,0,2do,0,0,12,0,0,18,2,0,27,0,0,0
43398,2904,2020-11-18T16:20:59.9019654Z,2019,32,11,28,21,0,3ro,1,0,11,0,0,21,4,0,31,0,0,0
43398,2905,2020-11-18T16:20:59.9029681Z,2019,28,10,22,15,0,4to,1,0,13,0,0,18,6,0,27,0,0,0
43398,2906,2020-11-18T16:20:59.9029681Z,2019,39,14,32,21,0,5to,0,0,18,0,0,25,7,0,39,0,0,0
43398,2907,2020-11-18T16:20:59.9029681Z,2019,41,17,31,22,0,6to,1,0,19,0,0,24,10,0,40,0,0,0
43398,2908,2020-11-18T16:20:59.9039672Z,2019,63,26,50,20,0,7mo,1,0,43,0,0,37,13,0,62,0,1,0
43398,2909,2020-11-18T16:20:59.9039672Z,2019,45,16,35,22,0,8vo,0,0,23,0,0,29,10,0,45,0,0,0
43398,2910,2020-11-18T16:20:59.9039672Z,2019,21,6,21,8,0,K,1,0,13,0,0,15,0,0,20,0,0,0
43398,32910,2021-06-24T13:18:28.8571473Z,2021,39,6,29,19,0,1ro,1,0,20,0,0,33,10,0,38,0,0,0
43398,32911,2021-06-24T13:18:28.8571473Z,2021,24,10,20,11,0,2do,1,0,13,0,0,14,4,0,23,0,0,0
43398,32912,2021-06-24T13:18:28.8571473Z,2021,34,11,29,13,0,3ro,1,0,21,0,0,23,5,0,33,0,0,0
43398,32913,2021-06-24T13:18:28.8571473Z,2021,40,13,31,22,0,4to,1,0,18,0,0,27,9,0,39,0,0,0
43398,32914,2021-06-24T13:18:28.8571473Z,2021,41,15,35,23,0,5to,1,0,18,0,0,26,6,0,40,0,0,0
43398,32915,2021-06-24T13:18:28.8571473Z,2021,63,29,43,26,0,6to,1,0,37,0,0,34,20,0,62,0,0,0
43398,32916,2021-06-24T13:18:28.8581487Z,2021,93,38,73,46,0,7mo,1,0,47,0,0,55,20,0,92,1,0,0
43398,32917,2021-06-24T13:18:28.8581487Z,2021,66,30,58,35,0,8vo,1,0,31,0,0,36,8,0,65,0,0,0
43398,32918,2021-06-24T13:18:28.8581487Z,2021,30,8,19,16,0,K,1,0,14,0,0,22,11,0,29,0,0,0
43398,32919,2021-06-24T13:18:28.8581487Z,2021,6,6,6,0,0,Sin Grado,0,0,6,0,0,0,0,0,6,0,0,0
43398,8914,2020-11-18T16:21:54.9856989Z,2020,26,9,24,11,0,1ro,1,0,15,0,0,17,2,0,25,0,0,0
43398,8915,2020-11-18T16:21:54.9866989Z,2020,38,13,35,14,0,2do,1,0,24,0,0,25,3,0,37,0,0,0
43398,8916,2020-11-18T16:21:54.9866989Z,2020,38,13,36,22,0,3ro,0,0,16,0,0,25,2,0,38,0,0,0
43398,8917,2020-11-18T16:21:54.9866989Z,2020,36,14,32,23,0,4to,1,0,13,0,0,22,4,0,35,0,0,0
43398,8918,2020-11-18T16:21:54.9866989Z,2020,45,20,38,22,0,5to,1,0,23,0,0,25,7,0,44,0,0,0
43398,8919,2020-11-18T16:21:54.9866989Z,2020,69,31,53,37,0,6to,1,0,32,0,0,38,16,0,68,0,0,0
43398,8920,2020-11-18T16:21:54.9877002Z,2020,77,39,68,37,0,7mo,1,0,40,0,0,38,9,0,76,0,0,0
43398,8921,2020-11-18T16:21:54.9877002Z,2020,46,18,36,16,0,8vo,0,0,30,0,0,28,10,0,46,0,0,0
43398,8922,2020-11-18T16:21:54.9877002Z,2020,46,10,38,23,0,K,1,0,23,0,0,36,8,0,45,0,0,0
43398,8923,2020-11-18T16:21:54.9877002Z,2020,5,4,4,0,0,Sin Grado,0,0,5,0,0,1,1,0,5,0,0,0
21212,1179,2020-11-18T16:20:44.6427907Z,2019,54,15,47,29,0,1ro,0,0,25,0,0,39,7,0,54,0,0,0
21212,1180,2020-11-18T16:20:44.6437907Z,2019,39,10,29,17,0,2do,0,0,22,0,0,29,10,0,39,2,0,0
21212,1181,2020-11-18T16:20:44.6437907Z,2019,54,14,41,29,0,3ro,0,0,25,0,0,40,13,0,53,0,0,1
21212,1182,2020-11-18T16:20:44.6437907Z,2019,50,16,37,26,0,4to,0,1,24,0,0,34,13,0,49,0,0,1
21212,1183,2020-11-18T16:20:44.6437907Z,2019,49,11,41,27,0,5to,0,0,22,0,1,38,8,0,49,1,0,0
21212,1184,2020-11-18T16:20:44.6437907Z,2019,48,13,38,19,0,6to,0,1,29,0,1,35,10,0,47,1,0,1
21212,1185,2020-11-18T16:20:44.6437907Z,2019,52,10,41,23,0,7mo,0,0,29,0,0,42,11,0,52,2,0,0
21212,1186,2020-11-18T16:20:44.644792Z,2019,51,20,41,23,0,8vo,1,2,28,0,0,31,10,0,50,0,0,0
21212,1187,2020-11-18T16:20:44.644792Z,2019,41,11,25,24,0,K,0,0,17,0,0,30,16,0,41,0,0,0
21212,31180,2021-06-24T13:18:13.1258617Z,2021,31,4,29,18,0,1ro,1,0,13,0,0,27,2,0,30,0,0,0
21212,31181,2021-06-24T13:18:13.1258617Z,2021,34,13,31,15,0,2do,0,1,19,0,0,21,3,0,34,0,0,0
21212,31182,2021-06-24T13:18:13.1268626Z,2021,43,12,37,22,0,3ro,0,0,21,0,0,31,6,0,43,0,0,0
21212,31183,2021-06-24T13:18:13.1268626Z,2021,39,9,34,19,0,4to,0,0,20,0,0,30,5,0,39,2,0,0
21212,31184,2021-06-24T13:18:13.1278627Z,2021,44,10,36,22,0,5to,0,0,22,0,0,34,8,0,44,0,0,0
21212,31185,2021-06-24T13:18:13.1278627Z,2021,46,11,35,26,0,6to,1,0,20,0,0,35,11,0,44,1,1,1
21212,31186,2021-06-24T13:18:13.1278627Z,2021,52,13,42,26,0,7mo,1,1,26,0,0,39,10,0,50,1,1,1
21212,31187,2021-06-24T13:18:13.1288632Z,2021,45,14,37,19,0,8vo,0,0,26,0,0,31,8,0,45,1,0,0
21212,31188,2021-06-24T13:18:13.1288632Z,2021,33,5,28,16,0,K,0,0,17,0,0,28,5,0,33,0,0,0
21212,7184,2020-11-18T16:21:44.2115135Z,2020,34,10,26,18,0,1ro,0,1,16,0,0,24,8,0,34,0,0,0
21212,7185,2020-11-18T16:21:44.2115135Z,2020,47,13,38,25,0,2do,0,1,22,0,0,34,9,0,47,0,0,0
21212,7186,2020-11-18T16:21:44.2115135Z,2020,38,10,29,17,0,3ro,1,1,21,0,0,28,9,0,37,2,0,0
21212,7187,2020-11-18T16:21:44.2115135Z,2020,51,12,35,28,0,4to,0,2,23,0,0,39,16,0,51,0,0,0
21212,7188,2020-11-18T16:21:44.2115135Z,2020,46,11,36,27,0,5to,0,0,19,0,0,35,10,0,45,0,0,1
21212,7189,2020-11-18T16:21:44.2115135Z,2020,53,13,44,29,0,6to,0,1,24,0,0,40,9,0,52,1,0,1
21212,7190,2020-11-18T16:21:44.2125144Z,2020,47,13,35,20,0,7mo,0,0,27,0,0,34,12,0,47,1,0,0
21212,7191,2020-11-18T16:21:44.2125144Z,2020,54,10,39,27,0,8vo,0,0,27,0,0,44,15,0,53,2,0,1
21212,7192,2020-11-18T16:21:44.2125144Z,2020,41,6,34,23,0,K,2,0,18,0,0,35,7,0,39,0,0,0
53140,33675,2021-06-24T13:18:33.691615Z,2021,33,7,27,14,0,1ro,0,0,19,0,0,26,6,0,33,0,0,0
53140,33676,2021-06-24T13:18:33.691615Z,2021,43,11,35,22,0,2do,0,0,21,0,0,32,8,0,43,0,0,0
53140,33677,2021-06-24T13:18:33.692615Z,2021,38,15,31,21,0,3ro,1,0,17,0,0,23,7,0,37,0,0,0
53140,33678,2021-06-24T13:18:33.692615Z,2021,58,22,51,30,0,4to,0,0,28,0,0,36,7,0,58,0,0,0
53140,33679,2021-06-24T13:18:33.6936164Z,2021,47,18,41,21,0,5to,1,0,26,0,0,29,6,0,46,0,0,0
53140,33680,2021-06-24T13:18:33.6936164Z,2021,45,11,38,18,0,6to,1,0,27,0,0,34,7,0,44,0,0,0
53140,33681,2021-06-24T13:18:33.6936164Z,2021,51,15,42,26,0,7mo,1,1,25,0,0,36,9,0,50,0,0,0
53140,33682,2021-06-24T13:18:33.6946173Z,2021,70,26,60,36,0,8vo,1,0,34,0,0,44,10,0,69,0,0,0
53140,33683,2021-06-24T13:18:33.6946173Z,2021,35,5,23,19,0,K,1,0,16,0,0,30,12,0,34,0,0,0
53140,33684,2021-06-24T13:18:33.6956174Z,2021,7,7,6,4,0,Sin Grado,0,0,3,0,0,0,1,0,7,0,0,0
53140,3650,2020-11-18T16:21:04.3319209Z,2019,35,13,31,15,0,1ro,0,0,20,0,0,22,4,0,35,0,0,0
53140,3651,2020-11-18T16:21:04.3319209Z,2019,65,24,53,35,0,2do,0,0,30,0,0,41,12,0,65,0,0,0
53140,3652,2020-11-18T16:21:04.3319209Z,2019,59,26,48,27,0,3ro,0,0,32,0,0,33,11,0,59,0,0,0
53140,3653,2020-11-18T16:21:04.3329218Z,2019,47,15,35,22,0,4to,1,0,25,0,0,32,12,0,46,0,0,0
53140,3654,2020-11-18T16:21:04.3329218Z,2019,49,16,39,24,0,5to,0,0,25,0,0,33,10,0,49,0,0,0
53140,3655,2020-11-18T16:21:04.3329218Z,2019,73,28,53,35,0,6to,0,0,38,0,0,45,20,0,73,0,0,0
53140,3656,2020-11-18T16:21:04.3329218Z,2019,41,15,33,22,0,7mo,2,0,19,0,0,26,8,0,39,0,0,0
53140,3657,2020-11-18T16:21:04.333924Z,2019,56,19,41,21,0,8vo,0,0,35,0,0,37,15,0,56,0,0,0
53140,3658,2020-11-18T16:21:04.333924Z,2019,58,8,43,35,0,K,0,0,23,0,0,50,15,0,58,0,0,0
53140,3659,2020-11-18T16:21:04.333924Z,2019,6,6,6,5,0,Sin Grado,0,0,1,0,0,0,0,0,6,0,0,0
53140,9669,2020-11-18T16:21:59.5037109Z,2020,45,11,35,21,0,1ro,0,0,24,0,0,34,10,0,45,0,0,0
53140,9670,2020-11-18T16:21:59.5037109Z,2020,39,14,32,20,0,2do,0,0,19,0,0,25,7,0,39,0,0,0
53140,9671,2020-11-18T16:21:59.5037109Z,2020,58,23,49,30,0,3ro,0,0,28,0,0,35,9,0,58,0,0,0
53140,9672,2020-11-18T16:21:59.5037109Z,2020,50,20,41,22,0,4to,0,0,28,0,0,30,9,0,50,0,0,0
53140,9673,2020-11-18T16:21:59.5037109Z,2020,46,12,34,19,0,5to,1,0,27,0,0,34,12,0,45,0,0,0
53140,9674,2020-11-18T16:21:59.5047122Z,2020,51,16,42,26,0,6to,1,0,25,0,0,35,9,0,50,0,0,0
53140,9675,2020-11-18T16:21:59.5047122Z,2020,75,31,57,36,0,7mo,0,0,39,0,0,44,18,0,75,0,0,0
53140,9676,2020-11-18T16:21:59.5047122Z,2020,40,15,32,23,0,8vo,2,0,17,0,0,25,8,0,38,0,0,0
53140,9677,2020-11-18T16:21:59.5047122Z,2020,38,8,33,15,0,K,0,0,23,0,0,30,5,0,38,0,0,0
53140,9678,2020-11-18T16:21:59.5057127Z,2020,9,9,9,6,0,Sin Grado,0,0,3,0,0,0,0,0,9,0,0,0
31427,1956,2020-11-18T16:20:53.4056348Z,2019,32,7,23,18,0,1ro,0,0,14,0,0,25,9,0,32,1,0,0
31427,1957,2020-11-18T16:20:53.4056348Z,2019,28,5,22,17,0,2do,0,0,11,0,0,23,6,0,28,1,0,0
31427,1958,2020-11-18T16:20:53.4056348Z,2019,33,6,22,15,0,3ro,0,0,18,0,0,27,11,0,33,0,0,0
31427,1959,2020-11-18T16:20:53.4056348Z,2019,51,9,35,23,0,4to,0,0,28,0,0,42,16,0,51,3,0,0
31427,1960,2020-11-18T16:20:53.4066343Z,2019,39,7,24,19,0,5to,0,0,20,0,0,32,15,0,39,1,0,0
31427,1961,2020-11-18T16:20:53.4066343Z,2019,58,7,39,26,0,6to,0,0,32,0,0,51,19,0,58,2,0,0
31427,1962,2020-11-18T16:20:53.4066343Z,2019,53,11,37,30,0,7mo,0,0,23,0,1,42,16,0,53,1,1,0
31427,1963,2020-11-18T16:20:53.4066343Z,2019,49,8,38,27,0,8vo,0,0,22,0,0,41,11,0,49,1,0,0
31427,1964,2020-11-18T16:20:53.4066343Z,2019,30,6,24,11,0,K,0,0,19,0,0,24,6,0,30,1,0,0
31427,1965,2020-11-18T16:20:53.4076357Z,2019,6,6,6,1,0,Sin Grado,0,0,5,0,0,0,0,0,6,0,0,0
31427,31965,2021-06-24T13:18:18.6938542Z,2021,30,6,25,14,0,1ro,0,0,16,0,0,24,5,0,30,0,0,0
31427,31966,2021-06-24T13:18:18.6938542Z,2021,30,9,26,12,0,2do,0,0,18,0,0,21,4,0,30,0,0,0
31427,31967,2021-06-24T13:18:18.6938542Z,2021,30,7,26,19,0,3ro,0,0,11,0,0,23,4,0,30,1,0,0
31427,31968,2021-06-24T13:18:18.6948556Z,2021,34,4,25,18,0,4to,0,0,16,0,0,30,9,0,34,1,0,0
31427,31969,2021-06-24T13:18:18.6948556Z,2021,35,8,28,14,0,5to,0,0,21,0,0,27,7,0,35,0,0,0
31427,31970,2021-06-24T13:18:18.6948556Z,2021,55,9,45,25,0,6to,1,0,30,0,0,46,10,0,54,2,0,0
31427,31971,2021-06-24T13:18:18.6948556Z,2021,43,8,33,23,0,7mo,0,0,20,0,0,35,10,0,43,1,0,0
31427,31972,2021-06-24T13:18:18.6958561Z,2021,62,7,44,28,0,8vo,0,0,34,0,0,55,18,0,62,2,1,0
31427,31973,2021-06-24T13:18:18.6958561Z,2021,22,2,18,11,0,K,1,0,11,0,0,20,4,0,21,0,0,0
31427,31974,2021-06-24T13:18:18.6958561Z,2021,4,4,4,0,0,Sin Grado,0,0,4,0,0,0,0,0,4,0,0,0
31427,7968,2020-11-18T16:21:49.1448036Z,2020,30,8,25,10,0,1ro,0,0,20,0,0,22,5,0,30,1,0,0
31427,7969,2020-11-18T16:21:49.1448036Z,2020,29,6,24,17,0,2do,0,0,12,0,0,23,5,1,28,1,0,0
31427,7970,2020-11-18T16:21:49.1458058Z,2020,31,4,26,17,0,3ro,0,0,14,0,0,27,5,0,31,1,0,0
31427,7971,2020-11-18T16:21:49.1458058Z,2020,35,6,23,17,0,4to,0,0,18,0,0,29,12,0,35,0,0,0
31427,7972,2020-11-18T16:21:49.1458058Z,2020,48,8,38,22,0,5to,0,0,26,0,0,40,10,0,48,3,0,0
31427,7973,2020-11-18T16:21:49.1458058Z,2020,39,7,28,19,0,6to,0,0,20,0,0,32,11,0,39,1,0,0
31427,7974,2020-11-18T16:21:49.1468049Z,2020,60,7,39,26,0,7mo,0,0,34,0,0,53,21,0,60,2,0,0
31427,7975,2020-11-18T16:21:49.1468049Z,2020,49,9,36,28,0,8vo,0,0,21,0,0,40,13,0,49,1,1,0
31427,7976,2020-11-18T16:21:49.1468049Z,2020,20,2,18,11,0,K,0,0,9,0,0,18,2,0,20,0,0,0
31427,7977,2020-11-18T16:21:49.1478058Z,2020,4,4,3,1,0,Sin Grado,0,0,3,0,0,0,1,0,4,0,0,0
12914,30448,2021-06-24T13:18:09.4992608Z,2021,26,2,23,15,0,1ro,0,0,11,0,0,24,3,0,26,0,0,0
12914,30449,2021-06-24T13:18:09.5002617Z,2021,26,6,21,11,0,2do,1,0,15,0,0,20,5,0,25,0,0,0
12914,30450,2021-06-24T13:18:09.5002617Z,2021,35,11,26,19,0,3ro,0,0,16,0,0,24,9,0,35,0,0,0
12914,30451,2021-06-24T13:18:09.5002617Z,2021,43,13,36,19,0,4to,0,0,24,0,0,30,7,0,43,0,0,0
12914,30452,2021-06-24T13:18:09.5002617Z,2021,42,18,35,15,0,5to,1,0,27,0,0,24,7,0,41,0,2,0
12914,30453,2021-06-24T13:18:09.5002617Z,2021,36,14,26,16,0,6to,1,0,20,0,0,22,10,0,35,0,2,0
12914,30454,2021-06-24T13:18:09.5012626Z,2021,39,16,33,19,0,7mo,0,0,20,0,0,23,6,0,39,0,0,0
12914,30455,2021-06-24T13:18:09.5012626Z,2021,44,20,32,22,0,8vo,0,0,22,0,0,24,12,0,44,0,0,0
12914,30456,2021-06-24T13:18:09.5012626Z,2021,40,10,34,17,0,K,0,0,23,0,0,30,6,0,40,0,0,0
12914,30457,2021-06-24T13:18:09.5022654Z,2021,5,5,4,3,0,Sin Grado,0,0,2,0,0,0,1,0,5,0,0,0
12914,450,2020-11-18T16:20:40.0667395Z,2019,31,9,26,16,0,1ro,0,0,15,0,0,22,5,0,31,0,0,0
12914,451,2020-11-18T16:20:40.0667395Z,2019,43,12,35,21,0,2do,0,0,22,0,0,31,8,0,43,0,0,0
12914,452,2020-11-18T16:20:40.0667395Z,2019,41,16,34,20,0,3ro,0,0,21,0,0,25,7,0,41,0,0,0
12914,453,2020-11-18T16:20:40.0667395Z,2019,36,13,31,18,0,4to,0,0,18,0,0,23,5,0,36,0,0,0
12914,454,2020-11-18T16:20:40.0677404Z,2019,34,14,28,14,0,5to,0,0,20,0,0,20,6,0,34,0,0,0
12914,455,2020-11-18T16:20:40.0677404Z,2019,38,17,33,19,0,6to,0,0,19,0,0,21,5,0,38,0,0,0
12914,456,2020-11-18T16:20:40.0677404Z,2019,48,22,40,23,0,7mo,0,0,25,0,0,26,8,0,48,0,0,0
12914,457,2020-11-18T16:20:40.0677404Z,2019,39,16,30,20,0,8vo,0,0,19,0,0,23,9,0,39,0,0,0
12914,458,2020-11-18T16:20:40.0687408Z,2019,26,4,1,11,0,K,0,0,15,0,0,22,25,0,26,0,0,0
12914,459,2020-11-18T16:20:40.0687408Z,2019,3,3,2,0,0,Sin Grado,0,0,3,0,0,0,1,0,3,0,0,0
12914,6451,2020-11-18T16:21:39.6684859Z,2020,27,4,26,12,0,1ro,1,0,15,0,0,23,1,0,26,0,0,0
12914,6452,2020-11-18T16:21:39.6684859Z,2020,33,9,25,17,0,2do,0,0,16,0,0,24,8,0,33,0,0,0
12914,6453,2020-11-18T16:21:39.6684859Z,2020,44,15,34,22,0,3ro,0,0,22,0,0,29,10,0,44,0,0,0
12914,6454,2020-11-18T16:21:39.6694863Z,2020,43,17,33,16,0,4to,0,0,27,0,0,26,10,0,43,0,0,0
12914,6455,2020-11-18T16:21:39.6694863Z,2020,36,13,27,18,0,5to,0,0,18,0,0,23,9,0,36,0,0,0
12914,6456,2020-11-18T16:21:39.6694863Z,2020,41,16,36,15,0,6to,0,0,26,0,0,25,5,0,41,0,0,0
12914,6457,2020-11-18T16:21:39.6694863Z,2020,42,18,34,21,0,7mo,0,0,21,0,0,24,8,0,42,0,0,0
12914,6458,2020-11-18T16:21:39.6694863Z,2020,49,24,41,27,0,8vo,0,0,22,0,0,25,8,0,49,0,0,0
12914,6459,2020-11-18T16:21:39.6704868Z,2020,24,5,22,14,0,K,0,0,10,0,0,19,2,0,24,0,0,0
12914,6460,2020-11-18T16:21:39.6704868Z,2020,6,6,5,3,0,Sin Grado,0,0,3,0,0,0,1,0,6,0,0,0
22459,1313,2020-11-18T16:20:45.8846205Z,2019,28,6,22,12,0,1ro,2,0,16,0,0,22,6,0,26,0,0,0
22459,1314,2020-11-18T16:20:45.8856232Z,2019,26,6,21,13,0,2do,0,0,13,0,0,20,5,0,26,0,0,0
22459,1315,2020-11-18T16:20:45.8856232Z,2019,26,4,24,15,0,3ro,0,0,11,0,0,22,2,0,26,0,1,0
22459,1316,2020-11-18T16:20:45.8856232Z,2019,24,4,18,13,0,4to,0,0,11,0,0,20,6,0,24,0,0,0
22459,1317,2020-11-18T16:20:45.8856232Z,2019,31,8,24,18,0,5to,1,0,13,0,0,23,7,0,30,0,1,0
22459,1318,2020-11-18T16:20:45.8856232Z,2019,33,9,30,19,0,6to,1,0,14,0,0,24,3,0,32,0,1,0
22459,1319,2020-11-18T16:20:45.8866209Z,2019,27,2,18,12,0,7mo,1,0,15,0,0,25,9,0,26,0,2,0
22459,1320,2020-11-18T16:20:45.8866209Z,2019,39,14,29,16,0,8vo,0,0,23,0,0,25,10,0,39,0,1,0
22459,1321,2020-11-18T16:20:45.8866209Z,2019,23,2,19,17,0,K,0,0,6,0,0,21,4,0,23,0,0,0
22459,1322,2020-11-18T16:20:45.8866209Z,2019,13,12,11,7,0,Sin Grado,0,2,6,0,0,1,2,0,13,0,0,0
22459,31314,2021-06-24T13:18:14.5508844Z,2021,34,8,26,15,0,1ro,0,0,19,0,0,26,8,0,34,0,0,0
22459,31315,2021-06-24T13:18:14.5508844Z,2021,26,5,21,15,0,2do,0,0,11,0,0,21,5,0,26,1,0,0
22459,31316,2021-06-24T13:18:14.5518853Z,2021,26,6,19,12,0,3ro,1,0,14,0,0,20,7,0,25,0,1,0
22459,31317,2021-06-24T13:18:14.5518853Z,2021,27,8,16,13,0,4to,0,0,14,0,0,19,11,0,27,1,1,0
22459,31318,2021-06-24T13:18:14.5518853Z,2021,28,5,21,16,0,5to,0,0,12,0,0,23,7,0,28,0,1,0
22459,31319,2021-06-24T13:18:14.5528858Z,2021,26,4,20,15,0,6to,0,0,11,0,0,22,6,0,26,0,0,0
22459,31320,2021-06-24T13:18:14.5528858Z,2021,34,9,24,23,0,7mo,1,0,11,0,0,25,10,0,33,0,1,0
22459,31321,2021-06-24T13:18:14.5528858Z,2021,33,9,29,20,0,8vo,0,0,13,0,0,24,4,0,33,0,1,0
22459,31322,2021-06-24T13:18:14.5528858Z,2021,26,5,16,12,0,K,0,0,14,0,0,21,10,0,26,0,0,0
22459,31323,2021-06-24T13:18:14.5538863Z,2021,25,25,15,7,0,Sin Grado,0,1,18,0,0,0,10,0,25,0,0,0
22459,7318,2020-11-18T16:21:45.3282599Z,2020,26,3,21,22,0,1ro,0,0,4,0,0,23,5,0,26,0,0,0
22459,7319,2020-11-18T16:21:45.3282599Z,2020,27,8,18,12,0,2do,2,0,15,0,0,19,9,0,25,0,0,0
22459,7320,2020-11-18T16:21:45.3282599Z,2020,25,7,20,11,0,3ro,0,0,14,0,0,18,5,0,25,0,0,0
22459,7321,2020-11-18T16:21:45.3282599Z,2020,26,5,23,14,0,4to,0,0,12,0,0,21,3,0,26,0,1,0
22459,7322,2020-11-18T16:21:45.3292599Z,2020,24,4,16,13,0,5to,0,0,11,0,0,20,8,0,24,0,0,0
22459,7323,2020-11-18T16:21:45.3292599Z,2020,31,10,26,19,0,6to,1,0,12,0,0,21,5,0,30,0,1,0
22459,7324,2020-11-18T16:21:45.3292599Z,2020,32,8,29,18,0,7mo,1,0,14,0,0,24,3,0,31,0,1,0
22459,7325,2020-11-18T16:21:45.3302613Z,2020,25,4,17,14,0,8vo,2,1,11,0,0,21,8,0,23,0,2,0
22459,7326,2020-11-18T16:21:45.3302613Z,2020,27,2,22,12,0,K,0,0,15,0,0,25,5,0,27,0,0,0
22459,7327,2020-11-18T16:21:45.3302613Z,2020,31,31,27,9,0,Sin Grado,0,1,22,0,0,0,4,0,30,0,0,1
53686,33736,2021-06-24T13:18:35.2597387Z,2021,9,0,9,5,0,1ro,0,1,4,0,0,9,0,0,9,0,0,0
53686,33737,2021-06-24T13:18:35.2597387Z,2021,13,6,12,6,0,2do,0,5,7,0,0,7,1,0,13,0,0,0
53686,33738,2021-06-24T13:18:35.2597387Z,2021,8,3,7,3,0,3ro,0,1,5,0,0,5,1,0,8,0,0,0
53686,33739,2021-06-24T13:18:35.2607401Z,2021,12,4,11,2,0,4to,0,0,10,0,0,8,1,0,12,0,0,0
53686,33740,2021-06-24T13:18:35.2607401Z,2021,10,2,9,4,0,5to,0,1,6,0,0,8,1,0,10,0,0,0
53686,33741,2021-06-24T13:18:35.2607401Z,2021,22,6,21,12,0,6to,0,1,10,0,0,16,1,0,22,0,0,0
53686,33742,2021-06-24T13:18:35.2617402Z,2021,13,4,11,5,0,7mo,0,2,8,0,0,9,2,0,13,0,0,0
53686,33743,2021-06-24T13:18:35.2617402Z,2021,27,10,25,9,0,8vo,0,2,18,0,0,17,2,0,27,0,0,0
53686,33744,2021-06-24T13:18:35.2617402Z,2021,9,1,8,4,0,K,0,0,5,0,0,8,1,0,9,0,0,0
53686,3712,2020-11-18T16:21:05.1084373Z,2019,8,2,6,3,0,1ro,0,0,5,0,0,6,2,0,8,0,0,0
53686,3713,2020-11-18T16:21:05.1084373Z,2019,15,8,13,3,0,2do,0,0,12,0,0,7,2,0,15,0,0,0
53686,3714,2020-11-18T16:21:05.1094373Z,2019,12,4,12,7,0,3ro,0,0,5,0,0,8,0,0,12,0,0,0
53686,3715,2020-11-18T16:21:05.1094373Z,2019,18,4,15,11,0,4to,0,0,7,0,0,14,3,0,18,0,0,0
53686,3716,2020-11-18T16:21:05.1094373Z,2019,10,3,9,4,0,5to,0,0,6,0,0,7,1,0,10,0,0,0
53686,3717,2020-11-18T16:21:05.1094373Z,2019,27,12,26,9,0,6to,0,0,18,0,0,15,1,0,27,0,0,0
53686,3718,2020-11-18T16:21:05.1094373Z,2019,22,3,19,13,0,7mo,0,0,9,0,0,19,3,0,22,0,0,0
53686,3719,2020-11-18T16:21:05.1104386Z,2019,19,4,16,11,0,8vo,1,0,8,0,0,15,3,0,18,0,0,0
53686,3720,2020-11-18T16:21:05.1104386Z,2019,12,6,12,8,0,K,0,0,4,0,0,6,0,0,12,0,0,0
53686,9730,2020-11-18T16:22:00.1151195Z,2020,12,5,12,4,0,1ro,0,0,8,0,0,7,0,0,12,0,0,0
53686,9731,2020-11-18T16:22:00.1151195Z,2020,7,2,6,2,0,2do,0,0,5,0,0,5,1,0,7,0,0,0
53686,9732,2020-11-18T16:22:00.1161195Z,2020,12,5,9,2,0,3ro,0,0,10,0,0,7,3,0,12,0,0,0
53686,9733,2020-11-18T16:22:00.1161195Z,2020,9,2,9,4,0,4to,0,0,5,0,0,7,0,0,9,0,0,0
53686,9734,2020-11-18T16:22:00.1161195Z,2020,19,5,16,11,0,5to,0,0,8,0,0,14,3,0,19,0,0,0
53686,9735,2020-11-18T16:22:00.1171209Z,2020,13,4,12,5,0,6to,0,0,8,0,0,9,1,0,13,0,0,0
53686,9736,2020-11-18T16:22:00.1171209Z,2020,27,11,25,8,0,7mo,0,0,19,0,0,16,2,0,27,0,0,0
53686,9737,2020-11-18T16:22:00.1181209Z,2020,21,3,18,11,0,8vo,0,0,10,0,0,18,3,0,21,0,0,0
53686,9738,2020-11-18T16:22:00.1181209Z,2020,7,1,6,4,0,K,0,0,3,0,0,6,1,0,7,0,0,0
32748,2111,2020-11-18T16:20:54.566407Z,2019,20,2,16,7,0,1ro,0,0,13,0,0,18,4,0,20,0,0,0
32748,2112,2020-11-18T16:20:54.566407Z,2019,17,6,13,7,0,2do,0,0,10,0,0,11,4,0,17,0,0,0
32748,2113,2020-11-18T16:20:54.566407Z,2019,27,6,23,14,0,3ro,0,0,13,0,0,21,4,0,27,0,0,0
32748,2114,2020-11-18T16:20:54.5674079Z,2019,24,7,14,9,0,4to,0,0,15,0,0,17,10,0,24,0,0,0
32748,2115,2020-11-18T16:20:54.5674079Z,2019,38,4,28,19,0,5to,0,0,19,0,0,34,10,0,38,0,0,0
32748,2116,2020-11-18T16:20:54.5674079Z,2019,46,7,32,20,0,6to,0,0,26,0,0,39,14,0,46,0,0,0
32748,2117,2020-11-18T16:20:54.5674079Z,2019,44,8,32,17,0,7mo,1,0,27,0,0,36,12,0,43,0,1,0
32748,2118,2020-11-18T16:20:54.5674079Z,2019,45,3,34,23,0,8vo,0,0,22,0,0,42,11,0,45,1,0,0
32748,2119,2020-11-18T16:20:54.5674079Z,2019,23,3,17,12,0,K,0,0,11,0,0,20,6,0,23,0,0,0
32748,2120,2020-11-18T16:20:54.5684084Z,2019,16,0,14,11,0,PK,0,0,5,0,0,16,2,0,16,0,0,0
32748,32117,2021-06-24T13:18:20.8944329Z,2021,18,0,17,12,0,1ro,0,0,6,0,0,18,1,0,18,0,0,0
32748,32118,2021-06-24T13:18:20.8944329Z,2021,17,4,13,4,0,2do,0,0,13,0,0,13,4,0,17,0,0,0
32748,32119,2021-06-24T13:18:20.8944329Z,2021,17,2,14,7,0,3ro,0,0,10,0,0,15,3,0,17,0,0,0
32748,32120,2021-06-24T13:18:20.8944329Z,2021,16,7,12,5,0,4to,0,0,11,0,0,9,4,0,16,0,0,0
32748,32121,2021-06-24T13:18:20.8944329Z,2021,29,7,27,16,0,5to,0,0,13,0,0,22,2,0,28,0,0,1
32748,32122,2021-06-24T13:18:20.8954325Z,2021,26,8,20,12,0,6to,0,0,14,0,0,18,6,0,26,0,0,0
32748,32123,2021-06-24T13:18:20.8954325Z,2021,41,5,31,22,0,7mo,0,0,19,0,0,36,10,0,41,0,0,0
32748,32124,2021-06-24T13:18:20.8954325Z,2021,45,3,33,20,0,8vo,0,0,25,0,0,42,12,0,45,0,0,0
32748,32125,2021-06-24T13:18:20.8954325Z,2021,16,4,15,9,0,K,0,0,7,0,0,12,1,0,16,0,0,0
32748,32126,2021-06-24T13:18:20.8964334Z,2021,9,0,7,7,0,PK,0,0,2,0,0,9,2,0,9,0,0,0
32748,8123,2020-11-18T16:21:50.2225229Z,2020,17,4,13,4,0,1ro,0,0,13,0,0,13,4,0,17,0,0,0
32748,8124,2020-11-18T16:21:50.2225229Z,2020,19,2,15,7,0,2do,0,0,12,0,0,17,4,0,19,0,0,0
32748,8125,2020-11-18T16:21:50.2225229Z,2020,18,7,14,7,0,3ro,0,0,11,0,0,11,4,0,18,0,0,0
32748,8126,2020-11-18T16:21:50.2225229Z,2020,31,8,29,16,0,4to,0,0,15,0,0,23,2,0,31,0,0,0
32748,8127,2020-11-18T16:21:50.2235242Z,2020,23,7,12,9,0,5to,0,0,14,0,0,16,11,0,23,0,0,0
32748,8128,2020-11-18T16:21:50.2235242Z,2020,39,6,30,19,0,6to,0,0,20,0,0,33,9,0,39,0,0,0
32748,8129,2020-11-18T16:21:50.2235242Z,2020,43,6,30,19,0,7mo,0,0,24,0,0,37,13,0,43,0,0,0
32748,8130,2020-11-18T16:21:50.2235242Z,2020,37,7,26,14,0,8vo,1,0,23,0,0,30,11,0,36,0,1,0
32748,8131,2020-11-18T16:21:50.2235242Z,2020,16,0,13,9,0,K,0,0,7,0,0,16,3,0,16,0,0,0
32748,8132,2020-11-18T16:21:50.2245242Z,2020,14,1,13,8,0,PK,0,0,6,0,0,13,1,0,14,0,0,0
25239,1505,2020-11-18T16:20:47.6377921Z,2019,20,6,17,10,0,1ro,1,0,10,0,0,14,3,0,19,0,0,0
25239,1506,2020-11-18T16:20:47.6377921Z,2019,23,8,21,4,0,2do,1,0,19,0,0,15,2,0,22,0,0,0
25239,1507,2020-11-18T16:20:47.6377921Z,2019,26,11,24,14,0,3ro,1,0,12,0,0,15,2,0,25,0,0,0
25239,1508,2020-11-18T16:20:47.6387925Z,2019,33,5,28,21,0,4to,0,1,12,0,0,28,5,0,33,0,0,0
25239,1509,2020-11-18T16:20:47.6387925Z,2019,42,9,39,18,0,5to,0,0,24,0,0,33,3,0,42,0,0,0
25239,1510,2020-11-18T16:20:47.6387925Z,2019,37,13,31,18,0,6to,2,0,19,0,0,24,6,0,35,0,0,0
25239,1511,2020-11-18T16:20:47.6397925Z,2019,33,12,27,22,0,7mo,0,2,11,0,0,21,6,0,33,0,0,0
25239,1512,2020-11-18T16:20:47.6397925Z,2019,24,8,22,9,0,8vo,1,1,15,0,0,16,2,0,23,0,0,0
25239,1513,2020-11-18T16:20:47.6397925Z,2019,26,7,22,10,0,K,1,0,16,0,0,19,4,0,25,0,0,0
25239,1514,2020-11-18T16:20:47.6397925Z,2019,14,12,12,5,0,Sin Grado,2,0,9,0,0,2,2,0,12,0,0,0
25239,31506,2021-06-24T13:18:15.8077843Z,2021,22,1,20,11,0,1ro,1,0,11,0,0,21,2,0,21,0,0,0
25239,31507,2021-06-24T13:18:15.8077843Z,2021,27,7,26,13,0,2do,1,0,14,0,0,20,1,0,26,0,0,0
25239,31508,2021-06-24T13:18:15.8087853Z,2021,30,10,28,14,0,3ro,3,0,16,0,0,20,2,0,27,0,0,0
25239,31509,2021-06-24T13:18:15.8087853Z,2021,28,7,23,10,0,4to,0,0,18,0,0,21,5,0,28,0,0,0
25239,31510,2021-06-24T13:18:15.8087853Z,2021,27,10,23,15,0,5to,1,0,12,0,0,17,4,0,26,0,0,0
25239,31511,2021-06-24T13:18:15.8097858Z,2021,36,9,26,22,0,6to,1,0,14,0,0,27,10,0,35,0,0,0
25239,31512,2021-06-24T13:18:15.8097858Z,2021,46,10,43,22,0,7mo,0,0,24,0,0,36,3,0,46,0,0,0
25239,31513,2021-06-24T13:18:15.8097858Z,2021,30,10,25,15,0,8vo,1,0,15,0,0,20,5,0,29,0,0,0
25239,31514,2021-06-24T13:18:15.8107867Z,2021,18,4,12,9,0,K,1,0,9,0,0,14,6,0,17,0,0,0
25239,31515,2021-06-24T13:18:15.8107867Z,2021,10,10,9,2,0,Sin Grado,0,0,8,0,0,0,1,0,10,0,0,0
25239,7509,2020-11-18T16:21:46.3669498Z,2020,27,6,25,13,0,1ro,1,0,14,0,0,21,2,0,26,0,0,0
25239,7510,2020-11-18T16:21:46.3669498Z,2020,28,9,26,14,0,2do,3,0,14,0,0,19,2,0,25,0,0,0
25239,7511,2020-11-18T16:21:46.3669498Z,2020,26,7,21,8,0,3ro,0,0,18,0,0,19,5,0,26,0,0,0
25239,7512,2020-11-18T16:21:46.3669498Z,2020,27,12,23,14,0,4to,1,0,13,0,0,15,4,0,26,0,0,0
25239,7513,2020-11-18T16:21:46.3669498Z,2020,36,7,27,22,0,5to,1,0,14,0,0,29,9,0,35,0,0,0
25239,7514,2020-11-18T16:21:46.3679503Z,2020,45,9,43,22,0,6to,1,1,23,0,0,36,2,0,44,0,1,0
25239,7515,2020-11-18T16:21:46.3679503Z,2020,32,11,23,15,0,7mo,2,0,17,0,0,21,9,0,30,0,0,0
25239,7516,2020-11-18T16:21:46.3679503Z,2020,38,13,33,24,0,8vo,0,0,14,0,0,25,5,0,38,0,0,0
25239,7517,2020-11-18T16:21:46.3679503Z,2020,21,0,17,10,0,K,1,0,11,0,0,21,4,0,20,0,0,0
25239,7518,2020-11-18T16:21:46.3679503Z,2020,12,11,10,2,0,Sin Grado,1,0,10,0,0,1,2,0,11,0,0,0
10892,101,2020-11-18T16:20:37.5510598Z,2019,39,10,33,27,0,1ro,0,0,12,0,0,29,6,0,39,0,0,0
10892,102,2020-11-18T16:20:37.5520612Z,2019,32,10,27,14,0,2do,0,0,18,0,0,22,5,0,32,0,0,0
10892,103,2020-11-18T16:20:37.5520612Z,2019,29,12,25,16,0,3ro,0,0,13,0,0,17,4,0,29,0,0,0
10892,104,2020-11-18T16:20:37.5520612Z,2019,42,14,37,22,0,4to,0,0,20,0,0,28,5,0,42,0,1,0
10892,105,2020-11-18T16:20:37.5530621Z,2019,18,3,15,7,0,5to,0,0,11,0,0,15,3,0,18,1,0,0
10892,106,2020-11-18T16:20:37.5530621Z,2019,39,14,37,20,0,6to,0,0,19,0,0,25,2,0,39,0,0,0
10892,107,2020-11-18T16:20:37.5530621Z,2019,32,13,27,15,0,7mo,1,0,17,0,0,19,5,0,31,0,0,0
10892,108,2020-11-18T16:20:37.5540625Z,2019,25,8,23,9,0,8vo,2,0,16,0,0,17,2,0,23,0,0,0
10892,109,2020-11-18T16:20:37.5540625Z,2019,25,4,23,10,0,K,0,0,15,0,0,21,2,0,25,0,0,0
10892,110,2020-11-18T16:20:37.5540625Z,2019,8,8,5,2,0,Sin Grado,0,0,6,0,0,0,3,0,8,0,0,0
10892,30101,2021-06-24T13:18:06.2899593Z,2021,13,1,11,7,0,1ro,0,0,6,0,0,12,2,0,13,0,0,0
10892,30102,2021-06-24T13:18:06.2909607Z,2021,29,4,23,14,0,2do,0,0,15,0,0,25,6,0,29,0,0,0
10892,30103,2021-06-24T13:18:06.2909607Z,2021,43,16,38,23,0,3ro,2,1,20,0,0,27,5,0,41,0,0,0
10892,30104,2021-06-24T13:18:06.2909607Z,2021,32,12,28,12,0,4to,0,1,20,0,0,20,4,0,32,0,0,0
10892,30105,2021-06-24T13:18:06.2909607Z,2021,26,9,25,11,0,5to,1,0,15,0,0,17,1,0,25,0,0,0
10892,30106,2021-06-24T13:18:06.2919616Z,2021,41,13,39,19,0,6to,0,1,22,0,0,28,2,0,41,0,1,0
10892,30107,2021-06-24T13:18:06.2919616Z,2021,20,4,19,8,0,7mo,0,1,12,0,0,16,1,0,20,0,0,0
10892,30108,2021-06-24T13:18:06.2919616Z,2021,37,12,33,21,0,8vo,0,0,16,0,0,25,4,0,37,0,0,0
10892,30109,2021-06-24T13:18:06.2919616Z,2021,29,8,22,11,0,K,0,0,18,0,0,21,7,1,28,0,0,0
10892,30110,2021-06-24T13:18:06.2929617Z,2021,8,8,7,3,0,Sin Grado,0,0,5,0,0,0,1,0,8,0,0,0
10892,6102,2020-11-18T16:21:38.2365291Z,2020,24,3,21,11,0,1ro,0,0,13,0,0,21,3,0,24,0,0,0
10892,6103,2020-11-18T16:21:38.2375291Z,2020,38,10,36,27,0,2do,0,0,11,0,0,28,2,0,38,0,0,0
10892,6104,2020-11-18T16:21:38.2375291Z,2020,32,11,24,13,0,3ro,0,0,19,0,0,21,8,0,32,0,0,0
10892,6105,2020-11-18T16:21:38.2375291Z,2020,26,10,24,14,0,4to,0,0,12,0,0,16,2,0,26,0,0,0
10892,6106,2020-11-18T16:21:38.2375291Z,2020,36,12,33,18,0,5to,0,0,18,0,0,24,3,0,36,0,1,0
10892,6107,2020-11-18T16:21:38.2375291Z,2020,19,4,17,6,0,6to,0,0,13,0,0,15,2,0,19,0,0,0
10892,6108,2020-11-18T16:21:38.2385304Z,2020,37,13,30,21,0,7mo,0,0,16,0,0,24,7,0,37,0,0,0
10892,6109,2020-11-18T16:21:38.2385304Z,2020,33,14,29,15,0,8vo,1,0,18,0,0,19,4,0,32,0,0,0
10892,6110,2020-11-18T16:21:38.2385304Z,2020,13,1,12,8,0,K,0,0,5,0,0,12,1,0,13,0,0,0
10892,6111,2020-11-18T16:21:38.2385304Z,2020,7,7,4,2,0,Sin Grado,0,0,5,0,0,0,3,0,7,0,0,0
51938,33497,2021-06-24T13:18:32.4907539Z,2021,13,3,10,6,0,1ro,0,0,7,0,0,10,3,0,13,0,0,0
51938,33498,2021-06-24T13:18:32.4917539Z,2021,21,3,19,11,0,2do,1,1,10,0,0,18,2,0,20,0,0,0
51938,33499,2021-06-24T13:18:32.4917539Z,2021,18,4,16,11,0,3ro,0,0,7,0,0,14,2,0,18,0,0,0
51938,33500,2021-06-24T13:18:33.3633792Z,2021,19,9,16,12,0,4to,0,1,7,0,0,10,3,0,19,0,0,0
51938,33501,2021-06-24T13:18:33.3643801Z,2021,28,12,22,12,0,5to,0,1,16,0,0,16,6,0,27,0,0,1
51938,33502,2021-06-24T13:18:33.3643801Z,2021,15,5,10,7,0,6to,0,0,8,0,0,10,5,0,15,0,0,0
51938,33503,2021-06-24T13:18:33.3643801Z,2021,20,5,11,9,0,7mo,0,0,11,0,0,15,9,0,20,0,0,0
51938,33504,2021-06-24T13:18:33.3653806Z,2021,19,5,17,7,0,8vo,0,0,12,0,0,14,2,0,19,0,0,0
51938,33505,2021-06-24T13:18:33.3653806Z,2021,12,2,7,5,0,K,0,0,7,0,0,10,5,0,12,0,0,0
51938,33506,2021-06-24T13:18:33.3653806Z,2021,5,5,1,3,0,Sin Grado,0,0,2,0,0,0,4,0,5,0,0,0
51938,3471,2020-11-18T16:21:02.5667457Z,2019,20,4,16,13,0,1ro,0,0,7,0,0,16,4,0,20,0,0,0
51938,3472,2020-11-18T16:21:02.5677461Z,2019,20,8,17,11,0,2do,0,1,9,0,0,12,3,0,20,0,0,0
51938,3473,2020-11-18T16:21:02.5677461Z,2019,28,11,22,13,0,3ro,0,1,15,0,0,17,6,0,27,0,0,1
51938,3474,2020-11-18T16:21:02.5677461Z,2019,20,6,16,8,0,4to,1,0,12,0,0,14,4,0,19,0,0,0
51938,3475,2020-11-18T16:21:02.5677461Z,2019,17,6,10,8,0,5to,0,0,9,0,0,11,7,0,17,0,0,0
51938,3476,2020-11-18T16:21:02.5687461Z,2019,23,7,19,9,0,6to,0,0,14,0,0,16,4,0,23,0,0,0
51938,3477,2020-11-18T16:21:02.5687461Z,2019,23,6,16,15,0,7mo,0,0,8,0,0,17,7,0,23,0,0,0
51938,3478,2020-11-18T16:21:02.5687461Z,2019,28,8,21,10,0,8vo,1,1,18,0,0,20,7,0,27,0,0,0
51938,3479,2020-11-18T16:21:02.5697511Z,2019,16,2,12,10,0,K,0,0,6,0,0,14,4,0,16,0,0,0
51938,3480,2020-11-18T16:21:02.5697511Z,2019,7,6,3,4,0,Sin Grado,0,0,3,0,0,1,4,0,7,0,0,0
51938,9492,2020-11-18T16:21:58.4560104Z,2020,25,2,20,14,0,1ro,0,2,11,0,0,23,5,0,25,0,0,0
51938,9493,2020-11-18T16:21:58.4560104Z,2020,23,5,19,14,0,2do,0,0,9,0,0,18,4,0,23,0,0,0
51938,9494,2020-11-18T16:21:58.4560104Z,2020,23,10,20,13,0,3ro,0,2,10,0,0,13,3,0,23,0,0,0
51938,9495,2020-11-18T16:21:58.4560104Z,2020,30,13,24,12,0,4to,0,5,18,0,0,17,6,0,29,0,0,1
51938,9496,2020-11-18T16:21:58.4560104Z,2020,19,7,15,8,0,5to,1,0,11,0,0,12,4,0,18,0,0,0
51938,9497,2020-11-18T16:21:58.4570113Z,2020,18,5,9,8,0,6to,0,0,10,0,0,13,9,0,18,0,0,0
51938,9498,2020-11-18T16:21:58.4570113Z,2020,28,8,24,12,0,7mo,1,2,16,0,0,20,4,0,27,0,0,0
51938,9499,2020-11-18T16:21:58.4570113Z,2020,29,6,22,19,0,8vo,0,6,10,0,0,23,7,0,29,0,0,0
51938,9500,2020-11-18T16:21:58.4570113Z,2020,11,0,9,5,0,K,0,0,6,0,0,11,2,0,11,0,0,0
51938,9501,2020-11-18T16:21:59.0604146Z,2020,6,6,3,4,0,Sin Grado,0,0,2,0,0,0,3,0,6,0,0,0
15453,30629,2021-06-24T13:18:10.6500864Z,2021,25,5,19,14,0,1ro,0,0,11,0,0,20,6,0,25,0,0,0
15453,30630,2021-06-24T13:18:10.6500864Z,2021,27,7,24,16,0,2do,1,0,11,0,0,20,3,0,26,0,0,0
15453,30631,2021-06-24T13:18:10.6510869Z,2021,38,12,28,15,0,3ro,0,0,23,0,0,26,10,0,38,0,0,0
15453,30632,2021-06-24T13:18:10.6510869Z,2021,42,13,36,20,0,4to,0,0,22,0,0,29,6,0,42,0,0,0
15453,30633,2021-06-24T13:18:10.6510869Z,2021,29,9,22,20,0,5to,0,1,9,0,0,20,7,0,29,0,0,0
15453,30634,2021-06-24T13:18:10.6520883Z,2021,45,14,35,26,0,6to,2,0,19,0,0,31,10,0,43,0,0,0
15453,30635,2021-06-24T13:18:10.6520883Z,2021,56,23,48,28,0,7mo,4,1,28,0,0,33,8,0,52,0,1,0
15453,30636,2021-06-24T13:18:10.6520883Z,2021,55,20,40,26,0,8vo,6,0,29,0,0,35,15,0,49,0,0,0
15453,30637,2021-06-24T13:18:10.6530888Z,2021,23,6,17,12,0,K,1,0,11,0,0,17,6,0,22,0,0,0
15453,30638,2021-06-24T13:18:10.6530888Z,2021,16,2,12,8,0,PK,0,0,8,0,0,14,4,0,16,0,0,0
15453,30639,2021-06-24T13:18:10.6530888Z,2021,5,5,4,1,0,Sin Grado,1,0,4,0,0,0,1,0,4,0,0,0
15453,631,2020-11-18T16:20:41.1834877Z,2019,42,14,38,19,0,1ro,0,0,23,0,0,28,4,0,42,0,0,0
15453,632,2020-11-18T16:20:41.1834877Z,2019,44,14,41,18,0,2do,1,0,26,0,0,30,3,0,43,0,0,0
15453,633,2020-11-18T16:20:41.1844868Z,2019,25,7,21,18,0,3ro,0,0,7,0,0,18,4,0,25,0,0,0
15453,634,2020-11-18T16:20:41.1844868Z,2019,37,13,29,22,0,4to,2,0,15,0,0,24,8,0,35,0,0,0
15453,635,2020-11-18T16:20:41.1844868Z,2019,36,14,32,15,0,5to,3,0,21,0,0,22,4,0,33,0,1,0
15453,636,2020-11-18T16:20:41.1844868Z,2019,56,22,41,28,0,6to,4,0,28,0,0,34,15,0,52,0,0,0
15453,637,2020-11-18T16:20:41.1854877Z,2019,52,19,37,21,0,7mo,2,0,31,0,0,33,15,0,50,0,0,0
15453,638,2020-11-18T16:20:41.1854877Z,2019,23,7,17,8,0,8vo,1,0,15,0,0,16,6,0,22,1,0,0
15453,639,2020-11-18T16:20:41.1854877Z,2019,24,3,22,12,0,K,1,0,12,0,0,21,2,0,23,0,0,0
15453,640,2020-11-18T16:20:41.1864899Z,2019,17,5,15,10,0,PK,0,0,7,0,0,12,2,0,17,0,0,0
15453,641,2020-11-18T16:20:41.1864899Z,2019,6,6,6,0,0,Sin Grado,2,0,6,0,0,0,0,0,4,0,0,0
15453,6631,2020-11-18T16:21:40.7542108Z,2020,27,7,25,15,0,1ro,1,0,12,0,0,20,2,0,26,0,0,0
15453,6632,2020-11-18T16:21:40.7542108Z,2020,41,12,34,17,0,2do,0,0,24,0,0,29,7,0,41,0,0,0
15453,6633,2020-11-18T16:21:40.7552117Z,2020,38,13,33,18,0,3ro,1,0,20,0,0,25,5,0,37,0,0,0
15453,6634,2020-11-18T16:21:40.7552117Z,2020,26,8,22,18,0,4to,0,0,8,0,0,18,4,0,26,0,0,0
15453,6635,2020-11-18T16:21:40.7552117Z,2020,43,15,31,26,0,5to,2,0,17,0,0,28,12,0,41,0,0,0
15453,6636,2020-11-18T16:21:40.756213Z,2020,53,23,47,26,0,6to,3,1,27,0,0,30,6,0,50,0,1,0
15453,6637,2020-11-18T16:21:40.756213Z,2020,54,20,42,27,0,7mo,5,0,27,0,0,34,12,0,49,0,0,0
15453,6638,2020-11-18T16:21:40.756213Z,2020,59,21,42,25,0,8vo,4,0,34,0,0,38,17,0,55,0,0,0
15453,6639,2020-11-18T16:21:40.756213Z,2020,25,4,20,12,0,K,0,0,13,0,0,21,5,0,25,0,0,0
15453,6640,2020-11-18T16:21:40.7572134Z,2020,16,4,13,6,0,PK,1,0,10,0,0,12,3,0,15,0,0,0
15453,6641,2020-11-18T16:21:40.7572134Z,2020,7,7,6,0,0,Sin Grado,3,0,7,0,0,0,1,0,4,0,0,0
20321,30927,2021-06-24T13:18:11.8069159Z,2021,19,7,18,10,0,1ro,0,2,9,0,0,12,1,0,19,0,0,0
20321,30928,2021-06-24T13:18:11.8069159Z,2021,20,5,18,13,0,2do,2,0,7,0,0,15,2,0,18,0,0,0
20321,30929,2021-06-24T13:18:11.8079173Z,2021,15,8,11,7,0,3ro,0,0,8,0,0,7,4,0,15,0,0,0
20321,30930,2021-06-24T13:18:11.8079173Z,2021,37,11,32,12,0,4to,1,1,25,0,0,26,5,0,36,1,0,0
20321,30931,2021-06-24T13:18:11.8079173Z,2021,26,6,21,14,0,5to,1,1,12,0,0,20,5,0,25,0,0,0
20321,30932,2021-06-24T13:18:11.8089174Z,2021,49,14,37,28,0,6to,1,0,21,0,0,35,12,0,48,0,0,0
20321,30933,2021-06-24T13:18:11.8089174Z,2021,36,12,31,18,0,7mo,0,3,18,0,0,24,5,0,36,1,0,0
20321,30934,2021-06-24T13:18:11.8089174Z,2021,45,12,32,22,0,8vo,0,1,23,0,0,33,13,0,45,1,0,0
20321,30935,2021-06-24T13:18:11.8089174Z,2021,30,11,23,13,0,K,1,1,17,0,0,19,7,0,29,0,0,0
20321,30936,2021-06-24T13:18:11.8099183Z,2021,23,23,19,4,0,Sin Grado,0,0,19,0,0,0,4,0,23,0,0,0
20321,6931,2020-11-18T16:21:42.5844275Z,2020,20,5,16,13,0,1ro,2,0,7,0,0,15,4,0,18,0,0,0
20321,6932,2020-11-18T16:21:42.5844275Z,2020,20,8,14,8,0,2do,0,0,12,0,0,12,6,0,20,0,0,0
20321,6933,2020-11-18T16:21:42.5844275Z,2020,39,12,30,13,0,3ro,1,1,26,0,0,27,9,0,38,1,0,0
20321,6934,2020-11-18T16:21:42.5844275Z,2020,26,5,22,14,0,4to,1,0,12,0,0,21,4,0,25,0,0,0
20321,6935,2020-11-18T16:21:42.5854275Z,2020,43,12,27,25,0,5to,1,0,18,0,0,31,16,0,42,0,0,0
20321,6936,2020-11-18T16:21:42.5854275Z,2020,41,12,28,21,0,6to,0,1,20,0,0,29,13,0,41,1,0,0
20321,6937,2020-11-18T16:21:42.5854275Z,2020,44,15,30,22,0,7mo,0,1,22,0,0,29,14,0,44,1,0,0
20321,6938,2020-11-18T16:21:42.5854275Z,2020,46,13,26,20,0,8vo,0,0,26,0,0,33,20,0,46,0,0,0
20321,6939,2020-11-18T16:21:42.5854275Z,2020,37,9,26,19,0,K,0,2,18,0,0,28,11,0,37,0,0,0
20321,6940,2020-11-18T16:21:42.5864284Z,2020,20,20,14,4,0,Sin Grado,0,0,16,0,0,0,6,0,20,0,0,0
20321,931,2020-11-18T16:20:43.3759445Z,2019,23,9,18,9,0,1ro,0,0,14,0,0,14,5,0,23,0,0,0
20321,932,2020-11-18T16:20:43.3759445Z,2019,41,14,31,15,0,2do,0,1,26,0,0,27,10,0,41,1,0,0
20321,933,2020-11-18T16:20:43.3759445Z,2019,33,10,25,20,0,3ro,0,1,13,0,0,23,8,0,33,0,0,0
20321,934,2020-11-18T16:20:43.3769458Z,2019,43,11,30,26,0,4to,1,0,17,0,0,32,13,0,42,0,0,0
20321,935,2020-11-18T16:20:43.3769458Z,2019,39,11,29,22,0,5to,0,0,17,0,0,28,10,0,39,1,0,0
20321,936,2020-11-18T16:20:43.3769458Z,2019,46,16,36,20,0,6to,0,0,26,0,0,30,10,0,46,1,0,0
20321,937,2020-11-18T16:20:43.3769458Z,2019,54,16,37,23,0,7mo,0,0,31,0,0,38,17,0,54,0,0,0
20321,938,2020-11-18T16:20:43.3779458Z,2019,77,18,47,43,0,8vo,0,0,34,0,0,59,30,0,77,0,0,0
20321,939,2020-11-18T16:20:43.3779458Z,2019,27,5,16,16,0,K,1,0,11,0,0,22,11,0,26,0,0,0
20321,940,2020-11-18T16:20:43.3779458Z,2019,24,21,19,1,0,Sin Grado,0,1,23,0,0,3,5,0,24,0,0,0
12401,30353,2021-06-24T13:18:08.84279Z,2021,30,12,29,13,0,1ro,0,0,17,0,0,18,1,0,30,0,0,0
12401,30354,2021-06-24T13:18:08.84279Z,2021,27,8,22,17,0,2do,0,0,10,0,0,19,5,0,27,0,0,0
12401,30355,2021-06-24T13:18:08.84279Z,2021,31,10,27,19,0,3ro,0,0,12,0,0,21,4,0,31,0,0,0
12401,30356,2021-06-24T13:18:08.84279Z,2021,33,12,29,18,0,4to,0,0,15,0,0,21,4,0,33,0,0,0
12401,30357,2021-06-24T13:18:08.8437914Z,2021,30,15,26,12,0,5to,0,0,18,0,0,15,4,0,30,0,0,0
12401,30358,2021-06-24T13:18:08.8437914Z,2021,32,15,27,10,0,6to,0,0,22,0,0,17,5,0,32,0,0,0
12401,30359,2021-06-24T13:18:08.8437914Z,2021,37,10,31,16,0,7mo,0,0,21,0,0,27,6,0,37,1,0,0
12401,30360,2021-06-24T13:18:08.8437914Z,2021,42,12,38,21,0,8vo,0,0,21,0,0,30,4,0,42,1,0,0
12401,30361,2021-06-24T13:18:08.8447941Z,2021,20,10,18,12,0,K,0,0,8,0,0,10,2,0,20,0,0,0
12401,30362,2021-06-24T13:18:08.8447941Z,2021,3,3,3,0,0,Sin Grado,0,0,3,0,0,0,0,0,3,0,0,0
12401,355,2020-11-18T16:20:39.644461Z,2019,34,12,27,17,0,1ro,0,0,17,0,0,22,7,0,34,0,0,0
12401,356,2020-11-18T16:20:39.644461Z,2019,37,11,28,22,0,2do,0,0,15,0,0,26,9,0,37,0,0,0
12401,357,2020-11-18T16:20:39.644461Z,2019,33,15,27,13,0,3ro,0,0,20,0,0,18,6,0,33,0,0,0
12401,358,2020-11-18T16:20:39.6454587Z,2019,27,12,17,11,0,4to,0,0,16,0,0,15,10,0,27,0,0,0
12401,359,2020-11-18T16:20:39.6454587Z,2019,42,13,34,20,0,5to,0,0,22,0,0,29,8,0,42,1,0,0
12401,360,2020-11-18T16:20:39.6454587Z,2019,39,10,29,19,0,6to,0,0,20,0,0,29,10,0,39,1,0,0
12401,361,2020-11-18T16:20:39.6454587Z,2019,41,11,31,18,0,7mo,0,0,23,0,0,30,10,0,41,2,0,0
12401,362,2020-11-18T16:20:39.6464596Z,2019,43,8,38,21,0,8vo,1,1,22,0,0,35,5,0,42,0,0,0
12401,363,2020-11-18T16:20:39.6464596Z,2019,31,11,25,23,0,K,0,1,8,0,0,20,6,0,31,0,0,0
12401,364,2020-11-18T16:20:39.6464596Z,2019,12,12,10,5,0,Sin Grado,0,0,7,0,0,0,2,0,12,0,0,0
12401,6356,2020-11-18T16:21:39.2552096Z,2020,28,7,22,20,0,1ro,0,0,8,0,0,21,6,0,28,0,0,0
12401,6357,2020-11-18T16:21:39.2562105Z,2020,31,10,22,18,0,2do,0,0,13,0,0,21,9,0,31,0,0,0
12401,6358,2020-11-18T16:21:39.2562105Z,2020,35,10,26,21,0,3ro,0,0,14,0,0,25,9,0,35,0,0,0
12401,6359,2020-11-18T16:21:39.2562105Z,2020,30,15,25,14,0,4to,0,0,16,0,0,15,5,0,30,0,0,0
12401,6360,2020-11-18T16:21:39.2572114Z,2020,28,12,19,11,0,5to,0,0,17,0,0,16,9,0,28,0,0,0
12401,6361,2020-11-18T16:21:39.2572114Z,2020,44,13,36,23,0,6to,0,0,21,0,0,31,8,0,44,1,0,0
12401,6362,2020-11-18T16:21:39.2572114Z,2020,40,11,31,19,0,7mo,0,0,21,0,0,29,9,0,40,1,0,0
12401,6363,2020-11-18T16:21:39.2582118Z,2020,40,11,31,16,0,8vo,0,0,24,0,0,29,9,0,40,2,0,0
12401,6364,2020-11-18T16:21:39.2582118Z,2020,34,12,29,17,0,K,0,0,17,0,0,22,5,0,34,0,0,0
12401,6365,2020-11-18T16:21:39.2582118Z,2020,9,9,8,1,0,Sin Grado,0,0,8,0,0,0,1,0,9,0,0,0
26765,1593,2020-11-18T16:20:47.6678121Z,2019,56,17,46,25,0,1ro,0,0,31,0,0,39,10,0,56,0,0,0
26765,1594,2020-11-18T16:20:47.6678121Z,2019,50,11,43,21,0,2do,0,0,29,0,0,39,7,0,50,2,0,0
26765,1595,2020-11-18T16:20:47.6678121Z,2019,49,11,36,31,0,3ro,0,1,18,0,0,38,13,0,49,2,0,0
26765,1596,2020-11-18T16:20:47.6678121Z,2019,73,28,60,38,0,4to,0,2,35,0,0,45,13,0,73,0,0,0
26765,1597,2020-11-18T16:20:47.6688134Z,2019,59,18,45,31,0,5to,0,0,28,0,0,41,14,0,59,1,0,0
26765,1598,2020-11-18T16:20:47.6688134Z,2019,48,11,43,25,0,K,0,0,23,0,0,37,5,0,48,0,0,0
26765,1599,2020-11-18T16:20:47.6688134Z,2019,3,3,3,1,0,Sin Grado,0,0,2,0,0,0,0,0,3,0,0,0
26765,31596,2021-06-24T13:18:15.8538173Z,2021,29,8,25,11,0,1ro,0,0,18,0,0,21,4,0,29,0,0,0
26765,31597,2021-06-24T13:18:15.8538173Z,2021,38,12,33,18,0,2do,0,0,20,0,0,26,5,0,38,0,0,0
26765,31598,2021-06-24T13:18:15.8538173Z,2021,47,9,41,21,0,3ro,0,0,26,0,0,38,6,0,47,0,0,0
26765,31599,2021-06-24T13:18:15.8538173Z,2021,47,14,43,19,0,4to,1,0,28,0,0,33,4,0,46,2,0,0
26765,31600,2021-06-24T13:18:16.049958Z,2021,39,9,28,21,0,5to,0,0,18,0,0,30,11,0,39,2,0,0
26765,31601,2021-06-24T13:18:16.049958Z,2021,29,4,27,12,0,K,0,0,17,0,0,25,2,0,29,0,0,0
26765,31602,2021-06-24T13:18:16.0509594Z,2021,2,2,1,1,0,Sin Grado,0,0,1,0,0,0,1,0,2,0,0,0
26765,7599,2020-11-18T16:21:46.3979701Z,2020,51,13,41,25,0,1ro,1,0,26,0,0,38,10,0,50,0,0,0
26765,7600,2020-11-18T16:21:46.3979701Z,2020,53,12,43,22,0,2do,0,0,31,0,0,41,10,0,53,0,0,0
26765,7601,2020-11-18T16:21:47.1774899Z,2020,52,11,43,22,0,3ro,1,0,30,0,0,41,9,0,51,2,0,0
26765,7602,2020-11-18T16:21:47.1784912Z,2020,54,11,40,30,0,4to,0,0,24,0,0,43,14,0,54,2,0,0
26765,7603,2020-11-18T16:21:47.1784912Z,2020,64,23,48,35,0,5to,1,0,29,0,0,41,16,0,63,0,0,0
26765,7604,2020-11-18T16:21:47.1784912Z,2020,35,6,26,16,0,K,0,0,19,0,0,29,9,0,35,0,0,0
26765,7605,2020-11-18T16:21:47.1794912Z,2020,2,2,2,1,0,Sin Grado,0,0,1,0,0,0,0,0,2,0,0,0
25007,1468,2020-11-18T16:20:46.3449271Z,2019,25,13,22,10,0,1ro,0,0,15,0,0,12,3,0,25,0,0,0
25007,1469,2020-11-18T16:20:46.3449271Z,2019,14,7,12,8,0,2do,0,0,6,0,0,7,2,0,14,0,0,0
25007,1470,2020-11-18T16:20:46.3449271Z,2019,19,4,18,9,0,3ro,1,0,10,0,0,15,1,0,18,0,0,0
25007,1471,2020-11-18T16:20:46.3449271Z,2019,18,8,18,9,0,4to,0,0,9,0,0,10,0,0,18,0,0,0
25007,1472,2020-11-18T16:20:46.3449271Z,2019,17,7,13,6,0,5to,0,0,11,0,0,10,4,0,17,0,0,0
25007,1473,2020-11-18T16:20:46.345928Z,2019,23,9,18,10,0,6to,0,0,13,0,0,14,5,0,23,0,0,0
25007,1474,2020-11-18T16:20:46.345928Z,2019,33,7,30,17,0,7mo,2,0,16,0,0,26,3,0,31,0,0,0
25007,1475,2020-11-18T16:20:46.345928Z,2019,33,9,25,16,0,8vo,0,0,17,0,0,24,8,0,33,0,0,0
25007,1476,2020-11-18T16:20:46.345928Z,2019,19,2,17,10,0,K,0,0,9,0,0,17,2,0,19,0,0,0
25007,31469,2021-06-24T13:18:14.9301552Z,2021,15,5,15,7,0,1ro,1,3,8,0,0,10,0,0,14,0,0,0
25007,31470,2021-06-24T13:18:14.9301552Z,2021,17,5,13,10,0,2do,0,3,7,0,0,12,4,0,17,0,0,0
25007,31471,2021-06-24T13:18:14.9301552Z,2021,19,7,13,8,0,3ro,0,1,11,0,0,12,6,0,19,0,0,0
25007,31472,2021-06-24T13:18:14.9311557Z,2021,13,7,10,7,0,4to,0,1,6,0,0,6,3,0,13,0,0,0
25007,31473,2021-06-24T13:18:14.9311557Z,2021,18,4,13,8,0,5to,1,1,10,0,0,14,5,0,17,0,0,0
25007,31474,2021-06-24T13:18:14.9311557Z,2021,20,9,18,10,0,6to,0,2,10,0,0,11,2,0,20,0,0,0
25007,31475,2021-06-24T13:18:14.9311557Z,2021,17,7,15,6,0,7mo,0,1,11,0,0,10,2,0,17,0,0,0
25007,31476,2021-06-24T13:18:14.9321571Z,2021,22,8,20,9,0,8vo,0,6,13,0,0,14,2,0,22,0,0,0
25007,31477,2021-06-24T13:18:14.9321571Z,2021,7,0,7,4,0,K,0,0,3,0,0,7,0,0,7,0,0,0
25007,7472,2020-11-18T16:21:45.7795613Z,2020,19,6,15,10,0,1ro,0,4,9,0,0,13,4,0,19,0,0,0
25007,7473,2020-11-18T16:21:45.7795613Z,2020,18,7,13,8,0,2do,0,3,10,0,0,11,5,0,18,0,0,0
25007,7474,2020-11-18T16:21:45.7795613Z,2020,13,8,12,7,0,3ro,0,3,6,0,0,5,1,0,13,0,0,0
25007,7475,2020-11-18T16:21:45.7805618Z,2020,17,4,13,8,0,4to,1,1,9,0,0,13,4,0,16,0,0,0
25007,7476,2020-11-18T16:21:45.7805618Z,2020,18,8,18,9,0,5to,0,2,9,0,0,10,0,0,18,0,0,0
25007,7477,2020-11-18T16:21:45.7805618Z,2020,14,7,13,5,0,6to,0,1,9,0,0,7,1,0,14,0,0,0
25007,7478,2020-11-18T16:21:45.7805618Z,2020,21,8,17,8,0,7mo,0,6,13,0,0,13,4,0,21,0,0,0
25007,7479,2020-11-18T16:21:45.7815631Z,2020,32,7,27,15,0,8vo,2,3,17,0,0,25,5,0,30,0,0,0
25007,7480,2020-11-18T16:21:45.7815631Z,2020,13,4,13,5,0,K,0,1,8,0,0,9,0,0,13,0,0,0
40030,2497,2020-11-18T16:20:56.2825541Z,2019,22,6,22,13,0,1ro,0,0,9,0,0,16,0,0,22,0,0,0
40030,2498,2020-11-18T16:20:56.2825541Z,2019,19,4,18,10,0,2do,0,0,9,0,0,15,1,0,19,0,0,0
40030,2499,2020-11-18T16:20:56.2825541Z,2019,15,5,12,7,0,3ro,0,0,8,0,0,10,3,0,15,0,0,0
40030,2500,2020-11-18T16:20:56.2835541Z,2019,29,7,26,15,0,4to,0,0,14,0,0,22,3,0,29,0,0,0
40030,2501,2020-11-18T16:20:57.6234494Z,2019,29,11,26,15,0,5to,0,0,14,0,0,18,3,0,29,0,0,0
40030,2502,2020-11-18T16:20:57.6244502Z,2019,33,14,29,17,0,6to,0,0,16,0,0,19,4,0,33,0,0,0
40030,2503,2020-11-18T16:20:57.6244502Z,2019,37,18,31,17,0,7mo,0,0,20,0,0,19,6,0,37,0,0,0
40030,2504,2020-11-18T16:20:57.6244502Z,2019,35,13,33,18,0,8vo,0,0,17,0,0,22,2,0,35,0,0,0
40030,2505,2020-11-18T16:20:57.6244502Z,2019,22,6,20,13,0,K,0,0,9,0,0,16,2,0,22,0,0,0
40030,2506,2020-11-18T16:20:57.6254502Z,2019,15,4,13,8,0,PK,3,0,7,0,0,11,2,0,12,0,0,0
40030,2507,2020-11-18T16:20:57.6254502Z,2019,4,3,4,2,0,Sin Grado,0,0,2,0,0,1,0,0,4,0,0,0
40030,32504,2021-06-24T13:18:25.2225419Z,2021,21,8,20,9,0,1ro,4,0,12,0,0,13,1,0,17,0,0,0
40030,32505,2021-06-24T13:18:25.2235424Z,2021,19,4,17,12,0,2do,0,0,7,0,0,15,2,0,19,0,0,0
40030,32506,2021-06-24T13:18:25.2235424Z,2021,22,5,21,13,0,3ro,0,0,9,0,0,17,1,0,22,0,0,0
40030,32507,2021-06-24T13:18:25.2235424Z,2021,21,5,18,13,0,4to,0,0,8,0,0,16,3,0,21,0,0,0
40030,32508,2021-06-24T13:18:25.2235424Z,2021,19,4,17,10,0,5to,0,0,9,0,0,15,2,0,19,0,0,0
40030,32509,2021-06-24T13:18:25.2245425Z,2021,36,10,31,17,0,6to,0,0,19,0,0,26,5,0,36,0,0,0
40030,32510,2021-06-24T13:18:25.2245425Z,2021,31,11,27,15,0,7mo,1,0,16,0,0,20,4,0,30,0,0,0
40030,32511,2021-06-24T13:18:25.2245425Z,2021,39,17,35,21,0,8vo,0,0,18,0,0,22,4,0,39,0,0,0
40030,32512,2021-06-24T13:18:25.2245425Z,2021,36,14,31,21,0,9no,0,0,15,0,0,22,5,0,35,0,0,1
40030,32513,2021-06-24T13:18:25.2255439Z,2021,16,4,14,10,0,K,0,0,6,0,0,12,2,0,16,0,0,0
40030,32514,2021-06-24T13:18:25.2255439Z,2021,10,2,10,3,0,PK,0,0,7,0,0,8,0,0,10,0,0,0
40030,32515,2021-06-24T13:18:25.2255439Z,2021,6,6,3,0,0,Sin Grado,0,0,6,0,0,0,3,0,6,0,0,0
40030,8509,2020-11-18T16:21:52.6211191Z,2020,19,5,16,11,0,1ro,0,0,8,0,0,14,3,0,19,0,0,0
40030,8510,2020-11-18T16:21:52.6211191Z,2020,19,3,18,10,0,2do,0,0,9,0,0,16,1,0,19,0,0,0
40030,8511,2020-11-18T16:21:52.6211191Z,2020,17,5,15,10,0,3ro,0,0,7,0,0,12,2,0,17,0,0,0
40030,8512,2020-11-18T16:21:52.6211191Z,2020,16,4,13,8,0,4to,0,0,8,0,0,12,3,0,16,0,0,0
40030,8513,2020-11-18T16:21:52.6211191Z,2020,25,6,21,13,0,5to,0,0,12,0,0,19,4,0,25,0,0,0
40030,8514,2020-11-18T16:21:52.62212Z,2020,28,10,26,13,0,6to,0,0,15,0,0,18,2,0,28,0,0,0
40030,8515,2020-11-18T16:21:52.62212Z,2020,33,13,30,18,0,7mo,0,0,15,0,0,20,3,0,33,0,0,0
40030,8516,2020-11-18T16:21:52.62212Z,2020,35,14,28,15,0,8vo,0,0,20,0,0,21,7,0,34,0,0,1
40030,8517,2020-11-18T16:21:52.62212Z,2020,26,6,23,15,0,9no,0,0,11,0,0,20,3,0,26,0,0,0
40030,8518,2020-11-18T16:21:52.62212Z,2020,17,6,16,8,0,K,2,0,9,0,0,11,1,0,15,0,0,0
40030,8519,2020-11-18T16:21:52.6231209Z,2020,11,1,9,8,0,PK,0,0,3,0,0,10,2,0,11,0,0,0
40030,8520,2020-11-18T16:21:52.6231209Z,2020,2,2,1,0,0,Sin Grado,0,0,2,0,0,0,1,0,2,0,0,0
41582,2673,2020-11-18T16:20:58.0737501Z,2019,51,10,50,25,0,1ro,0,0,26,0,0,41,1,0,50,0,0,1
41582,2674,2020-11-18T16:20:58.0737501Z,2019,40,8,38,21,0,2do,0,0,19,0,0,32,2,0,40,0,1,0
41582,2675,2020-11-18T16:20:58.0737501Z,2019,51,15,46,28,0,3ro,0,0,23,0,0,36,5,0,51,0,0,0
41582,2676,2020-11-18T16:20:58.0747478Z,2019,48,15,43,23,0,4to,1,0,25,0,0,33,5,0,47,0,1,0
41582,2677,2020-11-18T16:20:58.0747478Z,2019,46,18,43,22,0,5to,0,0,24,0,0,28,3,0,46,0,0,0
41582,2678,2020-11-18T16:20:58.0747478Z,2019,49,17,40,21,0,6to,0,0,28,0,0,32,9,0,49,0,0,0
41582,2679,2020-11-18T16:20:58.0747478Z,2019,53,19,43,17,0,7mo,0,0,36,0,0,34,10,0,53,0,0,0
41582,2680,2020-11-18T16:20:58.0747478Z,2019,44,16,38,20,0,8vo,0,0,24,0,0,28,6,0,44,0,0,0
41582,2681,2020-11-18T16:20:58.0757492Z,2019,33,6,26,20,0,K,0,0,13,0,0,27,7,0,33,0,0,0
41582,2682,2020-11-18T16:20:58.0757492Z,2019,27,25,26,9,0,Sin Grado,0,1,18,0,0,2,1,0,27,0,0,0
41582,32680,2021-06-24T13:18:26.2893069Z,2021,29,5,23,19,0,1ro,0,0,10,0,0,24,6,0,29,0,0,0
41582,32681,2021-06-24T13:18:26.2903078Z,2021,28,6,24,18,0,2do,1,0,10,0,0,22,4,0,27,0,0,0
41582,32682,2021-06-24T13:18:26.2903078Z,2021,46,8,44,22,0,3ro,1,0,24,0,0,38,2,0,44,0,0,1
41582,32683,2021-06-24T13:18:26.2903078Z,2021,43,9,36,24,0,4to,0,0,19,0,0,34,7,0,43,0,1,0
41582,32684,2021-06-24T13:18:26.2913079Z,2021,53,16,47,30,0,5to,0,0,23,0,0,37,6,0,53,0,0,0
41582,32685,2021-06-24T13:18:26.2913079Z,2021,55,19,47,25,0,6to,2,0,30,0,0,36,8,0,53,0,1,0
41582,32686,2021-06-24T13:18:26.2913079Z,2021,61,26,53,29,0,7mo,1,0,32,0,0,35,8,0,59,0,0,1
41582,32687,2021-06-24T13:18:26.2913079Z,2021,48,11,40,22,0,8vo,1,0,26,0,0,37,8,0,47,0,0,0
41582,32688,2021-06-24T13:18:26.2923088Z,2021,24,3,16,13,0,K,0,0,11,0,0,21,8,0,24,0,0,0
41582,32689,2021-06-24T13:18:26.2923088Z,2021,15,15,13,6,0,Sin Grado,0,0,9,0,0,0,2,0,15,0,0,0
41582,8684,2020-11-18T16:21:53.0844293Z,2020,30,5,26,17,0,1ro,0,0,13,0,0,25,4,0,30,0,0,0
41582,8685,2020-11-18T16:21:53.0844293Z,2020,46,9,46,22,0,2do,0,0,24,0,0,37,0,0,45,0,0,1
41582,8686,2020-11-18T16:21:53.0854297Z,2020,42,9,36,23,0,3ro,0,0,19,0,0,33,6,0,41,0,1,1
41582,8687,2020-11-18T16:21:53.0854297Z,2020,57,18,53,30,0,4to,0,0,27,0,0,39,4,0,57,0,0,0
41582,8688,2020-11-18T16:21:53.0864302Z,2020,48,15,43,23,0,5to,2,0,25,0,0,33,5,0,46,0,1,0
41582,8689,2020-11-18T16:21:53.0864302Z,2020,57,22,49,30,0,6to,0,0,27,0,0,35,8,0,56,0,0,1
41582,8690,2020-11-18T16:21:53.0864302Z,2020,46,12,36,20,0,7mo,0,0,26,0,0,34,10,0,46,0,0,0
41582,8691,2020-11-18T16:21:53.0864302Z,2020,55,17,45,21,0,8vo,0,0,34,0,0,38,10,0,55,0,0,0
41582,8692,2020-11-18T16:21:53.0874315Z,2020,31,6,26,20,0,K,0,0,11,0,0,25,5,0,31,0,0,0
41582,8693,2020-11-18T16:21:53.0874315Z,2020,29,29,28,11,0,Sin Grado,0,0,18,0,0,0,1,0,29,0,0,0
21659,1238,2020-11-18T16:20:45.0940924Z,2019,53,15,46,25,0,1ro,0,2,28,0,0,38,7,0,53,1,0,0
21659,1239,2020-11-18T16:20:45.0940924Z,2019,37,14,34,20,0,2do,1,0,17,0,0,23,3,0,36,2,0,0
21659,1240,2020-11-18T16:20:45.0940924Z,2019,54,18,48,32,0,3ro,0,4,22,0,0,36,6,0,54,1,0,0
21659,1241,2020-11-18T16:20:45.0950929Z,2019,67,22,52,38,0,4to,1,7,29,0,0,45,15,0,66,1,0,0
21659,1242,2020-11-18T16:20:45.0950929Z,2019,53,19,49,28,0,5to,0,1,25,0,0,34,4,0,51,1,0,2
21659,1243,2020-11-18T16:20:45.0950929Z,2019,74,32,61,34,0,6to,0,4,40,0,0,42,13,0,74,1,0,0
21659,1244,2020-11-18T16:20:45.0950929Z,2019,54,18,47,30,0,7mo,0,0,24,0,0,36,7,0,53,0,0,1
21659,1245,2020-11-18T16:20:45.0960942Z,2019,54,21,46,29,0,8vo,1,2,25,0,0,33,8,0,53,0,0,0
21659,1246,2020-11-18T16:20:45.0960942Z,2019,40,12,32,17,0,K,0,2,23,0,0,28,8,0,40,0,0,0
21659,1247,2020-11-18T16:20:45.0960942Z,2019,18,4,12,7,0,PK,0,1,11,0,0,14,6,0,18,0,0,0
21659,1248,2020-11-18T16:20:45.0960942Z,2019,25,23,15,7,0,Sin Grado,0,0,18,0,0,2,10,0,24,0,0,1
21659,31239,2021-06-24T13:18:14.0195031Z,2021,29,10,28,15,0,1ro,0,0,14,0,0,19,1,0,29,0,0,0
21659,31240,2021-06-24T13:18:14.0205036Z,2021,47,17,40,20,0,2do,1,0,27,0,0,30,7,0,46,0,0,0
21659,31241,2021-06-24T13:18:14.0205036Z,2021,40,11,36,19,0,3ro,0,0,21,0,0,29,4,0,40,1,0,0
21659,31242,2021-06-24T13:18:14.0205036Z,2021,37,15,32,18,0,4to,0,0,19,0,0,22,5,0,37,0,0,0
21659,31243,2021-06-24T13:18:14.0205036Z,2021,42,15,36,25,0,5to,0,0,17,0,0,27,6,0,42,1,0,0
21659,31244,2021-06-24T13:18:14.0215041Z,2021,64,20,50,30,0,6to,2,0,34,0,0,44,14,0,62,1,0,0
21659,31245,2021-06-24T13:18:14.0215041Z,2021,60,28,52,27,0,7mo,0,1,33,0,0,32,8,0,60,1,0,0
21659,31246,2021-06-24T13:18:14.0215041Z,2021,67,26,52,31,0,8vo,0,0,36,0,0,41,15,0,67,1,0,0
21659,31247,2021-06-24T13:18:14.0215041Z,2021,25,8,22,15,0,K,0,0,10,0,0,17,3,0,25,0,0,0
21659,31248,2021-06-24T13:18:14.0225042Z,2021,14,0,11,5,0,PK,0,0,9,0,0,14,3,0,14,0,0,0
21659,31249,2021-06-24T13:18:14.0225042Z,2021,27,27,24,11,0,Sin Grado,0,0,16,0,0,0,3,0,26,0,0,1
21659,7243,2020-11-18T16:21:44.6047769Z,2020,45,17,37,19,0,1ro,1,1,26,0,0,28,8,0,44,0,0,0
21659,7244,2020-11-18T16:21:44.6047769Z,2020,42,9,39,19,0,2do,0,2,23,0,0,33,3,0,42,1,0,0
21659,7245,2020-11-18T16:21:44.6047769Z,2020,38,14,36,19,0,3ro,1,0,19,0,0,24,2,0,37,2,0,0
21659,7246,2020-11-18T16:21:44.6057782Z,2020,46,17,42,28,0,4to,0,3,18,0,0,29,4,0,46,1,0,0
21659,7247,2020-11-18T16:21:44.6057782Z,2020,68,20,50,35,0,5to,2,5,33,0,0,48,18,0,66,1,0,0
21659,7248,2020-11-18T16:21:44.6057782Z,2020,63,31,55,27,0,6to,2,3,36,0,0,32,8,0,61,1,0,0
21659,7249,2020-11-18T16:21:44.6067782Z,2020,68,28,57,31,0,7mo,0,2,37,0,0,40,11,0,68,1,0,0
21659,7250,2020-11-18T16:21:44.6067782Z,2020,55,16,48,32,0,8vo,0,0,23,0,0,39,7,0,55,0,0,0
21659,7251,2020-11-18T16:21:44.6067782Z,2020,32,8,26,16,0,K,0,3,16,0,0,24,6,0,32,0,0,0
21659,7252,2020-11-18T16:21:44.6077786Z,2020,13,4,9,6,0,PK,0,0,7,0,0,9,4,0,13,0,0,0
21659,7253,2020-11-18T16:21:44.6077786Z,2020,34,34,28,10,0,Sin Grado,1,0,24,0,0,0,6,0,32,0,0,1
71035,11173,2020-11-18T16:22:08.3365981Z,2020,25,10,23,17,0,1ro,0,1,8,0,0,15,2,0,25,0,0,0
71035,11174,2020-11-18T16:22:08.3365981Z,2020,29,9,28,16,0,2do,0,1,13,0,0,20,1,0,29,0,0,0
71035,11175,2020-11-18T16:22:08.3365981Z,2020,33,11,29,18,0,3ro,0,9,15,0,0,22,4,0,33,0,0,0
71035,11176,2020-11-18T16:22:08.3365981Z,2020,40,12,5,20,0,4to,1,2,20,0,0,28,35,0,39,0,0,0
71035,11177,2020-11-18T16:22:08.3375999Z,2020,42,12,4,26,0,5to,0,5,16,0,0,30,38,0,42,0,0,0
71035,11178,2020-11-18T16:22:08.3375999Z,2020,44,17,4,23,0,6to,1,2,21,0,0,27,40,0,43,0,0,0
71035,11179,2020-11-18T16:22:08.3375999Z,2020,43,12,3,21,0,7mo,0,1,22,0,0,31,40,0,43,0,0,0
71035,11180,2020-11-18T16:22:08.3375999Z,2020,46,14,16,23,0,8vo,0,1,23,0,0,32,30,0,46,0,0,0
71035,11181,2020-11-18T16:22:08.3375999Z,2020,38,6,34,19,0,K,1,1,19,0,0,32,4,0,37,0,0,0
71035,11182,2020-11-18T16:22:08.3386022Z,2020,50,50,48,5,0,Sin Grado,0,4,45,0,0,0,2,0,50,1,0,0
71035,35194,2021-06-24T13:18:44.5634102Z,2021,36,7,34,17,0,1ro,1,1,19,0,0,29,2,0,35,0,0,0
71035,35195,2021-06-24T13:18:44.5644107Z,2021,23,9,22,14,0,2do,0,1,9,0,0,14,1,0,23,0,0,0
71035,35196,2021-06-24T13:18:44.5644107Z,2021,28,9,28,15,0,3ro,0,1,13,0,0,19,0,0,28,0,0,0
71035,35197,2021-06-24T13:18:44.5644107Z,2021,32,10,27,16,0,4to,0,8,16,0,0,22,5,0,32,0,0,0
71035,35198,2021-06-24T13:18:44.5644107Z,2021,35,12,32,17,0,5to,0,5,18,0,0,23,3,0,35,0,0,0
71035,35199,2021-06-24T13:18:44.5654121Z,2021,49,13,41,29,0,6to,0,5,20,0,0,36,8,0,49,0,0,0
71035,35200,2021-06-24T13:18:44.7865709Z,2021,40,17,35,19,0,7mo,0,2,21,0,0,23,5,0,40,0,0,0
71035,35201,2021-06-24T13:18:44.7865709Z,2021,41,11,34,20,0,8vo,0,1,21,0,0,30,7,1,40,0,0,0
71035,35202,2021-06-24T13:18:44.787571Z,2021,25,5,22,13,0,K,0,1,12,0,0,20,3,0,25,0,0,0
71035,35203,2021-06-24T13:18:44.787571Z,2021,31,30,29,4,0,Sin Grado,2,2,27,0,0,1,2,0,29,1,0,0
71035,5168,2020-11-18T16:21:14.0403961Z,2019,35,9,31,19,0,1ro,0,0,16,0,0,26,4,0,35,0,1,0
71035,5169,2020-11-18T16:21:14.0403961Z,2019,41,17,35,22,0,2do,0,0,19,0,0,24,6,0,41,0,0,0
71035,5170,2020-11-18T16:21:14.0413965Z,2019,36,12,29,18,0,3ro,1,0,18,0,0,24,7,0,35,0,0,0
71035,5171,2020-11-18T16:21:14.0413965Z,2019,39,10,33,22,0,4to,1,0,17,0,0,29,6,0,38,0,0,0
71035,5172,2020-11-18T16:21:14.0413965Z,2019,41,13,33,18,0,5to,2,0,23,0,0,28,8,0,39,0,0,0
71035,5173,2020-11-18T16:21:14.0413965Z,2019,40,9,31,23,0,6to,0,0,17,0,0,31,9,0,40,0,0,0
71035,5174,2020-11-18T16:21:14.0413965Z,2019,47,14,32,26,0,7mo,0,0,21,0,0,33,15,0,47,0,0,0
71035,5175,2020-11-18T16:21:14.0423983Z,2019,46,11,43,25,0,8vo,0,0,21,0,0,35,3,0,46,0,0,0
71035,5176,2020-11-18T16:21:14.0423983Z,2019,29,9,25,20,0,K,0,0,9,0,0,20,4,0,29,0,0,0
71035,5177,2020-11-18T16:21:14.0423983Z,2019,62,56,55,11,0,Sin Grado,1,3,51,0,0,6,7,0,61,1,0,0
20537,30986,2021-06-24T13:18:11.8249284Z,2021,12,0,10,6,0,1ro,0,0,6,0,0,12,2,0,12,0,0,0
20537,30987,2021-06-24T13:18:11.8259298Z,2021,17,3,16,9,0,2do,0,0,8,0,0,14,1,0,17,0,0,0
20537,30988,2021-06-24T13:18:11.8259298Z,2021,17,5,14,5,0,3ro,0,0,12,0,0,12,3,0,17,0,0,0
20537,30989,2021-06-24T13:18:11.8259298Z,2021,13,3,12,7,0,4to,0,0,6,0,0,10,1,0,13,0,0,0
20537,30990,2021-06-24T13:18:11.8259298Z,2021,13,7,12,6,0,5to,0,0,7,0,0,6,1,0,13,0,0,0
20537,30991,2021-06-24T13:18:11.8269307Z,2021,15,6,14,7,0,6to,0,0,8,0,0,9,1,0,15,0,0,0
20537,30992,2021-06-24T13:18:11.8269307Z,2021,20,8,19,11,0,7mo,0,1,9,0,0,12,1,0,20,0,0,0
20537,30993,2021-06-24T13:18:11.8269307Z,2021,21,6,18,10,0,8vo,0,0,11,0,0,15,3,0,21,0,0,0
20537,30994,2021-06-24T13:18:11.8269307Z,2021,14,3,11,4,0,K,0,0,10,0,0,11,3,0,14,0,0,0
20537,30995,2021-06-24T13:18:11.8269307Z,2021,9,9,6,0,0,Sin Grado,0,0,9,0,0,0,3,0,9,0,0,0
20537,6989,2020-11-18T16:21:42.6074422Z,2020,18,5,15,9,0,1ro,0,0,9,0,0,13,3,0,18,0,0,0
20537,6990,2020-11-18T16:21:42.6074422Z,2020,18,5,13,4,0,2do,0,0,14,0,0,13,5,0,18,0,0,0
20537,6991,2020-11-18T16:21:42.6084431Z,2020,12,3,8,7,0,3ro,0,0,5,0,0,9,4,0,12,0,0,0
20537,6992,2020-11-18T16:21:42.6084431Z,2020,17,9,16,7,0,4to,0,0,10,0,0,8,1,0,17,0,0,0
20537,6993,2020-11-18T16:21:42.6084431Z,2020,15,5,14,8,0,5to,0,0,7,0,0,10,1,0,15,0,0,0
20537,6994,2020-11-18T16:21:42.6084431Z,2020,20,8,20,11,0,6to,0,0,9,0,0,12,0,0,20,0,0,0
20537,6995,2020-11-18T16:21:42.6084431Z,2020,22,7,20,10,0,7mo,0,1,12,0,0,15,2,0,22,0,0,0
20537,6996,2020-11-18T16:21:42.6094435Z,2020,17,8,17,9,0,8vo,0,0,8,0,0,9,0,0,17,0,0,0
20537,6997,2020-11-18T16:21:42.6094435Z,2020,12,0,10,6,0,K,0,0,6,0,0,12,2,0,12,0,0,0
20537,6998,2020-11-18T16:21:42.6094435Z,2020,8,8,6,0,0,Sin Grado,0,0,8,0,0,0,2,0,8,0,0,0
20537,987,2020-11-18T16:20:43.3939574Z,2019,23,5,20,7,0,1ro,0,1,16,0,0,18,3,0,23,0,0,0
20537,988,2020-11-18T16:20:43.3939574Z,2019,17,3,17,10,0,2do,0,1,7,0,0,14,0,0,17,0,0,0
20537,989,2020-11-18T16:20:43.3939574Z,2019,20,10,18,11,0,3ro,0,1,9,0,0,10,2,0,20,0,0,0
20537,990,2020-11-18T16:20:43.3949578Z,2019,17,5,16,9,0,4to,0,2,8,0,0,12,1,0,17,0,0,0
20537,991,2020-11-18T16:20:43.3949578Z,2019,19,6,19,12,0,5to,0,1,7,0,0,13,0,0,19,0,0,0
20537,992,2020-11-18T16:20:43.3949578Z,2019,25,6,22,12,0,6to,0,3,13,0,0,19,3,0,25,0,0,0
20537,993,2020-11-18T16:20:43.3959583Z,2019,18,7,18,9,0,7mo,0,0,9,0,0,11,0,0,18,0,0,0
20537,994,2020-11-18T16:20:43.3959583Z,2019,16,3,13,5,0,8vo,0,1,11,0,0,13,3,0,16,0,0,0
20537,995,2020-11-18T16:20:43.3959583Z,2019,16,3,13,9,0,K,0,3,7,0,0,13,3,0,16,0,0,0
20537,996,2020-11-18T16:20:43.3959583Z,2019,11,11,8,1,0,Sin Grado,0,0,10,0,0,0,3,0,11,0,0,0
20545,1000,2020-11-18T16:20:43.3959583Z,2019,25,13,22,13,0,4to,0,0,12,0,0,12,3,0,25,1,0,0
20545,1001,2020-11-18T16:20:43.7952243Z,2019,17,6,14,5,0,5to,0,0,12,0,0,11,3,0,17,0,0,0
20545,1002,2020-11-18T16:20:43.7952243Z,2019,30,15,29,12,0,6to,0,0,18,0,0,15,1,0,30,2,0,0
20545,1003,2020-11-18T16:20:43.7962261Z,2019,24,9,20,10,0,7mo,0,0,14,0,0,15,4,0,24,0,0,0
20545,1004,2020-11-18T16:20:43.7962261Z,2019,20,7,16,12,0,8vo,1,0,8,0,0,13,4,0,19,0,0,0
20545,1005,2020-11-18T16:20:43.7962261Z,2019,20,0,18,14,0,K,2,0,6,0,0,20,2,0,17,0,0,1
20545,1006,2020-11-18T16:20:43.7962261Z,2019,10,10,8,5,0,Sin Grado,0,0,5,0,0,0,2,0,10,0,0,0
20545,30996,2021-06-24T13:18:11.8219265Z,2021,21,5,18,13,0,1ro,0,0,8,0,0,16,3,0,20,0,0,1
20545,30997,2021-06-24T13:18:11.8229274Z,2021,22,4,21,14,0,2do,2,1,8,0,0,18,1,0,20,0,0,0
20545,30998,2021-06-24T13:18:11.8229274Z,2021,19,8,17,6,0,3ro,0,1,13,0,0,11,2,0,19,1,0,0
20545,30999,2021-06-24T13:18:11.8229274Z,2021,21,6,20,11,0,4to,0,2,10,0,0,15,1,0,21,0,0,0
20545,31000,2021-06-24T13:18:12.0310762Z,2021,28,6,24,16,0,5to,0,4,12,0,0,22,4,0,28,1,0,0
20545,31001,2021-06-24T13:18:12.0310762Z,2021,18,9,18,9,0,6to,0,1,9,0,0,9,0,0,18,0,0,0
20545,31002,2021-06-24T13:18:12.0320767Z,2021,20,8,16,8,0,7mo,0,5,12,0,0,12,4,0,20,0,0,0
20545,31003,2021-06-24T13:18:12.0320767Z,2021,24,11,24,9,0,8vo,0,2,15,0,0,13,0,0,24,1,0,0
20545,31004,2021-06-24T13:18:12.0320767Z,2021,9,1,7,5,0,K,1,0,4,0,0,8,2,0,8,0,0,0
20545,31005,2021-06-24T13:18:12.0320767Z,2021,6,6,5,2,0,Sin Grado,0,0,4,0,0,0,1,0,6,0,0,0
20545,6999,2020-11-18T16:21:42.5974355Z,2020,21,2,20,14,0,1ro,2,0,7,0,0,19,1,0,19,0,0,0
20545,7000,2020-11-18T16:21:42.5984364Z,2020,19,6,14,4,0,2do,0,0,15,0,0,13,5,0,19,1,0,0
20545,7001,2020-11-18T16:21:43.6261236Z,2020,23,7,22,13,0,3ro,0,0,10,0,0,16,1,0,23,0,0,0
20545,7002,2020-11-18T16:21:43.6271236Z,2020,28,7,25,16,0,4to,0,0,12,0,0,21,3,0,28,1,0,0
20545,7003,2020-11-18T16:21:43.6271236Z,2020,21,10,17,11,0,5to,0,0,10,0,0,11,4,0,21,1,0,0
20545,7004,2020-11-18T16:21:43.6271236Z,2020,20,8,19,7,0,6to,0,0,13,0,0,12,1,0,20,0,0,0
20545,7005,2020-11-18T16:21:43.6281271Z,2020,27,13,26,10,0,7mo,0,0,17,0,0,14,1,0,27,2,0,0
20545,7006,2020-11-18T16:21:43.6281271Z,2020,22,8,19,9,0,8vo,0,0,13,0,0,14,3,0,22,0,0,0
20545,7007,2020-11-18T16:21:43.6281271Z,2020,14,3,11,7,0,K,0,0,7,0,0,11,3,0,14,0,0,0
20545,7008,2020-11-18T16:21:43.6291258Z,2020,5,5,3,1,0,Sin Grado,0,0,4,0,0,0,2,0,5,0,0,0
20545,997,2020-11-18T16:20:43.3949578Z,2019,20,7,19,8,0,1ro,0,0,12,0,0,13,1,0,20,1,0,0
20545,998,2020-11-18T16:20:43.3959583Z,2019,23,7,23,12,0,2do,0,0,11,0,0,16,0,0,23,0,0,0
20545,999,2020-11-18T16:20:43.3959583Z,2019,26,7,22,12,0,3ro,0,0,14,0,0,19,4,0,26,1,0,0
41814,2696,2020-11-18T16:20:58.0847553Z,2019,25,8,18,9,0,1ro,0,0,16,0,0,17,7,0,25,0,0,0
41814,2697,2020-11-18T16:20:58.0847553Z,2019,19,3,17,13,0,2do,0,0,6,0,1,16,2,0,19,0,0,0
41814,2698,2020-11-18T16:20:58.0847553Z,2019,35,17,32,17,0,3ro,0,0,18,0,0,18,3,0,35,0,0,0
41814,2699,2020-11-18T16:20:58.0857562Z,2019,17,6,15,7,0,4to,1,0,10,0,0,11,2,0,16,0,0,0
41814,2700,2020-11-18T16:20:58.0857562Z,2019,20,6,18,10,0,5to,1,0,10,0,0,14,2,0,19,0,0,0
41814,2701,2020-11-18T16:20:58.7331842Z,2019,36,13,31,19,0,6to,1,0,17,0,0,23,5,0,35,0,0,0
41814,2702,2020-11-18T16:20:58.7341855Z,2019,20,6,16,11,0,7mo,0,0,9,0,0,14,4,0,20,0,0,0
41814,2703,2020-11-18T16:20:58.7341855Z,2019,22,4,18,11,0,8vo,1,0,11,0,0,18,4,0,21,0,0,0
41814,2704,2020-11-18T16:20:58.7341855Z,2019,30,7,24,14,0,K,0,0,16,0,0,23,6,0,30,0,0,0
41814,32703,2021-06-24T13:18:27.1319111Z,2021,13,4,13,4,0,1ro,0,0,9,0,0,9,0,0,13,0,0,0
41814,32704,2021-06-24T13:18:27.1319111Z,2021,27,5,23,13,0,2do,1,0,14,0,0,22,4,0,26,0,0,0
41814,32705,2021-06-24T13:18:27.1319111Z,2021,22,7,17,8,0,3ro,0,0,14,0,0,15,5,0,22,0,0,0
41814,32706,2021-06-24T13:18:27.132912Z,2021,17,4,14,9,0,4to,0,0,8,0,0,13,3,0,17,0,0,0
41814,32707,2021-06-24T13:18:27.132912Z,2021,25,11,24,14,0,5to,0,0,11,0,0,14,1,0,25,0,0,0
41814,32708,2021-06-24T13:18:27.132912Z,2021,27,10,26,14,0,6to,1,0,13,0,0,17,1,0,26,0,0,0
41814,32709,2021-06-24T13:18:27.1339129Z,2021,27,8,22,11,0,7mo,0,0,16,0,0,19,5,0,27,0,0,0
41814,32710,2021-06-24T13:18:27.1339129Z,2021,29,10,27,15,0,8vo,0,0,14,0,0,19,2,0,29,0,0,0
41814,32711,2021-06-24T13:18:27.1339129Z,2021,13,3,11,6,0,K,0,0,7,0,0,10,2,0,13,0,0,0
41814,8707,2020-11-18T16:21:53.7929025Z,2020,29,7,24,15,0,1ro,0,0,14,0,0,22,5,0,29,0,0,0
41814,8708,2020-11-18T16:21:53.7939025Z,2020,23,8,15,8,0,2do,0,0,15,0,0,15,8,0,23,0,0,0
41814,8709,2020-11-18T16:21:53.7939025Z,2020,19,3,16,11,0,3ro,0,0,8,0,0,16,3,0,19,0,0,0
41814,8710,2020-11-18T16:21:53.7939025Z,2020,30,14,27,18,0,4to,0,0,12,0,0,16,3,0,30,0,0,0
41814,8711,2020-11-18T16:21:53.794903Z,2020,19,6,14,8,0,5to,1,0,11,0,0,13,5,0,18,0,0,0
41814,8712,2020-11-18T16:21:53.794903Z,2020,28,9,23,11,0,6to,0,0,17,0,0,19,5,0,28,0,0,0
41814,8713,2020-11-18T16:21:53.794903Z,2020,34,11,27,19,0,7mo,0,0,15,0,0,23,7,0,34,0,0,0
41814,8714,2020-11-18T16:21:53.794903Z,2020,21,6,16,9,0,8vo,0,0,12,0,0,15,5,0,21,0,0,0
41814,8715,2020-11-18T16:21:53.7959043Z,2020,18,5,17,5,0,K,0,0,13,0,0,13,1,0,18,0,0,0
12922,30458,2021-06-24T13:18:09.5092679Z,2021,51,15,40,25,0,1ro,0,0,26,0,0,36,11,0,51,0,0,0
12922,30459,2021-06-24T13:18:09.5102689Z,2021,46,21,42,22,0,2do,0,0,24,0,0,25,4,0,46,0,0,0
12922,30460,2021-06-24T13:18:09.5102689Z,2021,52,23,43,35,0,3ro,0,0,17,0,0,29,9,0,52,1,0,0
12922,30461,2021-06-24T13:18:09.5102689Z,2021,50,27,44,21,0,4to,2,0,29,0,0,23,6,0,48,1,1,0
12922,30462,2021-06-24T13:18:09.5102689Z,2021,59,21,43,22,0,5to,1,0,37,0,0,38,16,0,57,1,0,1
12922,30463,2021-06-24T13:18:09.5102689Z,2021,83,37,66,38,0,6to,4,0,45,0,0,46,17,0,79,1,0,0
12922,30464,2021-06-24T13:18:09.5112689Z,2021,78,26,61,36,0,7mo,3,0,42,0,0,52,17,0,74,2,0,1
12922,30465,2021-06-24T13:18:09.5112689Z,2021,89,37,64,43,0,8vo,3,0,46,0,0,52,25,0,86,2,0,0
12922,30466,2021-06-24T13:18:09.5112689Z,2021,35,5,27,16,0,K,0,0,19,0,0,30,8,0,35,0,0,0
12922,30467,2021-06-24T13:18:09.5112689Z,2021,14,4,12,7,0,PK,0,0,7,0,0,10,2,0,14,0,0,0
12922,30468,2021-06-24T13:18:09.5122699Z,2021,5,5,4,3,0,Sin Grado,0,0,2,0,0,0,1,0,5,0,0,0
12922,460,2020-11-18T16:20:40.0727448Z,2019,63,27,48,37,0,1ro,1,0,26,0,0,36,15,0,62,1,0,0
12922,461,2020-11-18T16:20:40.0727448Z,2019,49,22,37,26,0,2do,2,0,23,0,0,27,12,0,47,1,0,0
12922,462,2020-11-18T16:20:40.0727448Z,2019,54,24,32,19,0,3ro,1,0,35,0,0,30,22,0,53,1,0,0
12922,463,2020-11-18T16:20:40.0737444Z,2019,72,37,51,33,0,4to,3,0,39,0,0,35,21,0,69,1,0,0
12922,464,2020-11-18T16:20:40.0737444Z,2019,75,26,51,36,0,5to,2,0,39,0,0,49,24,0,73,2,0,0
12922,465,2020-11-18T16:20:40.0737444Z,2019,94,37,69,45,0,6to,3,0,49,0,0,57,25,0,91,2,0,0
12922,466,2020-11-18T16:20:40.0747448Z,2019,94,38,71,45,0,7mo,0,0,49,0,0,56,23,0,94,5,0,0
12922,467,2020-11-18T16:20:40.0747448Z,2019,95,24,60,42,0,8vo,1,0,53,0,0,71,35,0,94,1,0,0
12922,468,2020-11-18T16:20:40.0747448Z,2019,61,24,44,42,0,K,0,0,19,0,0,37,17,0,61,0,0,0
12922,469,2020-11-18T16:20:40.0747448Z,2019,14,4,6,8,0,PK,0,0,6,0,0,10,8,0,14,0,0,0
12922,470,2020-11-18T16:20:40.0747448Z,2019,6,6,4,2,0,Sin Grado,0,0,4,0,0,0,2,0,6,0,0,0
12922,6461,2020-11-18T16:21:39.6704868Z,2020,44,20,32,19,0,1ro,0,0,25,0,0,24,12,0,44,0,0,0
12922,6462,2020-11-18T16:21:39.6704868Z,2020,55,21,45,37,0,2do,0,0,18,0,0,34,10,0,55,1,0,0
12922,6463,2020-11-18T16:21:39.6704868Z,2020,47,23,38,22,0,3ro,2,0,25,0,0,24,9,0,45,1,0,0
12922,6464,2020-11-18T16:21:39.6714877Z,2020,63,26,41,24,0,4to,1,0,39,0,0,37,22,0,61,1,0,1
12922,6465,2020-11-18T16:21:39.6714877Z,2020,73,33,51,33,0,5to,4,0,40,0,0,40,22,0,69,1,0,0
12922,6466,2020-11-18T16:21:39.6714877Z,2020,83,27,55,40,0,6to,4,0,43,0,0,56,28,0,78,2,1,1
12922,6467,2020-11-18T16:21:39.6714877Z,2020,94,36,67,43,0,7mo,3,0,51,0,0,58,27,0,91,3,0,0
12922,6468,2020-11-18T16:21:39.672489Z,2020,107,39,81,52,0,8vo,0,0,55,0,0,68,26,0,107,5,0,0
12922,6469,2020-11-18T16:21:39.672489Z,2020,49,13,33,27,0,K,0,0,22,0,0,36,16,0,49,0,0,0
12922,6470,2020-11-18T16:21:39.672489Z,2020,14,2,12,6,0,PK,0,0,8,0,0,12,2,0,14,0,0,0
12922,6471,2020-11-18T16:21:39.672489Z,2020,6,6,5,3,0,Sin Grado,0,0,3,0,0,0,1,0,6,0,0,0
32540,2078,2020-11-18T16:20:53.9159725Z,2019,11,2,9,4,0,1ro,0,0,7,0,0,9,2,0,11,0,0,0
32540,2079,2020-11-18T16:20:53.9159725Z,2019,8,3,6,2,0,2do,0,0,6,0,0,5,2,0,8,0,0,0
32540,2080,2020-11-18T16:20:53.9159725Z,2019,14,4,10,7,0,3ro,0,0,7,0,1,10,4,0,14,0,0,0
32540,2081,2020-11-18T16:20:53.9169734Z,2019,13,5,10,5,0,4to,3,0,8,0,0,8,3,0,10,0,0,0
32540,2082,2020-11-18T16:20:53.9169734Z,2019,14,3,12,4,0,5to,1,0,10,0,0,11,2,0,13,0,0,0
32540,2083,2020-11-18T16:20:53.9169734Z,2019,9,1,3,6,0,6to,0,0,3,0,0,8,6,0,9,1,0,0
32540,2084,2020-11-18T16:20:53.9179734Z,2019,20,4,15,8,0,7mo,1,0,12,0,0,16,5,0,19,1,0,0
32540,2085,2020-11-18T16:20:53.9179734Z,2019,14,2,8,4,0,8vo,0,0,10,0,0,12,6,0,14,0,0,0
32540,2086,2020-11-18T16:20:53.9179734Z,2019,8,3,6,5,0,K,0,0,3,0,0,5,2,0,8,0,0,0
32540,32084,2021-06-24T13:18:20.104866Z,2021,20,2,15,8,0,1ro,0,0,12,0,0,18,5,0,20,0,0,0
32540,32085,2021-06-24T13:18:20.104866Z,2021,23,11,22,14,0,2do,0,0,9,0,0,12,1,0,23,0,0,0
32540,32086,2021-06-24T13:18:20.1058665Z,2021,19,4,17,8,0,3ro,0,0,11,0,0,15,2,0,19,0,0,0
32540,32087,2021-06-24T13:18:20.1058665Z,2021,15,6,13,7,0,4to,0,0,8,0,0,9,2,0,15,0,0,0
32540,32088,2021-06-24T13:18:20.1058665Z,2021,20,4,14,7,0,5to,0,0,13,0,0,16,6,0,20,0,0,0
32540,32089,2021-06-24T13:18:20.1058665Z,2021,20,4,16,8,0,6to,1,0,12,0,0,16,4,0,19,0,0,0
32540,32090,2021-06-24T13:18:20.1058665Z,2021,29,8,23,12,0,7mo,2,0,17,0,0,21,6,0,27,1,0,0
32540,32091,2021-06-24T13:18:20.1068684Z,2021,15,5,8,6,0,8vo,0,0,9,0,0,10,7,0,15,1,0,0
32540,32092,2021-06-24T13:18:20.1068684Z,2021,17,3,15,7,0,K,2,0,10,0,0,14,2,0,15,0,0,0
32540,8090,2020-11-18T16:21:49.574091Z,2020,17,6,13,11,0,1ro,0,0,6,0,0,11,4,0,17,0,0,0
32540,8091,2020-11-18T16:21:49.574091Z,2020,19,3,16,7,0,2do,0,0,12,0,0,16,3,0,19,0,0,0
32540,8092,2020-11-18T16:21:49.5750906Z,2020,13,6,12,5,0,3ro,0,0,8,0,0,7,1,0,13,0,0,0
32540,8093,2020-11-18T16:21:49.5750906Z,2020,17,4,12,6,0,4to,0,0,11,0,0,13,5,0,17,0,0,0
32540,8094,2020-11-18T16:21:49.5750906Z,2020,14,4,9,7,0,5to,1,0,7,0,0,10,5,0,13,0,0,0
32540,8095,2020-11-18T16:21:49.5760915Z,2020,22,5,18,8,0,6to,1,1,14,0,0,17,4,0,21,1,0,0
32540,8096,2020-11-18T16:21:49.5760915Z,2020,13,5,6,6,0,7mo,0,0,7,0,0,8,7,0,13,1,0,0
32540,8097,2020-11-18T16:21:49.5760915Z,2020,21,6,16,8,0,8vo,1,0,13,0,0,15,5,0,20,1,0,0
32540,8098,2020-11-18T16:21:49.5770933Z,2020,16,1,13,8,0,K,0,1,8,0,0,15,3,0,16,0,0,0
10512,30046,2021-06-24T13:18:05.8506454Z,2021,41,14,35,17,0,1ro,0,0,24,0,0,27,6,0,41,0,0,0
10512,30047,2021-06-24T13:18:05.8506454Z,2021,39,15,34,18,0,2do,0,0,21,0,0,24,5,0,39,0,0,0
10512,30048,2021-06-24T13:18:05.8506454Z,2021,47,16,38,20,0,3ro,0,0,27,0,0,31,9,0,47,0,1,0
10512,30049,2021-06-24T13:18:05.8516454Z,2021,49,20,47,21,0,4to,0,0,28,0,0,29,2,0,49,0,0,0
10512,30050,2021-06-24T13:18:05.8516454Z,2021,43,18,40,23,0,5to,1,0,20,0,0,25,3,0,42,0,1,0
10512,30051,2021-06-24T13:18:05.8516454Z,2021,78,31,64,40,0,6to,2,1,38,0,0,47,14,0,76,0,0,0
10512,30052,2021-06-24T13:18:05.8516454Z,2021,78,30,68,43,0,7mo,0,0,35,0,0,48,10,0,78,0,0,0
10512,30053,2021-06-24T13:18:05.8526459Z,2021,69,26,62,37,0,8vo,0,1,32,0,0,43,7,0,69,0,0,0
10512,30054,2021-06-24T13:18:05.8526459Z,2021,32,6,24,17,0,K,0,0,15,0,0,26,8,1,31,0,0,0
10512,30055,2021-06-24T13:18:05.8526459Z,2021,5,5,5,0,0,Sin Grado,0,0,5,0,0,0,0,0,5,0,1,0
10512,45,2020-11-18T16:20:36.6964948Z,2019,50,17,39,19,0,1ro,0,0,31,0,0,33,11,0,50,0,1,0
10512,46,2020-11-18T16:20:36.6974952Z,2019,47,15,43,22,0,2do,0,1,25,0,0,32,4,0,47,0,1,0
10512,47,2020-11-18T16:20:36.6974952Z,2019,33,12,25,17,0,3ro,0,0,16,0,0,21,8,0,33,0,0,0
10512,48,2020-11-18T16:20:36.6974952Z,2019,47,17,38,28,0,4to,0,1,19,0,0,30,9,0,47,0,1,0
10512,49,2020-11-18T16:20:36.6974952Z,2019,56,18,47,33,0,5to,0,0,23,0,0,38,9,0,56,0,0,0
10512,50,2020-11-18T16:20:36.6984961Z,2019,66,25,50,36,0,6to,0,0,30,0,0,41,16,0,66,0,0,0
10512,51,2020-11-18T16:20:36.6984961Z,2019,68,22,52,31,0,7mo,1,0,37,0,0,46,16,0,67,0,0,0
10512,52,2020-11-18T16:20:36.6984961Z,2019,48,24,34,16,0,8vo,1,0,32,0,0,24,14,0,47,0,0,0
10512,53,2020-11-18T16:20:36.6984961Z,2019,44,16,1,18,0,K,0,0,26,0,0,28,43,0,44,0,0,0
10512,54,2020-11-18T16:20:36.6984961Z,2019,6,6,6,0,0,Sin Grado,0,0,6,0,0,0,0,0,6,0,1,0
10512,6047,2020-11-18T16:21:37.6911659Z,2020,47,17,41,23,0,1ro,0,0,24,0,0,30,6,0,47,0,0,0
10512,6048,2020-11-18T16:21:37.6921655Z,2020,45,16,41,19,0,2do,0,0,26,0,0,29,4,0,45,0,1,0
10512,6049,2020-11-18T16:21:37.6921655Z,2020,53,17,47,25,0,3ro,0,0,28,0,0,36,6,0,53,0,1,0
10512,6050,2020-11-18T16:21:37.6921655Z,2020,45,20,36,24,0,4to,1,0,21,0,0,25,9,0,44,0,0,0
10512,6051,2020-11-18T16:21:37.6921655Z,2020,51,21,43,25,0,5to,0,0,26,0,0,30,8,0,51,0,1,0
10512,6052,2020-11-18T16:21:37.6921655Z,2020,83,28,70,46,0,6to,0,0,37,0,0,55,13,0,83,0,0,0
10512,6053,2020-11-18T16:21:37.6931664Z,2020,73,29,58,39,0,7mo,0,0,34,0,0,44,15,0,73,0,0,0
10512,6054,2020-11-18T16:21:37.6931664Z,2020,65,18,49,29,0,8vo,0,0,36,0,0,47,16,0,65,0,0,0
10512,6055,2020-11-18T16:21:37.6931664Z,2020,35,11,27,13,0,K,0,0,22,0,0,24,8,0,35,0,0,0
10512,6056,2020-11-18T16:21:37.6931664Z,2020,7,7,7,0,0,Sin Grado,0,0,7,0,0,0,0,0,7,0,1,0
21881,1276,2020-11-18T16:20:45.1040995Z,2019,34,16,27,15,0,1ro,1,0,19,0,0,18,7,0,33,0,0,0
21881,1277,2020-11-18T16:20:45.1040995Z,2019,30,7,26,16,0,2do,0,0,14,0,0,23,4,0,30,0,0,0
21881,1278,2020-11-18T16:20:45.1040995Z,2019,41,12,32,19,0,3ro,0,0,22,0,0,29,9,0,41,0,0,0
21881,1279,2020-11-18T16:20:45.1040995Z,2019,42,14,40,20,0,4to,0,0,22,0,0,28,2,0,42,0,0,0
21881,1280,2020-11-18T16:20:45.1050995Z,2019,34,11,24,18,0,5to,0,0,16,0,0,23,10,0,34,0,0,0
21881,1281,2020-11-18T16:20:45.1050995Z,2019,51,25,40,25,0,6to,0,0,26,0,0,26,11,0,51,0,0,0
21881,1282,2020-11-18T16:20:45.1050995Z,2019,42,15,35,17,0,7mo,0,0,25,0,0,27,7,0,42,0,0,0
21881,1283,2020-11-18T16:20:45.1050995Z,2019,49,24,41,27,0,8vo,0,0,22,0,0,25,8,0,49,0,0,0
21881,1284,2020-11-18T16:20:45.1050995Z,2019,23,10,20,5,0,K,1,0,18,0,0,13,3,0,22,0,0,0
21881,1285,2020-11-18T16:20:45.1061009Z,2019,4,4,2,1,0,Sin Grado,0,1,3,0,0,0,2,0,4,0,0,0
21881,31277,2021-06-24T13:18:14.0295094Z,2021,28,9,25,11,0,1ro,0,0,17,0,0,19,3,0,28,0,0,0
21881,31278,2021-06-24T13:18:14.0295094Z,2021,19,6,18,4,0,2do,0,0,15,0,0,13,1,0,19,0,0,0
21881,31279,2021-06-24T13:18:14.0295094Z,2021,35,18,33,15,0,3ro,1,1,20,0,0,17,2,0,34,0,0,0
21881,31280,2021-06-24T13:18:14.0305104Z,2021,26,7,25,15,0,4to,0,0,11,0,0,19,1,0,26,0,0,0
21881,31281,2021-06-24T13:18:14.0305104Z,2021,39,10,35,18,0,5to,0,1,21,0,0,29,4,0,39,0,0,0
21881,31282,2021-06-24T13:18:14.0305104Z,2021,43,14,40,18,0,6to,0,0,25,0,0,29,3,0,43,0,0,0
21881,31283,2021-06-24T13:18:14.0305104Z,2021,40,14,34,20,0,7mo,0,0,20,0,0,26,6,0,40,0,0,0
21881,31284,2021-06-24T13:18:14.0315113Z,2021,42,17,38,20,0,8vo,0,0,22,0,0,25,4,0,42,0,0,0
21881,31285,2021-06-24T13:18:14.0315113Z,2021,22,6,21,13,0,K,0,0,9,0,0,16,1,0,22,0,0,0
21881,31286,2021-06-24T13:18:14.0315113Z,2021,9,9,8,2,0,Sin Grado,0,3,7,0,0,0,1,0,9,0,0,0
21881,7281,2020-11-18T16:21:44.6077786Z,2020,20,8,17,6,0,1ro,1,0,14,0,0,12,3,0,19,0,0,0
21881,7282,2020-11-18T16:21:44.6077786Z,2020,38,18,31,16,0,2do,1,1,22,0,0,20,7,0,37,0,0,0
21881,7283,2020-11-18T16:21:44.6077786Z,2020,28,8,24,15,0,3ro,0,0,13,0,0,20,4,0,28,0,0,0
21881,7284,2020-11-18T16:21:44.6087795Z,2020,41,13,32,21,0,4to,0,2,20,0,0,28,9,0,41,0,0,0
21881,7285,2020-11-18T16:21:44.6087795Z,2020,42,14,39,17,0,5to,0,0,25,0,0,28,3,0,42,0,0,0
21881,7286,2020-11-18T16:21:44.6087795Z,2020,40,14,28,18,0,6to,0,0,22,0,0,26,12,0,40,0,0,0
21881,7287,2020-11-18T16:21:44.6097804Z,2020,43,18,34,21,0,7mo,0,0,22,0,0,25,9,0,43,0,0,0
21881,7288,2020-11-18T16:21:44.6097804Z,2020,37,12,30,13,0,8vo,0,0,24,0,0,25,7,0,37,0,0,0
21881,7289,2020-11-18T16:21:44.6097804Z,2020,30,5,25,13,0,K,0,0,17,0,0,25,5,0,30,0,0,0
21881,7290,2020-11-18T16:21:44.6097804Z,2020,6,6,5,0,0,Sin Grado,0,0,6,0,0,0,1,0,6,0,0,0
13334,30493,2021-06-24T13:18:09.5182751Z,2021,14,2,14,7,0,1ro,0,0,7,0,0,12,0,0,14,0,0,0
13334,30494,2021-06-24T13:18:09.5192751Z,2021,6,1,6,4,0,2do,0,0,2,0,0,5,0,0,6,0,0,0
13334,30495,2021-06-24T13:18:09.5192751Z,2021,9,1,9,1,0,3ro,0,0,8,0,0,8,0,0,9,0,0,0
13334,30496,2021-06-24T13:18:09.5192751Z,2021,8,2,7,5,0,4to,0,0,3,0,0,6,1,0,8,0,0,0
13334,30497,2021-06-24T13:18:09.5192751Z,2021,8,2,8,6,0,5to,0,0,2,0,0,6,0,0,8,0,0,0
13334,30498,2021-06-24T13:18:09.520276Z,2021,14,3,14,6,0,6to,0,0,8,0,0,11,0,0,14,0,1,0
13334,30499,2021-06-24T13:18:09.520276Z,2021,12,2,10,3,0,7mo,0,0,9,0,0,10,2,0,12,0,1,0
13334,30500,2021-06-24T13:18:10.3488706Z,2021,6,0,6,4,0,8vo,0,1,2,0,0,6,0,0,6,0,1,0
13334,30501,2021-06-24T13:18:10.3498707Z,2021,14,2,14,5,0,K,0,0,9,0,0,12,0,0,14,0,0,0
13334,496,2020-11-18T16:20:40.0747448Z,2019,11,2,10,6,0,1ro,0,0,5,0,0,9,1,0,11,0,0,0
13334,497,2020-11-18T16:20:40.0757466Z,2019,7,1,6,3,0,2do,0,0,4,0,0,6,1,0,7,0,0,0
13334,498,2020-11-18T16:20:40.0757466Z,2019,8,2,8,6,0,3ro,0,0,2,0,0,6,0,0,8,0,0,0
13334,499,2020-11-18T16:20:40.0757466Z,2019,13,2,12,5,0,4to,2,0,8,0,0,11,1,0,11,0,1,0
13334,500,2020-11-18T16:20:40.0757466Z,2019,11,0,8,3,0,5to,0,0,8,0,0,11,3,0,11,0,1,0
13334,501,2020-11-18T16:20:40.7562003Z,2019,7,2,7,5,0,6to,0,1,2,0,0,5,0,0,7,0,1,0
13334,502,2020-11-18T16:20:40.7562003Z,2019,5,2,4,4,0,7mo,0,0,1,0,0,3,1,0,5,0,0,0
13334,503,2020-11-18T16:20:40.7562003Z,2019,8,3,3,3,0,8vo,0,0,5,0,0,5,5,0,8,0,0,0
13334,504,2020-11-18T16:20:40.7562003Z,2019,5,1,4,4,0,K,0,0,1,0,0,4,1,0,5,0,0,0
13334,6495,2020-11-18T16:21:39.6824948Z,2020,7,0,6,4,0,1ro,0,0,3,0,0,7,1,0,7,0,0,0
13334,6496,2020-11-18T16:21:39.6824948Z,2020,12,1,11,5,0,2do,0,0,7,0,0,11,1,0,12,0,0,0
13334,6497,2020-11-18T16:21:39.6824948Z,2020,8,2,7,3,0,3ro,0,0,5,0,0,6,1,0,8,0,0,0
13334,6498,2020-11-18T16:21:39.6824948Z,2020,8,2,8,6,0,4to,0,0,2,0,0,6,0,0,8,0,0,0
13334,6499,2020-11-18T16:21:39.6824948Z,2020,16,3,13,7,0,5to,2,0,9,0,0,13,3,0,14,0,1,0
13334,6500,2020-11-18T16:21:39.6834948Z,2020,11,0,9,3,0,6to,0,0,8,0,0,11,2,0,11,0,1,0
13334,6501,2020-11-18T16:21:40.3399346Z,2020,6,0,6,5,0,7mo,0,1,1,0,0,6,0,0,6,0,1,0
13334,6502,2020-11-18T16:21:40.3399346Z,2020,5,2,4,4,0,8vo,0,0,1,0,0,3,1,0,5,0,0,0
13334,6503,2020-11-18T16:21:40.3399346Z,2020,16,3,14,7,0,K,0,0,9,0,0,13,2,0,16,0,0,0
12666,30387,2021-06-24T13:18:08.8568005Z,2021,12,3,11,4,0,1ro,0,0,8,0,0,9,1,0,12,0,0,0
12666,30388,2021-06-24T13:18:08.8568005Z,2021,13,6,13,8,0,2do,0,0,5,0,0,7,0,0,13,0,0,0
12666,30389,2021-06-24T13:18:08.8568005Z,2021,16,6,15,7,0,3ro,0,0,9,0,0,10,1,0,16,0,0,0
12666,30390,2021-06-24T13:18:08.8578006Z,2021,19,6,17,6,0,4to,1,0,13,0,0,13,2,0,18,0,0,0
12666,30391,2021-06-24T13:18:08.8578006Z,2021,11,3,11,8,0,5to,0,0,3,0,0,8,0,0,11,0,0,0
12666,30392,2021-06-24T13:18:08.8578006Z,2021,14,6,13,8,0,6to,0,0,6,0,0,8,1,0,14,0,0,0
12666,30393,2021-06-24T13:18:08.8578006Z,2021,22,9,20,12,0,7mo,0,0,10,0,0,13,2,0,22,0,0,0
12666,30394,2021-06-24T13:18:08.8578006Z,2021,10,6,9,3,0,8vo,0,0,7,0,0,4,1,0,10,0,0,0
12666,30395,2021-06-24T13:18:08.8588015Z,2021,15,1,15,7,0,K,0,0,8,0,0,14,0,0,15,0,0,0
12666,30396,2021-06-24T13:18:08.8588015Z,2021,6,6,6,1,0,Sin Grado,0,0,5,0,0,0,0,0,6,0,0,0
12666,389,2020-11-18T16:20:39.6514623Z,2019,20,8,19,8,0,1ro,0,0,12,0,0,12,1,0,20,0,0,0
12666,390,2020-11-18T16:20:39.6524641Z,2019,18,8,15,5,0,2do,1,0,13,0,0,10,3,0,17,0,0,0
12666,391,2020-11-18T16:20:39.6524641Z,2019,11,4,10,7,0,3ro,0,0,4,0,0,7,1,0,11,0,0,0
12666,392,2020-11-18T16:20:39.6524641Z,2019,14,5,11,9,0,4to,0,0,5,0,0,9,3,0,13,0,1,1
12666,393,2020-11-18T16:20:39.6524641Z,2019,20,7,16,10,0,5to,0,0,10,0,0,13,4,0,20,0,0,0
12666,394,2020-11-18T16:20:39.6534645Z,2019,15,7,15,4,0,6to,0,0,11,0,0,8,0,0,14,0,1,1
12666,395,2020-11-18T16:20:39.6534645Z,2019,20,6,17,6,0,7mo,0,0,14,0,0,14,3,0,20,1,0,0
12666,396,2020-11-18T16:20:39.6534645Z,2019,12,5,11,3,0,8vo,1,0,9,0,0,7,1,0,11,0,0,0
12666,397,2020-11-18T16:20:39.6534645Z,2019,12,3,12,7,0,K,0,0,5,0,0,9,0,0,11,0,0,1
12666,398,2020-11-18T16:20:39.6544659Z,2019,9,9,9,2,0,Sin Grado,0,0,7,0,0,0,0,0,9,0,0,0
12666,6390,2020-11-18T16:21:39.2592127Z,2020,10,4,10,6,0,1ro,0,0,4,0,0,6,0,0,10,0,0,0
12666,6391,2020-11-18T16:21:39.2592127Z,2020,18,7,15,8,0,2do,0,0,10,0,0,11,3,0,18,0,0,0
12666,6392,2020-11-18T16:21:39.2602136Z,2020,16,6,11,5,0,3ro,1,0,11,0,0,10,5,0,15,0,0,0
12666,6393,2020-11-18T16:21:39.2602136Z,2020,12,4,12,8,0,4to,0,0,4,0,0,8,0,0,12,0,0,0
12666,6394,2020-11-18T16:21:39.2602136Z,2020,15,7,14,8,0,5to,0,0,7,0,0,8,1,0,14,0,1,1
12666,6395,2020-11-18T16:21:39.2602136Z,2020,20,7,16,11,0,6to,0,0,9,0,0,13,4,0,20,0,0,0
12666,6396,2020-11-18T16:21:39.261214Z,2020,13,7,13,4,0,7mo,0,0,9,0,0,6,0,0,12,0,1,1
12666,6397,2020-11-18T16:21:39.261214Z,2020,18,5,16,5,0,8vo,0,0,13,0,0,13,2,0,18,1,0,0
12666,6398,2020-11-18T16:21:39.261214Z,2020,15,3,13,5,0,K,0,0,10,0,0,12,2,0,14,0,0,1
12666,6399,2020-11-18T16:21:39.2622149Z,2020,7,7,7,1,0,Sin Grado,0,0,6,0,0,0,0,0,7,0,0,0
43745,2934,2020-11-18T16:20:59.9089694Z,2019,15,5,11,8,0,1ro,0,0,7,0,0,10,4,0,15,0,0,0
43745,2935,2020-11-18T16:20:59.9089694Z,2019,20,5,18,13,0,2do,0,0,7,0,0,15,2,0,20,0,0,0
43745,2936,2020-11-18T16:20:59.9089694Z,2019,24,10,20,14,0,3ro,1,0,10,0,0,14,4,0,23,0,0,0
43745,2937,2020-11-18T16:20:59.9099707Z,2019,29,5,22,17,0,4to,2,0,12,0,0,24,7,0,27,0,0,0
43745,2938,2020-11-18T16:20:59.9099707Z,2019,30,8,23,17,0,5to,1,0,13,0,0,22,7,0,29,0,0,0
43745,2939,2020-11-18T16:20:59.9109716Z,2019,53,16,40,26,0,6to,3,0,27,0,0,37,13,0,50,0,1,0
43745,2940,2020-11-18T16:20:59.9109716Z,2019,42,11,30,19,0,7mo,1,0,23,0,0,31,12,0,41,0,0,0
43745,2941,2020-11-18T16:20:59.9109716Z,2019,51,13,37,22,0,8vo,1,0,29,0,0,38,14,0,50,1,0,0
43745,2942,2020-11-18T16:20:59.9119721Z,2019,24,6,23,12,0,K,1,0,12,0,0,18,1,0,23,0,0,0
43745,32943,2021-06-24T13:18:28.8871697Z,2021,25,6,19,12,0,1ro,2,0,13,0,0,19,6,0,23,0,0,0
43745,32944,2021-06-24T13:18:28.8881706Z,2021,22,5,21,15,0,2do,1,0,7,0,0,17,1,0,21,0,0,0
43745,32945,2021-06-24T13:18:28.8881706Z,2021,21,6,18,9,0,3ro,0,0,12,0,0,15,3,0,21,0,0,0
43745,32946,2021-06-24T13:18:28.8881706Z,2021,28,5,26,16,0,4to,0,0,12,0,0,23,2,0,28,0,0,0
43745,32947,2021-06-24T13:18:28.8881706Z,2021,30,11,26,16,0,5to,0,0,14,0,0,19,4,0,30,0,0,0
43745,32948,2021-06-24T13:18:28.8891707Z,2021,53,17,45,26,0,6to,2,0,27,0,0,36,8,0,51,0,1,0
43745,32949,2021-06-24T13:18:28.8891707Z,2021,34,9,32,17,0,7mo,2,0,17,0,0,25,2,0,32,0,1,0
43745,32950,2021-06-24T13:18:28.8891707Z,2021,70,19,57,33,0,8vo,2,0,37,0,0,51,13,0,68,0,0,0
43745,32951,2021-06-24T13:18:28.8891707Z,2021,26,4,20,12,0,K,0,0,14,0,0,22,6,0,25,0,0,1
43745,8947,2020-11-18T16:21:54.9937047Z,2020,21,6,21,12,0,1ro,2,0,9,0,0,15,0,0,19,0,0,0
43745,8948,2020-11-18T16:21:54.9937047Z,2020,14,4,10,7,0,2do,0,0,7,0,0,10,4,0,14,0,0,0
43745,8949,2020-11-18T16:21:54.9937047Z,2020,20,3,16,13,0,3ro,0,0,7,0,0,17,4,0,20,0,0,0
43745,8950,2020-11-18T16:21:54.9937047Z,2020,27,11,21,16,0,4to,1,0,11,0,0,16,6,0,26,0,0,0
43745,8951,2020-11-18T16:21:54.9947051Z,2020,33,5,24,19,0,5to,2,0,14,0,0,28,9,0,31,0,0,0
43745,8952,2020-11-18T16:21:54.9947051Z,2020,32,8,27,17,0,6to,3,0,15,0,0,24,5,0,29,0,0,0
43745,8953,2020-11-18T16:21:54.9947051Z,2020,51,15,42,24,0,7mo,3,0,27,0,0,36,9,0,48,0,0,0
43745,8954,2020-11-18T16:21:54.9947051Z,2020,41,9,33,18,0,8vo,1,0,23,0,0,32,8,0,40,0,0,0
43745,8955,2020-11-18T16:21:54.9947051Z,2020,16,2,13,10,0,K,1,0,6,0,0,14,3,0,15,0,0,0
51433,33411,2021-06-24T13:18:32.4587305Z,2021,14,3,13,2,0,1ro,2,0,12,0,0,11,1,0,12,0,0,0
51433,33412,2021-06-24T13:18:32.4587305Z,2021,18,8,15,5,0,2do,0,0,13,0,0,10,3,0,18,0,0,0
51433,33413,2021-06-24T13:18:32.4587305Z,2021,19,4,15,8,0,3ro,1,3,11,0,0,15,4,0,18,0,0,0
51433,33414,2021-06-24T13:18:32.4587305Z,2021,21,6,16,14,0,4to,0,1,7,0,0,15,5,0,21,0,0,0
51433,33415,2021-06-24T13:18:32.459731Z,2021,23,7,22,8,0,5to,0,1,15,0,0,16,1,0,23,0,0,0
51433,33416,2021-06-24T13:18:32.459731Z,2021,32,9,27,15,0,6to,2,3,17,0,0,23,5,0,30,1,0,0
51433,33417,2021-06-24T13:18:32.4607324Z,2021,39,10,34,18,0,7mo,1,4,21,0,0,29,5,0,38,0,0,0
51433,33418,2021-06-24T13:18:32.4607324Z,2021,26,5,24,16,0,8vo,1,1,10,0,0,21,2,0,25,0,0,0
51433,33419,2021-06-24T13:18:32.4607324Z,2021,18,5,11,5,0,K,1,1,13,0,0,13,7,0,17,0,0,0
51433,3386,2020-11-18T16:21:02.1544699Z,2019,14,1,10,7,0,1ro,0,0,7,0,0,13,4,0,14,0,0,0
51433,3387,2020-11-18T16:21:02.1554707Z,2019,19,4,13,13,0,2do,0,0,6,0,0,15,6,0,19,0,0,0
51433,3388,2020-11-18T16:21:02.1554707Z,2019,18,7,16,7,0,3ro,0,2,11,0,0,11,2,0,18,0,0,0
51433,3389,2020-11-18T16:21:02.1554707Z,2019,23,8,17,8,0,4to,1,0,15,0,0,15,6,0,22,0,0,0
51433,3390,2020-11-18T16:21:02.1554707Z,2019,30,5,25,12,0,5to,2,3,18,0,0,25,5,0,28,0,0,0
51433,3391,2020-11-18T16:21:02.1554707Z,2019,26,4,21,18,0,6to,1,1,8,0,0,22,5,0,25,0,0,0
51433,3392,2020-11-18T16:21:02.1564716Z,2019,37,11,27,14,0,7mo,2,5,23,0,0,26,10,0,35,0,1,0
51433,3393,2020-11-18T16:21:02.1564716Z,2019,32,13,28,12,0,8vo,0,1,20,0,0,19,4,0,32,0,1,0
51433,3394,2020-11-18T16:21:02.1564716Z,2019,15,4,13,2,0,K,0,0,13,0,0,11,2,0,15,0,0,0
51433,3395,2020-11-18T16:21:02.1564716Z,2019,2,1,2,0,0,Sin Grado,0,0,2,0,0,1,0,0,2,0,0,0
51433,9406,2020-11-18T16:21:58.4119814Z,2020,19,9,16,5,0,1ro,0,0,14,0,0,10,3,0,19,0,0,0
51433,9407,2020-11-18T16:21:58.4129823Z,2020,16,1,10,6,0,2do,0,3,10,0,0,15,6,0,16,0,0,0
51433,9408,2020-11-18T16:21:58.4129823Z,2020,20,4,13,15,0,3ro,0,1,5,0,0,16,7,0,20,0,0,0
51433,9409,2020-11-18T16:21:58.4129823Z,2020,23,9,20,9,0,4to,0,1,14,0,0,14,3,0,23,0,0,0
51433,9410,2020-11-18T16:21:58.4129823Z,2020,21,7,19,8,0,5to,1,4,13,0,0,14,2,0,20,0,0,0
51433,9411,2020-11-18T16:21:58.4139823Z,2020,41,8,30,19,0,6to,1,4,22,0,0,33,11,0,40,0,0,0
51433,9412,2020-11-18T16:21:58.4139823Z,2020,24,5,20,17,0,7mo,1,1,7,0,0,19,4,0,23,0,0,0
51433,9413,2020-11-18T16:21:58.4139823Z,2020,42,10,25,19,0,8vo,2,6,23,0,0,32,17,0,40,0,1,0
51433,9414,2020-11-18T16:21:58.4139823Z,2020,12,4,8,3,0,K,0,0,9,0,0,8,4,0,12,0,0,0
51433,9415,2020-11-18T16:21:58.4139823Z,2020,3,3,3,2,0,Sin Grado,0,0,1,0,0,0,0,0,3,0,0,0
71050,11197,2020-11-18T16:22:08.3325968Z,2020,33,7,29,16,0,1ro,0,1,17,0,0,26,4,0,33,0,0,0
71050,11198,2020-11-18T16:22:08.3325968Z,2020,36,15,29,13,0,2do,0,4,23,0,0,21,7,0,36,0,0,0
71050,11199,2020-11-18T16:22:08.3325968Z,2020,34,16,29,16,0,3ro,0,3,18,0,0,18,5,0,34,0,0,0
71050,11200,2020-11-18T16:22:08.3335977Z,2020,36,11,31,17,0,4to,1,1,19,0,0,25,5,0,35,0,0,0
71050,11201,2020-11-18T16:22:09.5594159Z,2020,39,19,36,24,0,5to,0,0,15,0,0,20,3,0,39,0,0,0
71050,11202,2020-11-18T16:22:09.5594159Z,2020,56,26,42,26,0,6to,0,0,30,0,0,30,14,0,56,0,0,0
71050,11203,2020-11-18T16:22:09.5594159Z,2020,47,10,34,18,0,7mo,0,0,29,0,0,37,13,0,47,0,0,0
71050,11204,2020-11-18T16:22:09.5594159Z,2020,55,12,43,32,0,8vo,0,0,23,0,0,43,12,0,55,0,0,0
71050,11205,2020-11-18T16:22:09.5604168Z,2020,38,13,31,22,0,K,0,6,16,0,0,25,7,0,38,0,0,0
71050,11206,2020-11-18T16:22:09.5604168Z,2020,7,7,7,2,0,PK,0,0,5,0,0,0,0,0,7,0,0,0
71050,11207,2020-11-18T16:22:09.5604168Z,2020,18,18,17,7,0,Sin Grado,0,0,11,0,0,0,1,0,18,0,0,0
71050,35218,2021-06-24T13:18:44.8025819Z,2021,33,8,28,18,0,1ro,0,0,15,0,0,25,5,0,33,0,0,0
71050,35219,2021-06-24T13:18:44.8035829Z,2021,35,6,33,16,0,2do,0,0,19,0,0,29,2,0,35,0,0,0
71050,35220,2021-06-24T13:18:44.8035829Z,2021,29,14,24,11,0,3ro,0,0,18,0,0,15,5,0,29,0,0,0
71050,35221,2021-06-24T13:18:44.8035829Z,2021,34,17,30,15,0,4to,0,0,19,0,0,17,4,0,34,0,0,0
71050,35222,2021-06-24T13:18:44.8035829Z,2021,37,9,34,17,0,5to,1,0,20,0,0,28,3,0,36,0,0,0
71050,35223,2021-06-24T13:18:44.8045834Z,2021,41,19,36,24,0,6to,0,0,17,0,0,22,5,0,41,0,0,0
71050,35224,2021-06-24T13:18:44.8045834Z,2021,58,25,49,28,0,7mo,0,0,30,0,0,33,9,0,58,0,0,0
71050,35225,2021-06-24T13:18:44.8045834Z,2021,49,11,41,19,0,8vo,0,0,30,0,0,38,8,0,49,0,0,0
71050,35226,2021-06-24T13:18:44.8045834Z,2021,21,5,16,9,0,K,0,0,12,0,0,16,5,0,21,0,0,0
71050,35227,2021-06-24T13:18:44.8045834Z,2021,4,4,4,1,0,PK,0,0,3,0,0,0,0,0,4,0,0,0
71050,35228,2021-06-24T13:18:44.8055848Z,2021,19,19,14,7,0,Sin Grado,0,0,12,0,0,0,5,0,19,0,0,0
71050,5192,2020-11-18T16:21:14.0453987Z,2019,38,18,31,14,0,1ro,0,1,24,0,0,20,7,0,38,1,0,0
71050,5193,2020-11-18T16:21:14.0453987Z,2019,33,17,30,15,0,2do,0,0,18,0,0,16,3,0,33,0,0,0
71050,5194,2020-11-18T16:21:14.0453987Z,2019,35,13,29,15,0,3ro,1,0,20,0,0,22,6,0,34,0,0,0
71050,5195,2020-11-18T16:21:14.0463996Z,2019,43,18,39,25,0,4to,0,0,18,0,0,25,4,0,43,0,0,0
71050,5196,2020-11-18T16:21:14.0463996Z,2019,52,23,41,26,0,5to,0,1,26,0,0,29,11,0,52,0,0,0
71050,5197,2020-11-18T16:21:14.0463996Z,2019,46,10,32,18,0,6to,0,0,28,0,0,36,14,0,46,0,0,0
71050,5198,2020-11-18T16:21:14.0474005Z,2019,52,13,37,28,0,7mo,0,0,24,0,0,39,15,0,52,0,0,0
71050,5199,2020-11-18T16:21:14.0474005Z,2019,45,16,36,16,0,8vo,0,0,29,0,0,29,9,0,45,0,0,0
71050,5200,2020-11-18T16:21:14.0474005Z,2019,40,6,34,20,0,K,0,0,20,0,0,34,6,0,40,0,0,0
71050,5201,2020-11-18T16:21:14.4246494Z,2019,9,9,6,3,0,PK,0,1,6,0,0,0,3,0,9,0,0,0
71050,5202,2020-11-18T16:21:14.4246494Z,2019,23,18,22,10,0,Sin Grado,0,0,13,0,0,5,1,0,23,0,0,0
36046,2443,2020-11-18T16:20:56.2575367Z,2019,174,29,159,90,0,6to,3,0,84,0,0,145,15,3,167,0,0,1
36046,2444,2020-11-18T16:20:56.2585389Z,2019,173,26,147,86,0,7mo,1,0,87,0,0,147,26,3,169,0,0,0
36046,2445,2020-11-18T16:20:56.2585389Z,2019,194,23,165,96,0,8vo,4,1,98,0,0,171,29,2,188,0,0,0
36046,2446,2020-11-18T16:20:56.2585389Z,2019,1,0,1,1,0,Sin Grado,0,0,0,0,0,1,0,0,1,0,0,0
36046,32451,2021-06-24T13:18:24.7161779Z,2021,94,5,88,44,0,6to,4,55,50,0,0,89,6,3,87,0,1,0
36046,32452,2021-06-24T13:18:24.7161779Z,2021,111,11,107,55,0,7mo,2,53,56,0,0,100,4,3,106,1,1,0
36046,32453,2021-06-24T13:18:24.719179Z,2021,128,23,121,66,0,8vo,1,1,62,0,0,105,7,3,124,0,0,0
36046,8456,2020-11-18T16:21:51.7975696Z,2020,114,14,100,55,0,6to,2,0,59,0,0,100,14,2,110,1,1,0
36046,8457,2020-11-18T16:21:51.7975696Z,2020,132,20,120,70,0,7mo,1,0,62,0,0,112,12,3,127,0,0,1
36046,8458,2020-11-18T16:21:51.7975696Z,2020,118,15,95,54,0,8vo,0,0,64,0,0,103,23,3,115,0,0,0
21873,1267,2020-11-18T16:20:45.1010969Z,2019,17,1,6,8,0,1ro,0,0,9,0,0,16,11,0,17,0,0,0
21873,1268,2020-11-18T16:20:45.1010969Z,2019,20,5,13,9,0,2do,0,0,11,0,0,15,7,0,20,0,0,0
21873,1269,2020-11-18T16:20:45.1010969Z,2019,17,1,9,8,0,3ro,0,0,9,0,0,16,8,0,17,0,0,0
21873,1270,2020-11-18T16:20:45.1020973Z,2019,19,0,9,9,0,4to,0,0,10,0,0,19,10,0,19,0,0,0
21873,1271,2020-11-18T16:20:45.1020973Z,2019,13,1,5,10,0,5to,1,0,3,0,0,12,8,0,12,0,1,0
21873,1272,2020-11-18T16:20:45.1020973Z,2019,22,0,13,11,0,6to,0,0,11,0,0,22,9,0,22,0,0,0
21873,1273,2020-11-18T16:20:45.1020973Z,2019,18,0,6,10,0,7mo,0,0,8,0,0,18,12,0,18,0,0,0
21873,1274,2020-11-18T16:20:45.1020973Z,2019,15,0,8,8,0,8vo,0,0,7,0,0,15,7,0,15,0,0,0
21873,1275,2020-11-18T16:20:45.1030982Z,2019,22,3,12,14,0,K,0,0,8,0,0,19,10,0,21,0,0,1
21873,31268,2021-06-24T13:18:14.023506Z,2021,19,3,15,7,0,1ro,0,0,12,0,0,16,4,0,19,0,0,0
21873,31269,2021-06-24T13:18:14.023506Z,2021,22,1,16,13,0,2do,0,0,9,0,0,21,6,0,21,0,0,1
21873,31270,2021-06-24T13:18:14.0245056Z,2021,25,0,22,12,0,3ro,1,0,13,0,0,25,3,0,24,0,0,0
21873,31271,2021-06-24T13:18:14.0245056Z,2021,27,3,23,13,0,4to,0,0,14,0,0,24,4,0,27,0,0,0
21873,31272,2021-06-24T13:18:14.0245056Z,2021,27,2,22,16,0,5to,0,0,11,0,0,25,5,0,27,0,0,0
21873,31273,2021-06-24T13:18:14.0245056Z,2021,22,0,18,10,0,6to,0,0,12,0,0,22,4,0,22,0,0,0
21873,31274,2021-06-24T13:18:14.0245056Z,2021,17,1,11,12,0,7mo,2,0,5,0,0,16,6,0,15,0,1,0
21873,31275,2021-06-24T13:18:14.0255066Z,2021,22,0,15,12,0,8vo,0,0,10,0,0,22,7,0,22,0,0,0
21873,31276,2021-06-24T13:18:14.0255066Z,2021,25,2,23,13,0,K,0,0,12,0,0,23,2,0,25,0,0,0
21873,7272,2020-11-18T16:21:44.6047769Z,2020,25,2,17,14,0,1ro,1,0,11,0,0,23,8,0,23,0,0,1
21873,7273,2020-11-18T16:21:44.6057782Z,2020,22,1,16,13,0,2do,2,0,9,0,0,21,6,0,20,0,0,0
21873,7274,2020-11-18T16:21:44.6057782Z,2020,22,3,16,11,0,3ro,0,0,11,0,0,19,6,0,22,0,0,0
21873,7275,2020-11-18T16:21:44.6057782Z,2020,21,1,11,12,0,4to,0,0,9,0,0,20,10,0,21,0,0,0
21873,7276,2020-11-18T16:21:44.6067782Z,2020,24,0,14,12,0,5to,1,0,12,0,0,24,10,0,23,0,0,0
21873,7277,2020-11-18T16:21:44.6067782Z,2020,17,1,8,12,0,6to,2,0,5,0,0,16,9,0,15,0,1,0
21873,7278,2020-11-18T16:21:44.6067782Z,2020,20,0,13,11,0,7mo,0,0,9,0,0,20,7,0,20,0,0,0
21873,7279,2020-11-18T16:21:44.6067782Z,2020,19,0,7,10,0,8vo,1,0,9,0,0,19,12,0,18,0,0,0
21873,7280,2020-11-18T16:21:44.6077786Z,2020,18,4,13,7,0,K,0,0,11,0,0,14,5,0,18,0,0,0
20214,30895,2021-06-24T13:18:11.4646705Z,2021,34,9,25,17,0,1ro,2,0,17,0,0,25,9,0,32,0,0,0
20214,30896,2021-06-24T13:18:11.4646705Z,2021,30,6,21,19,0,2do,0,0,11,0,0,24,9,0,30,0,0,0
20214,30897,2021-06-24T13:18:11.4656719Z,2021,30,13,21,11,0,3ro,2,0,19,0,0,17,9,0,28,0,0,0
20214,30898,2021-06-24T13:18:11.4656719Z,2021,36,13,28,14,0,4to,0,0,22,0,0,23,8,0,36,0,0,0
20214,30899,2021-06-24T13:18:11.4656719Z,2021,35,9,21,22,0,5to,0,0,13,0,0,26,14,0,35,0,0,0
20214,30900,2021-06-24T13:18:11.7818978Z,2021,43,15,22,20,0,6to,0,0,23,0,0,28,21,0,43,0,1,0
20214,30901,2021-06-24T13:18:11.7818978Z,2021,31,14,21,18,0,7mo,0,0,13,0,0,17,10,0,31,0,0,0
20214,30902,2021-06-24T13:18:11.7818978Z,2021,44,21,31,19,0,8vo,0,0,25,0,0,23,13,0,44,0,0,0
20214,30903,2021-06-24T13:18:11.7818978Z,2021,23,9,20,12,0,9no,0,0,11,0,0,14,3,0,23,0,0,0
20214,30904,2021-06-24T13:18:11.7828983Z,2021,33,9,24,13,0,K,0,0,20,0,0,24,9,0,33,0,0,0
20214,30905,2021-06-24T13:18:11.7828983Z,2021,60,9,51,29,0,PK,0,0,31,0,0,51,9,0,60,0,0,0
20214,6899,2020-11-18T16:21:42.057075Z,2020,34,4,21,20,0,1ro,1,1,14,0,0,30,13,0,33,0,0,0
20214,6900,2020-11-18T16:21:42.057075Z,2020,28,12,15,9,0,2do,2,1,19,0,0,16,13,0,26,0,0,0
20214,6901,2020-11-18T16:21:42.5754208Z,2020,34,11,24,15,0,3ro,0,0,19,0,0,23,10,0,34,0,0,0
20214,6902,2020-11-18T16:21:42.5754208Z,2020,37,9,17,21,0,4to,0,0,16,0,0,28,20,0,37,0,0,0
20214,6903,2020-11-18T16:21:42.5764217Z,2020,41,12,20,19,0,5to,0,0,22,0,0,29,21,0,41,0,0,0
20214,6904,2020-11-18T16:21:42.5764217Z,2020,33,12,21,19,0,6to,0,0,14,0,0,21,12,0,33,0,0,0
20214,6905,2020-11-18T16:21:42.5764217Z,2020,45,21,29,20,0,7mo,0,0,25,0,0,24,16,0,45,0,0,0
20214,6906,2020-11-18T16:21:42.5764217Z,2020,30,11,21,16,0,8vo,0,0,14,0,0,19,9,0,30,0,0,0
20214,6907,2020-11-18T16:21:42.5764217Z,2020,35,8,20,19,0,9no,0,0,16,0,0,27,15,0,35,0,0,0
20214,6908,2020-11-18T16:21:42.5774226Z,2020,30,6,18,13,0,K,1,1,17,0,0,24,12,0,29,0,0,0
20214,6909,2020-11-18T16:21:42.5774226Z,2020,64,8,47,31,0,PK,0,1,33,0,0,56,17,0,64,0,0,0
20214,898,2020-11-18T16:20:42.6554643Z,2019,34,15,21,12,0,1ro,2,0,22,0,0,19,13,0,32,0,0,0
20214,899,2020-11-18T16:20:42.6554643Z,2019,30,9,20,13,0,2do,0,1,17,0,0,21,10,0,30,0,0,0
20214,900,2020-11-18T16:20:42.6554643Z,2019,32,8,18,17,0,3ro,0,1,15,0,0,24,14,0,32,0,0,0
20214,901,2020-11-18T16:20:43.3599347Z,2019,42,13,21,21,0,4to,0,0,21,0,0,29,21,0,42,0,0,0
20214,902,2020-11-18T16:20:43.3599347Z,2019,29,9,19,18,0,5to,0,0,11,0,0,20,10,0,29,0,0,0
20214,903,2020-11-18T16:20:43.3599347Z,2019,44,19,27,24,0,6to,0,0,20,0,0,25,17,0,44,0,0,0
20214,904,2020-11-18T16:20:43.3599347Z,2019,35,15,25,17,0,7mo,0,0,18,0,0,20,10,0,35,0,0,0
20214,905,2020-11-18T16:20:43.3599347Z,2019,40,10,20,21,0,8vo,0,0,19,0,0,30,20,0,40,0,0,0
20214,906,2020-11-18T16:20:43.3609342Z,2019,24,10,16,14,0,9no,0,0,10,0,0,14,8,0,24,0,0,0
20214,907,2020-11-18T16:20:43.3609342Z,2019,34,4,23,17,0,K,0,0,17,0,0,30,11,0,34,0,0,0
20214,908,2020-11-18T16:20:43.3609342Z,2019,60,11,35,30,0,PK,0,1,30,0,0,49,25,0,60,0,0,0
71357,11272,2020-11-18T16:22:09.5884346Z,2020,31,9,24,13,0,1ro,1,0,18,0,0,22,7,0,30,0,0,0
71357,11273,2020-11-18T16:22:09.5884346Z,2020,19,4,17,15,0,2do,1,0,4,0,0,15,2,0,18,0,0,0
71357,11274,2020-11-18T16:22:09.5884346Z,2020,31,6,25,11,0,3ro,0,0,20,0,0,25,6,0,31,0,0,0
71357,11275,2020-11-18T16:22:09.5884346Z,2020,38,18,32,17,0,4to,0,0,21,0,0,20,6,0,38,0,0,0
71357,11276,2020-11-18T16:22:09.5894355Z,2020,33,12,25,17,0,5to,1,0,16,0,0,21,8,0,32,1,0,0
71357,11277,2020-11-18T16:22:09.5894355Z,2020,47,18,37,23,0,6to,1,0,24,0,0,29,10,0,46,2,0,0
71357,11278,2020-11-18T16:22:09.5894355Z,2020,47,16,33,23,0,7mo,0,0,24,0,0,31,14,0,47,0,0,0
71357,11279,2020-11-18T16:22:09.5894355Z,2020,51,15,35,26,0,8vo,1,0,25,0,0,36,16,0,50,2,0,0
71357,11280,2020-11-18T16:22:09.5904373Z,2020,35,8,31,15,0,K,0,0,20,0,0,27,4,0,35,0,0,0
71357,35293,2021-06-24T13:18:44.8456121Z,2021,28,7,25,11,0,1ro,0,0,17,0,0,21,3,0,28,0,0,0
71357,35294,2021-06-24T13:18:44.8456121Z,2021,30,9,24,12,0,2do,1,0,18,0,0,21,6,0,29,0,0,0
71357,35295,2021-06-24T13:18:44.8456121Z,2021,19,4,14,14,0,3ro,1,0,5,0,0,15,5,0,18,0,0,0
71357,35296,2021-06-24T13:18:44.8456121Z,2021,35,10,28,12,0,4to,0,0,23,0,0,25,7,0,35,0,0,0
71357,35297,2021-06-24T13:18:44.8466166Z,2021,33,14,28,16,0,5to,0,0,17,0,0,19,5,0,33,0,0,0
71357,35298,2021-06-24T13:18:44.8466166Z,2021,30,11,25,16,0,6to,0,0,14,0,0,19,5,0,30,2,0,0
71357,35299,2021-06-24T13:18:44.8466166Z,2021,44,18,35,22,0,7mo,1,0,22,0,0,26,9,0,43,2,0,0
71357,35300,2021-06-24T13:18:45.5451139Z,2021,44,13,36,21,0,8vo,0,0,23,0,0,31,8,0,44,0,0,0
71357,35301,2021-06-24T13:18:45.5451139Z,2021,23,1,20,10,0,K,0,0,13,0,0,22,3,0,23,0,0,0
71357,5267,2020-11-18T16:21:14.4706804Z,2019,21,7,18,14,0,1ro,1,0,7,0,0,14,3,0,20,0,0,0
71357,5268,2020-11-18T16:21:14.4706804Z,2019,31,5,25,12,0,2do,0,0,19,0,0,26,6,0,31,0,0,0
71357,5269,2020-11-18T16:21:14.4706804Z,2019,33,14,28,16,0,3ro,0,0,17,0,0,19,5,0,33,0,0,0
71357,5270,2020-11-18T16:21:14.4706804Z,2019,27,10,20,13,0,4to,1,0,14,0,0,17,7,0,26,0,0,0
71357,5271,2020-11-18T16:21:14.4716803Z,2019,54,23,42,23,0,5to,1,0,31,0,0,31,12,0,53,2,0,0
71357,5272,2020-11-18T16:21:14.4716803Z,2019,50,20,36,22,0,6to,0,0,28,0,0,30,14,0,50,0,0,0
71357,5273,2020-11-18T16:21:14.4716803Z,2019,50,16,34,24,0,7mo,1,0,26,0,0,34,16,0,49,1,0,0
71357,5274,2020-11-18T16:21:14.4716803Z,2019,33,7,19,15,0,8vo,0,0,18,0,0,26,14,0,33,0,0,0
71357,5275,2020-11-18T16:21:14.4716803Z,2019,30,9,24,11,0,K,0,0,19,0,0,21,6,0,30,0,0,0
30759,1848,2020-11-18T16:20:52.4810202Z,2019,57,18,50,27,0,1ro,1,0,30,0,0,39,7,0,56,0,0,0
30759,1849,2020-11-18T16:20:52.4820216Z,2019,68,27,52,38,0,2do,3,0,30,0,0,41,16,0,65,0,1,0
30759,1850,2020-11-18T16:20:52.4820216Z,2019,72,18,56,27,0,3ro,2,0,45,0,0,54,16,0,70,0,1,0
30759,1851,2020-11-18T16:20:52.4820216Z,2019,64,17,46,22,0,4to,2,0,42,0,0,47,18,0,62,0,0,0
30759,1852,2020-11-18T16:20:52.4820216Z,2019,78,17,57,39,0,5to,0,0,39,0,0,61,21,0,78,1,1,0
30759,1853,2020-11-18T16:20:52.4820216Z,2019,77,18,58,39,0,6to,1,0,38,0,0,59,19,0,76,0,0,0
30759,1854,2020-11-18T16:20:52.483022Z,2019,96,23,62,52,0,7mo,1,0,44,0,0,73,34,0,95,0,0,0
30759,1855,2020-11-18T16:20:52.483022Z,2019,99,21,59,52,0,8vo,2,0,47,0,0,78,40,0,97,0,0,0
30759,1856,2020-11-18T16:20:52.483022Z,2019,31,8,24,15,0,K,0,0,16,0,0,23,7,0,31,0,0,0
30759,1857,2020-11-18T16:20:52.483022Z,2019,14,14,12,4,0,Sin Grado,0,0,10,0,0,0,2,1,13,0,0,0
30759,31853,2021-06-24T13:18:17.7681898Z,2021,43,8,39,25,0,1ro,0,0,18,0,0,35,4,0,43,0,0,0
30759,31854,2021-06-24T13:18:17.7681898Z,2021,33,5,27,13,0,2do,0,0,20,0,0,28,6,0,33,0,0,0
30759,31855,2021-06-24T13:18:17.7691908Z,2021,67,16,56,35,0,3ro,1,0,32,0,0,51,11,0,66,0,0,0
30759,31856,2021-06-24T13:18:17.7691908Z,2021,79,28,62,45,0,4to,5,0,34,0,0,51,17,0,74,0,2,0
30759,31857,2021-06-24T13:18:17.7691908Z,2021,74,14,60,28,0,5to,2,0,46,0,0,60,14,0,72,0,0,0
30759,31858,2021-06-24T13:18:17.7691908Z,2021,75,14,54,32,0,6to,3,0,43,0,0,61,21,0,72,0,0,0
30759,31859,2021-06-24T13:18:17.7691908Z,2021,90,24,73,46,0,7mo,1,0,44,0,0,66,17,0,89,0,1,0
30759,31860,2021-06-24T13:18:17.7701917Z,2021,75,21,57,37,0,8vo,1,0,38,0,0,54,18,0,74,0,0,0
30759,31861,2021-06-24T13:18:17.7701917Z,2021,48,4,37,26,0,K,1,0,22,0,0,44,11,0,47,0,0,0
30759,31862,2021-06-24T13:18:17.7701917Z,2021,13,13,13,7,0,Sin Grado,0,0,6,0,0,0,0,0,13,0,0,0
30759,7856,2020-11-18T16:21:48.4793584Z,2020,27,7,22,10,0,1ro,1,0,17,0,0,20,5,0,26,0,0,0
30759,7857,2020-11-18T16:21:48.4793584Z,2020,57,16,47,29,0,2do,1,0,28,0,0,41,10,0,56,0,0,0
30759,7858,2020-11-18T16:21:48.4803602Z,2020,73,28,56,40,0,3ro,4,0,33,0,0,45,17,0,69,0,2,0
30759,7859,2020-11-18T16:21:48.4803602Z,2020,70,19,51,25,0,4to,1,0,45,0,0,51,19,0,69,0,0,0
30759,7860,2020-11-18T16:21:48.4803602Z,2020,56,13,40,21,0,5to,3,0,35,0,0,43,16,0,53,0,0,0
30759,7861,2020-11-18T16:21:48.4803602Z,2020,85,21,67,43,0,6to,1,0,42,0,0,64,18,0,84,0,1,0
30759,7862,2020-11-18T16:21:48.4803602Z,2020,75,21,54,38,0,7mo,0,0,37,0,0,54,21,0,75,0,0,0
30759,7863,2020-11-18T16:21:48.4813606Z,2020,93,17,61,53,0,8vo,1,0,40,0,0,76,32,0,91,0,0,1
30759,7864,2020-11-18T16:21:48.4813606Z,2020,42,7,18,23,0,K,0,0,19,0,0,35,24,0,41,0,0,1
30759,7865,2020-11-18T16:21:48.4813606Z,2020,13,13,12,4,0,Sin Grado,1,0,9,0,0,0,1,1,11,0,0,0
11494,194,2020-11-18T16:20:37.5820819Z,2019,18,3,14,11,0,1ro,1,0,7,0,0,15,4,0,16,0,0,1
11494,195,2020-11-18T16:20:37.5820819Z,2019,25,7,22,13,0,2do,1,0,12,0,0,18,3,0,23,0,0,1
11494,196,2020-11-18T16:20:37.5830828Z,2019,20,5,19,9,0,3ro,1,0,11,0,0,15,1,0,18,0,0,1
11494,197,2020-11-18T16:20:37.5830828Z,2019,32,8,26,15,0,4to,1,0,17,0,0,24,6,0,30,0,0,1
11494,198,2020-11-18T16:20:37.5830828Z,2019,35,9,28,16,0,5to,0,0,19,0,0,26,7,0,33,0,0,2
11494,199,2020-11-18T16:20:37.5830828Z,2019,37,12,29,24,0,6to,0,0,13,0,0,25,8,0,35,0,1,2
11494,200,2020-11-18T16:20:37.5840828Z,2019,26,9,20,14,0,7mo,0,0,12,0,0,17,6,0,26,0,0,0
11494,201,2020-11-18T16:20:38.7538625Z,2019,24,6,20,11,0,8vo,0,0,13,0,0,18,4,0,22,0,0,2
11494,202,2020-11-18T16:20:38.7548634Z,2019,21,4,19,16,0,K,0,0,5,0,0,17,2,0,20,0,0,1
11494,203,2020-11-18T16:20:38.7548634Z,2019,12,10,12,1,0,Sin Grado,1,0,11,0,0,2,0,0,10,0,1,1
11494,30193,2021-06-24T13:18:06.3299902Z,2021,13,3,13,4,0,1ro,0,0,9,0,0,10,0,0,12,0,0,1
11494,30194,2021-06-24T13:18:06.3299902Z,2021,21,5,18,10,0,2do,0,0,11,0,0,16,3,0,20,0,0,1
11494,30195,2021-06-24T13:18:06.3299902Z,2021,17,6,13,10,0,3ro,1,0,7,0,0,11,4,0,15,0,0,1
11494,30196,2021-06-24T13:18:06.3299902Z,2021,21,8,19,8,0,4to,1,0,13,0,0,13,2,0,20,0,0,0
11494,30197,2021-06-24T13:18:06.3309894Z,2021,21,6,20,9,0,5to,1,0,12,0,0,15,1,0,19,0,0,1
11494,30198,2021-06-24T13:18:06.3309894Z,2021,30,6,27,16,0,6to,2,0,14,0,0,24,3,0,27,0,0,1
11494,30199,2021-06-24T13:18:06.3309894Z,2021,36,9,28,17,0,7mo,0,0,19,0,0,27,8,0,34,1,0,2
11494,30200,2021-06-24T13:18:07.0635146Z,2021,34,9,28,21,0,8vo,0,0,13,0,0,25,6,0,32,0,1,2
11494,30201,2021-06-24T13:18:07.0635146Z,2021,14,3,11,7,0,K,0,0,7,0,0,11,3,0,14,0,0,0
11494,30202,2021-06-24T13:18:07.0645151Z,2021,11,11,11,2,0,Sin Grado,0,0,9,0,0,0,0,0,10,0,0,1
11494,6195,2020-11-18T16:21:38.2625465Z,2020,22,3,20,12,0,1ro,0,0,10,0,0,19,2,0,21,0,0,1
11494,6196,2020-11-18T16:21:38.2625465Z,2020,19,4,15,10,0,2do,1,0,9,0,0,15,4,0,17,0,0,1
11494,6197,2020-11-18T16:21:38.2625465Z,2020,25,8,22,13,0,3ro,1,0,12,0,0,17,3,0,23,0,0,1
11494,6198,2020-11-18T16:21:38.2625465Z,2020,20,5,19,8,0,4to,1,0,12,0,0,15,1,0,18,0,0,1
11494,6199,2020-11-18T16:21:38.2635465Z,2020,30,4,23,16,0,5to,2,0,14,0,0,26,7,0,27,0,0,1
11494,6200,2020-11-18T16:21:38.2635465Z,2020,37,10,30,15,0,6to,0,0,22,0,0,27,7,0,35,0,0,2
11494,6201,2020-11-18T16:21:38.6157822Z,2020,37,13,30,22,0,7mo,0,0,15,0,0,24,7,0,35,0,1,2
11494,6202,2020-11-18T16:21:38.6157822Z,2020,24,6,17,13,0,8vo,0,0,11,0,0,18,7,0,24,0,0,0
11494,6203,2020-11-18T16:21:38.6167831Z,2020,16,1,16,6,0,K,0,0,10,0,0,15,0,0,15,0,0,1
11494,6204,2020-11-18T16:21:38.6167831Z,2020,11,11,11,1,0,Sin Grado,0,0,10,0,0,0,0,0,10,0,0,1
21865,1258,2020-11-18T16:20:45.0970937Z,2019,60,24,51,27,0,1ro,0,1,33,0,0,36,9,0,60,0,0,0
21865,1259,2020-11-18T16:20:45.0970937Z,2019,49,15,41,24,0,2do,1,0,25,0,0,34,8,0,48,0,1,0
21865,1260,2020-11-18T16:20:45.0970937Z,2019,49,17,39,22,0,3ro,1,0,27,0,0,32,10,0,48,0,0,0
21865,1261,2020-11-18T16:20:45.0970937Z,2019,52,12,42,34,0,4to,0,0,18,0,0,40,10,0,52,1,2,0
21865,1262,2020-11-18T16:20:45.0970937Z,2019,54,14,39,32,0,5to,0,0,22,0,0,40,15,0,54,0,0,0
21865,1263,2020-11-18T16:20:45.0980955Z,2019,32,10,26,19,0,6to,0,0,13,0,0,22,6,0,32,0,1,0
21865,1264,2020-11-18T16:20:45.0980955Z,2019,64,16,48,31,0,7mo,0,0,33,0,0,48,16,0,64,0,0,0
21865,1265,2020-11-18T16:20:45.0980955Z,2019,54,19,41,21,0,8vo,0,0,33,0,0,35,13,0,54,0,0,0
21865,1266,2020-11-18T16:20:45.0980955Z,2019,40,13,31,20,0,K,0,0,20,0,0,27,9,0,40,0,0,0
21865,31259,2021-06-24T13:18:14.0245056Z,2021,47,14,39,22,0,1ro,0,0,25,0,0,33,8,0,47,0,0,0
21865,31260,2021-06-24T13:18:14.0245056Z,2021,40,9,35,21,0,2do,0,0,19,0,0,31,5,0,40,0,0,0
21865,31261,2021-06-24T13:18:14.0255066Z,2021,49,19,44,21,0,3ro,0,1,28,0,0,30,5,0,49,0,0,0
21865,31262,2021-06-24T13:18:14.0255066Z,2021,45,13,39,24,0,4to,0,0,21,0,0,32,6,0,44,0,0,1
21865,31263,2021-06-24T13:18:14.0255066Z,2021,48,18,42,21,0,5to,1,0,27,0,0,30,6,0,47,0,0,0
21865,31264,2021-06-24T13:18:14.0255066Z,2021,46,8,41,31,0,6to,0,1,15,0,0,38,5,0,46,1,0,0
21865,31265,2021-06-24T13:18:14.0265071Z,2021,47,13,41,31,0,7mo,0,0,16,0,0,34,6,0,47,0,0,0
21865,31266,2021-06-24T13:18:14.0265071Z,2021,35,12,31,20,0,8vo,0,0,15,0,0,23,4,0,35,0,0,0
21865,31267,2021-06-24T13:18:14.0265071Z,2021,44,8,35,21,0,K,0,0,23,0,0,36,9,0,44,0,0,0
21865,7263,2020-11-18T16:21:44.6017746Z,2020,36,8,29,18,0,1ro,0,1,18,0,0,28,7,0,36,0,0,0
21865,7264,2020-11-18T16:21:44.6017746Z,2020,53,19,45,24,0,2do,0,3,29,0,0,34,8,0,53,0,0,0
21865,7265,2020-11-18T16:21:44.6017746Z,2020,45,14,38,22,0,3ro,0,2,23,0,0,31,7,0,44,0,0,1
21865,7266,2020-11-18T16:21:44.602776Z,2020,47,17,37,23,0,4to,1,0,24,0,0,30,10,0,46,0,0,0
21865,7267,2020-11-18T16:21:44.602776Z,2020,49,13,42,30,0,5to,0,1,19,0,0,36,7,0,49,0,0,0
21865,7268,2020-11-18T16:21:44.602776Z,2020,49,12,38,31,0,6to,0,3,18,0,0,37,11,0,49,0,0,0
21865,7269,2020-11-18T16:21:44.603776Z,2020,36,12,29,21,0,7mo,0,1,15,0,0,24,7,0,36,0,0,0
21865,7270,2020-11-18T16:21:44.603776Z,2020,62,16,46,31,0,8vo,0,1,31,0,0,46,16,0,62,0,0,0
21865,7271,2020-11-18T16:21:44.603776Z,2020,50,14,37,22,0,K,0,2,28,0,0,36,13,0,50,0,0,0
32458,2057,2020-11-18T16:20:53.9099685Z,2019,13,4,11,6,0,1ro,0,0,7,0,0,9,2,0,13,0,0,0
32458,2058,2020-11-18T16:20:53.9099685Z,2019,17,6,10,6,0,2do,0,0,11,0,0,11,7,0,17,0,0,0
32458,2059,2020-11-18T16:20:53.9109694Z,2019,19,5,11,10,0,3ro,1,0,9,0,0,14,8,0,18,0,0,0
32458,2060,2020-11-18T16:20:53.9109694Z,2019,20,5,17,5,0,4to,2,0,15,0,0,15,3,0,18,0,0,0
32458,2061,2020-11-18T16:20:53.9109694Z,2019,18,6,14,8,0,5to,0,0,10,0,0,12,4,0,18,0,0,0
32458,2062,2020-11-18T16:20:53.9119694Z,2019,40,8,30,17,0,6to,0,0,23,0,0,32,10,0,40,0,0,0
32458,2063,2020-11-18T16:20:53.9119694Z,2019,38,9,32,19,0,7mo,0,1,19,0,0,29,6,0,38,0,1,0
32458,2064,2020-11-18T16:20:53.9119694Z,2019,46,5,36,19,0,8vo,0,2,27,0,0,41,10,0,46,0,0,0
32458,2065,2020-11-18T16:20:53.9119694Z,2019,8,1,7,5,0,K,0,0,3,0,0,7,1,0,8,0,0,0
32458,32063,2021-06-24T13:18:20.0938579Z,2021,12,2,10,9,0,1ro,0,0,3,0,0,10,2,0,12,0,0,0
32458,32064,2021-06-24T13:18:20.0938579Z,2021,11,1,10,6,0,2do,0,0,5,0,0,10,1,0,11,0,0,0
32458,32065,2021-06-24T13:18:20.0938579Z,2021,13,1,12,9,0,3ro,1,0,4,0,0,12,1,0,12,0,0,0
32458,32066,2021-06-24T13:18:20.0938579Z,2021,19,3,13,9,0,4to,0,0,10,0,0,16,6,0,19,0,0,0
32458,32067,2021-06-24T13:18:20.0948588Z,2021,17,3,16,8,0,5to,3,0,9,0,0,14,1,0,14,0,1,0
32458,32068,2021-06-24T13:18:20.0948588Z,2021,30,4,25,11,0,6to,2,0,19,0,0,26,5,0,28,0,0,0
32458,32069,2021-06-24T13:18:20.0948588Z,2021,35,7,27,22,0,7mo,2,0,13,0,0,28,8,0,33,0,1,0
32458,32070,2021-06-24T13:18:20.0958593Z,2021,48,10,37,23,0,8vo,0,0,25,0,0,38,11,0,48,0,0,0
32458,32071,2021-06-24T13:18:20.0958593Z,2021,9,1,6,5,0,K,0,0,4,0,0,8,3,0,9,0,0,0
32458,8069,2020-11-18T16:21:49.5730906Z,2020,6,0,5,4,0,1ro,0,0,2,0,0,6,1,0,6,0,0,0
32458,8070,2020-11-18T16:21:49.5730906Z,2020,15,2,13,9,0,2do,0,0,6,0,0,13,2,0,15,0,0,0
32458,8071,2020-11-18T16:21:49.574091Z,2020,19,5,12,9,0,3ro,0,0,10,0,0,14,7,0,19,0,0,0
32458,8072,2020-11-18T16:21:49.574091Z,2020,20,5,18,9,0,4to,2,0,11,0,0,15,2,0,18,0,0,0
32458,8073,2020-11-18T16:21:49.574091Z,2020,23,4,17,9,0,5to,2,0,14,0,0,19,6,0,21,0,0,0
32458,8074,2020-11-18T16:21:49.5750906Z,2020,35,8,29,21,0,6to,2,0,14,0,0,27,6,0,33,0,0,0
32458,8075,2020-11-18T16:21:49.5750906Z,2020,45,10,33,21,0,7mo,0,0,24,0,0,35,12,0,45,0,0,0
32458,8076,2020-11-18T16:21:49.5750906Z,2020,31,10,24,16,0,8vo,0,0,15,0,0,21,7,0,31,0,1,0
32458,8077,2020-11-18T16:21:49.5760915Z,2020,11,1,9,8,0,K,0,0,3,0,0,10,2,0,11,0,0,0
31393,1949,2020-11-18T16:20:53.3996295Z,2019,31,5,26,18,0,1ro,2,0,13,0,0,26,5,0,28,0,0,1
31393,1950,2020-11-18T16:20:53.4006299Z,2019,36,12,32,17,0,2do,1,0,19,0,0,24,4,0,35,1,0,0
31393,1951,2020-11-18T16:20:53.4006299Z,2019,32,3,26,15,0,3ro,0,0,17,0,0,29,6,0,31,0,0,1
31393,1952,2020-11-18T16:20:53.4006299Z,2019,33,6,29,16,0,4to,1,0,17,0,0,27,4,0,32,0,0,0
31393,1953,2020-11-18T16:20:53.4016308Z,2019,39,10,30,25,0,5to,3,0,14,0,0,29,9,0,36,0,0,0
31393,1954,2020-11-18T16:20:53.4016308Z,2019,18,8,15,10,0,K,0,0,8,0,0,10,3,0,17,0,0,1
31393,1955,2020-11-18T16:20:53.4016308Z,2019,13,12,13,6,0,Sin Grado,0,0,7,0,0,1,0,0,13,0,0,0
31393,31958,2021-06-24T13:18:18.6848485Z,2021,33,10,32,11,0,1ro,0,0,22,0,0,23,1,0,33,0,0,0
31393,31959,2021-06-24T13:18:18.6858485Z,2021,16,5,14,8,0,2do,0,0,8,0,0,11,2,0,16,0,0,0
31393,31960,2021-06-24T13:18:18.6858485Z,2021,31,5,28,17,0,3ro,0,0,14,0,0,26,3,0,31,0,0,0
31393,31961,2021-06-24T13:18:18.6858485Z,2021,26,12,23,13,0,4to,1,0,13,0,0,14,3,0,25,0,0,0
31393,31962,2021-06-24T13:18:18.6868499Z,2021,33,5,31,16,0,5to,0,0,17,0,0,28,2,0,33,0,0,0
31393,31963,2021-06-24T13:18:18.6868499Z,2021,22,6,22,10,0,K,0,0,12,0,0,16,0,0,22,0,0,0
31393,31964,2021-06-24T13:18:18.6868499Z,2021,10,10,9,3,0,Sin Grado,0,0,7,0,0,0,1,0,10,0,0,0
31393,7961,2020-11-18T16:21:49.1387991Z,2020,18,5,14,9,0,1ro,0,1,9,0,0,13,4,0,18,0,0,0
31393,7962,2020-11-18T16:21:49.1398005Z,2020,33,9,25,15,0,2do,0,0,18,0,0,24,8,0,33,0,0,0
31393,7963,2020-11-18T16:21:49.1398005Z,2020,27,12,18,13,0,3ro,1,0,14,0,0,15,9,0,26,0,0,0
31393,7964,2020-11-18T16:21:49.1398005Z,2020,31,4,27,15,0,4to,1,0,16,0,0,27,4,0,30,0,0,0
31393,7965,2020-11-18T16:21:49.1408005Z,2020,34,5,30,17,0,5to,0,1,17,0,0,29,4,0,34,0,0,0
31393,7966,2020-11-18T16:21:49.1408005Z,2020,36,9,36,14,0,K,0,0,22,0,0,27,0,0,36,0,0,0
31393,7967,2020-11-18T16:21:49.1408005Z,2020,16,16,16,5,0,Sin Grado,0,0,11,0,0,0,0,0,16,0,0,0
58123,10020,2020-11-18T16:22:01.9383354Z,2020,74,25,62,40,0,6to,1,2,34,0,0,49,12,0,73,0,1,0
58123,10021,2020-11-18T16:22:01.9383354Z,2020,82,27,62,32,0,7mo,0,2,50,0,0,55,20,0,82,1,1,0
58123,10022,2020-11-18T16:22:01.9393363Z,2020,76,23,68,31,0,8vo,3,4,45,0,0,53,8,0,73,2,1,0
58123,10023,2020-11-18T16:22:01.9393363Z,2020,11,11,11,4,0,Sin Grado,0,0,7,0,0,0,0,0,11,0,0,0
58123,34027,2021-06-24T13:18:36.9269355Z,2021,70,18,60,35,0,6to,0,2,35,0,0,52,10,0,70,0,0,0
58123,34028,2021-06-24T13:18:36.9279351Z,2021,64,25,58,34,0,7mo,1,2,30,0,0,39,6,0,63,0,1,0
58123,34029,2021-06-24T13:18:36.9279351Z,2021,75,23,61,28,0,8vo,0,1,47,0,0,52,14,0,75,1,1,0
58123,34030,2021-06-24T13:18:36.9279351Z,2021,11,11,10,4,0,Sin Grado,0,0,7,0,0,0,1,0,11,0,0,0
58123,4003,2020-11-18T16:21:07.2848905Z,2019,86,28,64,35,0,6to,0,2,51,0,0,58,22,0,86,1,1,0
58123,4004,2020-11-18T16:21:07.2848905Z,2019,73,23,64,31,0,7mo,3,3,42,0,0,50,9,0,70,2,1,0
58123,4005,2020-11-18T16:21:07.2848905Z,2019,84,30,71,40,0,8vo,0,3,44,0,0,54,13,0,84,0,0,0
58123,4006,2020-11-18T16:21:07.2848905Z,2019,11,11,11,3,0,Sin Grado,0,1,8,0,0,0,0,0,11,0,0,0
12765,30427,2021-06-24T13:18:09.4942578Z,2021,28,7,25,18,0,1ro,2,0,10,0,0,21,3,0,26,0,0,0
12765,30428,2021-06-24T13:18:09.4942578Z,2021,12,3,11,6,0,2do,0,0,6,0,0,9,1,0,12,0,0,0
12765,30429,2021-06-24T13:18:09.4942578Z,2021,20,7,19,7,0,3ro,1,0,13,0,0,13,1,0,19,0,0,0
12765,30430,2021-06-24T13:18:09.4952583Z,2021,24,8,21,11,0,4to,0,0,13,0,0,16,3,0,24,0,0,0
12765,30431,2021-06-24T13:18:09.4952583Z,2021,34,11,31,17,0,5to,0,0,17,0,0,23,3,0,34,0,0,0
12765,30432,2021-06-24T13:18:09.4962593Z,2021,45,10,35,26,0,6to,0,0,19,0,0,35,10,0,45,1,1,0
12765,30433,2021-06-24T13:18:09.4962593Z,2021,35,8,30,21,0,7mo,0,0,14,0,0,27,5,0,35,1,0,0
12765,30434,2021-06-24T13:18:09.4962593Z,2021,32,10,27,15,0,8vo,0,0,17,0,0,22,5,0,32,1,0,0
12765,30435,2021-06-24T13:18:09.4962593Z,2021,20,2,18,10,0,K,0,0,10,0,0,18,2,0,20,0,0,0
12765,429,2020-11-18T16:20:40.065739Z,2019,20,7,19,7,0,1ro,1,0,13,0,0,13,1,0,19,0,0,0
12765,430,2020-11-18T16:20:40.0667395Z,2019,24,6,20,12,0,2do,0,0,12,0,0,18,4,0,24,0,0,0
12765,431,2020-11-18T16:20:40.0667395Z,2019,29,10,26,17,0,3ro,0,0,12,0,0,19,3,0,29,0,0,0
12765,432,2020-11-18T16:20:40.0667395Z,2019,25,6,22,15,0,4to,0,0,10,0,0,19,3,0,25,1,0,0
12765,433,2020-11-18T16:20:40.0667395Z,2019,18,4,18,7,0,5to,0,1,11,0,0,14,0,0,18,0,0,0
12765,434,2020-11-18T16:20:40.0677404Z,2019,31,8,24,12,0,6to,0,0,19,0,0,23,7,0,31,1,0,0
12765,435,2020-11-18T16:20:40.0677404Z,2019,47,15,37,21,0,7mo,0,0,26,0,0,32,10,0,47,1,1,0
12765,436,2020-11-18T16:20:40.0677404Z,2019,55,13,39,26,0,8vo,0,0,29,0,1,42,16,0,55,0,0,0
12765,437,2020-11-18T16:20:40.0677404Z,2019,15,2,15,6,0,K,0,1,9,0,0,13,0,0,15,0,0,0
12765,6430,2020-11-18T16:21:39.6644832Z,2020,12,4,12,5,0,1ro,0,0,7,0,0,8,0,0,12,0,0,0
12765,6431,2020-11-18T16:21:39.6644832Z,2020,19,7,17,8,0,2do,1,0,11,0,0,12,2,0,18,0,0,0
12765,6432,2020-11-18T16:21:39.6644832Z,2020,25,8,22,12,0,3ro,0,0,13,0,0,17,3,0,25,0,0,0
12765,6433,2020-11-18T16:21:39.6654832Z,2020,35,12,32,18,0,4to,0,0,17,0,0,23,3,0,35,0,0,0
12765,6434,2020-11-18T16:21:39.6654832Z,2020,23,5,21,15,0,5to,0,0,8,0,0,18,2,0,23,1,1,0
12765,6435,2020-11-18T16:21:39.6654832Z,2020,38,9,31,22,0,6to,0,0,16,0,0,29,7,0,38,1,0,0
12765,6436,2020-11-18T16:21:39.6654832Z,2020,32,9,25,13,0,7mo,0,0,19,0,0,23,7,0,32,1,0,0
12765,6437,2020-11-18T16:21:39.6654832Z,2020,48,17,37,22,0,8vo,0,0,26,0,0,31,11,0,48,1,1,0
12765,6438,2020-11-18T16:21:39.6664845Z,2020,28,6,25,18,0,K,2,0,10,0,0,22,3,0,26,0,0,0
21022,1135,2020-11-18T16:20:44.631784Z,2019,21,8,19,10,0,1ro,0,2,11,0,0,13,2,0,21,0,0,0
21022,1136,2020-11-18T16:20:44.631784Z,2019,11,5,9,6,0,2do,0,0,5,0,0,6,2,0,11,0,0,0
21022,1137,2020-11-18T16:20:44.6327836Z,2019,17,7,15,6,0,3ro,0,0,11,0,0,10,2,0,17,0,0,0
21022,1138,2020-11-18T16:20:44.6327836Z,2019,15,7,12,6,0,4to,0,0,9,0,0,8,3,0,15,0,0,0
21022,1139,2020-11-18T16:20:44.6327836Z,2019,23,11,18,12,0,5to,0,0,11,0,0,12,5,0,23,0,0,0
21022,1140,2020-11-18T16:20:44.6327836Z,2019,29,12,21,11,0,6to,0,0,18,0,0,17,8,0,29,0,0,0
21022,1141,2020-11-18T16:20:44.6327836Z,2019,36,15,27,19,0,7mo,0,0,17,0,0,21,9,0,36,0,0,0
21022,1142,2020-11-18T16:20:44.6337845Z,2019,33,15,27,16,0,8vo,1,0,17,0,0,18,6,0,32,0,0,0
21022,1143,2020-11-18T16:20:44.6337845Z,2019,13,2,12,8,0,K,0,0,5,0,0,11,1,0,13,0,0,0
21022,1144,2020-11-18T16:20:44.6337845Z,2019,4,4,4,0,0,Sin Grado,0,1,4,0,0,0,0,0,4,0,0,0
21022,31136,2021-06-24T13:18:13.0948392Z,2021,22,3,15,12,0,1ro,0,0,10,0,0,19,7,0,22,0,0,0
21022,31137,2021-06-24T13:18:13.0958402Z,2021,13,4,9,9,0,2do,0,1,4,0,0,9,4,0,13,0,0,0
21022,31138,2021-06-24T13:18:13.0958402Z,2021,20,8,17,10,0,3ro,0,0,10,0,0,12,3,0,20,0,0,0
21022,31139,2021-06-24T13:18:13.0958402Z,2021,14,6,14,6,0,4to,0,0,8,0,0,8,0,0,14,0,0,0
21022,31140,2021-06-24T13:18:13.0968411Z,2021,25,7,21,12,0,5to,0,1,13,0,0,18,4,0,25,0,0,0
21022,31141,2021-06-24T13:18:13.0968411Z,2021,33,13,31,17,0,6to,0,0,16,0,0,20,2,0,33,0,0,0
21022,31142,2021-06-24T13:18:13.0968411Z,2021,32,14,32,20,0,7mo,0,0,12,0,0,18,0,0,32,0,0,0
21022,31143,2021-06-24T13:18:13.0978416Z,2021,34,11,22,14,0,8vo,0,1,20,0,0,23,12,0,34,0,0,0
21022,31144,2021-06-24T13:18:13.098843Z,2021,10,1,6,5,0,K,0,0,5,0,0,9,4,0,10,0,0,0
21022,31145,2021-06-24T13:18:13.098843Z,2021,6,6,5,0,0,Sin Grado,0,0,6,0,0,0,1,0,6,0,0,0
21022,7140,2020-11-18T16:21:44.2005073Z,2020,13,2,12,9,0,1ro,0,1,4,0,0,11,1,0,13,0,0,0
21022,7141,2020-11-18T16:21:44.2005073Z,2020,22,7,21,11,0,2do,0,0,11,0,0,15,1,0,21,0,0,1
21022,7142,2020-11-18T16:21:44.2005073Z,2020,12,5,9,5,0,3ro,0,0,7,0,0,7,3,0,12,0,0,0
21022,7143,2020-11-18T16:21:44.2015077Z,2020,16,6,16,5,0,4to,0,0,11,0,0,10,0,0,15,0,0,1
21022,7144,2020-11-18T16:21:44.2015077Z,2020,17,8,15,9,0,5to,0,1,8,0,0,9,2,0,17,0,0,0
21022,7145,2020-11-18T16:21:44.2015077Z,2020,30,13,26,18,0,6to,0,1,12,0,0,17,4,0,30,0,0,0
21022,7146,2020-11-18T16:21:44.2025086Z,2020,28,10,20,12,0,7mo,0,0,16,0,0,18,8,0,28,0,0,0
21022,7147,2020-11-18T16:21:44.2025086Z,2020,34,16,27,17,0,8vo,0,0,17,0,0,18,7,0,34,0,0,0
21022,7148,2020-11-18T16:21:44.2025086Z,2020,14,5,12,5,0,K,0,0,9,0,0,9,2,0,14,0,0,0
21022,7149,2020-11-18T16:21:44.2025086Z,2020,9,7,8,0,0,Sin Grado,0,2,9,0,0,2,1,0,9,0,0,0
11031,122,2020-11-18T16:20:37.5630696Z,2019,24,4,21,14,0,1ro,0,0,10,0,0,20,3,0,24,0,0,0
11031,123,2020-11-18T16:20:37.5630696Z,2019,28,7,21,14,0,2do,0,0,14,0,0,21,7,0,28,0,0,0
11031,124,2020-11-18T16:20:37.5630696Z,2019,28,5,22,18,0,3ro,0,1,10,0,0,23,6,0,28,1,0,0
11031,125,2020-11-18T16:20:37.5640696Z,2019,40,10,34,19,0,4to,0,0,21,0,0,30,6,0,40,0,0,0
11031,126,2020-11-18T16:20:37.5640696Z,2019,40,9,30,19,0,5to,0,0,21,0,0,31,10,0,40,0,0,0
11031,127,2020-11-18T16:20:37.5640696Z,2019,42,10,38,16,0,6to,0,0,26,0,0,32,4,0,42,1,0,0
11031,128,2020-11-18T16:20:37.5650696Z,2019,35,10,25,18,0,7mo,0,0,17,0,0,25,10,0,35,0,0,0
11031,129,2020-11-18T16:20:37.5650696Z,2019,58,15,42,30,0,8vo,0,0,28,0,0,43,16,0,58,0,0,0
11031,130,2020-11-18T16:20:37.5650696Z,2019,27,7,23,14,0,K,0,0,13,0,0,20,4,0,27,0,0,0
11031,131,2020-11-18T16:20:37.5650696Z,2019,1,1,1,1,0,Sin Grado,0,0,0,0,0,0,0,0,1,0,0,0
11031,30122,2021-06-24T13:18:06.298966Z,2021,17,1,17,9,0,1ro,0,0,8,0,0,16,0,0,17,0,0,0
11031,30123,2021-06-24T13:18:06.298966Z,2021,22,4,20,12,0,2do,0,0,10,0,0,18,2,0,22,0,0,0
11031,30124,2021-06-24T13:18:06.298966Z,2021,22,5,21,15,0,3ro,0,0,7,0,0,17,1,0,22,0,0,0
11031,30125,2021-06-24T13:18:06.298966Z,2021,24,7,22,11,0,4to,0,0,13,0,0,17,2,0,24,0,0,0
11031,30126,2021-06-24T13:18:06.2999669Z,2021,31,7,28,19,0,5to,0,1,12,0,0,24,3,0,31,2,0,0
11031,30127,2021-06-24T13:18:06.2999669Z,2021,37,8,30,22,0,6to,0,0,15,0,0,29,7,0,37,1,0,0
11031,30128,2021-06-24T13:18:06.2999669Z,2021,49,11,39,23,0,7mo,0,0,26,0,0,38,10,0,49,1,0,0
11031,30129,2021-06-24T13:18:06.3009674Z,2021,44,10,37,19,0,8vo,0,0,25,0,0,34,7,0,44,2,0,0
11031,30130,2021-06-24T13:18:06.3009674Z,2021,18,2,14,7,0,K,0,0,11,0,0,16,4,0,18,0,0,0
11031,6123,2020-11-18T16:21:38.2455353Z,2020,24,4,20,13,0,1ro,0,0,11,0,0,20,4,0,24,0,0,0
11031,6124,2020-11-18T16:21:38.2455353Z,2020,26,3,22,15,0,2do,0,0,11,0,0,23,4,0,26,0,0,0
11031,6125,2020-11-18T16:21:38.2465362Z,2020,25,8,17,11,0,3ro,0,0,14,0,0,17,8,0,25,0,0,0
11031,6126,2020-11-18T16:21:38.2465362Z,2020,28,6,21,16,0,4to,0,0,12,0,0,22,7,0,28,2,0,0
11031,6127,2020-11-18T16:21:38.2465362Z,2020,37,8,31,20,0,5to,0,0,17,0,0,29,6,0,37,1,0,0
11031,6128,2020-11-18T16:21:38.2465362Z,2020,48,10,34,25,0,6to,0,0,23,0,0,38,14,0,48,1,0,0
11031,6129,2020-11-18T16:21:38.2465362Z,2020,45,10,35,18,0,7mo,0,0,27,0,0,35,10,0,45,2,0,0
11031,6130,2020-11-18T16:21:38.2475362Z,2020,31,9,24,17,0,8vo,0,0,14,0,0,22,7,0,31,0,0,0
11031,6131,2020-11-18T16:21:38.2475362Z,2020,18,2,17,10,0,K,0,0,8,0,0,16,1,0,18,0,0,0
11031,6132,2020-11-18T16:21:38.2475362Z,2020,1,1,1,1,0,Sin Grado,0,0,0,0,0,0,0,0,1,0,0,0
35014,2289,2020-11-18T16:20:55.0277154Z,2019,27,2,25,19,0,1ro,0,0,8,0,0,25,2,0,27,0,0,0
35014,2290,2020-11-18T16:20:55.0277154Z,2019,24,2,21,13,0,2do,0,1,11,0,0,22,3,0,24,0,0,0
35014,2291,2020-11-18T16:20:55.0277154Z,2019,37,9,32,16,0,3ro,1,1,21,0,0,28,5,0,36,0,0,0
35014,2292,2020-11-18T16:20:55.0277154Z,2019,33,13,29,16,0,4to,0,1,17,0,0,20,4,0,33,0,0,0
35014,2293,2020-11-18T16:20:55.0287158Z,2019,37,7,30,16,0,5to,1,0,21,0,0,30,7,0,34,0,0,2
35014,2294,2020-11-18T16:20:55.0287158Z,2019,47,5,40,19,0,6to,0,1,28,0,0,42,7,0,47,0,1,0
35014,2295,2020-11-18T16:20:55.0287158Z,2019,51,15,45,23,0,7mo,0,0,28,0,0,36,6,0,51,0,0,0
35014,2296,2020-11-18T16:20:55.0287158Z,2019,46,8,39,19,0,8vo,0,0,27,0,0,38,7,0,46,0,0,0
35014,2297,2020-11-18T16:20:55.0287158Z,2019,22,2,22,10,0,K,0,0,12,0,0,20,0,0,22,0,0,0
35014,2298,2020-11-18T16:20:55.0297163Z,2019,11,11,10,3,0,Sin Grado,0,0,8,0,0,0,1,0,11,0,0,0
35014,32296,2021-06-24T13:18:21.7750634Z,2021,23,2,10,12,0,1ro,0,0,11,0,0,21,13,0,23,0,0,0
35014,32297,2021-06-24T13:18:21.7750634Z,2021,26,4,24,13,0,2do,0,0,13,0,0,22,2,0,25,0,0,1
35014,32298,2021-06-24T13:18:21.7750634Z,2021,23,6,22,16,0,3ro,0,0,7,0,0,17,1,0,23,0,0,0
35014,32299,2021-06-24T13:18:21.7750634Z,2021,24,2,24,13,0,4to,0,0,11,0,0,22,0,0,24,0,0,0
35014,32300,2021-06-24T13:18:23.2671331Z,2021,29,9,25,9,0,5to,1,0,20,0,0,20,4,0,28,0,0,0
35014,32301,2021-06-24T13:18:23.2671331Z,2021,29,11,25,15,0,6to,2,0,14,0,0,18,4,0,27,0,0,0
35014,32302,2021-06-24T13:18:23.268134Z,2021,45,12,40,20,0,7mo,2,0,25,0,0,33,5,0,41,0,0,2
35014,32303,2021-06-24T13:18:23.268134Z,2021,43,6,34,15,0,8vo,0,0,28,0,0,37,9,0,43,0,0,0
35014,32304,2021-06-24T13:18:23.268134Z,2021,16,3,9,8,0,K,0,0,8,0,0,13,7,0,15,0,0,1
35014,32305,2021-06-24T13:18:23.268134Z,2021,14,14,13,5,0,Sin Grado,0,0,9,0,0,0,1,0,14,0,0,0
35014,8301,2020-11-18T16:21:51.3872973Z,2020,25,5,24,12,0,1ro,0,0,13,0,0,20,1,0,24,0,0,1
35014,8302,2020-11-18T16:21:51.3872973Z,2020,24,3,22,16,0,2do,0,0,8,0,0,21,2,0,24,0,0,0
35014,8303,2020-11-18T16:21:51.3882987Z,2020,27,3,24,13,0,3ro,0,0,14,0,0,24,3,0,27,0,0,0
35014,8304,2020-11-18T16:21:51.3882987Z,2020,34,10,27,13,0,4to,1,0,21,0,0,24,7,0,33,0,0,0
35014,8305,2020-11-18T16:21:51.3882987Z,2020,22,10,18,10,0,5to,0,0,12,0,0,12,4,0,22,0,0,0
35014,8306,2020-11-18T16:21:51.3882987Z,2020,41,11,34,18,0,6to,2,0,23,0,0,30,7,0,37,0,0,2
35014,8307,2020-11-18T16:21:51.3882987Z,2020,48,7,41,18,0,7mo,0,0,30,0,0,41,7,0,48,0,1,0
35014,8308,2020-11-18T16:21:51.3892982Z,2020,41,10,36,18,0,8vo,0,0,23,0,0,31,5,0,41,0,0,0
35014,8309,2020-11-18T16:21:51.3892982Z,2020,23,1,0,13,0,K,0,0,10,0,0,22,23,0,23,0,0,0
35014,8310,2020-11-18T16:21:51.3892982Z,2020,8,8,7,2,0,Sin Grado,0,0,6,0,0,0,1,0,8,0,0,0
11312,145,2020-11-18T16:20:37.5670727Z,2019,19,8,17,10,0,1ro,0,0,9,0,0,11,2,0,19,0,0,0
11312,146,2020-11-18T16:20:37.5670727Z,2019,13,3,11,7,0,2do,1,0,6,0,0,10,2,0,12,0,0,0
11312,147,2020-11-18T16:20:37.5670727Z,2019,19,8,16,7,0,3ro,0,0,12,0,0,11,3,0,19,0,0,0
11312,148,2020-11-18T16:20:37.5680718Z,2019,26,10,24,13,0,4to,0,0,13,0,0,16,2,0,25,0,0,1
11312,149,2020-11-18T16:20:37.5680718Z,2019,22,4,16,6,0,5to,0,0,16,0,0,18,6,0,22,0,0,0
11312,150,2020-11-18T16:20:37.5680718Z,2019,20,6,18,7,0,6to,1,0,13,0,0,14,2,0,19,0,0,0
11312,151,2020-11-18T16:20:37.5680718Z,2019,24,10,23,9,0,7mo,0,0,15,0,0,14,1,0,24,0,0,0
11312,152,2020-11-18T16:20:37.5680718Z,2019,18,3,14,11,0,8vo,0,0,7,0,0,15,4,0,18,1,2,0
11312,153,2020-11-18T16:20:37.5690727Z,2019,21,4,15,13,0,K,0,0,8,0,0,17,6,0,20,0,0,1
11312,30144,2021-06-24T13:18:06.3039702Z,2021,23,9,21,9,0,1ro,0,0,14,0,0,14,2,0,23,0,0,0
11312,30145,2021-06-24T13:18:06.3039702Z,2021,14,3,11,11,0,2do,0,0,3,0,0,11,3,0,14,0,0,0
11312,30146,2021-06-24T13:18:06.3039702Z,2021,25,10,23,14,0,3ro,1,0,11,0,0,15,2,0,24,0,1,0
11312,30147,2021-06-24T13:18:06.3049698Z,2021,21,7,19,12,0,4to,1,0,9,0,0,14,2,0,20,0,0,0
11312,30148,2021-06-24T13:18:06.3049698Z,2021,19,6,18,7,0,5to,0,0,12,0,0,13,1,0,19,0,0,0
11312,30149,2021-06-24T13:18:06.3049698Z,2021,28,10,25,14,0,6to,0,0,14,0,0,18,3,0,28,0,0,0
11312,30150,2021-06-24T13:18:06.3049698Z,2021,28,5,23,9,0,7mo,1,0,19,0,0,23,5,0,27,0,0,0
11312,30151,2021-06-24T13:18:06.3059721Z,2021,21,7,19,10,0,8vo,1,0,11,0,0,14,2,0,20,0,0,0
11312,30152,2021-06-24T13:18:06.3059721Z,2021,15,6,15,8,0,K,0,0,7,0,0,9,0,0,15,0,0,0
11312,6146,2020-11-18T16:21:38.2465362Z,2020,14,3,10,12,0,1ro,0,0,2,0,0,11,4,0,14,0,0,0
11312,6147,2020-11-18T16:21:38.2465362Z,2020,25,9,20,13,0,2do,2,0,12,0,0,16,5,0,23,0,0,0
11312,6148,2020-11-18T16:21:38.2465362Z,2020,22,6,18,13,0,3ro,3,0,9,0,0,16,4,0,19,0,0,0
11312,6149,2020-11-18T16:21:38.2475362Z,2020,20,6,17,8,0,4to,0,0,12,0,0,14,3,0,20,0,0,0
11312,6150,2020-11-18T16:21:38.2475362Z,2020,24,11,23,13,0,5to,0,0,11,0,0,13,1,0,24,0,0,0
11312,6151,2020-11-18T16:21:38.2475362Z,2020,26,5,18,7,0,6to,1,0,19,0,0,21,8,0,25,0,0,0
11312,6152,2020-11-18T16:21:38.2475362Z,2020,19,6,15,8,0,7mo,1,0,11,0,0,13,4,0,18,0,0,0
11312,6153,2020-11-18T16:21:38.2475362Z,2020,26,10,24,10,0,8vo,0,0,16,0,0,16,2,0,26,0,0,0
11312,6154,2020-11-18T16:21:38.2475362Z,2020,22,9,18,9,0,K,1,0,13,0,0,13,4,0,21,0,0,0
57835,33991,2021-06-24T13:18:36.6857615Z,2021,35,7,31,18,0,1ro,1,2,17,0,0,28,4,0,34,0,0,0
57835,33992,2021-06-24T13:18:36.6857615Z,2021,39,14,30,13,0,2do,1,0,26,0,0,25,9,0,38,0,0,0
57835,33993,2021-06-24T13:18:36.6857615Z,2021,38,12,33,18,0,3ro,0,1,20,0,0,26,5,0,38,0,0,0
57835,33994,2021-06-24T13:18:36.6867624Z,2021,39,17,31,15,0,4to,1,3,24,0,0,22,8,0,38,0,0,0
57835,33995,2021-06-24T13:18:36.6867624Z,2021,51,18,36,30,0,5to,0,1,21,0,0,33,15,0,51,0,0,0
57835,33996,2021-06-24T13:18:36.6867624Z,2021,44,11,20,22,0,K,0,2,22,0,0,33,24,0,43,0,0,1
57835,33997,2021-06-24T13:18:36.6867624Z,2021,14,13,12,5,0,Sin Grado,0,1,9,0,0,1,2,0,14,0,0,0
57835,3967,2020-11-18T16:21:06.8886254Z,2019,54,19,48,24,0,1ro,0,1,30,0,0,35,6,0,54,0,1,0
57835,3968,2020-11-18T16:21:06.8886254Z,2019,52,20,46,22,0,2do,1,0,30,0,0,32,6,0,51,0,0,0
57835,3969,2020-11-18T16:21:06.8896267Z,2019,63,27,51,35,0,3ro,2,1,28,0,0,36,12,0,61,0,0,0
57835,3970,2020-11-18T16:21:06.8896267Z,2019,55,20,47,28,0,4to,0,2,27,0,0,35,8,0,55,0,0,0
57835,3971,2020-11-18T16:21:06.8896267Z,2019,46,15,40,23,0,5to,2,0,23,0,0,31,6,0,44,0,0,0
57835,3972,2020-11-18T16:21:06.8896267Z,2019,25,4,24,5,0,K,0,0,20,0,0,21,1,0,25,0,0,0
57835,3973,2020-11-18T16:21:06.8896267Z,2019,14,12,8,3,0,Sin Grado,0,0,11,0,0,2,6,0,14,0,1,0
57835,9984,2020-11-18T16:22:01.5590843Z,2020,47,16,45,17,0,1ro,1,0,30,0,0,31,2,0,46,0,0,0
57835,9985,2020-11-18T16:22:01.5590843Z,2020,44,13,39,19,0,2do,0,0,25,0,0,31,5,0,44,0,0,0
57835,9986,2020-11-18T16:22:01.5590843Z,2020,47,18,41,19,0,3ro,1,0,28,0,0,29,6,0,46,0,0,0
57835,9987,2020-11-18T16:22:01.5600843Z,2020,60,24,46,31,0,4to,1,0,29,0,0,36,14,0,59,0,0,0
57835,9988,2020-11-18T16:22:01.5600843Z,2020,57,20,49,32,0,5to,0,0,25,0,0,37,8,0,57,0,0,0
57835,9989,2020-11-18T16:22:01.5600843Z,2020,47,9,38,25,0,K,1,0,22,0,0,38,9,0,45,0,0,1
57835,9990,2020-11-18T16:22:01.5600843Z,2020,16,16,13,6,0,Sin Grado,0,0,10,0,0,0,3,0,16,0,0,0
22020,1289,2020-11-18T16:20:45.1061009Z,2019,18,7,14,9,0,1ro,0,0,9,0,0,11,4,0,18,0,0,0
22020,1290,2020-11-18T16:20:45.1061009Z,2019,23,6,16,14,0,2do,1,0,9,0,0,17,7,0,22,0,0,0
22020,1291,2020-11-18T16:20:45.1071009Z,2019,20,9,16,8,0,3ro,0,3,12,0,0,11,4,0,20,0,0,0
22020,1292,2020-11-18T16:20:45.1071009Z,2019,19,8,12,8,0,4to,0,0,11,0,0,11,7,0,19,0,0,0
22020,1293,2020-11-18T16:20:45.1071009Z,2019,29,10,24,12,0,5to,0,2,17,0,0,19,5,0,29,0,0,0
22020,1294,2020-11-18T16:20:45.1071009Z,2019,32,15,28,10,0,6to,1,1,22,0,0,17,4,0,31,0,1,0
22020,1295,2020-11-18T16:20:45.1071009Z,2019,29,14,22,12,0,7mo,0,2,17,0,0,15,7,0,29,0,1,0
22020,1296,2020-11-18T16:20:45.1081013Z,2019,26,13,21,11,0,8vo,1,0,15,0,0,13,5,0,25,0,0,0
22020,1297,2020-11-18T16:20:45.1081013Z,2019,12,6,10,7,0,K,0,0,5,0,0,6,2,0,12,0,0,0
22020,1298,2020-11-18T16:20:45.1081013Z,2019,42,42,37,9,0,Sin Grado,0,0,33,0,0,0,5,0,42,1,0,0
22020,31290,2021-06-24T13:18:14.0325118Z,2021,18,5,14,12,0,1ro,0,0,6,0,0,13,4,0,18,0,0,0
22020,31291,2021-06-24T13:18:14.0335136Z,2021,15,9,13,5,0,2do,0,0,10,0,0,6,2,0,15,0,0,0
22020,31292,2021-06-24T13:18:14.0335136Z,2021,17,7,14,8,0,3ro,0,1,9,0,0,10,3,0,17,0,0,0
22020,31293,2021-06-24T13:18:14.0335136Z,2021,17,8,15,8,0,4to,1,0,9,0,0,9,2,0,16,0,0,0
22020,31294,2021-06-24T13:18:14.0335136Z,2021,19,4,16,10,0,5to,1,1,9,0,0,15,3,0,18,0,0,0
22020,31295,2021-06-24T13:18:14.0345128Z,2021,18,9,13,7,0,6to,0,1,11,0,0,9,5,0,18,0,0,0
22020,31296,2021-06-24T13:18:14.0345128Z,2021,27,12,23,14,0,7mo,1,1,13,0,0,15,4,0,26,0,0,0
22020,31297,2021-06-24T13:18:14.0345128Z,2021,19,11,17,7,0,8vo,0,0,12,0,0,8,2,0,19,0,0,0
22020,31298,2021-06-24T13:18:14.0345128Z,2021,19,5,18,10,0,K,1,0,9,0,0,14,1,0,17,0,0,1
22020,31299,2021-06-24T13:18:14.0355151Z,2021,32,32,31,13,0,Sin Grado,0,0,19,0,0,0,1,0,32,0,0,0
22020,7294,2020-11-18T16:21:44.6107809Z,2020,12,6,8,6,0,1ro,0,0,6,0,0,6,4,0,12,0,0,0
22020,7295,2020-11-18T16:21:44.6107809Z,2020,16,7,14,7,0,2do,0,1,9,0,0,9,2,0,16,0,0,0
22020,7296,2020-11-18T16:21:44.6107809Z,2020,22,7,16,12,0,3ro,1,0,10,0,0,15,6,0,21,0,0,0
22020,7297,2020-11-18T16:21:44.6107809Z,2020,16,5,12,8,0,4to,0,2,8,0,0,11,4,0,16,0,0,0
22020,7298,2020-11-18T16:21:44.6117813Z,2020,16,8,11,8,0,5to,0,1,8,0,0,8,5,0,16,0,0,0
22020,7299,2020-11-18T16:21:44.6117813Z,2020,26,11,21,13,0,6to,0,2,13,0,0,15,5,0,26,0,0,0
22020,7300,2020-11-18T16:21:44.6117813Z,2020,22,13,17,7,0,7mo,0,1,15,0,0,9,5,0,22,0,0,0
22020,7301,2020-11-18T16:21:45.314251Z,2020,27,13,19,11,0,8vo,0,3,16,0,0,14,8,0,27,0,1,0
22020,7302,2020-11-18T16:21:45.314251Z,2020,19,4,14,13,0,K,0,0,6,0,0,15,5,0,19,0,0,0
22020,7303,2020-11-18T16:21:45.314251Z,2020,34,34,32,9,0,Sin Grado,0,0,25,0,0,0,2,0,34,1,0,0
58248,10055,2020-11-18T16:22:01.9523455Z,2020,18,2,14,7,0,1ro,0,1,11,0,0,16,4,0,18,0,0,0
58248,10056,2020-11-18T16:22:01.9523455Z,2020,21,2,18,8,0,2do,0,2,13,0,0,19,3,0,21,0,0,0
58248,10057,2020-11-18T16:22:01.9533464Z,2020,22,5,16,9,0,3ro,0,3,13,0,0,17,6,0,22,1,0,0
58248,10058,2020-11-18T16:22:01.9533464Z,2020,10,0,8,5,0,4to,0,1,5,0,0,10,2,0,10,0,0,0
58248,10059,2020-11-18T16:22:01.9533464Z,2020,19,8,18,7,0,5to,0,2,12,0,0,11,1,0,19,0,0,0
58248,10060,2020-11-18T16:22:01.9533464Z,2020,10,2,8,7,0,6to,0,1,3,0,0,8,2,0,10,0,0,0
58248,10061,2020-11-18T16:22:01.9543464Z,2020,14,5,13,8,0,7mo,0,1,6,0,0,9,1,0,14,0,0,0
58248,10062,2020-11-18T16:22:01.9543464Z,2020,28,10,25,9,0,8vo,0,4,19,0,0,18,3,0,28,0,0,0
58248,10063,2020-11-18T16:22:01.9543464Z,2020,14,2,11,7,0,K,0,4,7,0,0,12,3,0,14,0,0,0
58248,10064,2020-11-18T16:22:01.9553464Z,2020,2,2,2,1,0,Sin Grado,0,1,1,0,0,0,0,0,2,0,0,0
58248,34063,2021-06-24T13:18:36.9719672Z,2021,18,2,13,7,0,1ro,0,0,11,0,0,16,5,0,18,0,0,0
58248,34064,2021-06-24T13:18:36.9719672Z,2021,19,4,18,8,0,2do,0,0,11,0,0,15,1,0,19,0,0,0
58248,34065,2021-06-24T13:18:36.9729681Z,2021,18,1,15,7,0,3ro,0,0,11,0,0,17,3,0,18,0,0,0
58248,34066,2021-06-24T13:18:36.9729681Z,2021,18,4,14,7,0,4to,0,0,11,0,0,14,4,0,18,1,0,0
58248,34067,2021-06-24T13:18:36.9729681Z,2021,10,1,9,4,0,5to,0,0,6,0,0,9,1,0,10,0,0,0
58248,34068,2021-06-24T13:18:36.9729681Z,2021,14,7,14,6,0,6to,0,0,8,0,0,7,0,0,14,0,0,0
58248,34069,2021-06-24T13:18:36.973969Z,2021,11,1,8,7,0,7mo,0,0,4,0,0,10,3,0,11,0,0,0
58248,34070,2021-06-24T13:18:36.973969Z,2021,15,5,14,8,0,8vo,0,0,7,0,0,10,1,0,15,0,0,0
58248,34071,2021-06-24T13:18:36.9749686Z,2021,12,1,10,4,0,K,0,0,8,0,0,11,2,0,12,0,0,0
58248,34072,2021-06-24T13:18:36.9749686Z,2021,3,3,3,0,0,Sin Grado,0,0,3,0,0,0,0,0,3,0,0,0
58248,4037,2020-11-18T16:21:07.3009012Z,2019,23,2,20,9,0,1ro,0,3,14,0,0,21,3,0,23,0,0,0
58248,4038,2020-11-18T16:21:07.3009012Z,2019,26,4,18,12,0,2do,0,4,14,0,0,22,8,0,26,1,0,0
58248,4039,2020-11-18T16:21:07.3009012Z,2019,15,1,13,8,0,3ro,0,2,7,0,0,14,2,0,15,0,0,0
58248,4040,2020-11-18T16:21:07.3009012Z,2019,16,4,13,8,0,4to,0,1,8,0,0,12,3,0,16,0,0,0
58248,4041,2020-11-18T16:21:07.3019017Z,2019,20,7,15,10,0,5to,0,0,10,0,0,13,5,0,20,0,0,0
58248,4042,2020-11-18T16:21:07.3019017Z,2019,17,7,15,9,0,6to,0,2,8,0,0,10,2,0,17,0,0,0
58248,4043,2020-11-18T16:21:07.3019017Z,2019,24,10,21,8,0,7mo,0,1,16,0,0,14,3,0,24,0,0,0
58248,4044,2020-11-18T16:21:07.3019017Z,2019,19,6,17,7,0,8vo,0,4,12,0,0,13,2,0,19,0,0,0
58248,4045,2020-11-18T16:21:07.302903Z,2019,18,1,13,7,0,K,0,3,11,0,0,17,5,0,18,0,0,0
58248,4046,2020-11-18T16:21:07.302903Z,2019,3,3,3,2,0,Sin Grado,0,1,1,0,0,0,0,0,3,0,0,0
60442,10177,2020-11-18T16:22:02.7118475Z,2020,34,6,30,9,0,10mo,1,3,25,0,0,28,4,0,33,0,0,0
60442,10178,2020-11-18T16:22:02.7118475Z,2020,37,10,32,15,0,11mo,1,2,22,0,0,27,5,0,36,0,0,0
60442,10179,2020-11-18T16:22:02.7118475Z,2020,19,4,17,13,0,12mo,0,0,6,0,0,15,2,0,19,0,0,0
60442,10180,2020-11-18T16:22:02.7118475Z,2020,62,19,55,29,0,7mo,1,5,33,0,0,43,7,0,61,0,0,0
60442,10181,2020-11-18T16:22:02.7118475Z,2020,25,9,22,12,0,8vo,0,1,13,0,0,16,3,0,25,0,0,0
60442,10182,2020-11-18T16:22:02.7128479Z,2020,50,13,38,22,0,9no,1,3,28,0,0,37,12,0,49,0,0,0
60442,10183,2020-11-18T16:22:02.7128479Z,2020,11,11,10,5,0,Sin Grado,0,1,6,0,0,0,1,0,11,0,0,0
60442,34194,2021-06-24T13:18:37.5113537Z,2021,44,9,34,19,0,10mo,1,2,25,0,0,35,10,0,43,0,0,0
60442,34195,2021-06-24T13:18:37.5123542Z,2021,31,7,30,10,0,11mo,1,5,21,0,0,24,1,0,30,0,0,0
60442,34196,2021-06-24T13:18:37.5123542Z,2021,35,10,26,14,0,12mo,1,1,21,0,0,25,9,0,34,0,0,0
60442,34197,2021-06-24T13:18:37.5123542Z,2021,43,9,39,26,0,7mo,0,2,17,0,0,34,4,0,43,0,0,0
60442,34198,2021-06-24T13:18:37.5133551Z,2021,60,18,56,26,0,8vo,1,4,34,0,0,42,4,0,59,0,0,0
60442,34199,2021-06-24T13:18:37.5133551Z,2021,30,11,23,11,0,9no,0,0,19,0,0,19,7,0,30,0,0,0
60442,34200,2021-06-24T13:18:38.0267235Z,2021,11,11,6,4,0,Sin Grado,0,4,7,0,0,0,5,0,11,0,0,0
60442,4158,2020-11-18T16:21:08.0093754Z,2019,44,11,40,19,0,10mo,1,4,25,0,0,33,4,0,43,0,0,0
60442,4159,2020-11-18T16:21:08.0103749Z,2019,20,4,17,14,0,11mo,0,0,6,0,0,16,3,0,20,0,0,0
60442,4160,2020-11-18T16:21:08.0103749Z,2019,32,1,32,13,0,12mo,0,1,19,0,0,31,0,0,32,0,0,0
60442,4161,2020-11-18T16:21:08.0103749Z,2019,63,17,56,31,0,6to,1,1,32,0,0,46,7,0,62,0,0,0
60442,4162,2020-11-18T16:21:08.0113758Z,2019,28,11,25,15,0,7mo,1,0,13,0,0,17,3,0,27,0,0,0
60442,4163,2020-11-18T16:21:08.0113758Z,2019,54,16,41,26,0,8vo,1,2,28,0,0,38,13,0,53,0,0,0
60442,4164,2020-11-18T16:21:08.0123776Z,2019,44,10,40,14,0,9no,1,1,30,0,0,34,4,0,43,0,0,0
60442,4165,2020-11-18T16:21:08.0123776Z,2019,5,5,5,1,0,Sin Grado,0,2,4,0,0,0,0,0,5,0,0,0
28084,1678,2020-11-18T16:20:48.2672078Z,2019,47,17,36,20,0,1ro,1,0,27,0,0,30,11,0,46,0,0,0
28084,1679,2020-11-18T16:20:48.2672078Z,2019,53,18,43,28,0,2do,0,0,25,0,0,35,10,0,53,0,0,0
28084,1680,2020-11-18T16:20:48.2672078Z,2019,58,19,36,26,0,3ro,0,0,32,0,1,39,22,0,58,0,0,0
28084,1681,2020-11-18T16:20:48.2672078Z,2019,68,22,37,40,0,4to,2,0,28,0,0,46,31,0,66,0,0,0
28084,1682,2020-11-18T16:20:48.2672078Z,2019,60,20,41,29,0,5to,1,0,31,0,0,40,19,0,59,0,0,0
28084,1683,2020-11-18T16:20:48.2682096Z,2019,50,9,32,22,0,K,0,0,28,0,0,41,18,0,50,0,0,0
28084,1684,2020-11-18T16:20:48.2682096Z,2019,9,8,4,1,0,Sin Grado,0,0,8,0,0,1,5,0,9,0,0,0
28084,31680,2021-06-24T13:18:16.124012Z,2021,40,7,29,14,0,1ro,0,0,26,0,0,33,11,0,40,0,0,0
28084,31681,2021-06-24T13:18:16.124012Z,2021,33,11,24,13,0,2do,0,0,20,0,0,22,9,0,33,0,0,0
28084,31682,2021-06-24T13:18:16.124012Z,2021,37,9,26,20,0,3ro,1,1,17,0,0,28,11,0,36,0,0,0
28084,31683,2021-06-24T13:18:16.124012Z,2021,46,17,36,24,0,4to,0,1,22,0,0,29,10,0,46,0,0,0
28084,31684,2021-06-24T13:18:16.124012Z,2021,50,16,39,23,0,5to,0,0,27,0,0,34,11,0,50,0,0,0
28084,31685,2021-06-24T13:18:16.1250111Z,2021,39,9,27,20,0,K,0,0,19,0,0,30,12,1,38,0,0,0
28084,31686,2021-06-24T13:18:16.1250111Z,2021,9,9,7,2,0,Sin Grado,0,0,7,0,0,0,2,0,9,0,0,0
28084,7683,2020-11-18T16:21:47.2055086Z,2020,36,12,24,12,0,1ro,0,0,24,0,0,24,12,0,36,0,0,0
28084,7684,2020-11-18T16:21:47.2055086Z,2020,37,10,24,21,0,2do,1,0,16,0,0,27,13,0,36,0,0,0
28084,7685,2020-11-18T16:21:47.2055086Z,2020,54,20,42,28,0,3ro,0,0,26,0,0,34,12,0,54,0,0,0
28084,7686,2020-11-18T16:21:47.2065099Z,2020,58,19,40,25,0,4to,0,0,33,0,0,39,18,0,58,0,0,0
28084,7687,2020-11-18T16:21:47.2065099Z,2020,63,22,37,36,0,5to,2,1,27,0,0,41,26,0,61,0,0,0
28084,7688,2020-11-18T16:21:47.2065099Z,2020,45,9,33,15,0,K,0,0,30,0,0,36,12,0,45,0,0,0
28084,7689,2020-11-18T16:21:47.2065099Z,2020,3,3,2,1,0,Sin Grado,0,0,2,0,0,0,1,0,3,0,0,0
45468,3013,2020-11-18T16:21:00.321247Z,2019,72,28,64,31,0,10mo,0,0,41,0,0,44,8,0,72,2,0,0
45468,3014,2020-11-18T16:21:00.322247Z,2019,56,23,47,23,0,11mo,3,0,33,0,0,33,9,0,53,1,0,0
45468,3015,2020-11-18T16:21:00.322247Z,2019,44,0,33,20,0,12mo,1,0,24,0,0,44,11,0,43,1,0,0
45468,3016,2020-11-18T16:21:00.322247Z,2019,50,13,44,21,0,9no,3,0,29,0,0,37,6,0,47,1,0,0
45468,3017,2020-11-18T16:21:00.3232466Z,2019,17,11,15,3,0,Sin Grado,0,0,14,0,0,6,2,0,17,0,0,0
45468,33022,2021-06-24T13:18:29.8028269Z,2021,64,32,52,27,0,10mo,0,1,37,0,0,32,12,0,64,0,0,0
45468,33023,2021-06-24T13:18:29.8038261Z,2021,56,20,49,25,0,11mo,3,0,31,0,0,36,7,0,53,2,0,0
45468,33024,2021-06-24T13:18:29.8038261Z,2021,54,21,42,28,0,12mo,0,0,26,0,0,33,12,0,54,2,0,0
45468,33025,2021-06-24T13:18:29.8038261Z,2021,67,26,50,36,0,9no,1,0,31,0,0,41,17,0,66,0,1,0
45468,33026,2021-06-24T13:18:29.8038261Z,2021,18,17,17,3,0,Sin Grado,0,1,15,0,0,1,1,0,18,0,0,0
45468,9027,2020-11-18T16:21:55.4209899Z,2020,54,17,48,25,0,10mo,3,0,29,0,0,37,6,0,51,1,0,0
45468,9028,2020-11-18T16:21:55.4209899Z,2020,59,24,52,27,0,11mo,0,1,32,0,0,35,7,0,59,2,0,0
45468,9029,2020-11-18T16:21:55.4219912Z,2020,50,20,41,22,0,12mo,3,1,28,0,0,30,9,0,47,0,0,0
45468,9030,2020-11-18T16:21:55.4219912Z,2020,71,39,71,29,0,9no,1,1,42,0,0,32,0,0,70,0,0,0
45468,9031,2020-11-18T16:21:55.4219912Z,2020,13,12,13,3,0,Sin Grado,0,1,10,0,0,1,0,0,13,0,0,0
62927,10534,2020-11-18T16:22:04.9193219Z,2020,40,11,31,26,0,1ro,0,0,14,0,0,29,9,0,40,0,0,0
62927,10535,2020-11-18T16:22:04.9203223Z,2020,46,9,39,23,0,2do,1,0,23,0,0,37,7,0,45,0,0,0
62927,10536,2020-11-18T16:22:04.9203223Z,2020,43,11,38,19,0,3ro,3,0,24,0,0,32,5,0,40,0,0,0
62927,10537,2020-11-18T16:22:04.9203223Z,2020,47,16,38,21,0,4to,1,0,26,0,0,31,9,0,46,0,0,0
62927,10538,2020-11-18T16:22:04.9213245Z,2020,41,12,37,21,0,5to,2,0,20,0,0,29,4,0,37,0,0,2
62927,10539,2020-11-18T16:22:04.9213245Z,2020,39,14,37,21,0,K,1,0,18,0,0,25,2,0,38,0,0,0
62927,10540,2020-11-18T16:22:04.9213245Z,2020,5,5,4,1,0,Sin Grado,0,0,4,0,0,0,1,0,5,0,0,0
62927,34547,2021-06-24T13:18:40.2863433Z,2021,40,16,39,24,0,1ro,1,0,16,0,0,24,1,0,39,0,0,0
62927,34548,2021-06-24T13:18:40.2863433Z,2021,42,13,37,24,0,2do,0,0,18,0,0,29,5,0,42,0,0,0
62927,34549,2021-06-24T13:18:40.2863433Z,2021,42,9,36,20,0,3ro,1,0,22,0,0,33,6,0,41,0,0,0
62927,34550,2021-06-24T13:18:40.2873443Z,2021,41,12,37,16,0,4to,2,0,25,0,0,29,4,0,39,0,0,0
62927,34551,2021-06-24T13:18:40.2873443Z,2021,47,15,38,23,0,5to,2,0,24,0,0,32,9,0,45,0,0,0
62927,34552,2021-06-24T13:18:40.2873443Z,2021,49,12,45,23,0,K,0,0,26,0,0,37,4,0,49,0,0,0
62927,34553,2021-06-24T13:18:40.2873443Z,2021,4,4,4,1,0,Sin Grado,0,0,3,0,0,0,0,0,4,0,0,0
62927,4523,2020-11-18T16:21:10.8302524Z,2019,38,9,30,19,0,1ro,0,0,19,0,0,29,8,0,38,0,0,0
62927,4524,2020-11-18T16:21:10.8302524Z,2019,49,11,44,18,0,2do,4,0,31,0,0,38,5,0,45,0,0,0
62927,4525,2020-11-18T16:21:10.8312528Z,2019,53,21,43,23,0,3ro,0,0,30,0,0,32,10,0,53,0,0,0
62927,4526,2020-11-18T16:21:10.8312528Z,2019,47,11,41,27,0,4to,1,0,20,0,0,36,6,0,44,0,0,2
62927,4527,2020-11-18T16:21:10.8312528Z,2019,46,10,38,24,0,5to,0,0,22,0,0,36,8,0,46,0,0,0
62927,4528,2020-11-18T16:21:10.832255Z,2019,44,14,35,31,0,K,0,0,13,0,0,30,9,0,44,0,0,0
62927,4529,2020-11-18T16:21:10.832255Z,2019,7,6,7,3,0,Sin Grado,0,0,4,0,0,1,0,0,7,0,0,0
64410,10657,2020-11-18T16:22:05.3526124Z,2020,44,10,42,22,0,1ro,0,2,22,0,0,34,2,0,44,0,0,0
64410,10658,2020-11-18T16:22:05.3526124Z,2020,43,15,41,28,0,2do,0,1,15,0,0,28,2,0,43,0,0,0
64410,10659,2020-11-18T16:22:05.3526124Z,2020,30,9,29,16,0,3ro,0,0,14,0,0,21,1,0,30,0,0,0
64410,10660,2020-11-18T16:22:05.3536133Z,2020,42,8,39,22,0,4to,0,0,20,0,0,34,3,0,42,0,0,0
64410,10661,2020-11-18T16:22:05.3536133Z,2020,32,13,30,17,0,5to,0,1,15,0,0,19,2,0,32,0,0,0
64410,10662,2020-11-18T16:22:05.3536133Z,2020,46,9,43,25,0,K,0,0,21,0,0,37,3,0,46,0,0,0
64410,10663,2020-11-18T16:22:05.3536133Z,2020,10,10,8,1,0,Sin Grado,0,0,9,0,0,0,2,0,10,0,0,0
64410,34674,2021-06-24T13:18:41.1059308Z,2021,45,11,42,21,0,1ro,0,0,24,0,0,34,3,0,45,0,0,0
64410,34675,2021-06-24T13:18:41.1059308Z,2021,40,11,37,24,0,2do,0,1,16,0,0,29,3,0,40,0,0,0
64410,34676,2021-06-24T13:18:41.1059308Z,2021,40,16,38,25,0,3ro,0,0,15,0,0,24,2,0,40,0,0,0
64410,34677,2021-06-24T13:18:41.1069317Z,2021,29,9,29,14,0,4to,0,0,15,0,0,20,0,0,29,0,0,0
64410,34678,2021-06-24T13:18:41.1069317Z,2021,40,12,40,20,0,5to,0,0,20,0,0,28,0,0,40,0,0,0
64410,34679,2021-06-24T13:18:41.1069317Z,2021,39,10,36,18,0,K,0,1,21,0,0,29,3,0,39,0,0,0
64410,34680,2021-06-24T13:18:41.1069317Z,2021,10,10,10,2,0,Sin Grado,0,0,8,0,0,0,0,0,10,0,0,0
64410,4645,2020-11-18T16:21:11.2585389Z,2019,47,20,42,26,0,1ro,0,1,21,0,0,27,5,0,47,0,0,0
64410,4646,2020-11-18T16:21:11.2585389Z,2019,38,11,37,17,0,2do,0,0,21,0,0,27,1,0,38,0,1,0
64410,4647,2020-11-18T16:21:11.2585389Z,2019,43,9,39,25,0,3ro,1,0,18,0,0,34,4,0,42,0,0,0
64410,4648,2020-11-18T16:21:11.2585389Z,2019,36,13,33,18,0,4to,0,2,18,0,0,23,3,0,36,0,1,0
64410,4649,2020-11-18T16:21:11.2585389Z,2019,43,17,39,22,0,5to,0,0,21,0,0,26,4,0,43,0,0,0
64410,4650,2020-11-18T16:21:11.2595398Z,2019,41,7,39,25,0,K,0,1,16,0,0,34,2,0,41,0,0,0
64410,4651,2020-11-18T16:21:11.2595398Z,2019,9,8,7,0,0,Sin Grado,0,0,9,0,0,1,2,0,9,0,0,0
51482,33440,2021-06-24T13:18:32.4727405Z,2021,20,4,19,11,0,1ro,0,0,9,0,0,16,1,1,19,0,0,0
51482,33441,2021-06-24T13:18:32.4727405Z,2021,19,3,17,9,0,2do,0,0,10,0,0,16,2,0,19,1,0,0
51482,33442,2021-06-24T13:18:32.4727405Z,2021,12,3,10,5,0,3ro,0,0,7,0,0,9,2,0,12,0,0,0
51482,33443,2021-06-24T13:18:32.4737419Z,2021,11,5,11,4,0,4to,0,0,7,0,0,6,0,0,11,0,0,0
51482,33444,2021-06-24T13:18:32.4737419Z,2021,14,3,12,5,0,5to,0,0,9,0,0,11,2,0,14,0,0,0
51482,33445,2021-06-24T13:18:32.474742Z,2021,19,1,14,11,0,K,0,0,8,0,0,18,5,0,19,0,0,0
51482,3416,2020-11-18T16:21:02.5487341Z,2019,10,2,10,4,0,1ro,1,1,6,0,0,8,0,0,9,0,0,0
51482,3417,2020-11-18T16:21:02.5487341Z,2019,13,5,13,6,0,2do,0,0,7,0,0,8,0,0,13,0,0,0
51482,3418,2020-11-18T16:21:02.5487341Z,2019,13,2,12,5,0,3ro,0,0,8,0,0,11,1,0,13,0,0,0
51482,3419,2020-11-18T16:21:02.5487341Z,2019,12,2,11,5,0,4to,0,0,7,0,0,10,1,0,12,0,0,0
51482,3420,2020-11-18T16:21:02.5497341Z,2019,9,2,9,6,0,5to,1,0,3,0,0,7,0,0,8,0,1,0
51482,3421,2020-11-18T16:21:02.5497341Z,2019,14,2,13,6,0,K,0,0,8,0,0,12,1,0,14,1,0,0
51482,9436,2020-11-18T16:21:58.4159841Z,2020,16,3,13,6,0,1ro,0,1,10,0,0,13,3,0,16,1,0,0
51482,9437,2020-11-18T16:21:58.4159841Z,2020,10,1,9,5,0,2do,1,0,5,0,0,9,1,0,9,0,0,0
51482,9438,2020-11-18T16:21:58.4159841Z,2020,10,5,10,3,0,3ro,0,1,7,0,0,5,0,0,10,0,0,0
51482,9439,2020-11-18T16:21:58.4159841Z,2020,11,2,10,4,0,4to,0,0,7,0,0,9,1,0,11,0,0,0
51482,9440,2020-11-18T16:21:58.416985Z,2020,10,2,8,4,0,5to,0,0,6,0,0,8,2,0,10,0,0,0
51482,9441,2020-11-18T16:21:58.416985Z,2020,17,4,14,9,0,K,0,0,8,0,0,13,3,1,16,0,0,0
71878,11449,2020-11-18T16:22:10.5730928Z,2020,50,16,44,23,0,1ro,0,0,27,0,0,34,6,0,50,0,0,0
71878,11450,2020-11-18T16:22:10.5730928Z,2020,61,18,55,28,0,2do,0,0,33,0,0,43,6,0,60,0,0,1
71878,11451,2020-11-18T16:22:10.5740933Z,2020,51,15,44,28,0,3ro,0,0,23,0,0,36,7,0,51,1,0,0
71878,11452,2020-11-18T16:22:10.5740933Z,2020,46,15,34,21,0,4to,0,0,25,0,0,31,12,0,46,1,0,0
71878,11453,2020-11-18T16:22:10.5740933Z,2020,54,16,42,26,0,5to,1,0,28,0,0,38,12,0,52,1,0,1
71878,11454,2020-11-18T16:22:10.5740933Z,2020,61,12,52,29,0,K,0,0,32,0,0,49,9,0,60,0,0,1
71878,35470,2021-06-24T13:18:46.2446171Z,2021,62,17,52,33,0,1ro,1,0,29,0,0,45,10,0,61,0,1,0
71878,35471,2021-06-24T13:18:46.2446171Z,2021,49,17,42,26,0,2do,0,0,23,0,0,32,7,0,49,0,0,0
71878,35472,2021-06-24T13:18:46.2456171Z,2021,61,18,57,26,0,3ro,0,0,35,0,0,43,4,0,60,0,2,1
71878,35473,2021-06-24T13:18:46.2456171Z,2021,48,14,41,27,0,4to,0,0,21,0,0,34,7,0,48,1,1,0
71878,35474,2021-06-24T13:18:46.2456171Z,2021,46,17,40,19,0,5to,0,0,27,0,0,29,6,0,46,1,0,0
71878,35475,2021-06-24T13:18:46.2456171Z,2021,50,9,35,28,0,K,0,0,22,0,0,41,15,0,50,0,0,0
71878,5440,2020-11-18T16:21:15.4813531Z,2019,70,24,62,29,0,1ro,0,0,41,0,0,46,8,0,69,0,0,1
71878,5441,2020-11-18T16:21:15.4813531Z,2019,74,20,66,41,0,2do,0,0,33,0,0,54,8,0,74,1,0,0
71878,5442,2020-11-18T16:21:15.4813531Z,2019,57,21,43,24,0,3ro,0,0,33,0,0,36,14,0,57,1,0,0
71878,5443,2020-11-18T16:21:15.4813531Z,2019,64,19,53,31,0,4to,1,0,33,0,0,45,11,0,62,1,0,1
71878,5444,2020-11-18T16:21:15.482354Z,2019,76,25,56,35,0,5to,1,0,41,0,0,51,20,0,75,0,0,0
71878,5445,2020-11-18T16:21:15.482354Z,2019,59,15,51,25,0,K,0,0,34,0,0,44,8,0,59,0,0,0
75770,11589,2020-11-18T16:22:11.3305982Z,2020,58,19,42,27,0,1ro,1,0,31,0,0,39,16,0,57,0,0,0
75770,11590,2020-11-18T16:22:11.3305982Z,2020,38,9,31,14,0,2do,0,0,24,0,0,29,7,0,38,0,0,0
75770,11591,2020-11-18T16:22:11.3305982Z,2020,44,12,30,21,0,3ro,0,0,23,0,0,32,14,0,44,0,0,0
75770,11592,2020-11-18T16:22:11.331599Z,2020,34,8,23,21,0,4to,1,0,13,0,0,26,11,0,33,0,0,0
75770,11593,2020-11-18T16:22:11.331599Z,2020,35,15,29,21,0,5to,2,0,14,0,0,20,6,0,33,0,0,0
75770,11594,2020-11-18T16:22:11.331599Z,2020,28,15,22,12,0,6to,0,0,16,0,0,13,6,0,28,1,0,0
75770,11595,2020-11-18T16:22:11.331599Z,2020,38,10,30,19,0,K,0,0,19,0,0,28,8,0,38,0,0,0
75770,11596,2020-11-18T16:22:11.331599Z,2020,38,3,28,19,0,PK,0,0,19,0,0,35,10,0,38,0,0,0
75770,35612,2021-06-24T13:18:47.3684218Z,2021,40,9,32,19,0,1ro,0,0,21,0,0,31,8,0,40,0,0,0
75770,35613,2021-06-24T13:18:47.3694227Z,2021,54,18,44,29,0,2do,1,0,25,0,0,36,10,0,53,0,0,0
75770,35614,2021-06-24T13:18:47.3694227Z,2021,40,11,31,14,0,3ro,0,0,26,0,0,29,9,0,40,0,0,0
75770,35615,2021-06-24T13:18:47.3694227Z,2021,44,16,30,19,0,4to,0,0,25,0,0,28,14,0,44,0,0,0
75770,35616,2021-06-24T13:18:47.3694227Z,2021,28,6,24,17,0,5to,0,0,11,0,0,22,4,0,28,0,0,0
75770,35617,2021-06-24T13:18:47.3694227Z,2021,22,10,18,14,0,6to,1,0,8,0,0,12,4,0,21,0,0,0
75770,35618,2021-06-24T13:18:47.3704232Z,2021,43,13,36,22,0,K,1,0,21,0,0,30,7,0,42,0,0,0
75770,35619,2021-06-24T13:18:47.3704232Z,2021,35,6,25,19,0,PK,1,0,16,0,0,29,10,0,34,0,0,0
75770,5581,2020-11-18T16:21:16.2038361Z,2019,42,10,30,13,0,1ro,0,0,29,0,0,32,12,0,42,0,0,0
75770,5582,2020-11-18T16:21:16.2048366Z,2019,49,14,34,28,0,2do,0,0,21,0,0,35,15,0,49,0,0,0
75770,5583,2020-11-18T16:21:16.2048366Z,2019,43,12,31,23,0,3ro,0,0,20,0,0,31,12,0,43,0,0,0
75770,5584,2020-11-18T16:21:16.2048366Z,2019,39,13,29,25,0,4to,2,0,14,0,0,26,10,0,37,0,0,0
75770,5585,2020-11-18T16:21:16.2058384Z,2019,44,12,30,21,0,5to,0,0,23,0,0,32,14,0,44,1,0,0
75770,5586,2020-11-18T16:21:16.2058384Z,2019,13,10,10,1,0,6to,0,0,12,0,0,3,3,0,12,0,0,1
75770,5587,2020-11-18T16:21:16.2058384Z,2019,65,25,44,32,0,K,1,0,33,0,0,40,21,0,64,0,0,0
75770,5588,2020-11-18T16:21:16.2068379Z,2019,37,5,28,20,0,PK,0,0,17,0,0,32,9,0,37,0,0,0
75770,5589,2020-11-18T16:21:16.2068379Z,2019,3,2,1,3,0,Sin Grado,0,0,0,0,0,1,2,0,3,1,0,0
57026,33933,2021-06-24T13:18:36.6477342Z,2021,24,7,20,11,0,1ro,1,4,13,0,0,17,4,0,23,0,0,0
57026,33934,2021-06-24T13:18:36.6477342Z,2021,31,6,29,22,0,2do,1,0,9,0,0,25,2,1,29,0,0,0
57026,33935,2021-06-24T13:18:36.6477342Z,2021,31,7,29,16,0,3ro,0,2,15,0,0,24,2,0,31,0,0,0
57026,33936,2021-06-24T13:18:36.6477342Z,2021,31,13,28,17,0,4to,3,2,14,0,0,18,3,0,27,0,0,1
57026,33937,2021-06-24T13:18:36.6487347Z,2021,23,15,22,9,0,5to,0,2,14,0,0,8,1,0,23,0,0,0
57026,33938,2021-06-24T13:18:36.6487347Z,2021,24,3,17,10,0,K,0,4,14,0,0,21,7,0,24,0,0,0
57026,33939,2021-06-24T13:18:36.6487347Z,2021,35,34,24,9,0,Sin Grado,0,4,26,0,0,1,11,0,35,0,0,0
57026,3910,2020-11-18T16:21:06.7775518Z,2019,39,12,14,21,0,1ro,0,1,18,0,0,27,25,0,39,0,0,0
57026,3911,2020-11-18T16:21:06.7775518Z,2019,42,17,37,19,0,2do,0,0,23,0,0,25,5,0,42,0,0,0
57026,3912,2020-11-18T16:21:06.7775518Z,2019,35,13,31,20,0,3ro,0,0,15,0,0,22,4,0,35,0,0,0
57026,3913,2020-11-18T16:21:06.7775518Z,2019,52,15,47,25,0,4to,0,0,27,0,0,37,5,0,52,0,0,0
57026,3914,2020-11-18T16:21:06.7775518Z,2019,46,11,43,23,0,5to,3,0,23,0,0,35,3,0,43,0,0,0
57026,3915,2020-11-18T16:21:06.7785523Z,2019,24,4,1,18,0,K,0,0,6,0,0,20,23,0,24,0,0,0
57026,3916,2020-11-18T16:21:06.7785523Z,2019,31,28,11,5,0,Sin Grado,0,0,26,0,0,3,20,0,31,0,0,0
57026,9927,2020-11-18T16:22:01.5430728Z,2020,36,9,33,24,0,1ro,0,1,12,0,0,27,3,0,36,0,0,0
57026,9928,2020-11-18T16:22:01.5430728Z,2020,34,10,30,18,0,2do,0,0,16,0,0,24,4,0,33,0,0,1
57026,9929,2020-11-18T16:22:01.5440745Z,2020,40,13,34,23,0,3ro,2,0,17,0,0,27,6,0,38,0,0,0
57026,9930,2020-11-18T16:22:01.5440745Z,2020,27,15,27,10,0,4to,0,0,17,0,0,12,0,0,27,0,0,0
57026,9931,2020-11-18T16:22:01.5440745Z,2020,47,14,44,23,0,5to,0,1,24,0,0,33,3,0,47,0,0,0
57026,9932,2020-11-18T16:22:01.5450741Z,2020,24,6,21,13,0,K,0,0,11,0,0,18,3,0,24,0,0,0
57026,9933,2020-11-18T16:22:01.5450741Z,2020,34,33,21,8,0,Sin Grado,0,0,26,0,0,1,13,0,34,0,0,0
30098,1751,2020-11-18T16:20:48.8626035Z,2019,79,12,68,27,0,10mo,3,1,52,0,0,67,11,0,76,0,0,0
30098,1752,2020-11-18T16:20:48.8626035Z,2019,107,21,85,54,0,11mo,1,1,53,0,0,86,22,0,106,0,1,0
30098,1753,2020-11-18T16:20:48.8626035Z,2019,99,0,69,59,0,12mo,2,1,40,0,0,99,30,0,97,0,1,0
30098,1754,2020-11-18T16:20:48.8626035Z,2019,71,12,57,36,0,9no,1,1,35,0,0,59,14,0,70,0,0,0
30098,1755,2020-11-18T16:20:48.8636044Z,2019,36,33,28,9,0,Sin Grado,0,0,27,0,0,3,8,0,36,0,0,0
30098,31754,2021-06-24T13:18:17.235809Z,2021,92,28,82,34,0,10mo,1,3,58,0,0,64,10,0,91,0,0,0
30098,31755,2021-06-24T13:18:17.235809Z,2021,62,14,44,34,0,11mo,1,1,28,0,0,48,18,0,61,0,0,0
30098,31756,2021-06-24T13:18:17.235809Z,2021,71,13,51,22,0,12mo,5,2,49,0,0,58,20,0,66,0,0,0
30098,31757,2021-06-24T13:18:17.236809Z,2021,70,18,58,29,0,9no,3,1,41,0,0,52,12,0,67,0,1,0
30098,31758,2021-06-24T13:18:17.236809Z,2021,38,38,29,13,0,Sin Grado,0,2,25,0,0,0,9,0,38,0,0,0
30098,7757,2020-11-18T16:21:47.9169841Z,2020,79,14,67,42,0,10mo,2,2,37,0,0,65,12,0,77,0,0,0
30098,7758,2020-11-18T16:21:47.9169841Z,2020,82,13,67,28,0,11mo,5,3,54,0,0,69,15,0,77,0,0,0
30098,7759,2020-11-18T16:21:47.9169841Z,2020,107,19,86,53,0,12mo,2,3,54,0,0,88,21,0,105,0,1,0
30098,7760,2020-11-18T16:21:47.9169841Z,2020,90,28,74,30,0,9no,0,1,60,0,0,62,16,0,90,0,0,0
30098,7761,2020-11-18T16:21:47.9179836Z,2020,46,41,37,11,0,Sin Grado,0,0,35,0,0,5,9,0,46,0,0,0
62646,10466,2020-11-18T16:22:04.149808Z,2020,25,6,23,10,0,1ro,0,1,15,0,0,19,2,0,25,0,0,0
62646,10467,2020-11-18T16:22:04.1508085Z,2020,32,7,29,14,0,2do,0,0,18,0,0,25,3,0,32,0,0,0
62646,10468,2020-11-18T16:22:04.1508085Z,2020,39,14,37,15,0,3ro,2,0,24,0,0,25,2,0,37,0,0,0
62646,10469,2020-11-18T16:22:04.1508085Z,2020,29,8,28,12,0,4to,2,0,17,0,0,21,1,0,27,0,0,0
62646,10470,2020-11-18T16:22:04.1518098Z,2020,31,8,28,14,0,5to,1,0,17,0,0,23,3,0,30,0,0,0
62646,10471,2020-11-18T16:22:04.1518098Z,2020,56,14,52,30,0,6to,6,0,26,0,0,42,4,0,50,0,0,0
62646,10472,2020-11-18T16:22:04.1518098Z,2020,46,15,43,26,0,7mo,3,0,20,0,0,31,3,0,43,0,0,0
62646,10473,2020-11-18T16:22:04.1528107Z,2020,40,13,36,15,0,8vo,0,0,25,0,0,27,4,0,40,0,0,0
62646,10474,2020-11-18T16:22:04.1528107Z,2020,28,7,28,8,0,K,0,0,20,0,0,21,0,0,28,0,0,0
62646,10475,2020-11-18T16:22:04.1528107Z,2020,41,39,40,16,0,Sin Grado,1,0,25,0,0,2,1,0,40,0,0,0
62646,34479,2021-06-24T13:18:39.4967774Z,2021,25,6,24,10,0,1ro,0,0,15,0,0,19,1,0,25,0,0,0
62646,34480,2021-06-24T13:18:39.4977774Z,2021,24,6,24,9,0,2do,0,0,15,0,0,18,0,0,24,0,0,0
62646,34481,2021-06-24T13:18:39.4977774Z,2021,30,4,29,13,0,3ro,0,0,17,0,0,26,1,1,29,0,0,0
62646,34482,2021-06-24T13:18:39.4977774Z,2021,42,13,40,18,0,4to,2,0,24,0,0,29,2,1,39,0,1,0
62646,34483,2021-06-24T13:18:39.4977774Z,2021,28,7,26,11,0,5to,2,0,17,0,0,21,2,0,26,0,0,0
62646,34484,2021-06-24T13:18:39.4977774Z,2021,37,10,35,16,0,6to,1,0,21,0,0,27,2,2,34,0,2,0
62646,34485,2021-06-24T13:18:39.4987784Z,2021,58,15,55,29,0,7mo,6,0,29,0,0,43,3,0,52,0,0,0
62646,34486,2021-06-24T13:18:39.4987784Z,2021,45,15,43,24,0,8vo,2,0,21,0,0,30,2,0,43,0,0,0
62646,34487,2021-06-24T13:18:39.4987784Z,2021,21,5,20,9,0,K,0,0,12,0,0,16,1,1,20,0,0,0
62646,34488,2021-06-24T13:18:39.4987784Z,2021,47,46,43,17,0,Sin Grado,1,0,30,0,0,1,4,0,46,0,0,0
62646,4455,2020-11-18T16:21:10.139792Z,2019,32,9,31,14,0,1ro,0,0,18,0,0,23,1,0,32,0,0,0
62646,4456,2020-11-18T16:21:10.139792Z,2019,29,10,27,10,0,2do,1,0,19,0,0,19,2,0,28,0,0,0
62646,4457,2020-11-18T16:21:10.140792Z,2019,26,7,26,11,0,3ro,2,0,15,0,0,19,0,0,24,0,0,0
62646,4458,2020-11-18T16:21:10.140792Z,2019,27,8,27,12,0,4to,1,0,15,0,0,19,0,0,26,0,0,0
62646,4459,2020-11-18T16:21:10.140792Z,2019,28,10,26,12,0,5to,1,0,16,0,0,18,2,0,27,0,0,0
62646,4460,2020-11-18T16:21:10.1417934Z,2019,37,11,35,21,0,6to,1,0,16,0,0,26,2,0,36,0,0,0
62646,4461,2020-11-18T16:21:10.1417934Z,2019,30,13,29,12,0,7mo,0,0,18,0,0,17,1,0,30,0,0,0
62646,4462,2020-11-18T16:21:10.1417934Z,2019,31,10,30,17,0,8vo,2,0,14,0,0,21,1,0,29,0,0,0
62646,4463,2020-11-18T16:21:10.1427943Z,2019,22,6,19,8,0,K,0,0,14,0,0,16,3,0,22,0,0,0
62646,4464,2020-11-18T16:21:10.1427943Z,2019,34,29,33,15,0,Sin Grado,2,0,19,0,0,5,1,0,32,0,0,0
75788,11597,2020-11-18T16:22:11.3305982Z,2020,59,17,46,26,0,1ro,0,0,33,0,0,42,13,0,59,0,0,0
75788,11598,2020-11-18T16:22:11.3305982Z,2020,46,17,33,16,0,2do,1,0,30,0,0,29,13,1,44,0,0,0
75788,11599,2020-11-18T16:22:11.3305982Z,2020,66,29,54,27,0,3ro,1,0,39,0,0,37,12,0,65,0,1,0
75788,11600,2020-11-18T16:22:11.3305982Z,2020,58,20,48,25,0,4to,1,0,33,0,0,38,10,0,57,0,0,0
75788,11601,2020-11-18T16:22:11.7118535Z,2020,62,27,44,31,0,5to,2,0,31,0,0,35,18,0,60,1,0,0
75788,11602,2020-11-18T16:22:11.7118535Z,2020,34,13,27,20,0,6to,1,0,14,0,0,21,7,1,32,0,0,0
75788,11603,2020-11-18T16:22:11.7128531Z,2020,64,12,50,36,0,K,0,0,28,0,0,52,14,0,64,0,0,0
75788,11604,2020-11-18T16:22:11.7128531Z,2020,55,7,44,29,0,PK,0,0,26,0,0,48,11,0,55,0,0,0
75788,11605,2020-11-18T16:22:11.7128531Z,2020,38,38,37,10,0,Sin Grado,2,0,28,0,0,0,1,0,36,0,0,0
75788,35620,2021-06-24T13:18:47.3704232Z,2021,60,15,48,31,0,1ro,0,0,29,0,0,45,12,0,60,0,0,0
75788,35621,2021-06-24T13:18:47.3704232Z,2021,54,17,46,25,0,2do,0,0,29,0,0,37,8,0,54,0,0,0
75788,35622,2021-06-24T13:18:47.3704232Z,2021,47,18,41,17,0,3ro,0,0,30,0,0,29,6,1,46,0,0,0
75788,35623,2021-06-24T13:18:47.3714237Z,2021,56,24,47,24,0,4to,1,0,32,0,0,32,9,0,55,0,1,0
75788,35624,2021-06-24T13:18:47.3714237Z,2021,50,18,43,21,0,5to,0,0,29,0,0,32,7,0,50,0,0,0
75788,35625,2021-06-24T13:18:47.3714237Z,2021,27,11,21,10,0,6to,1,0,17,0,0,16,6,0,26,0,0,0
75788,35626,2021-06-24T13:18:47.3714237Z,2021,52,7,40,28,0,K,0,0,24,0,0,45,12,1,51,0,0,0
75788,35627,2021-06-24T13:18:47.3724256Z,2021,53,8,29,25,0,PK,0,0,28,0,0,45,24,0,52,0,0,1
75788,35628,2021-06-24T13:18:47.3724256Z,2021,28,28,23,7,0,Sin Grado,3,0,21,0,0,0,5,0,25,0,0,0
75788,5590,2020-11-18T16:21:16.2078384Z,2019,55,22,48,23,0,1ro,1,0,32,0,0,33,7,0,54,0,0,0
75788,5591,2020-11-18T16:21:16.2078384Z,2019,70,31,56,28,0,2do,2,0,42,0,0,39,14,0,68,0,1,0
75788,5592,2020-11-18T16:21:16.2088406Z,2019,66,21,54,30,0,3ro,1,0,36,0,0,45,12,0,65,0,0,0
75788,5593,2020-11-18T16:21:16.2088406Z,2019,71,30,48,35,0,4to,2,0,36,0,0,41,23,0,69,1,0,0
75788,5594,2020-11-18T16:21:16.2088406Z,2019,56,24,42,31,0,5to,1,0,25,0,0,32,14,1,54,0,0,0
75788,5595,2020-11-18T16:21:16.2098406Z,2019,33,9,24,17,0,6to,1,0,16,0,0,24,9,0,32,0,0,0
75788,5596,2020-11-18T16:21:16.2098406Z,2019,47,11,33,20,0,K,0,0,27,0,0,36,14,0,47,0,0,0
75788,5597,2020-11-18T16:21:16.2098406Z,2019,49,7,37,33,0,PK,0,0,16,0,0,42,12,0,49,0,0,0
75788,5598,2020-11-18T16:21:16.2108406Z,2019,31,30,31,10,0,Sin Grado,0,0,21,0,0,1,0,0,31,0,0,0
53702,33745,2021-06-24T13:18:35.2577382Z,2021,42,12,32,24,0,1ro,0,1,18,0,0,30,10,0,42,0,0,0
53702,33746,2021-06-24T13:18:35.2587387Z,2021,33,5,22,16,0,2do,0,1,17,0,0,28,11,0,33,0,0,0
53702,33747,2021-06-24T13:18:35.2587387Z,2021,34,10,23,15,0,3ro,0,2,19,0,0,24,11,0,34,0,1,0
53702,33748,2021-06-24T13:18:35.2587387Z,2021,53,20,40,22,0,4to,0,2,31,0,0,33,13,0,53,2,0,0
53702,33749,2021-06-24T13:18:35.2597387Z,2021,40,12,29,24,0,5to,0,1,16,0,0,28,11,0,40,0,0,0
53702,33750,2021-06-24T13:18:35.2597387Z,2021,39,6,27,17,0,K,0,0,22,0,0,33,12,0,39,0,0,0
53702,3721,2020-11-18T16:21:05.1094373Z,2019,46,12,29,22,0,1ro,0,0,24,0,0,34,17,0,46,0,1,0
53702,3722,2020-11-18T16:21:05.1104386Z,2019,63,17,47,33,0,2do,0,0,30,0,0,46,16,0,63,2,0,0
53702,3723,2020-11-18T16:21:05.1104386Z,2019,48,17,32,30,0,3ro,0,0,18,0,0,31,16,0,48,0,1,0
53702,3724,2020-11-18T16:21:05.1104386Z,2019,46,14,30,25,0,4to,0,0,21,0,1,32,16,0,46,1,0,0
53702,3725,2020-11-18T16:21:05.1104386Z,2019,45,10,26,25,0,5to,0,1,20,0,0,35,19,0,45,0,0,0
53702,3726,2020-11-18T16:21:05.1104386Z,2019,1,0,1,1,0,6to,0,0,0,0,0,1,0,0,1,0,0,0
53702,3727,2020-11-18T16:21:05.1114391Z,2019,40,6,27,20,0,K,0,0,20,0,0,34,13,0,40,0,0,0
53702,9739,2020-11-18T16:22:00.1141187Z,2020,37,5,5,19,0,1ro,0,0,18,0,0,32,32,0,37,0,0,0
53702,9740,2020-11-18T16:22:00.1151195Z,2020,41,12,18,18,0,2do,0,0,23,0,0,29,23,0,41,0,1,0
53702,9741,2020-11-18T16:22:00.1151195Z,2020,65,20,2,29,0,3ro,0,0,36,0,0,45,63,0,65,2,0,0
53702,9742,2020-11-18T16:22:00.1151195Z,2020,43,12,9,28,0,4to,0,0,15,0,0,31,34,0,43,0,0,0
53702,9743,2020-11-18T16:22:00.1161195Z,2020,46,14,31,26,0,5to,0,0,20,0,0,32,15,0,46,1,0,0
53702,9744,2020-11-18T16:22:00.1161195Z,2020,40,10,33,22,0,K,0,0,18,0,0,30,7,0,40,0,0,0
34355,2241,2020-11-18T16:20:55.0046998Z,2019,96,27,67,50,0,6to,2,1,46,0,0,69,29,0,94,0,0,0
34355,2242,2020-11-18T16:20:55.0057007Z,2019,112,28,81,61,0,7mo,2,2,51,0,0,84,31,0,110,0,0,0
34355,2243,2020-11-18T16:20:55.0057007Z,2019,115,32,89,57,0,8vo,1,1,58,0,0,83,26,0,114,0,1,0
34355,2244,2020-11-18T16:20:55.0057007Z,2019,28,26,22,8,0,Sin Grado,0,0,20,0,0,2,6,0,28,0,0,0
34355,32248,2021-06-24T13:18:21.7520471Z,2021,72,16,64,36,0,6to,0,1,36,0,0,56,8,0,72,0,1,0
34355,32249,2021-06-24T13:18:21.7530481Z,2021,90,26,76,36,0,7mo,1,0,54,0,0,64,14,0,89,0,0,0
34355,32250,2021-06-24T13:18:21.7530481Z,2021,83,19,66,43,0,8vo,1,0,40,0,0,64,17,0,82,0,0,0
34355,32251,2021-06-24T13:18:21.7530481Z,2021,30,30,28,13,0,Sin Grado,0,0,17,0,0,0,2,0,30,0,0,0
34355,8253,2020-11-18T16:21:50.6858339Z,2020,90,28,76,37,0,6to,1,0,53,0,0,62,14,0,88,0,0,1
34355,8254,2020-11-18T16:21:50.6858339Z,2020,90,22,67,47,0,7mo,1,0,43,0,0,68,23,0,89,0,0,0
34355,8255,2020-11-18T16:21:50.6858339Z,2020,107,25,83,60,0,8vo,2,0,47,0,0,82,24,0,105,0,0,0
34355,8256,2020-11-18T16:21:50.6868348Z,2020,29,29,25,8,0,Sin Grado,0,0,21,0,0,0,4,0,29,0,0,0
44511,2959,2020-11-18T16:20:59.9119721Z,2019,16,4,13,10,0,1ro,0,0,6,0,0,12,3,0,15,0,0,1
44511,2960,2020-11-18T16:20:59.9119721Z,2019,16,5,15,8,0,2do,1,0,8,0,0,11,1,0,14,0,0,1
44511,2961,2020-11-18T16:20:59.9119721Z,2019,20,5,18,10,0,3ro,0,0,10,0,0,15,2,0,20,0,0,0
44511,2962,2020-11-18T16:20:59.912973Z,2019,20,9,17,7,0,4to,2,0,13,0,0,11,3,1,17,0,1,0
44511,2963,2020-11-18T16:20:59.912973Z,2019,23,6,19,12,0,5to,0,0,11,0,0,17,4,0,23,0,0,0
44511,2964,2020-11-18T16:20:59.912973Z,2019,10,1,10,4,0,K,0,0,6,0,0,9,0,0,10,0,0,0
44511,32968,2021-06-24T13:18:28.907184Z,2021,12,3,12,3,0,1ro,0,0,9,0,0,9,0,0,12,0,0,0
44511,32969,2021-06-24T13:18:28.907184Z,2021,6,0,6,2,0,2do,0,0,4,0,0,6,0,0,6,0,0,0
44511,32970,2021-06-24T13:18:28.9081845Z,2021,18,7,17,12,0,3ro,0,0,6,0,0,11,1,0,18,0,0,0
44511,32971,2021-06-24T13:18:28.9081845Z,2021,14,5,14,7,0,4to,2,0,7,0,0,9,0,0,12,0,1,0
44511,32972,2021-06-24T13:18:28.9081845Z,2021,16,4,14,8,0,5to,0,0,8,0,0,12,2,0,16,0,0,0
44511,32973,2021-06-24T13:18:28.9081845Z,2021,8,2,7,3,0,K,0,0,5,0,0,6,1,0,8,0,0,0
44511,8972,2020-11-18T16:21:54.9987078Z,2020,6,1,6,3,0,1ro,0,0,3,0,0,5,0,0,6,0,0,0
44511,8973,2020-11-18T16:21:54.9987078Z,2020,17,5,13,11,0,2do,0,0,6,0,0,12,4,0,17,0,0,0
44511,8974,2020-11-18T16:21:54.9987078Z,2020,14,4,13,6,0,3ro,1,0,8,0,0,10,1,0,12,0,0,1
44511,8975,2020-11-18T16:21:54.9997087Z,2020,16,3,14,8,0,4to,0,0,8,0,0,13,2,0,16,0,0,0
44511,8976,2020-11-18T16:21:54.9997087Z,2020,19,8,16,7,0,5to,1,0,12,0,0,11,3,1,17,0,1,0
44511,8977,2020-11-18T16:21:54.9997087Z,2020,15,4,15,5,0,K,0,0,10,0,0,11,0,0,15,0,0,0
41061,2657,2020-11-18T16:20:58.0647417Z,2019,173,41,109,91,0,10mo,4,0,82,0,0,132,64,0,169,4,1,0
41061,2658,2020-11-18T16:20:58.0647417Z,2019,186,42,111,98,0,11mo,9,1,88,0,0,144,75,0,177,4,2,0
41061,2659,2020-11-18T16:20:58.065743Z,2019,156,0,100,69,0,12mo,5,1,87,0,0,156,56,0,151,0,0,0
41061,2660,2020-11-18T16:20:58.065743Z,2019,197,47,131,100,0,9no,4,0,97,0,0,150,66,0,193,2,1,0
41061,2661,2020-11-18T16:20:58.065743Z,2019,9,9,6,4,0,Sin Grado,0,0,5,0,0,0,3,0,9,0,0,0
41061,32664,2021-06-24T13:18:26.2732949Z,2021,179,43,133,83,0,10mo,7,0,96,0,0,136,46,0,172,1,0,0
41061,32665,2021-06-24T13:18:26.2742959Z,2021,180,36,128,89,0,11mo,5,0,91,0,0,144,52,0,175,0,3,0
41061,32666,2021-06-24T13:18:26.2742959Z,2021,146,32,102,78,0,12mo,7,0,68,0,0,114,44,0,139,3,1,0
41061,32667,2021-06-24T13:18:26.2742959Z,2021,188,54,142,88,0,9no,8,0,100,0,0,134,46,0,180,1,0,0
41061,32668,2021-06-24T13:18:26.2742959Z,2021,12,12,9,3,0,Sin Grado,0,0,9,0,0,0,3,0,12,0,0,0
41061,8668,2020-11-18T16:21:53.0624146Z,2020,189,39,117,91,0,10mo,4,0,98,0,0,150,72,0,185,2,1,0
41061,8669,2020-11-18T16:21:53.0624146Z,2020,169,39,101,87,0,11mo,4,1,82,0,0,130,68,0,165,4,1,0
41061,8670,2020-11-18T16:21:53.0634141Z,2020,165,37,99,87,0,12mo,8,0,78,0,0,128,66,0,157,4,1,0
41061,8671,2020-11-18T16:21:53.0634141Z,2020,183,51,128,76,0,9no,4,0,107,0,0,132,55,0,179,1,1,0
41061,8672,2020-11-18T16:21:53.0634141Z,2020,10,10,7,4,0,Sin Grado,0,0,6,0,0,0,3,0,10,0,0,0
42085,2727,2020-11-18T16:20:58.7481944Z,2019,33,14,33,19,0,1ro,0,0,14,0,0,19,0,0,33,0,0,0
42085,2728,2020-11-18T16:20:58.7481944Z,2019,19,8,19,8,0,2do,0,0,11,0,0,11,0,0,19,0,0,0
42085,2729,2020-11-18T16:20:58.7481944Z,2019,29,20,28,13,0,3ro,2,0,16,0,0,9,1,0,27,0,0,0
42085,2730,2020-11-18T16:20:58.7481944Z,2019,19,10,19,10,0,4to,1,0,9,0,0,9,0,0,18,0,0,0
42085,2731,2020-11-18T16:20:58.7491949Z,2019,21,12,20,10,0,5to,3,0,11,0,0,9,1,0,18,0,0,0
42085,2732,2020-11-18T16:20:58.7491949Z,2019,25,12,19,16,0,K,0,0,9,0,0,13,6,0,25,0,0,0
42085,2733,2020-11-18T16:20:58.7491949Z,2019,51,49,47,16,0,Sin Grado,1,2,35,0,0,2,4,0,50,0,0,0
42085,32734,2021-06-24T13:18:27.1389154Z,2021,22,9,20,11,0,1ro,0,0,11,0,0,13,2,0,22,0,0,0
42085,32735,2021-06-24T13:18:27.1389154Z,2021,24,13,24,12,0,2do,0,0,12,0,0,11,0,0,24,0,0,0
42085,32736,2021-06-24T13:18:27.1389154Z,2021,27,14,25,12,0,3ro,0,0,15,0,0,13,2,0,26,0,0,1
42085,32737,2021-06-24T13:18:27.1399168Z,2021,18,9,16,11,0,4to,0,0,7,0,0,9,2,0,18,0,0,0
42085,32738,2021-06-24T13:18:27.1399168Z,2021,28,18,25,12,0,5to,0,0,16,0,0,10,3,0,28,0,0,0
42085,32739,2021-06-24T13:18:27.1399168Z,2021,20,6,14,9,0,K,0,0,11,0,0,14,6,0,20,0,0,0
42085,32740,2021-06-24T13:18:27.1399168Z,2021,43,43,39,8,0,Sin Grado,0,0,35,0,0,0,4,0,43,0,0,0
42085,8738,2020-11-18T16:21:53.8009083Z,2020,26,14,26,18,0,1ro,0,0,8,0,0,12,0,0,26,0,0,0
42085,8739,2020-11-18T16:21:53.8009083Z,2020,35,15,34,14,0,2do,1,0,21,0,0,20,1,0,33,0,0,1
42085,8740,2020-11-18T16:21:53.8009083Z,2020,17,7,17,10,0,3ro,0,0,7,0,0,10,0,0,17,0,0,0
42085,8741,2020-11-18T16:21:53.8009083Z,2020,30,18,30,14,0,4to,1,0,16,0,0,12,0,0,29,0,0,0
42085,8742,2020-11-18T16:21:53.8019083Z,2020,15,11,15,6,0,5to,1,1,9,0,0,4,0,0,14,0,0,0
42085,8743,2020-11-18T16:21:53.8019083Z,2020,22,8,22,9,0,K,1,0,13,0,0,14,0,0,21,0,0,0
42085,8744,2020-11-18T16:21:53.8019083Z,2020,47,47,45,13,0,Sin Grado,0,0,34,0,0,0,2,0,47,0,0,0
47357,3127,2020-11-18T16:21:01.0217127Z,2019,77,25,64,42,0,1ro,3,0,35,0,0,52,13,0,74,0,0,0
47357,3128,2020-11-18T16:21:01.0217127Z,2019,73,18,66,35,0,2do,2,0,38,0,0,55,7,0,71,0,1,0
47357,3129,2020-11-18T16:21:01.0227132Z,2019,89,31,72,40,0,3ro,2,0,49,0,0,58,17,0,87,0,1,0
47357,3130,2020-11-18T16:21:01.0227132Z,2019,85,32,76,46,0,4to,3,0,39,0,0,53,9,0,82,0,0,0
47357,3131,2020-11-18T16:21:01.0227132Z,2019,98,42,74,48,0,5to,1,2,50,0,0,56,24,0,97,0,0,0
47357,3132,2020-11-18T16:21:01.0227132Z,2019,39,16,34,13,0,K,2,0,26,0,0,23,5,0,37,0,0,0
47357,3133,2020-11-18T16:21:01.0237149Z,2019,34,33,27,16,0,Sin Grado,1,0,18,0,0,1,7,0,33,0,0,0
47357,33143,2021-06-24T13:18:30.3231996Z,2021,51,17,44,26,0,1ro,2,0,25,0,0,34,7,0,49,0,0,0
47357,33144,2021-06-24T13:18:30.3231996Z,2021,38,16,31,16,0,2do,3,0,22,0,0,22,7,0,35,0,0,0
47357,33145,2021-06-24T13:18:30.3231996Z,2021,48,12,38,28,0,3ro,4,0,20,0,0,36,10,0,44,0,0,0
47357,33146,2021-06-24T13:18:30.3231996Z,2021,66,22,62,37,0,4to,1,0,29,0,0,44,4,0,65,0,1,0
47357,33147,2021-06-24T13:18:30.3231996Z,2021,62,20,54,25,0,5to,1,0,37,0,0,42,8,0,61,0,0,0
47357,33148,2021-06-24T13:18:30.3241997Z,2021,46,17,43,24,0,K,0,0,22,0,0,29,3,0,46,0,0,0
47357,33149,2021-06-24T13:18:30.3241997Z,2021,12,12,10,6,0,Sin Grado,0,0,6,0,0,0,2,0,12,0,0,0
47357,9141,2020-11-18T16:21:56.1424716Z,2020,44,17,36,17,0,1ro,2,0,27,0,0,27,8,0,42,0,0,0
47357,9142,2020-11-18T16:21:56.143472Z,2020,54,13,42,33,0,2do,3,0,21,0,0,41,12,0,51,0,0,0
47357,9143,2020-11-18T16:21:56.143472Z,2020,70,21,66,36,0,3ro,1,0,34,0,0,49,4,0,69,0,1,0
47357,9144,2020-11-18T16:21:56.143472Z,2020,68,23,57,27,0,4to,1,0,41,0,0,45,11,0,66,0,0,1
47357,9145,2020-11-18T16:21:56.143472Z,2020,65,28,59,30,0,5to,1,0,35,0,0,37,6,0,64,0,0,0
47357,9146,2020-11-18T16:21:56.143472Z,2020,49,16,41,24,0,K,2,0,25,0,0,33,8,0,47,0,0,0
47357,9147,2020-11-18T16:21:56.143472Z,2020,35,35,29,15,0,Sin Grado,1,0,20,0,0,0,6,0,33,0,0,1
75234,11545,2020-11-18T16:22:11.3135875Z,2020,60,10,47,33,0,1ro,3,0,27,0,0,50,13,0,57,0,0,0
75234,11546,2020-11-18T16:22:11.3135875Z,2020,67,21,58,31,0,2do,0,0,36,0,0,46,9,0,67,1,0,0
75234,11547,2020-11-18T16:22:11.3135875Z,2020,68,18,51,37,0,3ro,1,0,31,0,0,50,17,0,67,2,0,0
75234,11548,2020-11-18T16:22:11.3145875Z,2020,58,19,47,29,0,4to,1,0,29,0,0,39,11,0,57,0,0,0
75234,11549,2020-11-18T16:22:11.3145875Z,2020,49,17,33,24,0,5to,1,0,25,0,0,32,16,0,48,0,0,0
75234,11550,2020-11-18T16:22:11.3145875Z,2020,21,2,12,11,0,6to,3,0,10,0,0,19,9,0,18,0,0,0
75234,11551,2020-11-18T16:22:11.3145875Z,2020,57,13,42,31,0,K,0,1,26,0,0,44,15,0,57,0,0,0
75234,35567,2021-06-24T13:18:46.6018721Z,2021,49,13,37,26,0,1ro,0,0,23,0,0,36,12,0,49,0,0,0
75234,35568,2021-06-24T13:18:46.6018721Z,2021,57,11,47,33,0,2do,3,0,24,0,0,46,10,0,54,0,0,0
75234,35569,2021-06-24T13:18:46.6028731Z,2021,69,26,63,31,0,3ro,0,0,38,0,0,43,6,0,69,1,0,0
75234,35570,2021-06-24T13:18:46.6028731Z,2021,70,19,49,37,0,4to,2,0,33,0,0,51,21,0,68,2,0,0
75234,35571,2021-06-24T13:18:46.6028731Z,2021,57,20,46,28,0,5to,1,0,29,0,0,37,11,0,56,0,0,0
75234,35572,2021-06-24T13:18:46.6028731Z,2021,27,6,20,17,0,6to,2,0,10,0,0,21,7,0,25,0,0,0
75234,35573,2021-06-24T13:18:46.603874Z,2021,19,2,16,9,0,7mo,2,0,10,0,0,17,3,0,17,0,0,0
75234,35574,2021-06-24T13:18:46.603874Z,2021,47,12,37,21,0,K,0,0,26,0,0,35,10,0,47,0,0,0
75234,5537,2020-11-18T16:21:16.1808201Z,2019,66,20,52,30,0,1ro,0,0,36,0,0,46,14,0,66,1,0,0
75234,5538,2020-11-18T16:21:16.1808201Z,2019,66,15,41,34,0,2do,0,0,32,0,0,51,25,0,66,2,0,0
75234,5539,2020-11-18T16:21:16.1808201Z,2019,63,19,52,31,0,3ro,1,0,32,0,0,44,11,0,62,0,0,0
75234,5540,2020-11-18T16:21:16.1818228Z,2019,52,16,36,29,0,4to,0,0,23,0,0,36,16,0,52,0,0,0
75234,5541,2020-11-18T16:21:16.1818228Z,2019,42,11,31,22,0,5to,2,0,20,0,0,31,11,0,40,0,0,0
75234,5542,2020-11-18T16:21:16.1818228Z,2019,65,13,51,38,0,K,3,0,27,0,0,52,14,0,62,0,0,0
25312,1515,2020-11-18T16:20:47.6417947Z,2019,35,8,15,25,0,1ro,0,0,10,0,0,27,20,0,35,0,0,0
25312,1516,2020-11-18T16:20:47.6417947Z,2019,24,4,19,13,0,2do,0,0,11,0,0,20,5,0,24,2,0,0
25312,1517,2020-11-18T16:20:47.6417947Z,2019,44,7,25,27,0,3ro,0,0,17,0,0,37,19,0,44,0,1,0
25312,1518,2020-11-18T16:20:47.6427961Z,2019,31,4,21,14,0,4to,0,0,17,0,0,27,10,0,31,1,0,0
25312,1519,2020-11-18T16:20:47.6427961Z,2019,34,5,12,20,0,5to,0,0,14,0,0,29,22,0,34,0,0,0
25312,1520,2020-11-18T16:20:47.6427961Z,2019,53,10,26,26,0,6to,0,0,27,0,0,43,27,0,53,0,0,0
25312,1521,2020-11-18T16:20:47.6437952Z,2019,29,5,15,15,0,7mo,0,0,14,0,0,24,14,0,29,1,0,0
25312,1522,2020-11-18T16:20:47.6437952Z,2019,30,2,15,14,0,8vo,0,0,16,0,0,28,15,0,30,0,0,0
25312,1523,2020-11-18T16:20:47.6437952Z,2019,24,4,15,16,0,K,0,0,8,0,0,20,9,0,24,1,0,0
25312,31516,2021-06-24T13:18:15.8077843Z,2021,42,6,26,19,0,1ro,0,1,23,0,0,36,16,0,42,0,0,0
25312,31517,2021-06-24T13:18:15.8077843Z,2021,37,4,29,17,0,2do,0,0,20,0,0,33,8,0,37,1,0,0
25312,31518,2021-06-24T13:18:15.8077843Z,2021,43,5,29,27,0,3ro,0,1,16,0,0,38,14,0,43,0,0,0
25312,31519,2021-06-24T13:18:15.8087853Z,2021,41,5,25,19,0,4to,0,3,22,0,0,36,16,0,41,2,0,0
25312,31520,2021-06-24T13:18:15.8087853Z,2021,49,6,40,31,0,5to,0,0,18,0,0,43,9,0,49,0,0,0
25312,31521,2021-06-24T13:18:15.8087853Z,2021,40,4,20,21,0,6to,0,1,19,0,0,36,20,0,40,1,0,0
25312,31522,2021-06-24T13:18:15.8087853Z,2021,35,6,17,21,0,7mo,1,1,14,0,0,29,18,0,34,0,0,0
25312,31523,2021-06-24T13:18:15.8097858Z,2021,47,8,37,23,0,8vo,0,2,24,0,0,39,10,0,47,0,0,0
25312,31524,2021-06-24T13:18:15.8097858Z,2021,5,3,4,1,0,9no,0,0,4,0,0,2,1,0,5,0,0,0
25312,31525,2021-06-24T13:18:15.8097858Z,2021,26,6,12,18,0,K,0,0,8,0,0,20,14,0,26,0,0,0
25312,7519,2020-11-18T16:21:46.3719534Z,2020,37,6,27,21,0,1ro,0,1,16,0,0,31,10,0,37,1,0,0
25312,7520,2020-11-18T16:21:46.3719534Z,2020,34,5,22,24,0,2do,0,1,10,0,0,29,12,0,34,0,0,0
25312,7521,2020-11-18T16:21:46.3729534Z,2020,37,5,25,18,0,3ro,0,3,19,0,0,32,12,0,37,2,0,0
25312,7522,2020-11-18T16:21:46.3729534Z,2020,50,7,30,32,0,4to,0,0,18,0,0,43,20,0,50,0,0,0
25312,7523,2020-11-18T16:21:46.3729534Z,2020,40,5,26,20,0,5to,0,1,20,0,0,35,14,0,40,1,0,0
25312,7524,2020-11-18T16:21:46.3729534Z,2020,38,6,15,22,0,6to,1,1,16,0,0,32,23,1,36,0,0,0
25312,7525,2020-11-18T16:21:46.3729534Z,2020,50,10,29,24,0,7mo,0,2,26,0,0,40,21,0,50,0,0,0
25312,7526,2020-11-18T16:21:46.3739542Z,2020,26,6,11,13,0,8vo,0,0,13,0,0,20,15,0,26,1,0,0
25312,7527,2020-11-18T16:21:46.3739542Z,2020,11,1,3,9,0,9no,0,0,2,0,0,10,8,0,11,0,0,0
25312,7528,2020-11-18T16:21:46.3739542Z,2020,38,4,23,18,0,K,0,4,20,0,0,34,15,0,38,0,0,0
56085,33881,2021-06-24T13:18:35.7631003Z,2021,114,33,93,52,0,6to,0,0,62,0,0,81,21,0,114,0,1,0
56085,33882,2021-06-24T13:18:35.7631003Z,2021,90,29,73,42,0,7mo,1,0,48,0,0,61,17,0,89,0,0,0
56085,33883,2021-06-24T13:18:35.7631003Z,2021,116,40,94,41,0,8vo,1,2,75,0,0,76,22,0,115,2,0,0
56085,33884,2021-06-24T13:18:35.7641013Z,2021,23,22,18,3,0,Sin Grado,0,0,20,0,0,1,5,0,23,0,0,0
56085,3858,2020-11-18T16:21:05.5737475Z,2019,136,52,114,51,0,6to,1,2,85,0,0,84,22,0,135,3,0,0
56085,3859,2020-11-18T16:21:05.5737475Z,2019,102,33,84,37,0,7mo,0,2,65,0,0,69,18,0,102,2,0,0
56085,3860,2020-11-18T16:21:05.5737475Z,2019,105,40,86,58,0,8vo,1,2,47,0,0,65,19,0,104,0,1,0
56085,3861,2020-11-18T16:21:05.5747488Z,2019,23,19,19,3,0,Sin Grado,0,0,20,0,0,4,4,0,23,0,0,0
56085,9875,2020-11-18T16:22:00.5293954Z,2020,109,32,88,51,0,6to,3,3,58,0,0,77,21,0,106,3,0,0
56085,9876,2020-11-18T16:22:00.5293954Z,2020,133,52,116,46,0,7mo,2,2,87,0,0,81,17,0,131,3,0,0
56085,9877,2020-11-18T16:22:00.5293954Z,2020,101,35,77,41,0,8vo,0,1,60,0,0,66,24,0,101,2,0,0
56085,9878,2020-11-18T16:22:00.5293954Z,2020,20,20,15,3,0,Sin Grado,0,0,17,0,0,0,5,0,20,0,0,0
66316,10786,2020-11-18T16:22:06.0320661Z,2020,115,10,72,55,0,6to,6,0,60,0,0,105,43,1,108,0,0,0
66316,10787,2020-11-18T16:22:06.0330665Z,2020,121,13,43,73,0,7mo,5,0,48,0,0,108,78,0,116,0,0,0
66316,10788,2020-11-18T16:22:06.0330665Z,2020,106,12,49,55,0,8vo,0,0,51,0,0,94,57,3,103,0,0,0
66316,34803,2021-06-24T13:18:42.2237325Z,2021,103,17,62,50,0,6to,4,0,53,0,0,86,41,0,99,0,0,0
66316,34804,2021-06-24T13:18:42.2237325Z,2021,135,12,72,59,0,7mo,4,0,76,0,0,123,63,1,130,0,0,0
66316,34805,2021-06-24T13:18:42.2237325Z,2021,123,14,53,77,0,8vo,5,0,46,0,0,109,70,0,118,0,0,0
66316,4778,2020-11-18T16:21:11.9199805Z,2019,118,18,58,69,0,6to,5,0,49,0,0,100,60,0,113,1,0,0
66316,4779,2020-11-18T16:21:11.9199805Z,2019,105,14,45,53,0,7mo,0,0,52,0,0,91,60,2,103,0,0,0
66316,4780,2020-11-18T16:21:11.920981Z,2019,112,18,43,59,0,8vo,1,0,53,0,0,94,69,1,110,0,0,0
56820,33916,2021-06-24T13:18:36.6357256Z,2021,109,28,89,61,0,10mo,2,1,48,0,0,81,20,0,107,0,0,0
56820,33917,2021-06-24T13:18:36.6357256Z,2021,82,25,59,35,0,11mo,2,0,47,0,0,57,23,0,80,0,1,0
56820,33918,2021-06-24T13:18:36.6357256Z,2021,76,20,56,42,0,12mo,1,0,34,0,0,56,20,0,75,0,0,0
56820,33919,2021-06-24T13:18:36.6357256Z,2021,63,26,55,32,0,6to,0,0,31,0,0,37,8,0,63,0,0,0
56820,33920,2021-06-24T13:18:36.6367301Z,2021,78,21,58,33,0,7mo,4,0,45,0,0,57,20,0,74,0,0,0
56820,33921,2021-06-24T13:18:36.6367301Z,2021,104,36,78,48,0,8vo,6,0,56,0,0,68,26,0,98,0,1,0
56820,33922,2021-06-24T13:18:36.6367301Z,2021,104,28,82,48,0,9no,1,2,56,0,0,76,22,0,103,0,1,0
56820,33923,2021-06-24T13:18:36.6367301Z,2021,11,8,9,2,0,Sin Grado,1,0,9,0,0,3,2,0,10,0,0,0
56820,3893,2020-11-18T16:21:06.0900933Z,2019,87,24,68,44,0,10mo,1,0,43,0,0,63,19,0,86,0,0,0
56820,3894,2020-11-18T16:21:06.0900933Z,2019,74,15,54,41,0,11mo,0,0,33,0,0,59,20,0,74,0,0,0
56820,3895,2020-11-18T16:21:06.0900933Z,2019,72,0,58,34,0,12mo,2,0,38,0,0,72,14,0,70,0,0,0
56820,3896,2020-11-18T16:21:06.0910937Z,2019,99,35,84,45,0,6to,4,0,54,0,0,64,15,0,95,0,1,0
56820,3897,2020-11-18T16:21:06.0910937Z,2019,126,35,101,55,0,7mo,0,2,71,0,0,91,25,0,126,0,1,0
56820,3898,2020-11-18T16:21:06.0910937Z,2019,113,34,88,55,0,8vo,3,0,58,0,0,79,25,0,110,0,1,0
56820,3899,2020-11-18T16:21:06.0910937Z,2019,100,33,75,43,0,9no,3,0,57,0,0,67,25,0,97,0,1,0
56820,3900,2020-11-18T16:21:06.0920942Z,2019,18,17,18,6,0,Sin Grado,1,1,12,0,0,1,0,0,17,0,0,0
56820,9910,2020-11-18T16:22:01.546075Z,2020,85,29,60,37,0,10mo,2,0,48,0,0,56,25,0,83,0,1,0
56820,9911,2020-11-18T16:22:01.546075Z,2020,83,22,64,44,0,11mo,0,0,39,0,0,61,19,0,83,0,0,0
56820,9912,2020-11-18T16:22:01.546075Z,2020,69,14,51,39,0,12mo,0,0,30,0,0,55,18,0,69,0,0,0
56820,9913,2020-11-18T16:22:01.547075Z,2020,72,24,63,30,0,6to,4,0,42,0,0,48,9,0,68,0,0,0
56820,9914,2020-11-18T16:22:01.547075Z,2020,97,35,83,43,0,7mo,5,0,54,0,0,62,14,0,92,0,1,0
56820,9915,2020-11-18T16:22:01.547075Z,2020,113,33,92,52,0,8vo,0,0,61,0,0,80,21,0,113,0,1,0
56820,9916,2020-11-18T16:22:01.5480768Z,2020,109,31,91,57,0,9no,3,1,52,0,0,78,18,0,106,0,1,0
56820,9917,2020-11-18T16:22:01.5480768Z,2020,9,8,9,2,0,Sin Grado,1,0,7,0,0,1,0,0,8,0,0,0
47894,3165,2020-11-18T16:21:01.0307185Z,2019,268,46,177,126,0,10mo,5,1,142,0,0,222,91,0,263,0,1,0
47894,3166,2020-11-18T16:21:01.0317194Z,2019,249,40,174,123,0,11mo,2,0,126,0,0,209,75,0,247,0,0,0
47894,3167,2020-11-18T16:21:01.0317194Z,2019,240,0,168,126,0,12mo,2,0,114,0,0,240,72,0,238,0,0,0
47894,3168,2020-11-18T16:21:01.0317194Z,2019,265,57,223,121,0,9no,1,2,144,0,0,208,42,0,264,0,0,0
47894,33182,2021-06-24T13:18:30.3472168Z,2021,234,42,199,121,0,10mo,0,0,113,0,0,192,35,0,234,0,3,0
47894,33183,2021-06-24T13:18:30.3472168Z,2021,213,41,178,107,0,11mo,1,0,106,0,0,172,35,0,212,0,0,0
47894,33184,2021-06-24T13:18:30.3472168Z,2021,225,39,156,112,0,12mo,2,0,113,0,0,186,69,0,223,0,1,0
47894,33185,2021-06-24T13:18:30.3482173Z,2021,206,59,169,90,0,9no,2,2,116,0,0,147,37,0,203,0,0,1
47894,33186,2021-06-24T13:18:30.3482173Z,2021,12,12,9,5,0,Sin Grado,0,0,7,0,0,0,3,0,12,0,0,0
47894,9179,2020-11-18T16:21:56.1474747Z,2020,227,51,171,110,0,10mo,1,1,117,0,0,176,56,0,226,0,0,0
47894,9180,2020-11-18T16:21:56.1484756Z,2020,234,39,142,116,0,11mo,3,0,118,0,0,195,92,0,231,0,0,0
47894,9181,2020-11-18T16:21:56.1484756Z,2020,222,36,154,112,0,12mo,1,0,110,0,0,186,68,0,221,0,0,0
47894,9182,2020-11-18T16:21:56.1484756Z,2020,247,56,190,126,0,9no,0,1,121,0,0,191,57,0,247,0,0,0
11320,154,2020-11-18T16:20:37.5680718Z,2019,51,13,46,22,0,1ro,0,0,29,0,0,38,5,0,51,0,0,0
11320,155,2020-11-18T16:20:37.5680718Z,2019,48,11,41,25,0,2do,0,0,23,0,0,37,7,0,48,0,0,0
11320,156,2020-11-18T16:20:37.5690727Z,2019,32,9,21,19,0,3ro,0,0,13,0,0,23,11,0,32,0,0,0
11320,157,2020-11-18T16:20:37.5690727Z,2019,31,8,25,17,0,4to,0,0,14,0,0,23,6,0,31,0,0,0
11320,158,2020-11-18T16:20:37.5690727Z,2019,37,9,29,22,0,5to,0,0,15,0,0,28,8,0,37,0,0,0
11320,159,2020-11-18T16:20:37.5690727Z,2019,36,11,31,20,0,6to,0,0,16,0,0,25,5,0,36,0,0,0
11320,160,2020-11-18T16:20:37.5690727Z,2019,26,9,18,13,0,7mo,0,0,13,0,0,17,8,0,26,0,0,0
11320,161,2020-11-18T16:20:37.5700726Z,2019,38,11,28,19,0,8vo,0,0,19,0,0,27,10,0,38,0,0,0
11320,162,2020-11-18T16:20:37.5700726Z,2019,27,5,15,12,0,K,0,0,15,0,0,22,12,0,27,0,0,0
11320,163,2020-11-18T16:20:37.5700726Z,2019,9,0,6,7,0,PK,0,0,2,0,0,9,3,0,9,0,0,0
11320,30153,2021-06-24T13:18:06.3089736Z,2021,24,7,20,13,0,1ro,2,1,11,0,0,17,4,0,22,0,0,0
11320,30154,2021-06-24T13:18:06.3099741Z,2021,31,9,29,13,0,2do,0,0,18,0,0,22,2,0,31,0,0,0
11320,30155,2021-06-24T13:18:06.3099741Z,2021,46,9,38,20,0,3ro,0,0,26,0,0,37,8,0,46,0,0,0
11320,30156,2021-06-24T13:18:06.3099741Z,2021,42,10,40,21,0,4to,0,0,21,0,0,32,2,0,42,0,0,0
11320,30157,2021-06-24T13:18:06.3099741Z,2021,33,8,29,17,0,5to,0,0,16,0,0,25,4,0,33,1,0,0
11320,30158,2021-06-24T13:18:06.3109746Z,2021,35,6,27,19,0,6to,0,0,16,0,0,29,8,0,35,2,0,0
11320,30159,2021-06-24T13:18:06.3109746Z,2021,42,10,34,24,0,7mo,0,0,18,0,0,32,8,0,42,1,0,0
11320,30160,2021-06-24T13:18:06.3109746Z,2021,34,13,31,16,0,8vo,0,0,18,0,0,21,3,0,34,1,0,0
11320,30161,2021-06-24T13:18:06.3109746Z,2021,24,4,19,13,0,K,1,0,11,0,0,20,5,0,22,0,0,1
11320,30162,2021-06-24T13:18:06.3119755Z,2021,11,2,8,4,0,PK,0,0,7,0,0,9,3,0,11,0,0,0
11320,6155,2020-11-18T16:21:38.2495376Z,2020,29,9,26,12,0,1ro,0,0,17,0,0,20,3,0,29,0,0,0
11320,6156,2020-11-18T16:21:38.2495376Z,2020,43,9,40,18,0,2do,0,0,25,0,0,34,3,0,43,0,0,0
11320,6157,2020-11-18T16:21:38.2495376Z,2020,40,9,35,20,0,3ro,0,0,20,0,0,31,5,0,40,0,0,0
11320,6158,2020-11-18T16:21:38.2495376Z,2020,31,8,25,17,0,4to,0,0,14,0,0,23,6,0,31,1,0,0
11320,6159,2020-11-18T16:21:38.2495376Z,2020,32,7,26,18,0,5to,0,0,14,0,0,25,6,0,32,2,0,0
11320,6160,2020-11-18T16:21:38.250538Z,2020,39,9,32,22,0,6to,0,0,17,0,0,30,7,0,39,1,0,0
11320,6161,2020-11-18T16:21:38.250538Z,2020,38,12,33,18,0,7mo,0,0,20,0,0,26,5,0,38,1,0,0
11320,6162,2020-11-18T16:21:38.250538Z,2020,30,11,23,15,0,8vo,0,0,15,0,0,19,7,0,30,0,0,0
11320,6163,2020-11-18T16:21:38.250538Z,2020,25,4,20,12,0,K,3,0,13,0,0,21,5,0,22,0,0,0
11320,6164,2020-11-18T16:21:38.250538Z,2020,15,2,10,9,0,PK,1,0,6,0,0,13,5,0,14,0,0,0
35618,2353,2020-11-18T16:20:55.7321869Z,2019,146,20,117,66,0,10mo,1,0,80,0,0,126,29,1,144,1,0,0
35618,2354,2020-11-18T16:20:55.7331887Z,2019,157,25,111,78,0,11mo,0,0,79,0,0,132,46,0,156,0,0,1
35618,2355,2020-11-18T16:20:55.7331887Z,2019,152,0,98,94,0,12mo,4,0,58,0,0,152,54,1,147,0,2,0
35618,2356,2020-11-18T16:20:55.7331887Z,2019,166,30,136,83,0,9no,4,0,83,0,0,136,30,0,162,0,2,0
35618,2357,2020-11-18T16:20:55.7341873Z,2019,15,8,11,5,0,Sin Grado,0,0,10,0,0,7,4,0,15,0,0,0
35618,32360,2021-06-24T13:18:23.3331814Z,2021,160,28,126,78,0,10mo,0,0,82,0,0,132,34,0,160,2,2,0
35618,32361,2021-06-24T13:18:23.3331814Z,2021,168,32,120,75,0,11mo,5,0,93,0,0,136,48,0,163,0,2,0
35618,32362,2021-06-24T13:18:23.3331814Z,2021,138,21,92,65,0,12mo,3,0,73,0,0,117,46,0,134,1,1,1
35618,32363,2021-06-24T13:18:23.3341819Z,2021,121,27,93,63,0,9no,2,0,58,0,0,94,28,0,119,0,0,0
35618,32364,2021-06-24T13:18:23.3341819Z,2021,18,18,16,6,0,Sin Grado,0,0,12,0,0,0,2,0,18,0,0,0
35618,8365,2020-11-18T16:21:51.4043092Z,2020,157,34,108,77,0,10mo,5,0,80,0,0,123,49,0,152,0,2,0
35618,8366,2020-11-18T16:21:51.4043092Z,2020,149,24,109,69,0,11mo,3,0,80,0,0,125,40,0,146,2,1,0
35618,8367,2020-11-18T16:21:51.4053092Z,2020,156,28,106,79,0,12mo,0,0,77,0,0,128,50,0,156,0,0,0
35618,8368,2020-11-18T16:21:51.4053092Z,2020,161,29,128,78,0,9no,0,0,83,0,0,132,33,0,161,3,2,0
35618,8369,2020-11-18T16:21:51.4053092Z,2020,15,15,12,5,0,Sin Grado,0,0,10,0,0,0,3,0,15,0,0,0
56432,33908,2021-06-24T13:18:36.6147103Z,2021,137,44,111,60,0,10mo,2,0,77,0,0,93,26,0,134,0,0,1
56432,33909,2021-06-24T13:18:36.6147103Z,2021,133,33,109,59,0,11mo,1,0,74,0,0,100,24,0,132,0,0,0
56432,33910,2021-06-24T13:18:36.6147103Z,2021,106,27,87,59,0,12mo,2,0,47,0,0,79,19,0,104,0,0,0
56432,33911,2021-06-24T13:18:36.6147103Z,2021,152,51,134,75,0,9no,3,0,77,0,0,101,18,0,148,4,0,1
56432,3885,2020-11-18T16:21:05.5907591Z,2019,124,40,98,61,0,10mo,4,3,63,0,0,84,26,0,120,2,0,0
56432,3886,2020-11-18T16:21:05.5907591Z,2019,109,25,96,55,0,11mo,0,0,54,0,0,84,13,0,109,0,0,0
56432,3887,2020-11-18T16:21:05.5907591Z,2019,117,1,93,48,0,12mo,1,1,69,0,0,116,24,0,116,0,1,0
56432,3888,2020-11-18T16:21:05.5917595Z,2019,150,41,119,63,0,9no,0,5,87,0,0,109,31,0,150,0,1,0
56432,9902,2020-11-18T16:22:01.5310647Z,2020,130,37,104,53,0,10mo,1,0,77,0,0,93,26,0,129,0,0,0
56432,9903,2020-11-18T16:22:01.5310647Z,2020,103,31,82,57,0,11mo,2,0,46,0,0,72,21,0,101,0,0,0
56432,9904,2020-11-18T16:22:01.5320652Z,2020,94,23,82,46,0,12mo,0,0,48,0,0,71,12,0,94,0,0,0
56432,9905,2020-11-18T16:22:01.5320652Z,2020,130,45,108,57,0,9no,1,1,73,0,0,85,22,0,128,0,0,1
17368,30692,2021-06-24T13:18:10.9372926Z,2021,102,19,78,50,0,10mo,1,0,52,0,0,83,24,0,100,0,0,1
17368,30693,2021-06-24T13:18:10.9372926Z,2021,45,15,34,13,0,11mo,0,0,32,0,0,30,11,0,45,0,0,0
17368,30694,2021-06-24T13:18:10.9382926Z,2021,143,43,97,67,0,12mo,0,0,76,0,0,100,46,0,143,2,0,0
17368,30695,2021-06-24T13:18:10.9382926Z,2021,87,27,70,43,0,9no,0,0,44,0,0,60,17,0,87,1,0,0
17368,6694,2020-11-18T16:21:40.7712218Z,2020,48,13,31,15,0,10mo,0,0,33,0,0,35,17,0,48,0,0,0
17368,6695,2020-11-18T16:21:40.7722227Z,2020,152,45,92,76,0,11mo,0,0,76,0,0,107,60,0,152,2,0,0
17368,6696,2020-11-18T16:21:40.7722227Z,2020,128,28,94,66,0,12mo,2,0,62,0,0,100,34,0,126,6,0,0
17368,6697,2020-11-18T16:21:40.7722227Z,2020,117,24,69,61,0,9no,1,0,56,0,0,93,48,0,115,0,0,1
17368,693,2020-11-18T16:20:41.5927595Z,2019,148,44,95,75,0,10mo,0,0,73,0,0,104,53,0,148,1,0,0
17368,694,2020-11-18T16:20:41.5927595Z,2019,139,32,101,70,1,11mo,2,0,69,0,0,107,38,0,137,5,0,0
17368,695,2020-11-18T16:20:41.5927595Z,2019,173,0,127,85,0,12mo,2,0,88,0,0,173,46,0,171,0,0,0
17368,696,2020-11-18T16:20:41.5927595Z,2019,44,15,36,15,0,9no,0,0,29,0,0,29,8,0,44,0,0,0
17327,30682,2021-06-24T13:18:10.6711017Z,2021,62,18,51,31,0,10mo,0,0,31,0,0,44,11,0,62,0,0,0
17327,30683,2021-06-24T13:18:10.6711017Z,2021,62,9,53,32,0,11mo,0,0,30,0,0,53,9,0,62,0,0,0
17327,30684,2021-06-24T13:18:10.6721018Z,2021,66,12,53,29,0,12mo,0,0,37,0,0,54,13,0,66,0,0,0
17327,30685,2021-06-24T13:18:10.6721018Z,2021,56,17,46,28,0,9no,0,0,28,0,0,39,10,0,56,0,0,0
17327,30686,2021-06-24T13:18:10.6721018Z,2021,4,4,3,0,0,Sin Grado,0,0,4,0,0,0,1,0,4,0,0,0
17327,6684,2020-11-18T16:21:40.7652187Z,2020,71,14,58,34,0,10mo,1,0,37,0,0,57,13,0,70,0,0,0
17327,6685,2020-11-18T16:21:40.7652187Z,2020,65,11,50,27,0,11mo,1,0,38,0,0,54,15,0,64,0,0,0
17327,6686,2020-11-18T16:21:40.7652187Z,2020,56,14,48,22,0,12mo,0,0,34,0,0,42,8,0,56,0,0,0
17327,6687,2020-11-18T16:21:40.7662201Z,2020,69,20,55,35,0,9no,0,0,34,0,0,49,14,0,69,0,0,0
17327,6688,2020-11-18T16:21:40.7662201Z,2020,4,4,2,0,0,Sin Grado,0,0,4,0,0,0,2,0,4,0,0,0
17327,684,2020-11-18T16:20:41.194493Z,2019,74,15,50,30,0,10mo,3,0,44,0,0,59,24,0,71,0,0,0
17327,685,2020-11-18T16:20:41.1954948Z,2019,57,15,48,23,0,11mo,0,0,34,0,0,42,9,0,57,0,0,0
17327,686,2020-11-18T16:20:41.1954948Z,2019,68,0,47,38,0,12mo,4,0,30,0,0,68,21,0,64,0,0,0
17327,687,2020-11-18T16:20:41.1954948Z,2019,72,13,62,35,0,9no,3,0,37,0,0,59,10,0,69,0,0,0
47639,3151,2020-11-18T16:21:01.0247154Z,2019,30,5,21,16,0,10mo,0,0,14,0,0,25,9,0,30,0,0,0
47639,3152,2020-11-18T16:21:01.0247154Z,2019,55,9,44,26,0,11mo,0,0,29,0,0,46,11,0,55,0,0,0
47639,3153,2020-11-18T16:21:01.0247154Z,2019,44,0,35,15,0,12mo,1,0,29,0,0,44,9,0,43,0,0,0
47639,3154,2020-11-18T16:21:01.0247154Z,2019,61,19,49,24,0,9no,0,0,37,0,0,42,12,0,61,0,0,0
47639,3155,2020-11-18T16:21:01.0257163Z,2019,4,3,4,0,0,Sin Grado,0,0,4,0,0,1,0,0,4,0,0,0
47639,33167,2021-06-24T13:18:30.3422139Z,2021,38,7,32,18,0,10mo,1,0,20,0,0,31,6,0,37,0,0,0
47639,33168,2021-06-24T13:18:30.3422139Z,2021,53,12,41,25,0,11mo,0,0,28,0,0,41,12,0,53,0,0,0
47639,33169,2021-06-24T13:18:30.343214Z,2021,20,5,14,11,0,12mo,0,0,9,0,0,15,6,0,20,0,0,0
47639,33170,2021-06-24T13:18:30.343214Z,2021,41,10,38,20,0,9no,0,0,21,0,0,31,3,0,41,0,0,0
47639,33171,2021-06-24T13:18:30.343214Z,2021,7,7,7,0,0,Sin Grado,1,0,7,0,0,0,0,0,6,0,0,0
47639,9165,2020-11-18T16:21:56.1444725Z,2020,57,15,39,25,0,10mo,0,0,32,0,0,42,18,0,57,0,0,0
47639,9166,2020-11-18T16:21:56.1444725Z,2020,23,6,15,13,0,11mo,0,0,10,0,0,17,8,0,23,0,0,0
47639,9167,2020-11-18T16:21:56.1444725Z,2020,51,7,42,26,0,12mo,0,0,25,0,0,44,9,0,51,0,0,0
47639,9168,2020-11-18T16:21:56.1444725Z,2020,42,11,32,19,0,9no,1,0,23,0,0,31,10,0,41,0,0,0
47639,9169,2020-11-18T16:21:56.1454734Z,2020,3,3,3,0,0,Sin Grado,1,0,3,0,0,0,0,0,2,0,0,0
55244,33833,2021-06-24T13:18:35.7410841Z,2021,288,43,208,138,0,10mo,2,0,150,0,0,245,80,0,286,9,1,0
55244,33834,2021-06-24T13:18:35.7420855Z,2021,308,68,202,144,0,11mo,3,0,164,0,0,240,106,0,305,10,1,0
55244,33835,2021-06-24T13:18:35.7420855Z,2021,273,55,190,138,0,12mo,1,0,135,0,0,218,83,0,272,9,1,0
55244,33836,2021-06-24T13:18:35.7420855Z,2021,146,30,102,69,0,9no,0,0,77,0,0,116,44,0,146,6,0,0
55244,33837,2021-06-24T13:18:35.7420855Z,2021,27,27,22,2,0,Sin Grado,0,0,25,0,0,0,5,0,27,0,0,0
55244,3810,2020-11-18T16:21:05.5597386Z,2019,287,61,188,147,0,10mo,1,0,140,0,0,226,99,0,286,9,1,0
55244,3811,2020-11-18T16:21:05.5597386Z,2019,245,42,163,137,0,11mo,0,0,108,0,0,203,82,0,245,7,0,0
55244,3812,2020-11-18T16:21:05.560739Z,2019,281,0,192,145,0,12mo,3,0,136,0,0,281,89,0,278,0,2,0
55244,3813,2020-11-18T16:21:05.560739Z,2019,234,50,162,110,0,9no,1,0,124,0,0,184,72,0,233,6,1,0
55244,3814,2020-11-18T16:21:05.560739Z,2019,29,18,24,4,0,Sin Grado,0,0,25,0,0,11,5,0,29,0,0,0
55244,9827,2020-11-18T16:22:00.5153865Z,2020,326,71,201,157,0,10mo,3,3,169,0,0,255,125,0,323,10,1,0
55244,9828,2020-11-18T16:22:00.5153865Z,2020,284,62,174,146,0,11mo,1,2,138,0,0,222,110,0,283,9,1,0
55244,9829,2020-11-18T16:22:00.5153865Z,2020,240,43,157,134,0,12mo,0,1,106,0,0,197,83,0,240,7,0,0
55244,9830,2020-11-18T16:22:00.5163869Z,2020,295,42,203,131,0,9no,2,3,164,0,0,253,92,0,293,8,1,0
55244,9831,2020-11-18T16:22:00.5163869Z,2020,33,33,28,3,0,Sin Grado,0,1,30,0,0,0,5,0,33,0,0,0
28373,1700,2020-11-18T16:20:48.2712109Z,2019,76,29,62,32,0,10mo,1,4,44,0,0,47,14,0,75,1,2,0
28373,1701,2020-11-18T16:20:48.8495946Z,2019,83,27,69,44,0,11mo,1,13,39,0,0,56,14,0,82,0,1,0
28373,1702,2020-11-18T16:20:48.8495946Z,2019,109,0,88,45,0,12mo,1,17,64,0,0,109,21,0,108,0,0,0
28373,1703,2020-11-18T16:20:48.8495946Z,2019,75,23,63,37,0,9no,0,4,38,0,1,52,12,0,75,0,0,0
28373,1704,2020-11-18T16:20:48.8505951Z,2019,21,17,19,5,0,Sin Grado,0,0,16,0,0,4,2,0,21,0,1,0
28373,31702,2021-06-24T13:18:17.1197257Z,2021,56,20,50,25,0,10mo,0,13,31,0,0,36,6,1,55,0,0,0
28373,31703,2021-06-24T13:18:17.1197257Z,2021,70,26,55,34,0,11mo,1,1,36,0,0,44,15,0,69,0,0,0
28373,31704,2021-06-24T13:18:17.1207285Z,2021,70,23,53,34,0,12mo,0,3,36,0,0,47,17,0,70,2,2,0
28373,31705,2021-06-24T13:18:17.1207285Z,2021,67,20,60,31,0,9no,4,13,36,0,0,47,7,0,63,2,2,0
28373,31706,2021-06-24T13:18:17.1207285Z,2021,41,40,32,12,0,Sin Grado,0,2,29,0,0,1,9,0,41,0,1,0
28373,7705,2020-11-18T16:21:47.9019738Z,2020,70,27,54,33,0,10mo,2,2,37,0,0,43,16,0,68,0,0,0
28373,7706,2020-11-18T16:21:47.9019738Z,2020,71,21,51,36,0,11mo,0,3,35,0,0,50,20,0,71,3,2,0
28373,7707,2020-11-18T16:21:47.9019738Z,2020,79,23,60,44,0,12mo,1,8,35,0,0,56,19,0,78,0,1,0
28373,7708,2020-11-18T16:21:47.9019738Z,2020,57,21,45,31,0,9no,0,2,26,0,0,36,12,1,56,0,0,0
28373,7709,2020-11-18T16:21:47.9029743Z,2020,50,41,42,10,0,Sin Grado,0,2,40,0,0,9,8,0,50,0,1,0
28571,1746,2020-11-18T16:20:48.8616031Z,2019,252,56,169,137,0,10mo,0,0,115,0,0,196,83,0,252,0,0,0
28571,1747,2020-11-18T16:20:48.8616031Z,2019,218,60,149,119,0,11mo,3,0,99,0,0,158,69,0,215,0,0,0
28571,1748,2020-11-18T16:20:48.8616031Z,2019,272,0,180,140,0,12mo,5,5,132,0,0,272,92,0,267,0,0,0
28571,1749,2020-11-18T16:20:48.8626035Z,2019,232,63,170,132,0,9no,1,0,100,0,0,169,62,0,231,1,0,0
28571,1750,2020-11-18T16:20:48.8626035Z,2019,3,1,2,1,0,Sin Grado,0,0,2,0,0,2,1,0,3,0,0,0
28571,31749,2021-06-24T13:18:17.234808Z,2021,256,98,188,139,0,10mo,1,1,117,0,0,158,68,0,255,0,0,0
28571,31750,2021-06-24T13:18:17.234808Z,2021,209,57,151,120,0,11mo,1,3,89,0,0,152,58,0,208,1,0,0
28571,31751,2021-06-24T13:18:17.234808Z,2021,210,48,155,128,0,12mo,0,0,82,0,0,162,55,0,210,0,0,0
28571,31752,2021-06-24T13:18:17.235809Z,2021,211,70,172,105,0,9no,0,2,106,0,0,141,39,0,211,0,0,0
28571,31753,2021-06-24T13:18:17.235809Z,2021,1,1,1,0,0,Sin Grado,0,0,1,0,0,0,0,0,1,0,0,0
28571,7752,2020-11-18T16:21:47.913981Z,2020,228,59,167,128,0,10mo,1,0,100,0,0,169,61,0,227,1,0,0
28571,7753,2020-11-18T16:21:47.913981Z,2020,222,48,146,131,0,11mo,0,0,91,0,0,174,76,0,222,0,0,0
28571,7754,2020-11-18T16:21:47.913981Z,2020,205,59,132,111,0,12mo,2,0,94,0,0,146,73,0,203,0,0,0
28571,7755,2020-11-18T16:21:47.9149823Z,2020,261,104,180,134,0,9no,1,1,127,0,0,157,81,0,260,0,0,0
28571,7756,2020-11-18T16:21:47.9149823Z,2020,3,2,3,1,0,Sin Grado,0,0,2,0,0,1,0,0,3,0,0,0
36053,2447,2020-11-18T16:20:56.2595389Z,2019,98,16,80,54,0,10mo,1,0,44,0,0,82,18,0,97,0,0,0
36053,2448,2020-11-18T16:20:56.2605389Z,2019,101,17,70,54,0,11mo,3,0,47,0,0,84,31,0,98,0,0,0
36053,2449,2020-11-18T16:20:56.2605389Z,2019,150,1,96,78,0,12mo,2,0,72,0,0,149,54,0,148,0,0,0
36053,2450,2020-11-18T16:20:56.2605389Z,2019,97,28,72,42,0,9no,1,0,55,0,0,69,25,0,96,0,0,0
36053,2451,2020-11-18T16:20:56.2605389Z,2019,44,40,35,8,0,Sin Grado,0,0,36,0,0,4,9,0,44,0,1,0
36053,32454,2021-06-24T13:18:24.7231823Z,2021,77,18,65,44,0,10mo,1,0,33,0,0,59,12,0,76,0,0,0
36053,32455,2021-06-24T13:18:24.7231823Z,2021,99,26,66,47,0,11mo,4,0,52,0,0,73,33,0,95,0,0,0
36053,32456,2021-06-24T13:18:24.7241828Z,2021,91,14,68,49,0,12mo,1,0,42,0,0,77,23,0,90,0,0,0
36053,32457,2021-06-24T13:18:24.7241828Z,2021,84,23,61,47,0,9no,2,0,37,0,0,61,23,0,82,0,0,0
36053,32458,2021-06-24T13:18:24.7241828Z,2021,46,45,38,10,0,Sin Grado,0,0,36,0,0,1,8,0,46,0,1,0
36053,8459,2020-11-18T16:21:51.7985705Z,2020,101,27,78,46,0,10mo,2,4,55,0,0,74,23,0,97,0,0,2
36053,8460,2020-11-18T16:21:51.799571Z,2020,97,15,75,50,0,11mo,1,5,47,0,0,82,22,0,96,0,0,0
36053,8461,2020-11-18T16:21:51.799571Z,2020,93,15,67,54,0,12mo,3,1,39,0,0,78,26,0,90,1,0,0
36053,8462,2020-11-18T16:21:51.799571Z,2020,81,20,65,45,0,9no,1,5,36,0,0,61,16,0,80,0,0,0
36053,8463,2020-11-18T16:21:51.8005714Z,2020,43,43,34,8,0,Sin Grado,0,0,35,0,0,0,9,0,43,0,1,0
17558,30725,2021-06-24T13:18:11.1784648Z,2021,299,97,237,147,0,10mo,2,0,152,0,0,202,62,0,297,0,1,0
17558,30726,2021-06-24T13:18:11.1784648Z,2021,295,80,236,162,0,11mo,3,0,133,0,0,215,59,0,292,0,0,0
17558,30727,2021-06-24T13:18:11.1794658Z,2021,271,69,210,154,0,12mo,1,0,117,0,0,202,61,0,270,0,0,0
17558,30728,2021-06-24T13:18:11.1794658Z,2021,321,117,258,154,0,9no,8,0,167,0,0,204,63,0,313,1,1,0
17558,30729,2021-06-24T13:18:11.1794658Z,2021,25,25,23,9,0,Sin Grado,1,0,16,0,0,0,2,0,24,0,0,0
17558,6727,2020-11-18T16:21:41.434662Z,2020,310,84,249,166,0,10mo,5,0,144,0,0,226,61,0,305,0,1,0
17558,6728,2020-11-18T16:21:41.4356628Z,2020,291,75,209,165,0,11mo,1,0,126,0,0,216,82,0,290,0,0,0
17558,6729,2020-11-18T16:21:41.4356628Z,2020,259,59,196,118,0,12mo,2,0,141,0,0,200,63,0,257,0,0,0
17558,6730,2020-11-18T16:21:41.4356628Z,2020,286,91,224,141,0,9no,1,0,145,0,0,195,62,0,284,0,1,1
17558,6731,2020-11-18T16:21:41.4366624Z,2020,15,15,15,5,0,Sin Grado,0,0,10,0,0,0,0,0,15,0,0,0
17558,726,2020-11-18T16:20:42.108101Z,2019,318,83,226,179,0,10mo,1,0,139,0,0,235,92,0,317,0,0,0
17558,727,2020-11-18T16:20:42.108101Z,2019,270,59,204,122,0,11mo,2,0,148,0,0,211,66,0,268,0,0,0
17558,728,2020-11-18T16:20:42.108101Z,2019,292,0,216,152,0,12mo,0,0,140,0,0,292,76,0,292,0,0,0
17558,729,2020-11-18T16:20:42.108101Z,2019,312,88,234,166,0,9no,5,0,146,0,0,224,78,0,307,0,1,0
17558,730,2020-11-18T16:20:42.108101Z,2019,15,10,15,6,0,Sin Grado,0,0,9,0,0,5,0,0,15,0,0,0
17863,30777,2021-06-24T13:18:11.2054858Z,2021,141,33,109,75,0,10mo,1,2,66,0,0,108,32,0,140,3,0,0
17863,30778,2021-06-24T13:18:11.2054858Z,2021,129,26,101,71,0,11mo,1,0,58,0,0,103,28,0,128,2,0,0
17863,30779,2021-06-24T13:18:11.2064858Z,2021,94,23,78,39,0,12mo,1,1,55,0,0,71,16,0,93,1,2,0
17863,30780,2021-06-24T13:18:11.2064858Z,2021,110,26,88,54,0,9no,1,1,56,0,0,84,22,0,109,0,0,0
17863,30781,2021-06-24T13:18:11.2064858Z,2021,19,18,13,3,0,Sin Grado,0,0,16,0,0,1,6,0,19,0,0,0
17863,6780,2020-11-18T16:21:41.4496712Z,2020,149,32,116,83,0,10mo,1,0,66,0,0,117,33,0,148,2,0,0
17863,6781,2020-11-18T16:21:41.4496712Z,2020,106,26,86,46,0,11mo,1,0,60,0,0,80,20,0,105,1,2,0
17863,6782,2020-11-18T16:21:41.4496712Z,2020,102,27,78,48,0,12mo,0,0,54,0,0,75,24,0,102,5,0,0
17863,6783,2020-11-18T16:21:41.4506717Z,2020,159,36,112,86,0,9no,1,3,73,0,0,123,47,0,158,3,0,0
17863,6784,2020-11-18T16:21:41.4506717Z,2020,14,14,11,3,0,Sin Grado,0,0,11,0,0,0,3,0,14,0,0,0
17863,779,2020-11-18T16:20:42.119108Z,2019,127,31,102,58,0,10mo,1,0,69,0,0,96,25,0,126,1,2,0
17863,780,2020-11-18T16:20:42.1201089Z,2019,105,27,87,50,0,11mo,0,0,55,0,0,78,18,0,105,5,0,0
17863,781,2020-11-18T16:20:42.1201089Z,2019,150,0,128,77,0,12mo,0,1,73,0,0,150,22,0,150,1,0,0
17863,782,2020-11-18T16:20:42.1201089Z,2019,150,33,125,75,0,9no,1,0,75,0,0,117,25,0,149,2,0,0
17863,783,2020-11-18T16:20:42.1201089Z,2019,14,7,12,3,0,Sin Grado,0,0,11,0,0,7,2,0,14,0,0,0
35766,2359,2020-11-18T16:20:55.7341873Z,2019,270,44,202,130,0,10mo,3,0,140,0,0,226,68,0,267,0,1,0
35766,2360,2020-11-18T16:20:55.7341873Z,2019,174,20,117,84,0,11mo,4,0,90,0,0,154,57,0,170,0,0,0
35766,2361,2020-11-18T16:20:55.7341873Z,2019,215,0,146,124,0,12mo,2,1,91,0,0,215,69,0,213,0,0,0
35766,2362,2020-11-18T16:20:55.7351887Z,2019,250,45,187,117,0,9no,3,3,133,0,0,205,63,0,247,0,1,0
35766,2363,2020-11-18T16:20:55.7351887Z,2019,30,18,26,6,0,Sin Grado,1,0,24,0,0,12,4,0,29,0,0,0
35766,32366,2021-06-24T13:18:23.3451891Z,2021,239,39,192,122,0,10mo,1,0,117,0,0,200,47,0,238,0,0,0
35766,32367,2021-06-24T13:18:23.3451891Z,2021,192,32,152,98,0,11mo,4,0,94,0,0,160,40,0,188,0,1,0
35766,32368,2021-06-24T13:18:23.3451891Z,2021,185,25,142,91,0,12mo,5,1,94,0,0,160,43,0,180,0,2,0
35766,32369,2021-06-24T13:18:23.3451891Z,2021,206,41,168,117,0,9no,1,0,89,0,0,165,38,0,205,1,0,0
35766,32370,2021-06-24T13:18:23.3461905Z,2021,18,18,14,4,0,Sin Grado,0,0,14,0,0,0,4,0,18,0,0,0
35766,8371,2020-11-18T16:21:51.4083123Z,2020,227,38,169,117,0,10mo,2,0,110,0,0,189,58,0,225,0,1,0
35766,8372,2020-11-18T16:21:51.4083123Z,2020,216,33,157,103,0,11mo,2,0,113,0,0,183,59,0,214,0,0,0
35766,8373,2020-11-18T16:21:51.4083123Z,2020,152,19,104,72,0,12mo,4,0,80,0,0,133,48,0,148,0,0,0
35766,8374,2020-11-18T16:21:51.4093123Z,2020,253,47,183,129,0,9no,2,0,124,0,0,206,70,0,251,0,0,0
35766,8375,2020-11-18T16:21:51.4093123Z,2020,24,24,22,6,0,Sin Grado,0,0,18,0,0,0,2,0,24,0,0,0
35501,2335,2020-11-18T16:20:55.7271829Z,2019,94,14,64,38,0,10mo,0,0,56,0,0,80,30,0,94,0,0,0
35501,2336,2020-11-18T16:20:55.7271829Z,2019,117,25,75,59,0,11mo,3,0,58,0,0,92,42,1,113,0,1,0
35501,2337,2020-11-18T16:20:55.7271829Z,2019,120,0,85,57,0,12mo,2,0,63,0,0,120,35,0,118,0,1,0
35501,2338,2020-11-18T16:20:55.7281842Z,2019,150,38,112,73,0,9no,4,0,77,0,0,112,38,0,146,1,0,0
35501,2339,2020-11-18T16:20:55.7281842Z,2019,52,23,47,15,0,Sin Grado,1,1,37,0,0,29,5,0,51,0,0,0
35501,32342,2021-06-24T13:18:23.3271771Z,2021,121,32,96,56,0,10mo,2,0,65,0,0,89,25,0,119,0,1,0
35501,32343,2021-06-24T13:18:23.3271771Z,2021,128,30,102,66,0,11mo,3,0,62,0,0,98,26,0,125,1,0,0
35501,32344,2021-06-24T13:18:23.3271771Z,2021,75,10,58,33,0,12mo,0,0,42,0,0,65,17,0,75,1,0,0
35501,32345,2021-06-24T13:18:23.3271771Z,2021,106,23,81,42,0,9no,1,0,64,0,0,83,25,0,105,0,2,0
35501,32346,2021-06-24T13:18:23.328178Z,2021,79,70,61,23,0,Sin Grado,2,0,56,0,0,9,18,0,77,0,0,0
35501,8347,2020-11-18T16:21:51.3993057Z,2020,145,37,115,70,0,10mo,4,0,75,0,0,108,30,0,141,1,0,0
35501,8348,2020-11-18T16:21:51.3993057Z,2020,93,12,65,38,0,11mo,0,0,55,0,0,81,28,0,93,0,0,0
35501,8349,2020-11-18T16:21:51.3993057Z,2020,113,25,75,58,0,12mo,3,0,55,0,0,88,38,1,109,0,1,0
35501,8350,2020-11-18T16:21:51.4003066Z,2020,125,34,92,57,0,9no,2,0,68,0,0,91,33,0,123,0,1,0
35501,8351,2020-11-18T16:21:51.4003066Z,2020,58,44,52,18,0,Sin Grado,1,1,40,0,0,14,6,0,57,0,0,0
28530,1719,2020-11-18T16:20:48.8555995Z,2019,90,27,68,50,0,10mo,0,2,40,0,0,63,22,0,90,1,0,0
28530,1720,2020-11-18T16:20:48.8555995Z,2019,72,24,65,44,0,11mo,0,3,28,0,0,48,7,0,72,0,0,0
28530,1721,2020-11-18T16:20:48.8555995Z,2019,45,0,37,32,0,12mo,0,1,13,0,0,45,8,0,45,0,0,0
28530,1722,2020-11-18T16:20:48.8555995Z,2019,64,15,47,33,0,9no,0,0,31,0,0,49,17,0,64,1,0,0
28530,1723,2020-11-18T16:20:48.8555995Z,2019,4,3,3,4,0,Sin Grado,0,0,0,0,0,1,1,0,4,0,0,0
28530,31721,2021-06-24T13:18:17.2077889Z,2021,106,47,92,53,0,10mo,2,0,53,0,0,59,14,0,104,0,0,0
28530,31722,2021-06-24T13:18:17.2087903Z,2021,61,12,44,35,0,11mo,0,0,26,0,0,49,17,0,61,1,0,0
28530,31723,2021-06-24T13:18:17.2087903Z,2021,77,25,64,44,0,12mo,0,0,33,0,0,52,13,0,77,1,0,0
28530,31724,2021-06-24T13:18:17.2087903Z,2021,90,27,80,41,0,9no,0,0,49,0,0,63,10,0,90,0,0,0
28530,31725,2021-06-24T13:18:17.2087903Z,2021,5,5,5,4,0,Sin Grado,0,0,1,0,0,0,0,0,5,0,0,0
28530,7724,2020-11-18T16:21:47.9089778Z,2020,62,14,46,35,0,10mo,0,1,27,0,0,48,16,0,62,1,0,0
28530,7725,2020-11-18T16:21:47.9089778Z,2020,79,26,61,45,0,11mo,0,0,34,0,0,53,18,0,79,1,0,0
28530,7726,2020-11-18T16:21:47.9099783Z,2020,66,23,61,40,0,12mo,0,0,26,0,0,43,5,0,66,0,0,0
28530,7727,2020-11-18T16:21:47.9099783Z,2020,100,44,79,47,0,9no,2,0,53,0,0,56,21,0,98,0,0,0
28530,7728,2020-11-18T16:21:47.9099783Z,2020,4,4,3,4,0,Sin Grado,0,0,0,0,0,0,1,0,4,0,0,0
36384,2475,2020-11-18T16:20:56.2705456Z,2019,120,16,94,60,0,10mo,8,0,60,0,0,104,26,0,112,2,0,0
36384,2476,2020-11-18T16:20:56.2705456Z,2019,87,12,57,44,0,11mo,7,0,43,0,0,75,30,1,79,0,0,0
36384,2477,2020-11-18T16:20:56.2715461Z,2019,96,0,66,63,0,12mo,1,0,33,0,0,96,30,0,95,0,0,0
36384,2478,2020-11-18T16:20:56.2715461Z,2019,126,16,103,69,0,9no,4,0,57,0,0,110,23,0,122,2,1,0
36384,2479,2020-11-18T16:20:56.2725469Z,2019,8,6,7,2,0,Sin Grado,0,0,6,0,0,2,1,0,8,0,0,0
36384,32482,2021-06-24T13:18:24.7291858Z,2021,133,22,97,73,0,10mo,1,0,60,0,0,111,36,0,132,2,0,0
36384,32483,2021-06-24T13:18:24.7291858Z,2021,108,14,88,59,0,11mo,4,0,49,0,0,94,20,0,104,2,1,0
36384,32484,2021-06-24T13:18:24.7301867Z,2021,99,12,79,49,0,12mo,6,0,50,0,0,87,20,0,93,2,0,0
36384,32485,2021-06-24T13:18:24.7301867Z,2021,128,23,95,72,0,9no,5,0,56,0,0,105,33,0,123,1,0,0
36384,32486,2021-06-24T13:18:24.7301867Z,2021,11,11,10,1,0,Sin Grado,0,0,10,0,0,0,1,0,11,0,0,0
36384,8487,2020-11-18T16:21:51.8085763Z,2020,112,15,88,61,0,10mo,4,0,51,0,0,97,24,0,108,2,1,0
36384,8488,2020-11-18T16:21:51.8085763Z,2020,102,13,74,52,0,11mo,6,0,50,0,0,89,28,0,96,2,0,0
36384,8489,2020-11-18T16:21:51.8085763Z,2020,83,12,54,43,0,12mo,5,0,40,0,0,71,29,1,77,0,0,0
36384,8490,2020-11-18T16:21:51.8085763Z,2020,131,18,82,78,0,9no,0,0,53,0,0,113,49,1,130,2,0,0
36384,8491,2020-11-18T16:21:51.8095777Z,2020,10,10,9,3,0,Sin Grado,0,0,7,0,0,0,1,0,10,0,1,0
54445,33777,2021-06-24T13:18:35.2767516Z,2021,89,26,57,43,0,1ro,1,4,46,0,0,63,32,0,87,0,0,1
54445,33778,2021-06-24T13:18:35.2767516Z,2021,69,20,51,26,0,2do,1,1,43,0,0,49,18,0,68,0,0,0
54445,33779,2021-06-24T13:18:35.2777525Z,2021,67,25,46,34,0,3ro,1,3,33,0,0,42,21,0,66,0,0,0
54445,33780,2021-06-24T13:18:35.2777525Z,2021,83,30,53,37,0,4to,2,2,46,0,0,53,30,0,80,0,0,1
54445,33781,2021-06-24T13:18:35.2777525Z,2021,87,17,54,48,0,5to,2,3,39,0,0,70,33,0,85,0,0,0
54445,33782,2021-06-24T13:18:35.2787526Z,2021,44,11,30,21,0,K,0,1,23,0,0,33,14,0,43,0,0,1
54445,3754,2020-11-18T16:21:05.1144409Z,2019,69,22,43,33,0,1ro,2,7,36,0,0,47,26,0,67,0,0,0
54445,3755,2020-11-18T16:21:05.1144409Z,2019,84,29,44,37,0,2do,2,4,47,0,0,55,40,0,81,1,0,1
54445,3756,2020-11-18T16:21:05.1154409Z,2019,84,20,47,46,0,3ro,2,7,38,0,0,64,37,0,82,0,0,0
54445,3757,2020-11-18T16:21:05.1154409Z,2019,70,21,42,39,0,4to,2,3,31,0,0,49,28,0,68,0,0,0
54445,3758,2020-11-18T16:21:05.1154409Z,2019,99,25,70,53,0,5to,2,5,46,0,0,74,29,0,97,1,0,0
54445,3759,2020-11-18T16:21:05.1154409Z,2019,63,16,0,24,0,K,0,1,39,0,0,47,63,0,63,0,0,0
54445,9771,2020-11-18T16:22:00.1281294Z,2020,61,16,40,20,0,1ro,2,1,41,0,0,45,21,0,59,0,0,0
54445,9772,2020-11-18T16:22:00.1291285Z,2020,63,21,40,30,0,2do,1,4,33,0,0,42,23,0,62,0,0,0
54445,9773,2020-11-18T16:22:00.1291285Z,2020,85,30,54,38,0,3ro,2,3,47,0,0,55,31,0,81,0,0,2
54445,9774,2020-11-18T16:22:00.1291285Z,2020,80,16,47,42,0,4to,2,5,38,0,0,64,33,0,78,0,0,0
54445,9775,2020-11-18T16:22:00.1301285Z,2020,68,20,34,37,0,5to,3,2,31,0,0,48,34,0,65,0,0,0
54445,9776,2020-11-18T16:22:00.1301285Z,2020,73,16,48,33,0,K,0,3,40,0,0,57,25,0,71,0,0,2
12229,30309,2021-06-24T13:18:08.7907536Z,2021,18,3,17,12,0,1ro,0,0,6,0,0,15,1,0,18,0,0,0
12229,30310,2021-06-24T13:18:08.7917541Z,2021,23,10,22,7,0,2do,0,0,16,0,0,13,1,0,23,0,0,0
12229,30311,2021-06-24T13:18:08.7917541Z,2021,16,3,15,14,0,3ro,0,0,2,0,0,13,1,0,16,0,0,0
12229,30312,2021-06-24T13:18:08.7917541Z,2021,27,15,27,10,0,4to,0,0,17,0,0,12,0,0,27,0,0,0
12229,30313,2021-06-24T13:18:08.7917541Z,2021,18,6,14,7,0,5to,1,0,11,0,0,12,4,0,17,0,0,0
12229,30314,2021-06-24T13:18:08.7927542Z,2021,16,3,9,6,0,K,0,0,10,0,0,13,7,0,16,0,0,0
12229,30315,2021-06-24T13:18:08.7927542Z,2021,4,4,3,0,0,Sin Grado,1,0,4,0,0,0,1,0,3,0,1,0
12229,311,2020-11-18T16:20:39.6314489Z,2019,25,7,24,19,0,1ro,0,0,6,0,0,18,1,0,25,0,0,0
12229,312,2020-11-18T16:20:39.6324494Z,2019,26,13,26,10,0,2do,0,0,16,0,0,13,0,0,26,0,0,0
12229,313,2020-11-18T16:20:39.6324494Z,2019,25,10,25,11,0,3ro,1,0,14,0,0,15,0,0,24,0,0,0
12229,314,2020-11-18T16:20:39.6324494Z,2019,26,13,25,12,0,4to,2,0,14,0,0,13,1,0,24,0,1,0
12229,315,2020-11-18T16:20:39.6334507Z,2019,27,15,26,16,0,5to,0,0,11,0,0,12,1,0,27,0,0,0
12229,316,2020-11-18T16:20:39.6334507Z,2019,31,16,31,7,0,K,2,0,24,0,0,15,0,0,29,0,0,0
12229,317,2020-11-18T16:20:39.6334507Z,2019,4,4,4,0,0,Sin Grado,1,0,4,0,0,0,0,0,3,0,1,0
12229,6312,2020-11-18T16:21:39.231194Z,2020,25,12,25,5,0,1ro,1,0,20,0,0,13,0,0,24,0,0,0
12229,6313,2020-11-18T16:21:39.231194Z,2020,25,7,25,19,0,2do,0,0,6,0,0,18,0,0,25,0,0,0
12229,6314,2020-11-18T16:21:39.2321944Z,2020,31,15,31,14,0,3ro,0,0,17,0,0,16,0,0,31,0,0,0
12229,6315,2020-11-18T16:21:39.2321944Z,2020,20,7,20,8,0,4to,1,0,12,0,0,13,0,0,19,0,0,0
12229,6316,2020-11-18T16:21:39.2321944Z,2020,24,15,24,11,0,5to,3,0,13,0,0,9,0,0,21,0,1,0
12229,6317,2020-11-18T16:21:39.2321944Z,2020,22,6,22,13,0,K,1,0,9,0,0,16,0,0,21,0,0,0
12229,6318,2020-11-18T16:21:39.2331944Z,2020,4,4,4,0,0,Sin Grado,1,0,4,0,0,0,0,0,3,0,1,0
32755,2121,2020-11-18T16:20:54.566407Z,2019,87,26,80,43,0,10mo,1,0,44,0,0,61,7,0,86,0,0,0
32755,2122,2020-11-18T16:20:54.566407Z,2019,84,16,67,37,0,11mo,1,0,47,0,0,68,17,0,83,0,0,0
32755,2123,2020-11-18T16:20:54.566407Z,2019,71,0,61,36,0,12mo,1,0,35,0,0,71,10,0,70,0,0,0
32755,2124,2020-11-18T16:20:54.566407Z,2019,123,34,94,52,0,9no,0,0,71,0,0,89,29,0,122,0,0,1
32755,2125,2020-11-18T16:20:54.566407Z,2019,18,13,16,6,0,Sin Grado,0,0,12,0,0,5,2,0,18,0,0,0
32755,32127,2021-06-24T13:18:20.8834238Z,2021,107,20,92,52,0,10mo,0,2,55,0,0,87,15,0,107,0,0,0
32755,32128,2021-06-24T13:18:20.8834238Z,2021,104,25,87,43,0,11mo,0,0,61,0,0,79,17,0,103,0,0,1
32755,32129,2021-06-24T13:18:20.8834238Z,2021,70,21,63,33,0,12mo,1,0,37,0,0,49,7,0,69,0,0,0
32755,32130,2021-06-24T13:18:20.8834238Z,2021,101,29,86,60,0,9no,1,0,41,0,0,72,15,0,100,0,1,0
32755,32131,2021-06-24T13:18:20.8844252Z,2021,25,25,19,7,0,Sin Grado,0,0,18,0,0,0,6,0,25,0,0,0
32755,8133,2020-11-18T16:21:50.2205215Z,2020,110,29,89,44,0,10mo,0,0,66,0,0,81,21,0,109,0,0,1
32755,8134,2020-11-18T16:21:50.2205215Z,2020,77,23,68,35,0,11mo,1,0,42,0,0,54,9,0,76,0,0,0
32755,8135,2020-11-18T16:21:50.2205215Z,2020,76,14,61,35,0,12mo,1,0,41,0,0,62,15,0,75,0,0,0
32755,8136,2020-11-18T16:21:50.2205215Z,2020,111,17,95,51,0,9no,0,0,60,0,0,94,16,0,111,0,0,0
32755,8137,2020-11-18T16:21:50.221522Z,2020,26,26,23,7,0,Sin Grado,0,0,19,0,0,0,3,0,26,0,0,0
11502,204,2020-11-18T16:20:38.7598665Z,2019,189,62,146,92,0,6to,1,0,97,0,0,127,43,0,188,0,0,0
11502,205,2020-11-18T16:20:38.7598665Z,2019,167,56,133,82,0,7mo,2,1,85,0,0,111,34,0,165,0,0,0
11502,206,2020-11-18T16:20:38.7608674Z,2019,176,63,137,88,0,8vo,2,2,88,0,0,113,39,0,174,0,0,0
11502,30203,2021-06-24T13:18:07.066517Z,2021,159,50,129,69,0,6to,5,0,90,0,0,109,30,0,154,3,1,0
11502,30204,2021-06-24T13:18:07.0675175Z,2021,163,50,138,69,0,7mo,2,0,94,0,0,113,25,0,161,1,1,0
11502,30205,2021-06-24T13:18:07.0675175Z,2021,171,59,147,82,0,8vo,1,0,89,0,0,112,24,0,170,0,0,0
11502,30206,2021-06-24T13:18:07.0675175Z,2021,5,5,4,1,0,Sin Grado,1,0,4,0,0,0,1,0,4,0,0,0
11502,6205,2020-11-18T16:21:38.6187849Z,2020,163,53,125,67,0,6to,2,0,96,0,0,110,38,0,161,1,1,0
11502,6206,2020-11-18T16:21:38.6187849Z,2020,175,62,143,85,0,7mo,1,0,90,0,0,113,32,0,174,0,0,0
11502,6207,2020-11-18T16:21:38.6187849Z,2020,157,58,126,77,0,8vo,1,0,80,0,0,99,31,0,156,0,0,0
11502,6208,2020-11-18T16:21:38.6187849Z,2020,5,5,5,1,0,Sin Grado,1,0,4,0,0,0,0,0,4,0,0,0
70623,11087,2020-11-18T16:22:07.6371327Z,2020,188,63,132,74,0,10mo,3,1,114,0,0,125,56,0,185,0,1,0
70623,11088,2020-11-18T16:22:07.6371327Z,2020,157,55,100,67,0,11mo,2,0,90,0,0,102,57,0,155,2,0,0
70623,11089,2020-11-18T16:22:07.6371327Z,2020,90,27,56,43,0,12mo,2,0,47,0,0,63,34,0,88,0,0,0
70623,11090,2020-11-18T16:22:07.6381327Z,2020,240,91,185,117,0,9no,3,1,123,0,0,149,55,0,237,0,0,0
70623,11091,2020-11-18T16:22:07.6381327Z,2020,54,52,48,15,0,Sin Grado,1,4,39,0,0,2,6,0,53,0,0,0
70623,35108,2021-06-24T13:18:44.4793499Z,2021,211,76,166,110,0,10mo,2,1,101,0,0,135,45,0,209,0,0,0
70623,35109,2021-06-24T13:18:44.4793499Z,2021,170,58,127,66,0,11mo,2,0,104,0,0,112,43,0,168,0,1,0
70623,35110,2021-06-24T13:18:44.4793499Z,2021,137,49,92,61,0,12mo,1,1,76,0,0,88,45,0,136,2,0,0
70623,35111,2021-06-24T13:18:44.4803509Z,2021,184,70,150,88,0,9no,4,0,96,0,0,114,34,0,180,1,0,0
70623,35112,2021-06-24T13:18:44.4803509Z,2021,50,50,45,18,0,Sin Grado,1,0,32,0,0,0,5,0,49,0,0,0
70623,5081,2020-11-18T16:21:13.4379948Z,2019,182,62,118,82,0,10mo,2,0,100,0,0,120,64,0,180,2,0,0
70623,5082,2020-11-18T16:21:13.4379948Z,2019,97,28,57,46,0,11mo,2,0,51,0,0,69,40,0,95,0,0,0
70623,5083,2020-11-18T16:21:13.4389952Z,2019,134,0,87,63,0,12mo,2,1,71,0,0,134,47,0,132,0,0,0
70623,5084,2020-11-18T16:21:13.4389952Z,2019,220,82,157,83,0,9no,4,0,137,0,0,138,63,0,216,0,1,0
70623,5085,2020-11-18T16:21:13.4389952Z,2019,55,34,45,14,0,Sin Grado,0,3,41,0,0,21,10,0,55,0,0,0
77651,11705,2020-11-18T16:22:12.3092528Z,2020,110,33,88,53,0,10mo,1,4,57,0,0,77,22,0,109,0,0,0
77651,11706,2020-11-18T16:22:12.3092528Z,2020,107,37,79,62,0,11mo,3,5,45,0,0,70,28,0,104,0,0,0
77651,11707,2020-11-18T16:22:12.3102528Z,2020,100,28,69,55,0,12mo,0,2,45,0,0,72,31,0,100,0,0,0
77651,11708,2020-11-18T16:22:12.3102528Z,2020,70,25,57,34,0,9no,1,2,36,0,0,45,13,0,69,0,0,0
77651,11709,2020-11-18T16:22:12.3102528Z,2020,90,90,85,24,0,Sin Grado,2,9,66,0,0,0,5,0,88,0,1,0
77651,35727,2021-06-24T13:18:47.734684Z,2021,67,20,49,37,0,10mo,1,0,30,0,0,47,18,0,66,0,0,0
77651,35728,2021-06-24T13:18:47.734684Z,2021,108,32,84,49,0,11mo,2,6,59,0,0,76,24,0,106,0,0,0
77651,35729,2021-06-24T13:18:47.7356854Z,2021,101,31,72,60,0,12mo,3,2,41,0,0,70,29,0,98,0,0,0
77651,35730,2021-06-24T13:18:47.7356854Z,2021,116,48,98,67,0,9no,1,1,49,0,0,68,18,0,115,0,0,0
77651,35731,2021-06-24T13:18:47.7356854Z,2021,96,95,83,24,0,Sin Grado,1,5,72,0,0,1,13,0,95,0,0,0
77651,5698,2020-11-18T16:21:16.6311218Z,2019,138,50,96,77,0,10mo,3,8,61,0,0,88,42,0,135,0,0,0
77651,5699,2020-11-18T16:21:16.6311218Z,2019,121,26,82,65,0,11mo,1,1,56,0,0,95,39,1,119,0,1,0
77651,5700,2020-11-18T16:21:16.6321231Z,2019,123,4,81,66,0,12mo,0,4,57,0,0,119,42,0,123,0,0,0
77651,5701,2020-11-18T16:21:17.1404614Z,2019,125,41,102,51,0,9no,2,8,74,0,0,84,23,0,123,0,0,0
77651,5702,2020-11-18T16:21:17.1404614Z,2019,104,69,98,30,0,Sin Grado,1,18,74,0,0,35,6,0,103,0,1,0
42770,2793,2020-11-18T16:20:58.7622042Z,2019,25,8,20,10,0,1ro,0,0,15,0,0,17,5,0,25,0,0,0
42770,2794,2020-11-18T16:20:58.7632047Z,2019,26,4,19,13,0,2do,0,0,13,0,0,22,7,0,26,2,0,0
42770,2795,2020-11-18T16:20:58.7632047Z,2019,31,4,21,17,0,3ro,0,0,14,0,0,27,10,0,31,0,0,0
42770,2796,2020-11-18T16:20:58.7632047Z,2019,23,6,17,8,0,4to,0,0,15,0,0,17,6,0,23,0,0,0
42770,2797,2020-11-18T16:20:58.7632047Z,2019,24,5,17,11,0,5to,0,0,13,0,0,19,7,0,24,0,0,0
42770,2798,2020-11-18T16:20:58.7642051Z,2019,25,5,22,12,0,K,0,0,13,0,0,20,3,0,25,0,0,0
42770,2799,2020-11-18T16:20:58.7642051Z,2019,22,6,18,11,0,PK,0,0,11,0,0,16,4,0,22,0,0,0
42770,32799,2021-06-24T13:18:27.2099666Z,2021,25,3,24,13,0,1ro,0,0,12,0,0,22,1,0,25,0,0,0
42770,32800,2021-06-24T13:18:28.1806626Z,2021,26,7,23,13,0,2do,0,0,13,0,0,19,3,0,26,0,0,0
42770,32801,2021-06-24T13:18:28.1806626Z,2021,28,11,24,13,0,3ro,0,0,15,0,0,17,4,0,28,0,0,0
42770,32802,2021-06-24T13:18:28.1806626Z,2021,24,3,19,11,0,4to,0,0,13,0,0,21,5,0,24,2,0,0
42770,32803,2021-06-24T13:18:28.1816636Z,2021,28,5,19,14,0,5to,0,0,14,0,0,23,9,0,28,0,0,0
42770,32804,2021-06-24T13:18:28.1816636Z,2021,27,6,22,14,0,K,0,0,13,0,0,21,5,0,27,0,0,0
42770,32805,2021-06-24T13:18:28.1816636Z,2021,17,1,15,7,0,PK,0,0,10,0,0,16,2,0,17,0,0,0
42770,8803,2020-11-18T16:21:54.2091797Z,2020,23,5,21,13,0,1ro,0,0,10,0,0,18,2,0,23,0,0,0
42770,8804,2020-11-18T16:21:54.2091797Z,2020,22,9,17,9,0,2do,0,0,13,0,0,13,5,0,22,0,0,0
42770,8805,2020-11-18T16:21:54.2091797Z,2020,20,3,14,10,0,3ro,0,0,10,0,0,17,6,0,20,2,0,0
42770,8806,2020-11-18T16:21:54.2091797Z,2020,28,4,19,14,0,4to,0,0,14,0,0,24,9,0,28,0,0,0
42770,8807,2020-11-18T16:21:54.2091797Z,2020,23,6,16,8,0,5to,0,0,15,0,0,17,7,0,23,0,0,0
42770,8808,2020-11-18T16:21:54.2101802Z,2020,27,4,26,14,0,K,0,0,13,0,0,23,1,0,27,0,0,0
42770,8809,2020-11-18T16:21:54.2101802Z,2020,17,1,14,9,0,PK,0,0,8,0,0,16,3,0,17,0,0,0
14241,30549,2021-06-24T13:18:10.3909003Z,2021,51,22,46,28,0,10mo,0,0,23,0,0,29,5,0,51,0,0,0
14241,30550,2021-06-24T13:18:10.3909003Z,2021,50,28,42,27,0,11mo,0,0,23,0,0,22,8,1,49,0,0,0
14241,30551,2021-06-24T13:18:10.3909003Z,2021,60,23,51,23,0,12mo,0,0,37,0,0,37,9,0,60,0,0,0
14241,30552,2021-06-24T13:18:10.3919022Z,2021,33,9,28,15,0,6to,1,0,18,0,0,24,5,0,32,0,0,0
14241,30553,2021-06-24T13:18:10.3919022Z,2021,39,19,38,24,0,7mo,1,0,15,0,0,20,1,0,38,0,0,0
14241,30554,2021-06-24T13:18:10.3919022Z,2021,49,19,43,24,0,8vo,0,0,25,0,0,30,6,0,49,0,0,0
14241,30555,2021-06-24T13:18:10.3929018Z,2021,67,35,63,25,0,9no,2,0,42,0,0,32,4,0,65,0,0,0
14241,30556,2021-06-24T13:18:10.3929018Z,2021,11,11,10,0,0,Sin Grado,0,0,11,0,0,0,1,0,11,0,0,0
14241,552,2020-11-18T16:20:40.7732118Z,2019,77,25,66,27,0,10mo,0,0,50,0,0,52,11,0,77,0,1,0
14241,553,2020-11-18T16:20:40.7732118Z,2019,71,25,56,27,0,11mo,0,1,44,0,0,46,15,1,70,0,0,0
14241,554,2020-11-18T16:20:40.7732118Z,2019,56,0,44,27,0,12mo,0,0,29,0,0,56,12,1,55,0,0,0
14241,555,2020-11-18T16:20:40.7732118Z,2019,55,26,52,25,0,6to,0,0,30,0,0,29,3,0,55,0,0,0
14241,556,2020-11-18T16:20:40.7742136Z,2019,64,30,55,26,0,7mo,1,0,38,0,0,34,9,0,63,0,0,0
14241,557,2020-11-18T16:20:40.7742136Z,2019,90,36,78,49,0,8vo,0,0,41,0,0,54,12,1,89,0,0,0
14241,558,2020-11-18T16:20:40.7742136Z,2019,77,33,67,37,0,9no,1,0,40,0,0,44,10,1,75,0,0,0
14241,559,2020-11-18T16:20:40.7742136Z,2019,6,6,4,0,0,Sin Grado,0,0,6,0,0,0,2,0,6,0,0,0
14241,6551,2020-11-18T16:21:40.3569449Z,2020,49,26,41,25,0,10mo,0,0,24,0,0,23,8,1,48,0,0,0
14241,6552,2020-11-18T16:21:40.3569449Z,2020,67,24,54,24,0,11mo,0,0,43,0,0,43,13,0,67,0,0,0
14241,6553,2020-11-18T16:21:40.3569449Z,2020,58,20,45,24,0,12mo,0,0,34,0,0,38,13,0,58,0,0,0
14241,6554,2020-11-18T16:21:40.3569449Z,2020,41,16,38,26,0,6to,1,0,15,0,0,25,3,0,40,0,0,0
14241,6555,2020-11-18T16:21:40.3569449Z,2020,50,20,47,22,0,7mo,0,0,28,0,0,30,3,0,50,0,0,0
14241,6556,2020-11-18T16:21:40.3579458Z,2020,62,27,52,27,0,8vo,1,0,35,0,0,35,10,0,61,0,0,0
14241,6557,2020-11-18T16:21:40.3579458Z,2020,55,30,48,29,0,9no,0,0,26,0,0,25,7,0,55,0,0,0
14241,6558,2020-11-18T16:21:40.3579458Z,2020,8,8,5,0,0,Sin Grado,0,0,8,0,0,0,3,0,8,0,0,0
61440,10243,2020-11-18T16:22:03.1221213Z,2020,106,31,80,50,0,10mo,10,2,56,0,0,75,26,1,95,0,1,0
61440,10244,2020-11-18T16:22:03.1221213Z,2020,111,34,81,62,0,11mo,6,0,49,0,0,77,30,0,104,0,0,1
61440,10245,2020-11-18T16:22:03.1221213Z,2020,104,23,71,59,0,12mo,11,3,45,0,0,81,33,0,92,0,0,1
61440,10246,2020-11-18T16:22:03.1221213Z,2020,125,34,79,65,0,9no,5,2,60,0,0,91,46,0,119,1,0,1
61440,10247,2020-11-18T16:22:03.1231222Z,2020,5,5,3,0,0,Sin Grado,0,0,5,0,0,0,2,1,4,0,0,0
61440,34259,2021-06-24T13:18:38.0747584Z,2021,110,30,81,56,0,10mo,3,0,54,0,0,80,29,0,106,0,0,1
61440,34260,2021-06-24T13:18:38.0757593Z,2021,100,30,77,45,0,11mo,9,0,55,0,0,70,23,1,90,0,1,0
61440,34261,2021-06-24T13:18:38.0757593Z,2021,101,33,68,59,0,12mo,6,1,42,0,0,68,33,1,93,0,0,1
61440,34262,2021-06-24T13:18:38.0757593Z,2021,110,42,79,54,0,9no,3,1,56,0,0,68,31,0,107,3,0,0
61440,4228,2020-11-18T16:21:09.0150446Z,2019,118,34,88,65,0,10mo,9,1,53,0,0,84,30,0,107,0,0,2
61440,4229,2020-11-18T16:21:09.0150446Z,2019,111,23,76,57,0,11mo,14,7,54,0,0,88,35,0,95,0,0,2
61440,4230,2020-11-18T16:21:09.0160468Z,2019,96,0,59,45,0,12mo,11,3,51,0,0,96,37,0,85,0,0,0
61440,4231,2020-11-18T16:21:09.0160468Z,2019,113,34,89,55,0,9no,9,2,58,0,0,79,24,1,103,0,1,0
61440,4232,2020-11-18T16:21:09.0160468Z,2019,5,5,3,0,0,Sin Grado,0,0,5,0,0,0,2,1,4,0,1,0
69013,10819,2020-11-18T16:22:06.5313985Z,2020,36,7,30,18,0,1ro,0,0,18,0,0,29,6,1,35,0,0,0
69013,10820,2020-11-18T16:22:06.5323994Z,2020,47,10,42,21,0,2do,1,0,26,0,0,37,5,0,46,0,0,0
69013,10821,2020-11-18T16:22:06.5323994Z,2020,36,9,31,21,0,3ro,0,0,15,0,0,27,5,0,36,0,0,0
69013,10822,2020-11-18T16:22:06.5323994Z,2020,46,12,43,23,0,4to,1,0,23,0,0,34,3,0,45,0,0,0
69013,10823,2020-11-18T16:22:06.5323994Z,2020,41,14,34,22,0,5to,0,0,19,0,0,27,7,0,40,0,1,1
69013,10824,2020-11-18T16:22:06.5323994Z,2020,38,5,38,15,0,K,3,0,23,0,0,33,0,0,35,0,0,0
69013,10825,2020-11-18T16:22:06.5333999Z,2020,12,12,12,5,0,Sin Grado,0,0,7,0,0,0,0,0,12,0,0,0
69013,34840,2021-06-24T13:18:42.2977856Z,2021,33,7,32,15,0,1ro,1,0,18,0,0,26,1,0,32,0,0,0
69013,34841,2021-06-24T13:18:42.2977856Z,2021,33,8,27,14,0,2do,0,0,19,0,0,25,6,0,33,0,0,0
69013,34842,2021-06-24T13:18:42.2977856Z,2021,41,9,37,18,0,3ro,0,0,23,0,0,32,4,0,41,0,0,0
69013,34843,2021-06-24T13:18:42.2977856Z,2021,31,8,28,19,0,4to,1,0,12,0,0,23,3,0,30,0,0,0
69013,34844,2021-06-24T13:18:42.2987861Z,2021,38,8,33,22,0,5to,1,0,16,0,0,30,5,0,37,0,0,0
69013,34845,2021-06-24T13:18:42.2987861Z,2021,26,6,21,14,0,K,1,0,12,0,0,20,5,0,25,0,0,0
69013,34846,2021-06-24T13:18:42.2987861Z,2021,11,11,11,5,0,Sin Grado,0,0,6,0,0,0,0,0,11,0,0,0
69013,4812,2020-11-18T16:21:12.3792871Z,2019,55,16,52,24,0,1ro,0,1,31,0,0,39,3,0,55,0,0,0
69013,4813,2020-11-18T16:21:12.3792871Z,2019,40,9,35,21,0,2do,0,2,19,0,0,31,5,1,39,0,0,0
69013,4814,2020-11-18T16:21:12.3792871Z,2019,45,12,41,25,0,3ro,2,0,20,0,0,33,4,0,43,0,0,0
69013,4815,2020-11-18T16:21:12.380288Z,2019,59,20,50,33,0,4to,0,1,26,0,0,39,9,0,58,0,1,1
69013,4816,2020-11-18T16:21:12.380288Z,2019,50,24,48,25,0,5to,2,1,25,0,0,26,2,0,48,0,0,0
69013,4817,2020-11-18T16:21:12.380288Z,2019,46,9,38,26,0,K,0,0,20,0,0,37,8,0,46,0,0,0
69013,4818,2020-11-18T16:21:12.3812889Z,2019,13,12,12,2,0,Sin Grado,0,0,11,0,0,1,1,0,13,0,0,0
61531,10275,2020-11-18T16:22:03.1301267Z,2020,158,5,26,94,0,10mo,1,0,64,0,0,153,132,0,156,0,0,1
61531,10276,2020-11-18T16:22:03.1301267Z,2020,135,0,25,68,0,11mo,0,0,67,0,0,135,110,0,134,0,0,1
61531,10277,2020-11-18T16:22:03.1301267Z,2020,134,4,28,80,0,12mo,4,0,54,0,0,130,106,0,130,0,0,0
61531,10278,2020-11-18T16:22:03.1311285Z,2020,130,3,21,80,0,9no,4,0,50,0,0,127,109,0,126,0,0,0
61531,34290,2021-06-24T13:18:38.117789Z,2021,150,3,39,91,0,10mo,3,0,59,0,0,147,111,1,146,0,0,0
61531,34291,2021-06-24T13:18:38.117789Z,2021,151,5,37,89,0,11mo,2,0,62,0,0,146,114,0,148,0,0,1
61531,34292,2021-06-24T13:18:38.1187891Z,2021,128,1,30,65,0,12mo,0,0,63,0,0,127,98,0,127,0,0,1
61531,34293,2021-06-24T13:18:38.1187891Z,2021,152,4,37,98,0,9no,2,0,54,0,0,148,115,4,146,0,0,0
61531,4261,2020-11-18T16:21:09.0240508Z,2019,107,0,19,57,0,10mo,0,0,50,0,0,107,88,0,106,0,0,1
61531,4262,2020-11-18T16:21:09.0240508Z,2019,154,4,35,88,0,11mo,4,0,66,0,0,150,119,0,150,0,0,0
61531,4263,2020-11-18T16:21:09.0240508Z,2019,124,0,32,76,0,12mo,9,0,48,0,0,124,92,0,115,0,0,0
61531,4264,2020-11-18T16:21:09.0250508Z,2019,78,4,18,43,0,9no,1,0,35,0,0,74,60,0,76,0,0,1
62166,10383,2020-11-18T16:22:03.7405349Z,2020,160,59,126,80,0,10mo,4,1,80,0,0,101,34,0,155,0,0,1
62166,10384,2020-11-18T16:22:03.7415353Z,2020,147,48,96,73,0,11mo,4,3,74,0,0,99,51,0,143,0,0,0
62166,10385,2020-11-18T16:22:03.7415353Z,2020,129,41,101,60,0,12mo,2,8,69,0,0,88,28,0,127,0,0,0
62166,10386,2020-11-18T16:22:03.7415353Z,2020,118,26,96,58,0,9no,3,0,60,0,0,92,22,0,115,0,0,0
62166,34398,2021-06-24T13:18:38.6331583Z,2021,132,29,103,62,0,10mo,2,1,70,0,0,103,29,0,130,0,0,0
62166,34399,2021-06-24T13:18:38.6331583Z,2021,169,63,126,82,0,11mo,5,2,87,0,0,106,43,0,163,0,0,1
62166,34400,2021-06-24T13:18:39.4197219Z,2021,150,46,99,75,0,12mo,2,2,75,0,0,104,51,0,148,0,0,0
62166,34401,2021-06-24T13:18:39.4197219Z,2021,149,46,122,83,0,9no,3,2,66,0,0,103,27,0,146,0,0,0
62166,4370,2020-11-18T16:21:09.7034997Z,2019,138,45,87,66,0,10mo,4,7,72,0,0,93,51,0,134,0,0,0
62166,4371,2020-11-18T16:21:09.7045006Z,2019,123,41,95,55,0,11mo,3,7,68,0,0,82,28,0,120,0,0,0
62166,4372,2020-11-18T16:21:09.7045006Z,2019,1,0,1,1,0,12mo,0,0,0,0,0,1,0,0,1,0,0,0
62166,4373,2020-11-18T16:21:09.7045006Z,2019,161,61,127,75,0,9no,3,2,86,0,0,100,34,0,158,0,0,0
18234,30824,2021-06-24T13:18:11.4546638Z,2021,48,19,40,26,0,1ro,0,0,22,0,0,29,8,0,48,0,0,0
18234,30825,2021-06-24T13:18:11.4556634Z,2021,40,8,37,19,0,2do,0,0,21,0,0,32,3,0,40,0,0,0
18234,30826,2021-06-24T13:18:11.4556634Z,2021,53,19,44,31,0,3ro,0,0,22,0,0,34,9,0,53,0,0,0
18234,30827,2021-06-24T13:18:11.4556634Z,2021,49,16,40,24,0,4to,2,0,25,0,0,33,9,0,47,0,0,0
18234,30828,2021-06-24T13:18:11.4556634Z,2021,43,16,36,19,0,5to,0,0,24,0,0,27,7,0,43,0,0,0
18234,30829,2021-06-24T13:18:11.4566648Z,2021,63,19,45,33,0,6to,5,0,30,0,0,44,18,0,57,0,0,1
18234,30830,2021-06-24T13:18:11.4566648Z,2021,77,22,64,39,0,7mo,1,0,38,0,0,55,13,0,76,0,0,0
18234,30831,2021-06-24T13:18:11.4566648Z,2021,82,25,65,51,0,8vo,1,0,31,0,0,57,17,0,81,0,0,0
18234,30832,2021-06-24T13:18:11.4576666Z,2021,37,5,33,17,0,K,1,0,20,0,0,32,4,0,36,0,0,0
18234,6828,2020-11-18T16:21:42.0400634Z,2020,45,6,30,24,0,1ro,0,0,21,0,0,39,15,0,45,0,0,0
18234,6829,2020-11-18T16:21:42.0410643Z,2020,56,20,44,33,0,2do,1,0,23,0,0,36,12,0,55,0,0,0
18234,6830,2020-11-18T16:21:42.0410643Z,2020,47,15,31,25,0,3ro,1,0,22,0,0,32,16,0,46,0,0,0
18234,6831,2020-11-18T16:21:42.0410643Z,2020,41,15,33,17,0,4to,1,0,24,0,0,26,8,0,40,0,0,0
18234,6832,2020-11-18T16:21:42.0410643Z,2020,56,20,43,30,0,5to,5,0,26,0,0,36,13,0,51,0,0,0
18234,6833,2020-11-18T16:21:42.0420647Z,2020,73,20,55,34,0,6to,1,0,39,0,0,53,18,0,72,0,0,0
18234,6834,2020-11-18T16:21:42.0420647Z,2020,83,27,67,50,0,7mo,1,0,33,0,0,56,16,0,82,0,0,0
18234,6835,2020-11-18T16:21:42.0420647Z,2020,50,15,37,20,0,8vo,0,0,30,0,0,35,13,0,50,0,0,0
18234,6836,2020-11-18T16:21:42.0420647Z,2020,48,19,36,27,0,K,0,0,21,0,0,29,12,0,48,0,0,0
18234,827,2020-11-18T16:20:42.6414541Z,2019,49,18,43,29,0,1ro,0,4,20,0,0,31,6,0,49,0,0,0
18234,828,2020-11-18T16:20:42.6414541Z,2019,55,23,42,26,0,2do,0,3,29,0,0,32,13,0,55,0,0,0
18234,829,2020-11-18T16:20:42.6414541Z,2019,43,14,36,20,0,3ro,0,3,23,0,0,29,7,0,43,0,0,0
18234,830,2020-11-18T16:20:42.6424546Z,2019,53,20,42,28,0,4to,4,7,25,0,0,33,11,0,49,0,0,0
18234,831,2020-11-18T16:20:42.6424546Z,2019,55,15,37,27,0,5to,1,2,28,0,0,40,18,0,54,0,0,0
18234,832,2020-11-18T16:20:42.6424546Z,2019,84,28,60,48,0,6to,1,3,36,0,0,56,24,0,83,0,0,0
18234,833,2020-11-18T16:20:42.6424546Z,2019,49,17,35,20,0,7mo,0,1,29,0,0,32,14,0,49,0,0,0
18234,834,2020-11-18T16:20:42.643455Z,2019,96,39,81,51,0,8vo,2,2,45,0,0,57,15,0,94,0,1,0
18234,835,2020-11-18T16:20:42.643455Z,2019,51,12,35,30,0,K,0,0,21,0,0,39,16,0,51,0,0,0
24760,1431,2020-11-18T16:20:46.3329191Z,2019,21,10,19,7,0,1ro,0,0,14,0,0,11,2,0,21,0,0,0
24760,1432,2020-11-18T16:20:46.3329191Z,2019,13,9,12,7,0,2do,0,1,6,0,0,4,1,0,13,0,0,0
24760,1433,2020-11-18T16:20:46.3329191Z,2019,12,9,10,8,0,3ro,0,0,4,0,0,3,2,0,12,0,0,0
24760,1434,2020-11-18T16:20:46.3339204Z,2019,15,3,13,9,0,4to,0,0,6,0,0,12,2,0,15,0,0,0
24760,1435,2020-11-18T16:20:46.3339204Z,2019,10,3,10,6,0,5to,0,0,4,0,0,7,0,0,10,0,0,0
24760,1436,2020-11-18T16:20:46.3339204Z,2019,14,5,14,10,0,K,0,0,4,0,0,9,0,0,14,0,0,0
24760,1437,2020-11-18T16:20:46.3339204Z,2019,34,33,31,9,0,Sin Grado,0,1,25,0,0,1,3,0,34,0,0,0
24760,31431,2021-06-24T13:18:14.9121432Z,2021,20,4,16,11,0,1ro,1,0,9,0,0,16,4,0,19,0,0,0
24760,31432,2021-06-24T13:18:14.9121432Z,2021,22,11,18,7,0,2do,0,0,15,0,0,11,4,1,21,0,0,0
24760,31433,2021-06-24T13:18:14.9121432Z,2021,17,6,13,3,0,3ro,0,0,14,0,0,11,4,0,17,0,0,0
24760,31434,2021-06-24T13:18:14.9121432Z,2021,22,14,18,9,0,4to,1,0,13,0,0,8,4,0,21,0,0,0
24760,31435,2021-06-24T13:18:14.9131433Z,2021,16,10,11,8,0,5to,1,0,8,0,0,6,5,0,15,0,0,0
24760,31436,2021-06-24T13:18:14.9131433Z,2021,13,1,10,8,0,K,0,0,5,0,0,12,3,0,13,0,0,0
24760,31437,2021-06-24T13:18:14.9131433Z,2021,32,31,23,9,0,Sin Grado,0,0,23,0,0,1,9,0,32,0,0,0
24760,7434,2020-11-18T16:21:45.7635503Z,2020,22,11,21,12,0,1ro,0,0,10,0,0,11,1,1,21,0,0,0
24760,7435,2020-11-18T16:21:45.7635503Z,2020,16,7,13,5,0,2do,0,0,11,0,0,9,3,0,16,0,0,0
24760,7436,2020-11-18T16:21:45.7645516Z,2020,18,11,17,7,0,3ro,0,0,11,0,0,7,1,0,18,0,0,0
24760,7437,2020-11-18T16:21:45.7645516Z,2020,14,10,11,7,0,4to,0,0,7,0,0,4,3,0,14,0,0,0
24760,7438,2020-11-18T16:21:45.7645516Z,2020,13,3,11,6,0,5to,0,0,7,0,0,10,2,1,12,0,0,0
24760,7439,2020-11-18T16:21:45.7645516Z,2020,17,4,12,9,0,K,2,0,8,0,0,13,5,0,15,0,0,0
24760,7440,2020-11-18T16:21:45.7655525Z,2020,33,32,29,8,0,Sin Grado,0,0,25,0,0,1,4,0,33,0,0,0
65953,10727,2020-11-18T16:22:06.014054Z,2020,7,6,2,1,0,K,0,0,6,0,0,1,5,0,7,0,0,0
65953,10728,2020-11-18T16:22:06.014054Z,2020,23,11,9,8,0,PK,0,0,15,0,0,12,14,0,23,0,0,0
65953,10729,2020-11-18T16:22:06.014054Z,2020,74,74,54,28,0,Sin Grado,2,0,46,0,0,0,20,0,71,0,0,1
65953,34744,2021-06-24T13:18:41.4621871Z,2021,6,3,4,3,0,K,0,0,3,0,0,3,2,0,6,0,0,0
65953,34745,2021-06-24T13:18:41.4621871Z,2021,13,9,4,4,0,PK,0,0,9,0,0,4,9,0,13,0,0,0
65953,34746,2021-06-24T13:18:41.4621871Z,2021,81,80,56,25,0,Sin Grado,1,0,56,0,0,1,25,0,79,0,0,1
65953,4718,2020-11-18T16:21:11.9029712Z,2019,3,2,2,0,0,K,0,0,3,0,0,1,1,0,3,0,0,0
65953,4719,2020-11-18T16:21:11.9029712Z,2019,26,15,18,10,0,PK,1,0,16,0,0,11,8,0,25,0,0,0
65953,4720,2020-11-18T16:21:11.9039703Z,2019,76,73,57,25,0,Sin Grado,3,0,51,0,0,3,19,0,71,0,0,2
10611,30066,2021-06-24T13:18:05.8736612Z,2021,51,49,48,21,0,Sin Grado,0,0,30,0,0,2,3,0,51,0,0,0
10611,6067,2020-11-18T16:21:37.6901646Z,2020,50,49,50,18,0,Sin Grado,0,0,32,0,0,1,0,0,50,0,0,0
10611,66,2020-11-18T16:20:36.6834864Z,2019,55,41,53,18,0,Sin Grado,0,0,37,0,0,14,2,0,55,0,0,0
62968,10559,2020-11-18T16:22:04.9263268Z,2020,37,6,34,24,0,1ro,1,0,13,0,0,31,3,0,36,0,0,0
62968,10560,2020-11-18T16:22:04.9263268Z,2020,43,11,40,16,0,2do,2,0,27,0,0,32,3,0,41,0,0,0
62968,10561,2020-11-18T16:22:04.9263268Z,2020,46,20,43,26,0,3ro,2,0,20,0,0,26,3,0,43,0,0,1
62968,10562,2020-11-18T16:22:04.9263268Z,2020,33,13,30,22,0,4to,3,0,11,0,0,20,3,0,30,0,0,0
62968,10563,2020-11-18T16:22:04.9263268Z,2020,47,10,44,20,0,5to,0,0,27,0,0,37,3,0,47,0,0,0
62968,10564,2020-11-18T16:22:04.9273272Z,2020,70,25,65,33,0,6to,3,0,37,0,0,45,5,0,67,0,0,0
62968,10565,2020-11-18T16:22:04.9273272Z,2020,61,19,55,33,0,7mo,1,0,28,0,0,42,6,0,60,0,0,0
62968,10566,2020-11-18T16:22:04.9273272Z,2020,51,10,46,25,0,8vo,3,0,26,0,0,41,5,0,48,0,0,0
62968,10567,2020-11-18T16:22:04.9273272Z,2020,45,6,36,21,0,K,1,0,24,0,0,39,9,0,44,0,0,0
62968,34573,2021-06-24T13:18:40.2423117Z,2021,49,9,46,21,0,1ro,2,0,28,0,0,40,3,0,47,0,0,0
62968,34574,2021-06-24T13:18:40.2433127Z,2021,34,5,29,22,0,2do,2,0,12,0,0,29,5,0,32,0,0,0
62968,34575,2021-06-24T13:18:40.2433127Z,2021,43,11,39,17,0,3ro,2,0,26,0,0,32,4,0,41,0,0,0
62968,34576,2021-06-24T13:18:40.2433127Z,2021,39,16,37,21,0,4to,1,0,18,0,0,23,2,0,38,0,0,0
62968,34577,2021-06-24T13:18:40.2433127Z,2021,35,13,32,24,0,5to,3,0,11,0,0,22,3,0,32,0,0,0
62968,34578,2021-06-24T13:18:40.2443141Z,2021,64,14,63,29,0,6to,1,0,35,0,0,50,1,0,62,0,0,1
62968,34579,2021-06-24T13:18:40.2443141Z,2021,65,20,60,31,0,7mo,5,0,34,0,0,45,5,0,60,0,0,0
62968,34580,2021-06-24T13:18:40.2443141Z,2021,56,19,52,31,0,8vo,1,0,25,0,0,37,4,0,55,0,0,0
62968,34581,2021-06-24T13:18:40.2443141Z,2021,28,11,28,15,0,K,0,0,13,0,0,17,0,0,28,0,0,0
62968,4548,2020-11-18T16:21:10.8372577Z,2019,59,13,52,23,0,1ro,4,0,36,0,0,46,7,0,55,0,0,0
62968,4549,2020-11-18T16:21:10.8372577Z,2019,38,18,36,24,0,2do,1,0,14,0,0,20,2,0,37,0,0,0
62968,4550,2020-11-18T16:21:10.8382582Z,2019,37,12,32,16,0,3ro,2,0,21,0,0,25,5,0,35,0,0,0
62968,4551,2020-11-18T16:21:10.8382582Z,2019,41,11,36,17,0,4to,0,0,24,0,0,30,5,0,41,0,0,0
62968,4552,2020-11-18T16:21:10.8382582Z,2019,52,16,42,21,0,5to,3,0,31,0,0,36,10,0,49,0,0,0
62968,4553,2020-11-18T16:21:10.8382582Z,2019,62,19,57,31,0,6to,1,0,31,0,0,43,5,0,61,0,0,0
62968,4554,2020-11-18T16:21:10.8392591Z,2019,60,13,53,27,0,7mo,4,0,33,0,0,47,7,0,56,0,0,0
62968,4555,2020-11-18T16:21:10.8392591Z,2019,45,11,42,25,0,8vo,3,0,20,0,0,34,3,0,42,0,0,0
62968,4556,2020-11-18T16:21:10.8392591Z,2019,47,6,32,33,0,K,0,0,14,0,0,41,15,0,47,0,0,0
65557,10711,2020-11-18T16:22:06.0150549Z,2020,16,5,14,7,0,1ro,0,0,9,0,0,11,2,0,16,0,0,0
65557,10712,2020-11-18T16:22:06.0160558Z,2020,22,10,21,8,0,2do,0,0,14,0,0,12,1,0,22,0,0,0
65557,10713,2020-11-18T16:22:06.0160558Z,2020,25,10,21,12,0,3ro,0,0,13,0,0,15,4,0,25,0,0,0
65557,10714,2020-11-18T16:22:06.0160558Z,2020,25,10,22,7,0,4to,1,0,18,0,0,15,3,0,24,0,0,0
65557,10715,2020-11-18T16:22:06.0160558Z,2020,27,7,23,15,0,5to,0,0,12,0,0,20,4,0,27,0,0,0
65557,10716,2020-11-18T16:22:06.0170554Z,2020,81,27,71,43,0,6to,2,0,38,0,0,54,10,0,79,1,0,0
65557,10717,2020-11-18T16:22:06.0170554Z,2020,85,37,78,39,0,7mo,5,0,46,0,0,48,7,0,80,0,1,0
65557,10718,2020-11-18T16:22:06.0170554Z,2020,87,32,80,43,0,8vo,3,0,44,0,0,55,7,0,84,0,1,0
65557,10719,2020-11-18T16:22:06.0180567Z,2020,25,6,25,16,0,K,0,0,9,0,0,19,0,0,24,0,0,1
65557,34728,2021-06-24T13:18:41.4591848Z,2021,24,6,20,13,0,1ro,0,0,11,0,0,18,4,0,24,0,0,0
65557,34729,2021-06-24T13:18:41.4601861Z,2021,14,6,13,6,0,2do,0,0,8,0,0,8,1,0,14,0,0,0
65557,34730,2021-06-24T13:18:41.4601861Z,2021,22,10,18,8,0,3ro,0,0,14,0,0,12,4,0,22,0,0,0
65557,34731,2021-06-24T13:18:41.4601861Z,2021,27,11,22,13,0,4to,0,0,14,0,0,16,5,0,27,0,0,0
65557,34732,2021-06-24T13:18:41.4601861Z,2021,27,11,25,11,0,5to,1,0,16,0,0,16,2,0,26,0,0,0
65557,34733,2021-06-24T13:18:41.4601861Z,2021,90,28,84,46,0,6to,3,0,44,0,0,62,6,1,85,0,1,1
65557,34734,2021-06-24T13:18:41.4611866Z,2021,83,32,78,41,0,7mo,1,1,42,0,0,51,5,0,82,1,0,0
65557,34735,2021-06-24T13:18:41.4611866Z,2021,88,34,82,40,0,8vo,5,0,48,0,0,54,6,0,83,0,1,0
65557,34736,2021-06-24T13:18:41.4611866Z,2021,16,5,15,9,0,K,0,0,7,0,0,11,1,0,16,0,0,0
65557,4699,2020-11-18T16:21:11.2675447Z,2019,27,14,26,12,0,1ro,0,0,15,0,0,13,1,0,27,0,0,0
65557,4700,2020-11-18T16:21:11.2675447Z,2019,22,8,17,11,0,2do,0,0,11,0,0,14,5,0,22,0,0,0
65557,4701,2020-11-18T16:21:11.9049707Z,2019,27,13,24,11,0,3ro,0,0,16,0,0,14,3,0,27,0,0,0
65557,4702,2020-11-18T16:21:11.9049707Z,2019,24,5,23,12,0,4to,1,0,12,0,0,19,1,0,23,0,0,0
65557,4703,2020-11-18T16:21:11.9049707Z,2019,28,9,26,16,0,5to,0,1,12,0,0,19,2,0,28,1,0,0
65557,4704,2020-11-18T16:21:11.9049707Z,2019,89,37,81,45,0,6to,4,0,44,0,0,52,8,0,85,0,1,0
65557,4705,2020-11-18T16:21:11.9059707Z,2019,79,29,74,44,0,7mo,4,0,35,0,0,50,5,0,75,0,2,0
65557,4706,2020-11-18T16:21:11.9059707Z,2019,98,31,88,48,0,8vo,2,1,50,0,0,67,10,0,96,0,0,0
65557,4707,2020-11-18T16:21:11.9059707Z,2019,17,3,15,6,0,K,0,0,11,0,0,14,2,0,17,0,0,0
24612,1400,2020-11-18T16:20:45.9036325Z,2019,53,15,45,26,0,1ro,1,8,27,0,0,38,8,0,52,0,0,0
24612,1401,2020-11-18T16:20:46.3229133Z,2019,41,14,34,19,0,2do,0,2,22,0,1,27,7,0,41,0,0,0
24612,1402,2020-11-18T16:20:46.3229133Z,2019,37,15,28,19,0,3ro,0,4,18,0,0,22,9,0,37,0,0,0
24612,1403,2020-11-18T16:20:46.3229133Z,2019,45,13,29,24,0,4to,0,4,21,0,0,32,16,0,45,0,0,0
24612,1404,2020-11-18T16:20:46.3229133Z,2019,45,11,36,17,0,5to,0,3,28,0,0,34,9,0,45,0,0,0
24612,1405,2020-11-18T16:20:46.3229133Z,2019,46,8,35,17,0,K,0,0,29,0,1,38,11,0,46,0,0,0
24612,31401,2021-06-24T13:18:14.8971322Z,2021,64,11,57,31,0,1ro,1,1,33,0,0,53,7,0,63,0,0,0
24612,31402,2021-06-24T13:18:14.8981327Z,2021,42,11,34,12,0,2do,0,0,30,0,0,31,8,0,42,0,0,0
24612,31403,2021-06-24T13:18:14.8981327Z,2021,43,11,36,23,0,3ro,1,1,20,0,0,32,7,0,42,0,0,0
24612,31404,2021-06-24T13:18:14.8981327Z,2021,36,11,30,20,0,4to,0,2,16,0,0,25,6,0,36,0,0,0
24612,31405,2021-06-24T13:18:14.8981327Z,2021,39,13,30,25,0,5to,0,3,14,0,0,26,9,0,38,0,0,1
24612,31406,2021-06-24T13:18:14.8981327Z,2021,47,6,41,23,0,K,1,0,24,0,0,41,6,0,45,0,0,1
24612,7404,2020-11-18T16:21:45.7515428Z,2020,46,9,35,17,0,1ro,0,0,29,0,0,37,11,0,46,0,0,0
24612,7405,2020-11-18T16:21:45.7515428Z,2020,47,11,35,24,0,2do,1,3,23,0,0,36,12,0,46,0,0,0
24612,7406,2020-11-18T16:21:45.7515428Z,2020,37,10,29,21,0,3ro,0,1,16,0,0,27,8,0,37,0,0,0
24612,7407,2020-11-18T16:21:45.7525437Z,2020,38,12,28,22,0,4to,0,3,16,0,0,26,10,0,36,0,0,2
24612,7408,2020-11-18T16:21:45.7525437Z,2020,45,11,30,22,0,5to,0,1,23,0,0,34,15,0,45,0,0,0
24612,7409,2020-11-18T16:21:45.7525437Z,2020,65,9,57,29,0,K,1,1,36,0,0,56,8,0,64,0,0,0
71365,11281,2020-11-18T16:22:09.5884346Z,2020,33,17,30,10,0,1ro,0,0,23,0,0,16,3,0,33,0,0,0
71365,11282,2020-11-18T16:22:09.5884346Z,2020,50,21,42,25,0,2do,1,1,25,0,0,29,8,0,48,0,0,1
71365,11283,2020-11-18T16:22:09.5884346Z,2020,45,20,43,20,0,3ro,3,2,25,0,0,25,2,0,42,0,0,0
71365,11284,2020-11-18T16:22:09.5894355Z,2020,42,22,35,24,0,4to,2,2,18,0,0,20,7,0,40,0,0,0
71365,11285,2020-11-18T16:22:09.5894355Z,2020,46,18,41,26,0,5to,1,2,20,0,0,28,5,0,45,0,0,0
71365,11286,2020-11-18T16:22:09.5894355Z,2020,51,19,48,23,0,K,0,0,28,0,0,32,3,0,51,0,0,0
71365,11287,2020-11-18T16:22:09.5904373Z,2020,28,3,19,11,0,PK,0,0,17,0,0,25,9,0,28,0,0,0
71365,11288,2020-11-18T16:22:09.5904373Z,2020,29,29,29,7,0,Sin Grado,0,1,22,0,0,0,0,0,29,0,0,0
71365,35302,2021-06-24T13:18:45.5651283Z,2021,43,13,38,20,0,1ro,1,0,23,0,0,30,5,0,42,0,0,0
71365,35303,2021-06-24T13:18:45.5661306Z,2021,38,19,32,12,0,2do,0,0,26,0,0,19,6,0,38,0,0,0
71365,35304,2021-06-24T13:18:45.5661306Z,2021,53,26,49,27,0,3ro,1,3,26,0,0,27,4,0,51,0,0,1
71365,35305,2021-06-24T13:18:45.5661306Z,2021,45,22,42,22,0,4to,3,2,23,0,0,23,3,0,42,0,0,0
71365,35306,2021-06-24T13:18:45.5671302Z,2021,47,24,41,24,0,5to,2,2,23,0,0,23,6,0,45,0,0,0
71365,35307,2021-06-24T13:18:45.5671302Z,2021,35,8,34,14,0,K,0,0,21,0,0,27,1,0,35,0,0,0
71365,35308,2021-06-24T13:18:45.5671302Z,2021,15,3,11,7,0,PK,0,0,8,0,0,12,4,0,15,0,0,0
71365,35309,2021-06-24T13:18:45.5681316Z,2021,19,19,17,5,0,Sin Grado,0,0,14,0,0,0,2,0,19,0,0,0
71365,5276,2020-11-18T16:21:14.4706804Z,2019,59,30,49,26,0,1ro,2,2,33,0,0,29,10,0,56,0,0,1
71365,5277,2020-11-18T16:21:14.4716803Z,2019,55,25,53,29,0,2do,2,0,26,0,0,30,2,0,53,0,0,0
71365,5278,2020-11-18T16:21:14.4716803Z,2019,47,24,41,27,0,3ro,1,0,20,0,0,23,6,0,46,0,0,0
71365,5279,2020-11-18T16:21:14.4716803Z,2019,48,15,42,24,0,4to,1,1,24,0,0,33,6,0,47,0,0,0
71365,5280,2020-11-18T16:21:14.4716803Z,2019,55,18,50,27,0,5to,3,2,28,0,0,37,5,0,52,0,0,0
71365,5281,2020-11-18T16:21:14.4716803Z,2019,45,20,41,18,0,K,0,1,27,0,0,25,4,0,45,0,0,0
71365,5282,2020-11-18T16:21:14.4726808Z,2019,32,9,28,18,0,PK,1,0,14,0,0,23,4,0,31,0,0,0
71365,5283,2020-11-18T16:21:14.4726808Z,2019,25,24,25,6,0,Sin Grado,0,1,19,0,0,1,0,0,25,0,0,0
28548,1724,2020-11-18T16:20:48.8606018Z,2019,68,21,55,35,0,1ro,1,3,33,0,0,47,13,0,67,0,0,0
28548,1725,2020-11-18T16:20:48.8606018Z,2019,77,34,63,41,0,2do,1,2,36,0,0,43,14,0,76,0,0,0
28548,1726,2020-11-18T16:20:48.8606018Z,2019,64,15,45,35,0,3ro,1,0,29,0,0,49,19,0,62,1,0,1
28548,1727,2020-11-18T16:20:48.8606018Z,2019,77,30,62,36,0,4to,3,2,41,0,0,47,15,0,74,0,0,0
28548,1728,2020-11-18T16:20:48.8606018Z,2019,54,18,40,36,0,5to,0,3,18,0,0,36,14,0,54,0,0,0
28548,1729,2020-11-18T16:20:48.8616031Z,2019,67,18,52,36,0,6to,0,2,31,0,0,49,15,0,67,0,0,0
28548,1730,2020-11-18T16:20:48.8616031Z,2019,44,13,34,15,0,7mo,0,0,29,0,0,31,10,0,44,0,0,0
28548,1731,2020-11-18T16:20:48.8616031Z,2019,68,13,59,40,0,8vo,0,1,28,0,0,55,9,0,68,0,0,0
28548,1732,2020-11-18T16:20:48.8616031Z,2019,63,17,50,33,0,K,1,2,30,0,0,46,13,0,62,0,0,0
28548,1733,2020-11-18T16:20:48.8626035Z,2019,16,4,11,9,0,PK,0,2,7,0,0,12,5,0,16,0,0,0
28548,1734,2020-11-18T16:20:48.8626035Z,2019,23,23,18,8,0,Sin Grado,0,1,15,0,0,0,5,0,23,0,0,0
28548,31726,2021-06-24T13:18:17.2187961Z,2021,43,13,36,25,0,1ro,1,3,18,0,0,30,7,0,42,0,0,0
28548,31727,2021-06-24T13:18:17.2187961Z,2021,52,14,46,28,0,2do,2,3,24,0,0,38,6,0,50,0,0,0
28548,31728,2021-06-24T13:18:17.2187961Z,2021,51,17,40,28,0,3ro,1,7,23,0,0,34,11,0,50,0,0,0
28548,31729,2021-06-24T13:18:17.2187961Z,2021,66,26,49,35,0,4to,2,4,31,0,0,40,17,0,63,0,0,1
28548,31730,2021-06-24T13:18:17.2197966Z,2021,55,15,38,27,0,5to,1,2,28,0,0,40,17,0,53,0,0,1
28548,31731,2021-06-24T13:18:17.2197966Z,2021,58,26,44,31,0,6to,1,3,27,0,0,32,14,0,57,0,0,0
28548,31732,2021-06-24T13:18:17.2197966Z,2021,63,24,52,36,0,7mo,2,2,27,0,0,39,11,0,60,0,0,1
28548,31733,2021-06-24T13:18:17.2207984Z,2021,67,16,56,35,0,8vo,2,1,32,0,0,51,11,0,65,0,0,0
28548,31734,2021-06-24T13:18:17.2207984Z,2021,41,4,33,27,0,K,0,1,14,0,0,37,8,0,41,0,0,0
28548,31735,2021-06-24T13:18:17.2207984Z,2021,15,1,11,8,0,PK,0,0,7,0,0,14,4,0,15,0,0,0
28548,31736,2021-06-24T13:18:17.2217989Z,2021,39,39,35,17,0,Sin Grado,0,3,22,0,0,0,4,0,39,0,0,0
28548,7729,2020-11-18T16:21:47.912981Z,2020,71,24,53,33,0,1ro,1,6,38,0,0,47,18,0,70,0,0,0
28548,7730,2020-11-18T16:21:47.912981Z,2020,54,17,44,28,0,2do,1,8,26,0,0,37,10,0,53,0,0,0
28548,7731,2020-11-18T16:21:47.912981Z,2020,69,29,49,40,0,3ro,2,8,29,0,0,40,20,0,67,0,0,0
28548,7732,2020-11-18T16:21:47.912981Z,2020,59,15,43,28,0,4to,1,3,31,0,0,44,16,0,57,1,0,1
28548,7733,2020-11-18T16:21:47.912981Z,2020,68,21,48,37,0,5to,2,7,31,0,0,47,20,0,66,0,0,0
28548,7734,2020-11-18T16:21:47.913981Z,2020,58,23,47,32,0,6to,2,6,26,0,0,35,11,0,56,0,0,0
28548,7735,2020-11-18T16:21:47.913981Z,2020,66,15,51,34,0,7mo,1,7,32,0,0,51,15,0,65,0,0,0
28548,7736,2020-11-18T16:21:47.913981Z,2020,54,17,44,17,0,8vo,0,0,37,0,0,37,10,0,54,0,0,0
28548,7737,2020-11-18T16:21:47.913981Z,2020,48,14,38,25,0,K,2,5,23,0,0,34,10,0,46,0,0,0
28548,7738,2020-11-18T16:21:47.913981Z,2020,16,0,14,9,0,PK,0,2,7,0,0,16,2,0,16,0,0,0
28548,7739,2020-11-18T16:21:47.9149823Z,2020,31,31,27,14,0,Sin Grado,0,4,17,0,0,0,4,0,31,0,0,0
70011,10875,2020-11-18T16:22:06.5464088Z,2020,37,15,29,13,0,1ro,0,0,24,0,0,22,8,0,37,0,0,0
70011,10876,2020-11-18T16:22:06.5474092Z,2020,38,16,33,10,0,2do,3,0,28,0,0,22,5,0,34,0,0,1
70011,10877,2020-11-18T16:22:06.5474092Z,2020,47,14,42,18,0,3ro,0,0,29,0,0,33,5,0,47,1,0,0
70011,10878,2020-11-18T16:22:06.5474092Z,2020,46,15,35,19,0,4to,1,0,27,0,0,31,11,0,45,0,0,0
70011,10879,2020-11-18T16:22:06.5474092Z,2020,47,16,39,18,0,5to,1,1,29,0,0,31,8,0,46,0,0,0
70011,10880,2020-11-18T16:22:06.5474092Z,2020,38,9,34,16,0,K,0,0,22,0,0,29,4,0,38,0,0,0
70011,10881,2020-11-18T16:22:06.5484101Z,2020,21,21,21,10,0,Sin Grado,0,0,11,0,0,0,0,0,21,0,0,0
70011,34897,2021-06-24T13:18:42.9752712Z,2021,32,9,26,16,0,1ro,1,0,16,0,0,23,6,0,31,0,0,0
70011,34898,2021-06-24T13:18:42.9752712Z,2021,33,11,27,11,0,2do,0,0,22,0,0,22,6,0,32,0,0,1
70011,34899,2021-06-24T13:18:42.9752712Z,2021,38,16,28,13,0,3ro,3,0,25,0,0,22,10,0,33,0,0,2
70011,34900,2021-06-24T13:18:43.3075103Z,2021,51,14,39,20,0,4to,0,0,31,0,0,37,12,0,51,1,0,0
70011,34901,2021-06-24T13:18:43.3075103Z,2021,45,16,36,18,0,5to,1,1,27,0,0,29,9,0,44,0,0,0
70011,34902,2021-06-24T13:18:43.3075103Z,2021,40,15,23,16,0,K,0,0,24,0,0,25,17,0,40,0,0,0
70011,34903,2021-06-24T13:18:43.3085108Z,2021,17,17,17,9,0,Sin Grado,0,0,8,0,0,0,0,0,17,0,0,0
70011,4867,2020-11-18T16:21:12.3983014Z,2019,38,17,32,8,0,1ro,1,0,30,0,0,21,6,0,36,0,0,1
70011,4868,2020-11-18T16:21:12.3983014Z,2019,53,18,45,22,0,2do,1,0,31,0,0,35,8,0,52,1,0,0
70011,4869,2020-11-18T16:21:12.3983014Z,2019,48,17,41,19,0,3ro,1,1,29,0,0,31,7,0,47,0,0,0
70011,4870,2020-11-18T16:21:12.3983014Z,2019,46,18,42,18,0,4to,0,2,28,0,0,28,4,0,46,0,0,0
70011,4871,2020-11-18T16:21:12.3993009Z,2019,55,15,52,32,0,5to,1,0,23,0,0,40,3,0,54,0,0,0
70011,4872,2020-11-18T16:21:12.3993009Z,2019,31,9,25,13,0,K,0,0,18,0,0,22,6,0,31,0,0,0
70011,4873,2020-11-18T16:21:12.3993009Z,2019,20,20,17,12,0,Sin Grado,0,1,8,0,0,0,3,0,20,0,1,0
27383,1622,2020-11-18T16:20:48.2511986Z,2019,66,20,52,25,0,1ro,2,14,41,0,0,46,14,0,64,1,0,0
27383,1623,2020-11-18T16:20:48.2521995Z,2019,96,41,73,43,0,2do,3,16,53,0,0,55,23,0,93,2,0,0
27383,1624,2020-11-18T16:20:48.2521995Z,2019,73,28,59,41,0,3ro,0,11,32,0,0,45,14,0,73,0,0,0
27383,1625,2020-11-18T16:20:48.2521995Z,2019,64,15,51,43,0,4to,1,8,21,0,0,49,13,0,63,2,0,0
27383,1626,2020-11-18T16:20:48.2531999Z,2019,71,17,47,47,0,5to,0,11,24,0,0,54,24,0,71,1,0,0
27383,1627,2020-11-18T16:20:48.2531999Z,2019,49,14,14,23,0,K,0,11,26,0,0,35,35,0,49,2,0,0
27383,1628,2020-11-18T16:20:48.2531999Z,2019,30,28,21,8,0,Sin Grado,0,1,22,0,0,2,9,0,30,0,0,0
27383,31625,2021-06-24T13:18:16.1090019Z,2021,51,12,40,20,0,1ro,0,1,31,0,0,39,11,0,51,0,0,0
27383,31626,2021-06-24T13:18:16.1090019Z,2021,51,23,45,23,0,2do,0,0,28,0,0,28,6,0,51,2,0,0
27383,31627,2021-06-24T13:18:16.1090019Z,2021,55,17,48,23,0,3ro,1,0,32,0,0,38,7,0,54,1,0,0
27383,31628,2021-06-24T13:18:16.110001Z,2021,82,36,63,41,0,4to,1,1,41,0,0,46,19,0,81,2,0,0
27383,31629,2021-06-24T13:18:16.110001Z,2021,66,26,54,37,0,5to,1,0,29,0,0,40,12,0,65,0,0,0
27383,31630,2021-06-24T13:18:16.1110024Z,2021,50,14,42,19,0,K,1,0,31,0,0,36,8,0,49,0,0,0
27383,31631,2021-06-24T13:18:16.1110024Z,2021,1,1,1,0,0,Sin Grado,0,0,1,0,0,0,0,0,1,0,0,0
27383,7628,2020-11-18T16:21:47.1854948Z,2020,51,19,44,25,0,1ro,0,10,26,0,0,32,7,0,51,2,0,0
27383,7629,2020-11-18T16:21:47.1854948Z,2020,56,16,43,24,0,2do,1,4,32,0,0,40,13,0,55,1,0,0
27383,7630,2020-11-18T16:21:47.1854948Z,2020,82,33,59,39,0,3ro,1,9,43,0,0,49,23,0,81,3,0,0
27383,7631,2020-11-18T16:21:47.1864957Z,2020,64,24,48,36,0,4to,0,2,28,0,0,40,16,0,64,0,0,0
27383,7632,2020-11-18T16:21:47.1864957Z,2020,59,16,47,38,0,5to,1,0,21,0,0,43,12,0,58,1,0,0
27383,7633,2020-11-18T16:21:47.1864957Z,2020,48,7,41,21,0,K,0,3,27,0,0,41,7,0,48,0,0,0
27383,7634,2020-11-18T16:21:47.1864957Z,2020,25,25,23,4,0,Sin Grado,0,1,21,0,0,0,2,0,25,0,0,0
12633,30380,2021-06-24T13:18:08.8467938Z,2021,41,8,35,22,0,1ro,0,0,19,0,0,33,6,0,41,0,0,0
12633,30381,2021-06-24T13:18:08.8477943Z,2021,38,8,32,19,0,2do,0,0,19,0,0,30,6,0,38,0,0,0
12633,30382,2021-06-24T13:18:08.8477943Z,2021,36,12,32,14,0,3ro,0,0,22,0,0,24,4,0,36,0,0,0
12633,30383,2021-06-24T13:18:08.8477943Z,2021,39,12,32,17,0,4to,0,0,22,0,0,27,7,0,39,1,0,0
12633,30384,2021-06-24T13:18:08.8487952Z,2021,40,12,32,19,0,5to,0,0,21,0,0,28,8,0,40,0,0,0
12633,30385,2021-06-24T13:18:08.8487952Z,2021,45,11,36,19,0,K,0,0,26,0,0,34,9,0,45,0,0,0
12633,30386,2021-06-24T13:18:08.8487952Z,2021,1,1,1,0,0,Sin Grado,0,0,1,0,0,0,0,0,1,0,0,0
12633,382,2020-11-18T16:20:39.6484618Z,2019,26,8,23,7,0,1ro,0,0,19,0,0,18,3,0,26,0,0,0
12633,383,2020-11-18T16:20:39.6484618Z,2019,34,14,26,14,0,2do,1,0,20,0,0,20,8,0,33,0,0,0
12633,384,2020-11-18T16:20:39.6494623Z,2019,47,11,37,20,0,3ro,0,0,27,0,0,36,10,0,47,0,0,0
12633,385,2020-11-18T16:20:39.6494623Z,2019,39,14,31,23,0,4to,1,0,16,0,0,25,8,0,38,0,0,0
12633,386,2020-11-18T16:20:39.6494623Z,2019,40,10,29,21,0,5to,0,0,19,0,0,30,11,0,40,1,0,0
12633,387,2020-11-18T16:20:39.6504618Z,2019,33,5,24,21,0,K,0,0,12,0,0,28,9,0,33,0,0,0
12633,388,2020-11-18T16:20:39.6504618Z,2019,1,1,1,0,0,Sin Grado,0,0,1,0,0,0,0,0,1,0,0,0
12633,6383,2020-11-18T16:21:39.2532091Z,2020,37,7,28,20,0,1ro,0,0,17,0,0,30,9,0,37,0,0,0
12633,6384,2020-11-18T16:21:39.2542096Z,2020,26,7,21,10,0,2do,0,0,16,0,0,19,5,0,26,0,0,0
12633,6385,2020-11-18T16:21:39.2542096Z,2020,35,14,31,16,0,3ro,1,0,19,0,0,21,4,0,34,0,0,0
12633,6386,2020-11-18T16:21:39.2542096Z,2020,43,10,34,20,0,4to,0,0,23,0,0,33,9,0,43,0,0,0
12633,6387,2020-11-18T16:21:39.2552096Z,2020,39,15,27,21,0,5to,0,0,18,0,0,24,12,0,39,0,0,0
12633,6388,2020-11-18T16:21:39.2552096Z,2020,35,8,27,17,0,K,1,0,18,0,0,27,8,0,34,0,0,0
12633,6389,2020-11-18T16:21:39.2552096Z,2020,1,1,1,0,0,Sin Grado,0,0,1,0,0,0,0,0,1,0,0,0
26500,1586,2020-11-18T16:20:47.6618081Z,2019,74,33,64,24,0,1ro,1,1,50,0,0,41,10,0,72,0,0,1
26500,1587,2020-11-18T16:20:47.6618081Z,2019,72,27,62,37,0,2do,3,1,35,0,0,45,10,0,69,0,0,0
26500,1588,2020-11-18T16:20:47.6628085Z,2019,64,18,56,29,0,3ro,1,0,35,0,0,46,8,0,63,0,0,0
26500,1589,2020-11-18T16:20:47.6628085Z,2019,72,27,56,37,0,4to,1,2,35,0,0,45,16,0,71,0,0,0
26500,1590,2020-11-18T16:20:47.6628085Z,2019,63,16,52,22,0,5to,1,0,41,0,0,47,11,0,62,0,0,0
26500,1591,2020-11-18T16:20:47.6628085Z,2019,61,15,24,30,0,K,1,0,31,0,0,46,37,2,58,0,0,0
26500,1592,2020-11-18T16:20:47.663809Z,2019,9,9,8,3,0,Sin Grado,0,0,6,0,0,0,1,0,9,0,0,0
26500,31589,2021-06-24T13:18:15.8548187Z,2021,62,16,56,32,0,1ro,1,0,30,0,0,46,6,0,61,0,0,0
26500,31590,2021-06-24T13:18:15.8558197Z,2021,68,25,54,34,0,2do,0,0,34,0,0,43,14,1,67,0,0,0
26500,31591,2021-06-24T13:18:15.8558197Z,2021,49,19,43,22,0,3ro,2,0,27,0,0,30,6,0,46,0,0,1
26500,31592,2021-06-24T13:18:15.8558197Z,2021,40,14,36,21,0,4to,0,0,19,0,0,26,4,0,40,0,0,0
26500,31593,2021-06-24T13:18:15.8558197Z,2021,50,15,38,19,0,5to,0,0,31,0,0,35,12,0,50,0,0,0
26500,31594,2021-06-24T13:18:15.8568202Z,2021,31,9,23,16,0,K,0,0,15,0,0,22,8,0,31,0,0,0
26500,31595,2021-06-24T13:18:15.8578202Z,2021,1,1,1,1,0,Sin Grado,0,0,0,0,0,0,0,0,1,0,0,0
26500,7592,2020-11-18T16:21:46.3909662Z,2020,65,28,59,34,0,1ro,1,0,31,0,0,37,6,1,63,0,0,0
26500,7593,2020-11-18T16:21:46.3909662Z,2020,62,24,53,23,0,2do,4,1,39,0,0,38,9,0,57,0,0,1
26500,7594,2020-11-18T16:21:46.3919666Z,2020,45,16,40,22,0,3ro,1,0,23,0,0,29,5,0,44,0,0,0
26500,7595,2020-11-18T16:21:46.3919666Z,2020,49,14,45,21,0,4to,0,0,28,0,0,35,4,0,49,0,0,0
26500,7596,2020-11-18T16:21:46.3919666Z,2020,58,18,49,30,0,5to,1,0,28,0,0,40,9,0,57,0,0,0
26500,7597,2020-11-18T16:21:46.3919666Z,2020,75,21,70,34,0,K,2,0,41,0,0,54,5,0,73,0,0,0
26500,7598,2020-11-18T16:21:46.3929666Z,2020,2,2,2,1,0,Sin Grado,0,0,1,0,0,0,0,0,2,0,0,0
51862,33486,2021-06-24T13:18:32.4927544Z,2021,44,10,40,20,0,1ro,0,0,24,0,0,34,4,0,44,0,0,0
51862,33487,2021-06-24T13:18:32.4927544Z,2021,61,19,55,26,0,2do,2,0,35,0,0,42,6,0,59,0,0,0
51862,33488,2021-06-24T13:18:32.4927544Z,2021,67,26,58,30,0,3ro,0,0,37,0,0,41,9,0,67,0,0,0
51862,33489,2021-06-24T13:18:32.4937554Z,2021,58,18,52,25,0,4to,0,0,33,0,0,40,6,0,58,0,0,0
51862,33490,2021-06-24T13:18:32.4937554Z,2021,60,21,53,28,0,5to,0,0,32,0,0,39,7,0,59,0,0,1
51862,33491,2021-06-24T13:18:32.4937554Z,2021,45,10,38,24,0,K,0,0,21,0,0,35,7,0,43,0,0,2
51862,33492,2021-06-24T13:18:32.4947559Z,2021,9,9,9,5,0,Sin Grado,0,0,4,0,0,0,0,0,9,0,0,0
51862,3460,2020-11-18T16:21:02.563743Z,2019,60,23,51,25,0,1ro,1,0,35,0,0,37,9,0,58,0,0,1
51862,3461,2020-11-18T16:21:02.563743Z,2019,55,18,46,28,0,2do,0,2,27,0,0,37,9,0,55,0,0,0
51862,3462,2020-11-18T16:21:02.5647448Z,2019,68,26,56,28,0,3ro,0,2,40,0,0,42,12,0,67,0,0,1
51862,3463,2020-11-18T16:21:02.5647448Z,2019,73,15,56,38,0,4to,1,1,35,0,0,58,17,0,71,0,0,1
51862,3464,2020-11-18T16:21:02.5647448Z,2019,77,17,60,42,0,5to,1,2,35,0,0,60,17,1,75,0,0,0
51862,3465,2020-11-18T16:21:02.5647448Z,2019,57,14,45,24,0,K,1,2,33,0,0,43,12,1,55,0,0,0
51862,3466,2020-11-18T16:21:02.5657448Z,2019,17,17,17,9,0,Sin Grado,0,0,8,0,0,0,0,0,17,0,0,0
51862,9481,2020-11-18T16:21:58.4440028Z,2020,62,20,55,26,0,1ro,2,3,36,0,0,42,7,0,60,0,0,0
51862,9482,2020-11-18T16:21:58.4440028Z,2020,63,24,55,29,0,2do,0,3,34,0,0,39,8,0,63,0,0,0
51862,9483,2020-11-18T16:21:58.4440028Z,2020,57,15,51,26,0,3ro,0,4,31,0,0,42,6,0,57,0,0,0
51862,9484,2020-11-18T16:21:58.4440028Z,2020,68,23,57,32,0,4to,0,7,36,0,0,45,11,0,67,0,0,1
51862,9485,2020-11-18T16:21:58.4440028Z,2020,70,14,59,38,0,5to,1,10,32,0,0,56,11,0,68,0,0,1
51862,9486,2020-11-18T16:21:58.4440028Z,2020,55,14,47,22,0,K,0,0,33,0,0,41,8,0,55,0,0,0
51862,9487,2020-11-18T16:21:58.4450037Z,2020,17,16,17,9,0,Sin Grado,0,0,8,0,0,1,0,0,17,0,0,0
35899,2391,2020-11-18T16:20:55.7491976Z,2019,22,6,20,7,0,1ro,2,2,15,0,0,16,2,0,20,0,0,0
35899,2392,2020-11-18T16:20:55.7491976Z,2019,14,4,13,3,0,2do,1,1,11,0,0,10,1,0,13,0,1,0
35899,2393,2020-11-18T16:20:55.7501985Z,2019,24,8,22,11,0,3ro,0,1,13,0,0,16,2,0,24,0,0,0
35899,2394,2020-11-18T16:20:55.7501985Z,2019,24,3,22,12,0,4to,2,3,12,0,0,21,2,0,22,0,0,0
35899,2395,2020-11-18T16:20:55.7501985Z,2019,18,4,17,10,0,5to,1,3,8,0,0,14,1,0,17,0,0,0
35899,2396,2020-11-18T16:20:55.7501985Z,2019,34,12,27,16,0,6to,0,3,18,0,0,22,7,0,34,0,0,0
35899,2397,2020-11-18T16:20:55.7501985Z,2019,35,11,32,19,0,7mo,1,2,16,0,0,24,3,0,34,0,0,0
35899,2398,2020-11-18T16:20:55.751198Z,2019,43,15,38,19,0,8vo,3,1,24,0,0,28,5,0,40,0,1,0
35899,2399,2020-11-18T16:20:55.751198Z,2019,21,3,19,17,0,K,0,0,4,0,0,18,2,0,21,0,0,0
35899,2400,2020-11-18T16:20:55.751198Z,2019,23,22,19,5,0,Sin Grado,0,4,18,0,0,1,4,1,22,0,1,0
35899,32399,2021-06-24T13:18:23.6283924Z,2021,16,3,14,8,0,1ro,0,1,8,0,0,13,2,0,16,0,0,0
35899,32400,2021-06-24T13:18:24.6911582Z,2021,23,2,22,13,0,2do,0,3,10,0,0,21,1,0,23,1,0,0
35899,32401,2021-06-24T13:18:24.6911582Z,2021,24,6,21,8,0,3ro,2,5,16,0,0,18,3,0,22,0,0,0
35899,32402,2021-06-24T13:18:24.6911582Z,2021,13,4,12,3,0,4to,1,1,10,0,0,9,1,0,12,0,1,0
35899,32403,2021-06-24T13:18:24.6911582Z,2021,22,7,20,10,0,5to,0,3,12,0,0,15,2,0,22,0,0,0
35899,32404,2021-06-24T13:18:24.6921592Z,2021,30,5,27,16,0,6to,2,1,14,0,0,25,3,0,28,0,0,0
35899,32405,2021-06-24T13:18:24.6921592Z,2021,32,11,30,15,0,7mo,1,2,17,0,0,21,2,0,31,0,0,0
35899,32406,2021-06-24T13:18:24.6921592Z,2021,25,8,23,12,0,8vo,0,1,13,0,0,17,2,0,25,0,0,0
35899,32407,2021-06-24T13:18:24.6921592Z,2021,19,7,18,8,0,K,0,2,11,0,0,12,1,0,18,0,0,1
35899,32408,2021-06-24T13:18:24.6921592Z,2021,19,19,14,3,0,Sin Grado,0,3,16,0,0,0,5,1,18,0,1,0
35899,8404,2020-11-18T16:21:51.7875621Z,2020,20,2,19,12,0,1ro,0,0,8,0,0,18,1,0,20,0,0,0
35899,8405,2020-11-18T16:21:51.7875621Z,2020,26,6,23,10,0,2do,2,0,16,0,0,20,3,0,24,0,0,0
35899,8406,2020-11-18T16:21:51.7885643Z,2020,14,4,12,4,0,3ro,1,0,10,0,0,10,2,0,13,0,1,0
35899,8407,2020-11-18T16:21:51.7885643Z,2020,24,6,21,11,0,4to,0,0,13,0,0,18,3,0,24,0,0,0
35899,8408,2020-11-18T16:21:51.7885643Z,2020,25,4,20,13,0,5to,2,0,12,0,0,21,5,0,23,0,0,0
35899,8409,2020-11-18T16:21:51.7895643Z,2020,32,11,32,17,0,6to,1,0,15,0,0,21,0,0,31,0,0,0
35899,8410,2020-11-18T16:21:51.7895643Z,2020,28,8,22,15,0,7mo,0,0,13,0,0,20,6,0,28,0,0,0
35899,8411,2020-11-18T16:21:51.7895643Z,2020,35,10,32,18,0,8vo,1,0,17,0,0,25,3,0,34,0,0,0
35899,8412,2020-11-18T16:21:51.7905647Z,2020,25,5,20,11,0,K,0,0,14,0,0,20,5,0,25,0,0,0
35899,8413,2020-11-18T16:21:51.7905647Z,2020,23,23,19,3,0,Sin Grado,0,0,20,0,0,0,4,1,22,0,1,0
61564,10296,2020-11-18T16:22:03.1371311Z,2020,124,50,109,53,0,6to,6,0,71,0,0,74,15,1,117,4,1,0
61564,10297,2020-11-18T16:22:03.1371311Z,2020,131,41,110,64,0,7mo,6,0,67,0,0,90,21,0,124,5,0,1
61564,10298,2020-11-18T16:22:03.138132Z,2020,141,50,121,67,0,8vo,5,1,74,0,0,91,20,0,135,4,0,1
61564,10299,2020-11-18T16:22:03.138132Z,2020,8,8,8,2,0,Sin Grado,0,0,6,0,0,0,0,0,8,0,0,0
61564,34311,2021-06-24T13:18:38.598133Z,2021,147,58,127,67,0,6to,7,1,80,0,0,89,20,0,139,1,0,1
61564,34312,2021-06-24T13:18:38.598133Z,2021,145,58,127,63,0,7mo,12,0,82,0,0,87,18,0,133,4,0,0
61564,34313,2021-06-24T13:18:38.5991335Z,2021,140,45,120,66,0,8vo,8,0,74,0,0,95,20,0,131,5,0,1
61564,34314,2021-06-24T13:18:38.5991335Z,2021,11,11,11,5,0,Sin Grado,0,0,6,0,0,0,0,0,11,0,0,0
61564,4282,2020-11-18T16:21:09.0380596Z,2019,127,41,108,56,0,6to,7,0,71,0,0,86,19,0,119,5,0,1
61564,4283,2020-11-18T16:21:09.03906Z,2019,159,57,137,76,0,7mo,9,0,83,0,0,102,22,0,149,4,0,1
61564,4284,2020-11-18T16:21:09.03906Z,2019,160,65,136,67,0,8vo,8,1,93,0,0,95,24,0,150,1,0,2
61564,4285,2020-11-18T16:21:09.03906Z,2019,10,8,10,4,0,Sin Grado,1,0,6,0,0,2,0,0,9,0,0,0
